GAME_ID,TEAM_ID_home,TEAM_ID_away,PTS_home,PTS_away,FG_PCT_home,FG_PCT_away,HOME_TEAM_WINS,GAME_DATE,G_home,W_home,L_home,W_PCT_home,G_away,W_away,L_away,W_PCT_away
22200477,1610612740,1610612759,126.0,117.0,0.484,0.478,1,2022-12-22,31,19,12,0.613,31,10,21,0.323
22200478,1610612762,1610612764,120.0,112.0,0.488,0.561,1,2022-12-22,35,19,16,0.543,33,12,21,0.364
22200466,1610612739,1610612749,114.0,106.0,0.482,0.47,1,2022-12-21,33,22,11,0.667,31,22,9,0.71
22200467,1610612755,1610612765,113.0,93.0,0.441,0.392,1,2022-12-21,30,18,12,0.6,34,8,26,0.235
22200468,1610612737,1610612741,108.0,110.0,0.429,0.5,0,2022-12-21,32,16,16,0.5,31,13,18,0.419
22200469,1610612738,1610612754,112.0,117.0,0.386,0.469,0,2022-12-21,32,22,10,0.688,32,16,16,0.5
22200470,1610612751,1610612744,143.0,113.0,0.643,0.494,1,2022-12-21,32,20,12,0.625,33,15,18,0.455
22200471,1610612752,1610612761,106.0,113.0,0.553,0.447,0,2022-12-21,32,18,14,0.563,32,14,18,0.438
22200472,1610612745,1610612753,110.0,116.0,0.466,0.451,0,2022-12-21,31,9,22,0.29,33,12,21,0.364
22200473,1610612750,1610612742,99.0,104.0,0.494,0.453,0,2022-12-21,32,16,16,0.5,32,16,16,0.5
22200474,1610612760,1610612757,101.0,98.0,0.468,0.494,1,2022-12-21,32,14,18,0.438,32,17,15,0.531
22200475,1610612758,1610612747,134.0,120.0,0.505,0.5,1,2022-12-21,30,17,13,0.567,31,13,18,0.419
22200476,1610612746,1610612766,126.0,105.0,0.506,0.402,1,2022-12-21,33,19,14,0.576,32,8,24,0.25
22200461,1610612765,1610612762,111.0,126.0,0.506,0.505,0,2022-12-20,33,8,25,0.242,34,18,16,0.529
22200462,1610612748,1610612741,103.0,113.0,0.469,0.548,0,2022-12-20,32,16,16,0.5,30,12,18,0.4
22200463,1610612752,1610612744,132.0,94.0,0.517,0.473,1,2022-12-20,31,18,13,0.581,32,15,17,0.469
22200464,1610612756,1610612764,110.0,113.0,0.461,0.475,0,2022-12-20,32,19,13,0.594,32,12,20,0.375
22200465,1610612743,1610612763,105.0,91.0,0.449,0.444,1,2022-12-20,30,19,11,0.633,30,19,11,0.633
22200452,1610612739,1610612762,122.0,99.0,0.614,0.387,1,2022-12-19,32,21,11,0.656,33,17,16,0.515
22200453,1610612755,1610612761,104.0,101.0,0.4,0.42,1,2022-12-19,29,17,12,0.586,31,13,18,0.419
22200454,1610612737,1610612753,126.0,125.0,0.511,0.474,1,2022-12-19,31,16,15,0.516,32,11,21,0.344
22200455,1610612745,1610612759,105.0,124.0,0.426,0.554,0,2022-12-19,30,9,21,0.3,30,10,20,0.333
22200456,1610612750,1610612742,116.0,106.0,0.472,0.408,1,2022-12-19,31,16,15,0.516,31,15,16,0.484
22200457,1610612740,1610612749,119.0,128.0,0.424,0.556,0,2022-12-19,30,18,12,0.6,30,22,8,0.733
22200458,1610612760,1610612757,123.0,121.0,0.455,0.5,1,2022-12-19,31,13,18,0.419,31,17,14,0.548
22200459,1610612756,1610612747,130.0,104.0,0.495,0.448,1,2022-12-19,31,19,12,0.613,30,13,17,0.433
22200460,1610612758,1610612766,119.0,125.0,0.474,0.516,0,2022-12-19,29,16,13,0.552,31,8,23,0.258
22200445,1610612738,1610612753,92.0,95.0,0.348,0.384,0,2022-12-18,31,22,9,0.71,31,11,20,0.355
22200446,1610612754,1610612752,106.0,109.0,0.433,0.47,0,2022-12-18,31,15,16,0.484,30,17,13,0.567
22200447,1610612765,1610612751,121.0,124.0,0.477,0.55,0,2022-12-18,32,8,24,0.25,31,19,12,0.613
22200448,1610612761,1610612744,110.0,126.0,0.421,0.531,0,2022-12-18,30,13,17,0.433,31,15,16,0.484
22200449,1610612750,1610612741,150.0,126.0,0.655,0.523,1,2022-12-18,30,15,15,0.5,29,11,18,0.379
22200450,1610612743,1610612766,119.0,115.0,0.457,0.427,1,2022-12-18,29,18,11,0.621,30,7,23,0.233
22200451,1610612747,1610612764,119.0,117.0,0.5,0.463,1,2022-12-18,29,13,16,0.448,31,11,20,0.355
22200438,1610612746,1610612764,102.0,93.0,0.43,0.429,1,2022-12-17,32,18,14,0.563,30,11,19,0.367
22200439,1610612759,1610612748,101.0,111.0,0.429,0.512,0,2022-12-17,29,9,20,0.31,31,16,15,0.516
22200440,1610612739,1610612742,100.0,99.0,0.426,0.409,1,2022-12-17,31,20,11,0.645,30,15,15,0.5
22200441,1610612745,1610612757,95.0,107.0,0.4,0.471,0,2022-12-17,29,9,20,0.31,30,17,13,0.567
22200442,1610612749,1610612762,123.0,97.0,0.533,0.453,1,2022-12-17,29,21,8,0.724,32,17,15,0.531
22200443,1610612760,1610612763,115.0,109.0,0.413,0.378,1,2022-12-17,30,12,18,0.4,29,19,10,0.655
22200444,1610612756,1610612740,118.0,114.0,0.47,0.584,1,2022-12-17,30,18,12,0.6,29,18,11,0.621
22200428,1610612766,1610612737,106.0,125.0,0.398,0.547,0,2022-12-16,29,7,22,0.241,30,15,15,0.5
22200429,1610612765,1610612758,113.0,122.0,0.459,0.524,0,2022-12-16,31,8,23,0.258,28,16,12,0.571
22200430,1610612738,1610612753,109.0,117.0,0.417,0.462,0,2022-12-16,30,22,8,0.733,30,10,20,0.333
22200431,1610612739,1610612754,118.0,112.0,0.5,0.525,1,2022-12-16,30,19,11,0.633,30,15,15,0.5
22200432,1610612755,1610612744,118.0,106.0,0.459,0.415,1,2022-12-16,28,16,12,0.571,30,14,16,0.467
22200433,1610612761,1610612751,116.0,119.0,0.488,0.605,0,2022-12-16,29,13,16,0.448,30,18,12,0.6
22200434,1610612741,1610612752,91.0,114.0,0.468,0.402,0,2022-12-16,28,11,17,0.393,29,16,13,0.552
22200435,1610612760,1610612750,110.0,112.0,0.466,0.494,0,2022-12-16,29,11,18,0.379,29,14,15,0.483
22200436,1610612742,1610612757,130.0,110.0,0.556,0.438,1,2022-12-16,29,15,14,0.517,29,16,13,0.552
22200437,1610612747,1610612743,126.0,108.0,0.527,0.481,1,2022-12-16,28,12,16,0.429,28,17,11,0.607
22200424,1610612745,1610612748,108.0,111.0,0.468,0.443,0,2022-12-15,28,9,19,0.321,30,15,15,0.5
22200425,1610612763,1610612749,142.0,101.0,0.549,0.372,1,2022-12-15,28,19,9,0.679,28,20,8,0.714
22200426,1610612762,1610612740,132.0,129.0,0.457,0.475,1,2022-12-15,31,17,14,0.548,28,18,10,0.643
22200427,1610612746,1610612756,95.0,111.0,0.378,0.463,0,2022-12-15,31,17,14,0.548,29,17,12,0.586
22200414,1610612766,1610612765,134.0,141.0,0.412,0.516,0,2022-12-14,28,7,21,0.25,30,8,22,0.267
22200415,1610612754,1610612744,125.0,119.0,0.506,0.465,1,2022-12-14,29,15,14,0.517,29,14,15,0.483
22200416,1610612753,1610612737,135.0,124.0,0.505,0.5,1,2022-12-14,29,9,20,0.31,29,14,15,0.483
22200417,1610612761,1610612758,123.0,124.0,0.5,0.484,0,2022-12-14,28,13,15,0.464,27,15,12,0.556
22200418,1610612741,1610612752,120.0,128.0,0.548,0.495,0,2022-12-14,27,11,16,0.407,28,15,13,0.536
22200419,1610612760,1610612748,108.0,110.0,0.5,0.43,0,2022-12-14,28,11,17,0.393,29,14,15,0.483
22200420,1610612759,1610612757,112.0,128.0,0.464,0.605,0,2022-12-14,28,9,19,0.321,28,16,12,0.571
22200421,1610612742,1610612739,90.0,105.0,0.392,0.526,0,2022-12-14,28,14,14,0.5,29,18,11,0.621
22200422,1610612743,1610612764,141.0,128.0,0.651,0.527,1,2022-12-14,27,17,10,0.63,29,11,18,0.379
22200423,1610612746,1610612750,99.0,88.0,0.382,0.419,1,2022-12-14,30,17,13,0.567,28,13,15,0.464
22200409,1610612755,1610612758,123.0,103.0,0.512,0.413,1,2022-12-13,27,15,12,0.556,26,14,12,0.538
22200410,1610612749,1610612744,128.0,111.0,0.549,0.4,1,2022-12-13,27,20,7,0.741,28,14,14,0.5
22200411,1610612745,1610612756,111.0,97.0,0.42,0.32,1,2022-12-13,27,9,18,0.333,28,16,12,0.571
22200412,1610612762,1610612740,121.0,100.0,0.476,0.398,1,2022-12-13,30,16,14,0.533,27,18,9,0.667
22200413,1610612747,1610612738,118.0,122.0,0.473,0.442,0,2022-12-13,27,11,16,0.407,29,22,7,0.759
22200402,1610612754,1610612748,82.0,87.0,0.354,0.386,0,2022-12-12,28,14,14,0.5,28,13,15,0.464
22200403,1610612764,1610612751,100.0,112.0,0.468,0.494,0,2022-12-12,28,11,17,0.393,29,17,12,0.586
22200404,1610612763,1610612737,128.0,103.0,0.602,0.356,1,2022-12-12,27,18,9,0.667,28,14,14,0.5
22200405,1610612742,1610612760,121.0,114.0,0.419,0.477,1,2022-12-12,27,14,13,0.519,27,11,16,0.407
22200406,1610612759,1610612739,112.0,111.0,0.474,0.489,1,2022-12-12,27,9,18,0.333,28,17,11,0.607
22200407,1610612757,1610612750,133.0,112.0,0.539,0.495,1,2022-12-12,27,15,12,0.556,27,13,14,0.481
22200408,1610612746,1610612738,113.0,93.0,0.489,0.434,1,2022-12-12,29,16,13,0.552,28,21,7,0.75
22200395,1610612740,1610612756,129.0,124.0,0.581,0.467,1,2022-12-11,26,18,8,0.692,27,16,11,0.593
22200396,1610612765,1610612747,117.0,124.0,0.462,0.548,0,2022-12-11,29,7,22,0.241,26,11,15,0.423
22200397,1610612752,1610612758,112.0,99.0,0.449,0.398,1,2022-12-11,27,14,13,0.519,25,14,11,0.56
22200398,1610612753,1610612761,111.0,99.0,0.468,0.4,1,2022-12-11,28,8,20,0.286,27,13,14,0.481
22200399,1610612755,1610612766,131.0,113.0,0.554,0.409,1,2022-12-11,26,14,12,0.538,27,7,20,0.259
22200400,1610612737,1610612741,123.0,122.0,0.48,0.48,1,2022-12-11,27,14,13,0.519,26,11,15,0.423
22200401,1610612745,1610612749,97.0,92.0,0.44,0.367,1,2022-12-11,26,8,18,0.308,26,19,7,0.731
22200387,1610612748,1610612759,111.0,115.0,0.481,0.538,0,2022-12-10,27,12,15,0.444,26,8,18,0.308
22200388,1610612754,1610612751,133.0,136.0,0.553,0.52,0,2022-12-10,27,14,13,0.519,28,16,12,0.571
22200389,1610612764,1610612746,107.0,114.0,0.435,0.426,0,2022-12-10,27,11,16,0.407,28,15,13,0.536
22200390,1610612739,1610612760,110.0,102.0,0.471,0.458,1,2022-12-10,27,17,10,0.63,26,11,15,0.423
22200391,1610612741,1610612742,144.0,115.0,0.635,0.456,1,2022-12-10,25,11,14,0.44,26,13,13,0.5
22200392,1610612744,1610612738,123.0,107.0,0.511,0.437,1,2022-12-10,27,14,13,0.519,27,21,6,0.778
22200393,1610612743,1610612762,115.0,110.0,0.547,0.459,1,2022-12-10,26,16,10,0.615,29,15,14,0.517
22200394,1610612757,1610612750,124.0,118.0,0.518,0.542,1,2022-12-10,26,14,12,0.538,26,13,13,0.5
22200377,1610612766,1610612752,102.0,121.0,0.44,0.441,0,2022-12-09,26,7,19,0.269,26,13,13,0.5
22200378,1610612754,1610612764,121.0,111.0,0.506,0.532,1,2022-12-09,26,14,12,0.538,26,11,15,0.423
22200379,1610612753,1610612761,113.0,109.0,0.592,0.424,1,2022-12-09,27,7,20,0.259,26,13,13,0.5
22200380,1610612751,1610612737,120.0,116.0,0.542,0.495,1,2022-12-09,27,15,12,0.556,26,13,13,0.5
22200381,1610612739,1610612758,95.0,106.0,0.43,0.53,0,2022-12-09,26,16,10,0.615,24,14,10,0.583
22200382,1610612755,1610612747,133.0,122.0,0.533,0.5,1,2022-12-09,25,13,12,0.52,25,10,15,0.4
22200383,1610612763,1610612765,114.0,103.0,0.484,0.4,1,2022-12-09,26,17,9,0.654,28,7,21,0.25
22200384,1610612740,1610612756,128.0,117.0,0.511,0.5,1,2022-12-09,25,17,8,0.68,26,16,10,0.615
22200385,1610612762,1610612750,108.0,118.0,0.433,0.532,0,2022-12-09,28,15,13,0.536,25,13,12,0.52
22200386,1610612742,1610612749,105.0,106.0,0.466,0.437,0,2022-12-09,25,13,12,0.52,25,19,6,0.76
22200374,1610612748,1610612746,115.0,110.0,0.511,0.463,1,2022-12-08,26,12,14,0.462,27,14,13,0.519
22200375,1610612759,1610612745,118.0,109.0,0.554,0.449,1,2022-12-08,25,7,18,0.28,25,7,18,0.28
22200376,1610612757,1610612743,120.0,121.0,0.484,0.516,0,2022-12-08,25,13,12,0.52,25,15,10,0.6
22200363,1610612753,1610612746,116.0,111.0,0.421,0.411,1,2022-12-07,26,6,20,0.231,26,14,12,0.538
22200364,1610612751,1610612766,122.0,116.0,0.57,0.534,1,2022-12-07,26,14,12,0.538,25,7,18,0.28
22200365,1610612752,1610612737,113.0,89.0,0.446,0.376,1,2022-12-07,25,12,13,0.48,25,13,12,0.52
22200366,1610612761,1610612747,126.0,113.0,0.443,0.425,1,2022-12-07,25,13,12,0.52,24,10,14,0.417
22200367,1610612741,1610612764,115.0,111.0,0.5,0.488,1,2022-12-07,24,10,14,0.417,25,11,14,0.44
22200368,1610612763,1610612760,123.0,102.0,0.511,0.37,1,2022-12-07,25,16,9,0.64,25,11,14,0.44
22200369,1610612749,1610612758,126.0,113.0,0.479,0.473,1,2022-12-07,24,18,6,0.75,23,13,10,0.565
22200370,1610612750,1610612754,121.0,115.0,0.473,0.481,1,2022-12-07,24,12,12,0.5,25,13,12,0.52
22200371,1610612740,1610612765,104.0,98.0,0.459,0.389,1,2022-12-07,24,16,8,0.667,27,7,20,0.259
22200372,1610612762,1610612744,124.0,123.0,0.535,0.459,1,2022-12-07,27,15,12,0.556,26,13,13,0.5
22200373,1610612756,1610612738,98.0,125.0,0.398,0.485,0,2022-12-07,25,16,9,0.64,26,21,5,0.808
22200360,1610612739,1610612747,116.0,102.0,0.516,0.427,1,2022-12-06,25,16,9,0.64,23,10,13,0.435
22200361,1610612748,1610612765,96.0,116.0,0.429,0.494,0,2022-12-06,25,11,14,0.44,26,7,19,0.269
22200362,1610612743,1610612742,115.0,116.0,0.513,0.5,0,2022-12-06,24,14,10,0.583,24,13,11,0.542
22200352,1610612766,1610612746,117.0,119.0,0.48,0.484,0,2022-12-05,24,7,17,0.292,25,14,11,0.56
22200353,1610612753,1610612749,102.0,109.0,0.366,0.447,0,2022-12-05,25,5,20,0.2,23,17,6,0.739
22200354,1610612737,1610612760,114.0,121.0,0.431,0.453,0,2022-12-05,24,13,11,0.542,24,11,13,0.458
22200355,1610612761,1610612738,110.0,116.0,0.459,0.489,0,2022-12-05,24,12,12,0.5,25,20,5,0.8
22200356,1610612745,1610612755,132.0,123.0,0.447,0.448,1,2022-12-05,24,7,17,0.292,24,12,12,0.5
22200357,1610612763,1610612748,101.0,93.0,0.467,0.392,1,2022-12-05,24,15,9,0.625,24,11,13,0.458
22200358,1610612742,1610612756,130.0,111.0,0.524,0.44,1,2022-12-05,23,12,11,0.522,24,16,8,0.667
22200359,1610612744,1610612754,104.0,112.0,0.404,0.478,0,2022-12-05,25,13,12,0.52,24,13,11,0.542
22200344,1610612740,1610612743,121.0,106.0,0.506,0.506,1,2022-12-04,23,15,8,0.652,23,14,9,0.609
22200345,1610612759,1610612756,95.0,133.0,0.437,0.521,0,2022-12-04,24,6,18,0.25,23,16,7,0.696
22200346,1610612751,1610612738,92.0,103.0,0.405,0.432,0,2022-12-04,25,13,12,0.52,24,19,5,0.792
22200347,1610612765,1610612763,112.0,122.0,0.44,0.467,0,2022-12-04,25,6,19,0.24,23,14,9,0.609
22200348,1610612752,1610612739,92.0,81.0,0.407,0.349,1,2022-12-04,24,11,13,0.458,24,15,9,0.625
22200349,1610612764,1610612747,119.0,130.0,0.467,0.542,0,2022-12-04,24,11,13,0.458,22,10,12,0.455
22200350,1610612758,1610612741,110.0,101.0,0.465,0.442,1,2022-12-04,22,13,9,0.591,23,9,14,0.391
22200351,1610612757,1610612754,116.0,100.0,0.488,0.44,1,2022-12-04,24,13,11,0.542,23,12,11,0.522
22200337,1610612752,1610612742,100.0,121.0,0.455,0.43,0,2022-12-03,23,10,13,0.435,22,11,11,0.5
22200338,1610612746,1610612758,96.0,123.0,0.355,0.517,0,2022-12-03,24,13,11,0.542,21,12,9,0.571
22200339,1610612766,1610612749,96.0,105.0,0.391,0.47,0,2022-12-03,23,7,16,0.304,22,16,6,0.727
22200340,1610612761,1610612753,121.0,108.0,0.56,0.487,1,2022-12-03,23,12,11,0.522,24,5,19,0.208
22200341,1610612750,1610612760,128.0,135.0,0.528,0.516,0,2022-12-03,23,11,12,0.478,23,10,13,0.435
22200342,1610612744,1610612745,120.0,101.0,0.529,0.44,1,2022-12-03,24,13,11,0.542,23,6,17,0.261
22200343,1610612762,1610612757,111.0,116.0,0.452,0.482,0,2022-12-03,26,14,12,0.538,23,12,11,0.522
22200326,1610612766,1610612764,117.0,116.0,0.421,0.453,1,2022-12-02,22,7,15,0.318,23,11,12,0.478
22200327,1610612737,1610612743,117.0,109.0,0.557,0.529,1,2022-12-02,23,13,10,0.565,22,14,8,0.636
22200328,1610612738,1610612748,116.0,120.0,0.46,0.475,0,2022-12-02,23,18,5,0.783,23,11,12,0.478
22200329,1610612751,1610612761,114.0,105.0,0.537,0.437,1,2022-12-02,24,13,11,0.542,22,11,11,0.5
22200330,1610612739,1610612753,107.0,96.0,0.488,0.494,1,2022-12-02,23,15,8,0.652,23,5,18,0.217
22200331,1610612749,1610612747,129.0,133.0,0.532,0.542,0,2022-12-02,21,15,6,0.714,21,9,12,0.429
22200332,1610612763,1610612755,117.0,109.0,0.433,0.44,1,2022-12-02,22,13,9,0.591,23,12,11,0.522
22200333,1610612759,1610612740,99.0,117.0,0.388,0.435,0,2022-12-02,23,6,17,0.261,22,14,8,0.636
22200334,1610612756,1610612745,121.0,122.0,0.529,0.494,0,2022-12-02,22,15,7,0.682,22,6,16,0.273
22200335,1610612762,1610612754,139.0,119.0,0.554,0.435,1,2022-12-02,25,14,11,0.56,22,12,10,0.545
22200336,1610612744,1610612741,119.0,111.0,0.483,0.462,1,2022-12-02,23,12,11,0.522,22,9,13,0.409
22200325,1610612765,1610612742,131.0,125.0,0.543,0.535,1,2022-12-01,24,6,18,0.25,21,10,11,0.476
22200312,1610612739,1610612755,113.0,85.0,0.608,0.416,1,2022-11-30,22,14,8,0.636,22,12,10,0.545
22200313,1610612753,1610612737,108.0,125.0,0.494,0.543,0,2022-11-30,22,5,17,0.227,22,12,10,0.545
22200314,1610612738,1610612748,134.0,121.0,0.554,0.522,1,2022-11-30,22,18,4,0.818,22,10,12,0.455
22200315,1610612751,1610612764,113.0,107.0,0.464,0.438,1,2022-11-30,23,12,11,0.522,22,11,11,0.5
22200316,1610612752,1610612749,103.0,109.0,0.42,0.433,0,2022-11-30,22,10,12,0.455,20,15,5,0.75
22200317,1610612750,1610612763,109.0,101.0,0.461,0.425,1,2022-11-30,22,11,11,0.5,21,12,9,0.571
22200318,1610612740,1610612761,126.0,108.0,0.523,0.477,1,2022-11-30,21,13,8,0.619,21,11,10,0.524
22200319,1610612760,1610612759,119.0,111.0,0.511,0.446,1,2022-11-30,22,9,13,0.409,22,6,16,0.273
22200320,1610612743,1610612745,120.0,100.0,0.53,0.42,1,2022-11-30,21,14,7,0.667,21,5,16,0.238
22200321,1610612756,1610612741,132.0,113.0,0.527,0.5,1,2022-11-30,21,15,6,0.714,21,9,12,0.429
22200322,1610612762,1610612746,125.0,112.0,0.556,0.398,1,2022-11-30,24,13,11,0.542,23,13,10,0.565
22200323,1610612758,1610612754,137.0,114.0,0.505,0.4,1,2022-11-30,20,11,9,0.55,21,12,9,0.571
22200324,1610612747,1610612757,128.0,109.0,0.495,0.467,1,2022-11-30,20,8,12,0.4,22,11,11,0.5
22200309,1610612765,1610612752,110.0,140.0,0.506,0.563,0,2022-11-29,23,5,18,0.217,21,10,11,0.476
22200310,1610612742,1610612744,116.0,113.0,0.462,0.477,1,2022-11-29,20,10,10,0.5,22,11,11,0.5
22200311,1610612757,1610612746,112.0,118.0,0.467,0.461,0,2022-11-29,21,11,10,0.524,22,13,9,0.591
22200299,1610612755,1610612737,104.0,101.0,0.453,0.5,1,2022-11-28,21,12,9,0.571,21,11,10,0.524
22200300,1610612764,1610612750,142.0,127.0,0.571,0.5,1,2022-11-28,21,11,10,0.524,21,10,11,0.476
22200301,1610612738,1610612766,140.0,105.0,0.591,0.488,1,2022-11-28,21,17,4,0.81,21,6,15,0.286
22200302,1610612751,1610612753,109.0,102.0,0.543,0.475,1,2022-11-28,22,11,11,0.5,21,5,16,0.238
22200303,1610612761,1610612739,100.0,88.0,0.44,0.378,1,2022-11-28,20,11,9,0.55,21,13,8,0.619
22200304,1610612740,1610612760,105.0,101.0,0.448,0.37,1,2022-11-28,20,12,8,0.6,21,8,13,0.381
22200305,1610612743,1610612745,129.0,113.0,0.568,0.459,1,2022-11-28,20,13,7,0.65,20,5,15,0.25
22200306,1610612762,1610612741,107.0,114.0,0.482,0.462,0,2022-11-28,23,12,11,0.522,20,9,11,0.45
22200307,1610612758,1610612756,117.0,122.0,0.523,0.532,0,2022-11-28,19,10,9,0.526,20,14,6,0.7
22200308,1610612747,1610612754,115.0,116.0,0.43,0.41,0,2022-11-28,19,7,12,0.368,20,12,8,0.6
22200290,1610612751,1610612757,111.0,97.0,0.526,0.443,1,2022-11-27,21,10,11,0.476,20,11,9,0.55
22200291,1610612750,1610612744,114.0,137.0,0.443,0.575,0,2022-11-27,20,10,10,0.5,21,11,10,0.524
22200292,1610612746,1610612754,114.0,100.0,0.447,0.383,1,2022-11-27,21,12,9,0.571,19,11,8,0.579
22200293,1610612737,1610612748,98.0,106.0,0.398,0.488,0,2022-11-27,20,11,9,0.55,21,10,11,0.476
22200294,1610612738,1610612764,130.0,121.0,0.55,0.537,1,2022-11-27,20,16,4,0.8,20,10,10,0.5
22200295,1610612765,1610612739,94.0,102.0,0.456,0.429,0,2022-11-27,22,5,17,0.227,20,13,7,0.65
22200296,1610612752,1610612763,123.0,127.0,0.506,0.484,0,2022-11-27,20,9,11,0.45,20,12,8,0.6
22200297,1610612753,1610612755,103.0,133.0,0.456,0.649,0,2022-11-27,20,5,15,0.25,20,11,9,0.55
22200298,1610612749,1610612742,124.0,115.0,0.558,0.513,1,2022-11-27,19,14,5,0.737,19,9,10,0.474
22200286,1610612761,1610612742,105.0,100.0,0.432,0.479,1,2022-11-26,19,10,9,0.526,18,9,9,0.5
22200287,1610612745,1610612760,118.0,105.0,0.523,0.392,1,2022-11-26,19,5,14,0.263,20,8,12,0.4
22200288,1610612759,1610612747,138.0,143.0,0.505,0.58,0,2022-11-26,21,6,15,0.286,18,7,11,0.389
22200289,1610612756,1610612762,113.0,112.0,0.457,0.506,1,2022-11-26,19,13,6,0.684,22,12,10,0.545
22200272,1610612766,1610612750,110.0,108.0,0.449,0.427,1,2022-11-25,20,6,14,0.3,19,10,9,0.526
22200273,1610612753,1610612755,99.0,107.0,0.425,0.476,0,2022-11-25,19,5,14,0.263,19,10,9,0.526
22200274,1610612752,1610612757,129.0,132.0,0.438,0.494,0,2022-11-25,19,9,10,0.474,19,11,8,0.579
22200275,1610612738,1610612758,122.0,104.0,0.494,0.414,1,2022-11-25,19,15,4,0.789,18,10,8,0.556
22200276,1610612754,1610612751,128.0,117.0,0.5,0.534,1,2022-11-25,18,11,7,0.611,20,9,11,0.45
22200277,1610612748,1610612764,110.0,107.0,0.472,0.43,1,2022-11-25,20,9,11,0.45,19,10,9,0.526
22200278,1610612745,1610612737,128.0,122.0,0.471,0.476,1,2022-11-25,18,4,14,0.222,19,11,8,0.579
22200279,1610612763,1610612740,132.0,111.0,0.516,0.43,1,2022-11-25,19,11,8,0.579,19,11,8,0.579
22200280,1610612749,1610612739,117.0,102.0,0.506,0.391,1,2022-11-25,18,13,5,0.722,19,12,7,0.632
22200281,1610612760,1610612741,123.0,119.0,0.463,0.436,1,2022-11-25,19,8,11,0.421,19,8,11,0.421
22200282,1610612759,1610612747,94.0,105.0,0.38,0.482,0,2022-11-25,20,6,14,0.3,17,6,11,0.353
22200283,1610612756,1610612765,108.0,102.0,0.483,0.424,1,2022-11-25,18,12,6,0.667,21,5,16,0.238
22200284,1610612744,1610612762,129.0,118.0,0.515,0.474,1,2022-11-25,20,10,10,0.5,21,12,9,0.571
22200285,1610612746,1610612743,104.0,114.0,0.544,0.494,0,2022-11-25,20,11,9,0.55,19,12,7,0.632
22200260,1610612766,1610612755,107.0,101.0,0.478,0.442,1,2022-11-23,19,5,14,0.263,18,9,9,0.5
22200261,1610612739,1610612757,114.0,96.0,0.554,0.449,1,2022-11-23,18,12,6,0.667,18,10,8,0.556
22200262,1610612754,1610612750,101.0,115.0,0.385,0.61,0,2022-11-23,17,10,7,0.588,18,10,8,0.556
22200263,1610612737,1610612758,115.0,106.0,0.446,0.461,1,2022-11-23,18,11,7,0.611,17,10,7,0.588
22200264,1610612738,1610612742,125.0,112.0,0.536,0.537,1,2022-11-23,18,14,4,0.778,17,9,8,0.529
22200265,1610612748,1610612764,113.0,105.0,0.419,0.472,1,2022-11-23,19,8,11,0.421,18,10,8,0.556
22200266,1610612761,1610612751,98.0,112.0,0.356,0.549,0,2022-11-23,18,9,9,0.5,19,9,10,0.474
22200267,1610612749,1610612741,113.0,118.0,0.456,0.494,0,2022-11-23,17,12,5,0.706,18,8,10,0.444
22200268,1610612760,1610612743,126.0,131.0,0.433,0.477,0,2022-11-23,18,7,11,0.389,18,11,7,0.611
22200269,1610612759,1610612740,110.0,129.0,0.482,0.573,0,2022-11-23,19,6,13,0.316,18,11,7,0.611
22200270,1610612762,1610612765,116.0,125.0,0.494,0.494,0,2022-11-23,20,12,8,0.6,20,5,15,0.25
22200271,1610612744,1610612746,124.0,107.0,0.495,0.453,1,2022-11-23,19,9,10,0.474,19,11,8,0.579
22200256,1610612755,1610612751,115.0,106.0,0.434,0.55,1,2022-11-22,17,9,8,0.529,18,8,10,0.444
22200257,1610612763,1610612758,109.0,113.0,0.451,0.433,0,2022-11-22,18,10,8,0.556,16,10,6,0.625
22200258,1610612743,1610612765,108.0,110.0,0.5,0.511,0,2022-11-22,17,10,7,0.588,19,4,15,0.211
22200259,1610612756,1610612747,115.0,105.0,0.471,0.424,1,2022-11-22,17,11,6,0.647,16,5,11,0.313
22200248,1610612739,1610612737,114.0,102.0,0.6,0.437,1,2022-11-21,17,11,6,0.647,17,10,7,0.588
22200249,1610612754,1610612753,123.0,102.0,0.5,0.424,1,2022-11-21,16,10,6,0.625,18,5,13,0.278
22200250,1610612741,1610612738,121.0,107.0,0.517,0.437,1,2022-11-21,17,7,10,0.412,17,13,4,0.765
22200251,1610612749,1610612757,119.0,111.0,0.547,0.473,1,2022-11-21,16,12,4,0.75,17,10,7,0.588
22200252,1610612750,1610612748,105.0,101.0,0.435,0.389,1,2022-11-21,17,9,8,0.529,18,7,11,0.389
22200253,1610612740,1610612744,128.0,83.0,0.538,0.378,1,2022-11-21,17,10,7,0.588,18,8,10,0.444
22200254,1610612760,1610612752,119.0,129.0,0.489,0.526,0,2022-11-21,17,7,10,0.412,18,9,9,0.5
22200255,1610612746,1610612762,121.0,114.0,0.516,0.449,1,2022-11-21,18,11,7,0.611,19,12,7,0.632
22200240,1610612756,1610612752,116.0,95.0,0.426,0.4,1,2022-11-20,16,10,6,0.625,17,8,9,0.471
22200241,1610612764,1610612766,106.0,102.0,0.43,0.39,1,2022-11-20,17,10,7,0.588,18,4,14,0.222
22200242,1610612758,1610612765,137.0,129.0,0.553,0.528,1,2022-11-20,15,9,6,0.6,18,3,15,0.167
22200243,1610612751,1610612763,127.0,115.0,0.602,0.434,1,2022-11-20,17,8,9,0.471,17,10,7,0.588
22200244,1610612739,1610612748,113.0,87.0,0.53,0.388,1,2022-11-20,16,10,6,0.625,17,7,10,0.412
22200245,1610612745,1610612744,120.0,127.0,0.456,0.535,0,2022-11-20,17,3,14,0.176,17,8,9,0.471
22200246,1610612742,1610612743,97.0,98.0,0.449,0.474,0,2022-11-20,16,9,7,0.563,16,10,6,0.625
22200247,1610612747,1610612759,123.0,92.0,0.529,0.39,1,2022-11-20,15,5,10,0.333,18,6,12,0.333
22200235,1610612737,1610612761,124.0,122.0,0.5,0.444,1,2022-11-19,16,10,6,0.625,17,9,8,0.529
22200237,1610612755,1610612750,109.0,112.0,0.479,0.471,0,2022-11-19,16,8,8,0.5,16,8,8,0.5
22200238,1610612757,1610612762,113.0,118.0,0.47,0.462,0,2022-11-19,16,10,6,0.625,18,12,6,0.667
22200239,1610612746,1610612759,119.0,97.0,0.543,0.414,1,2022-11-19,17,10,7,0.588,17,6,11,0.353
22200224,1610612764,1610612748,107.0,106.0,0.427,0.357,1,2022-11-18,16,9,7,0.563,16,7,9,0.438
22200225,1610612739,1610612766,132.0,122.0,0.533,0.4,1,2022-11-18,15,9,6,0.6,17,4,13,0.235
22200226,1610612755,1610612749,110.0,102.0,0.513,0.456,1,2022-11-18,15,8,7,0.533,15,11,4,0.733
22200227,1610612741,1610612753,107.0,108.0,0.461,0.494,0,2022-11-18,16,6,10,0.375,16,5,11,0.313
22200228,1610612745,1610612754,91.0,99.0,0.337,0.402,0,2022-11-18,16,3,13,0.188,14,8,6,0.571
22200229,1610612763,1610612760,121.0,110.0,0.419,0.469,1,2022-11-18,16,10,6,0.625,16,7,9,0.438
22200230,1610612742,1610612743,127.0,99.0,0.597,0.422,1,2022-11-18,15,9,6,0.6,15,9,6,0.6
22200231,1610612740,1610612738,109.0,117.0,0.494,0.482,0,2022-11-18,16,9,7,0.563,16,13,3,0.813
22200232,1610612762,1610612756,134.0,133.0,0.56,0.521,1,2022-11-18,17,11,6,0.647,15,9,6,0.6
22200233,1610612744,1610612752,111.0,101.0,0.451,0.345,1,2022-11-18,16,7,9,0.438,16,8,8,0.5
22200234,1610612747,1610612765,128.0,121.0,0.551,0.467,1,2022-11-18,14,4,10,0.286,17,3,14,0.176
22200221,1610612757,1610612751,107.0,109.0,0.387,0.506,0,2022-11-17,15,10,5,0.667,16,7,9,0.438
22200222,1610612758,1610612759,130.0,112.0,0.578,0.548,1,2022-11-17,14,8,6,0.571,16,6,10,0.375
22200223,1610612746,1610612765,96.0,91.0,0.407,0.375,1,2022-11-17,16,9,7,0.563,16,3,13,0.188
22200211,1610612766,1610612754,113.0,125.0,0.457,0.537,0,2022-11-16,16,4,12,0.25,13,7,6,0.538
22200212,1610612753,1610612750,108.0,126.0,0.452,0.523,0,2022-11-16,15,4,11,0.267,15,7,8,0.467
22200213,1610612764,1610612760,120.0,121.0,0.512,0.543,0,2022-11-16,15,8,7,0.533,15,7,8,0.467
22200214,1610612737,1610612738,101.0,126.0,0.416,0.545,0,2022-11-16,15,9,6,0.6,15,12,3,0.8
22200215,1610612761,1610612748,112.0,104.0,0.512,0.545,1,2022-11-16,16,9,7,0.563,15,7,8,0.467
22200216,1610612749,1610612739,113.0,98.0,0.477,0.429,1,2022-11-16,14,11,3,0.786,14,8,6,0.571
22200217,1610612740,1610612741,124.0,110.0,0.506,0.494,1,2022-11-16,15,9,6,0.6,15,6,9,0.4
22200218,1610612742,1610612745,92.0,101.0,0.304,0.467,0,2022-11-16,14,8,6,0.571,15,3,12,0.2
22200219,1610612743,1610612752,103.0,106.0,0.439,0.44,0,2022-11-16,14,9,5,0.643,15,8,7,0.533
22200220,1610612756,1610612744,130.0,119.0,0.512,0.457,1,2022-11-16,14,9,5,0.643,15,6,9,0.4
22200206,1610612740,1610612763,113.0,102.0,0.473,0.413,1,2022-11-15,14,8,6,0.571,15,9,6,0.6
22200207,1610612742,1610612746,103.0,101.0,0.438,0.531,1,2022-11-15,13,8,5,0.615,15,8,7,0.533
22200208,1610612762,1610612752,111.0,118.0,0.434,0.473,0,2022-11-15,16,10,6,0.625,14,7,7,0.5
22200209,1610612757,1610612759,117.0,110.0,0.519,0.518,1,2022-11-15,14,10,4,0.714,15,6,9,0.4
22200210,1610612758,1610612751,153.0,121.0,0.596,0.494,1,2022-11-15,13,7,6,0.538,15,6,9,0.4
22200199,1610612765,1610612761,111.0,115.0,0.455,0.488,0,2022-11-14,15,3,12,0.2,15,8,7,0.533
22200200,1610612753,1610612766,105.0,112.0,0.409,0.477,0,2022-11-14,14,4,10,0.286,15,4,11,0.267
22200201,1610612738,1610612760,126.0,122.0,0.479,0.48,1,2022-11-14,14,11,3,0.786,14,6,8,0.429
22200202,1610612748,1610612756,113.0,112.0,0.458,0.485,1,2022-11-14,14,7,7,0.5,13,8,5,0.615
22200203,1610612745,1610612746,106.0,122.0,0.453,0.506,0,2022-11-14,14,2,12,0.143,14,8,6,0.571
22200204,1610612749,1610612737,106.0,121.0,0.415,0.478,0,2022-11-14,13,10,3,0.769,14,9,5,0.643
22200205,1610612744,1610612759,132.0,95.0,0.534,0.36,1,2022-11-14,14,6,8,0.429,14,6,8,0.429
22200192,1610612752,1610612760,135.0,145.0,0.495,0.625,0,2022-11-13,13,6,7,0.462,13,6,7,0.462
22200193,1610612739,1610612750,124.0,129.0,0.449,0.561,0,2022-11-13,13,8,5,0.615,14,6,8,0.429
22200194,1610612764,1610612763,102.0,92.0,0.419,0.396,1,2022-11-13,14,8,6,0.571,14,9,5,0.643
22200195,1610612755,1610612762,105.0,98.0,0.482,0.394,1,2022-11-13,14,7,7,0.5,15,10,5,0.667
22200196,1610612741,1610612743,103.0,126.0,0.494,0.6,0,2022-11-13,14,6,8,0.429,13,9,4,0.692
22200197,1610612758,1610612744,122.0,115.0,0.516,0.467,1,2022-11-13,12,6,6,0.5,13,5,8,0.385
22200198,1610612747,1610612751,116.0,103.0,0.484,0.45,1,2022-11-13,13,3,10,0.231,14,6,8,0.429
22200184,1610612746,1610612751,95.0,110.0,0.4,0.482,0,2022-11-12,13,7,6,0.538,13,6,7,0.462
22200185,1610612764,1610612762,121.0,112.0,0.5,0.468,1,2022-11-12,13,7,6,0.538,14,10,4,0.714
22200186,1610612765,1610612738,108.0,117.0,0.416,0.429,0,2022-11-12,14,3,11,0.214,13,10,3,0.769
22200187,1610612754,1610612761,118.0,104.0,0.5,0.394,1,2022-11-12,12,6,6,0.5,14,7,7,0.5
22200188,1610612755,1610612737,121.0,109.0,0.55,0.449,1,2022-11-12,13,6,7,0.462,13,8,5,0.615
22200189,1610612748,1610612766,132.0,115.0,0.527,0.511,1,2022-11-12,13,6,7,0.462,14,3,11,0.214
22200190,1610612742,1610612757,117.0,112.0,0.506,0.45,1,2022-11-12,12,7,5,0.583,13,9,4,0.692
22200191,1610612740,1610612745,119.0,106.0,0.488,0.506,1,2022-11-12,13,7,6,0.538,13,2,11,0.154
22200176,1610612738,1610612743,131.0,112.0,0.556,0.457,1,2022-11-11,12,9,3,0.75,12,8,4,0.667
22200177,1610612753,1610612756,114.0,97.0,0.524,0.4,1,2022-11-11,13,4,9,0.308,12,8,4,0.667
22200178,1610612752,1610612765,121.0,112.0,0.447,0.463,1,2022-11-11,12,6,6,0.5,13,3,10,0.231
22200179,1610612760,1610612761,132.0,113.0,0.559,0.432,1,2022-11-11,12,5,7,0.417,13,7,6,0.538
22200180,1610612759,1610612749,111.0,93.0,0.506,0.327,1,2022-11-11,13,6,7,0.462,12,10,2,0.833
22200181,1610612763,1610612750,114.0,103.0,0.5,0.468,1,2022-11-11,13,9,4,0.692,13,5,8,0.385
22200182,1610612744,1610612739,106.0,101.0,0.488,0.402,1,2022-11-11,12,5,7,0.417,12,8,4,0.667
22200183,1610612747,1610612758,114.0,120.0,0.477,0.517,0,2022-11-11,12,2,10,0.167,11,5,6,0.455
22200172,1610612764,1610612742,113.0,105.0,0.488,0.43,1,2022-11-10,12,6,6,0.5,11,6,5,0.545
22200173,1610612737,1610612755,104.0,95.0,0.443,0.386,1,2022-11-10,12,8,4,0.667,12,5,7,0.417
22200174,1610612748,1610612766,117.0,112.0,0.433,0.489,1,2022-11-10,12,5,7,0.417,13,3,10,0.231
22200175,1610612740,1610612757,95.0,106.0,0.418,0.435,0,2022-11-10,12,6,6,0.5,12,9,3,0.75
22200161,1610612753,1610612742,94.0,87.0,0.493,0.376,1,2022-11-09,12,3,9,0.25,10,6,4,0.6
22200159,1610612766,1610612757,95.0,105.0,0.374,0.533,0,2022-11-09,12,3,9,0.25,11,8,3,0.727
22200160,1610612754,1610612743,119.0,122.0,0.469,0.489,0,2022-11-09,11,5,6,0.455,11,8,3,0.727
22200162,1610612737,1610612762,119.0,125.0,0.468,0.468,0,2022-11-09,11,7,4,0.636,13,10,3,0.769
22200163,1610612738,1610612765,128.0,112.0,0.534,0.416,1,2022-11-09,11,8,3,0.727,12,3,9,0.25
22200164,1610612751,1610612752,112.0,85.0,0.483,0.322,1,2022-11-09,12,5,7,0.417,11,5,6,0.455
22200165,1610612761,1610612745,116.0,109.0,0.412,0.44,1,2022-11-09,12,7,5,0.583,12,2,10,0.167
22200166,1610612741,1610612740,111.0,115.0,0.506,0.5,0,2022-11-09,13,6,7,0.462,11,6,5,0.545
22200167,1610612750,1610612756,117.0,129.0,0.526,0.485,0,2022-11-09,12,5,7,0.417,11,8,3,0.727
22200168,1610612760,1610612749,132.0,136.0,0.45,0.472,0,2022-11-09,11,4,7,0.364,11,10,1,0.909
22200169,1610612759,1610612763,122.0,124.0,0.48,0.51,0,2022-11-09,12,5,7,0.417,12,8,4,0.667
22200170,1610612746,1610612747,114.0,101.0,0.506,0.455,1,2022-11-09,12,7,5,0.583,11,2,9,0.182
22200171,1610612758,1610612739,127.0,120.0,0.526,0.535,1,2022-11-09,10,4,6,0.4,11,8,3,0.727
22200144,1610612766,1610612764,100.0,108.0,0.416,0.525,0,2022-11-07,11,3,8,0.273,11,5,6,0.455
22200145,1610612753,1610612745,127.0,134.0,0.549,0.529,0,2022-11-07,11,2,9,0.182,11,2,9,0.182
22200146,1610612765,1610612760,112.0,103.0,0.419,0.402,1,2022-11-07,11,3,8,0.273,10,4,6,0.4
22200147,1610612754,1610612740,129.0,122.0,0.5,0.495,1,2022-11-07,10,5,5,0.5,10,5,5,0.5
22200148,1610612755,1610612756,100.0,88.0,0.388,0.438,1,2022-11-07,11,5,6,0.455,10,7,3,0.7
22200149,1610612737,1610612749,117.0,98.0,0.465,0.414,1,2022-11-07,10,7,3,0.7,10,9,1,0.9
22200150,1610612748,1610612757,107.0,110.0,0.476,0.528,0,2022-11-07,11,4,7,0.364,10,7,3,0.7
22200151,1610612741,1610612761,111.0,97.0,0.525,0.424,1,2022-11-07,12,6,6,0.5,11,6,5,0.545
22200152,1610612763,1610612738,106.0,109.0,0.451,0.463,0,2022-11-07,11,7,4,0.636,10,7,3,0.7
22200153,1610612750,1610612752,107.0,120.0,0.469,0.438,0,2022-11-07,11,5,6,0.455,10,5,5,0.5
22200154,1610612759,1610612743,109.0,115.0,0.524,0.534,0,2022-11-07,11,5,6,0.455,10,7,3,0.7
22200155,1610612742,1610612751,96.0,94.0,0.444,0.438,1,2022-11-07,9,6,3,0.667,11,4,7,0.364
22200156,1610612744,1610612758,116.0,113.0,0.5,0.407,1,2022-11-07,11,4,7,0.364,9,3,6,0.333
22200157,1610612762,1610612747,139.0,116.0,0.558,0.488,1,2022-11-07,12,9,3,0.75,10,2,8,0.2
22200158,1610612746,1610612739,119.0,117.0,0.506,0.518,1,2022-11-07,11,6,5,0.545,10,8,2,0.8
22200140,1610612747,1610612739,100.0,114.0,0.46,0.44,0,2022-11-06,9,2,7,0.222,9,8,1,0.889
22200141,1610612761,1610612741,113.0,104.0,0.427,0.455,1,2022-11-06,10,6,4,0.6,11,5,6,0.455
22200142,1610612763,1610612764,103.0,97.0,0.429,0.427,1,2022-11-06,10,7,3,0.7,10,4,6,0.4
22200143,1610612746,1610612762,102.0,110.0,0.494,0.467,0,2022-11-06,10,5,5,0.5,11,8,3,0.727
22200132,1610612753,1610612758,123.0,126.0,0.543,0.505,0,2022-11-05,10,2,8,0.2,8,3,5,0.375
22200133,1610612766,1610612751,94.0,98.0,0.372,0.393,0,2022-11-05,10,3,7,0.3,10,4,6,0.4
22200134,1610612737,1610612740,124.0,121.0,0.456,0.435,1,2022-11-05,9,6,3,0.667,9,5,4,0.556
22200135,1610612752,1610612738,118.0,133.0,0.511,0.534,0,2022-11-05,9,4,5,0.444,9,6,3,0.667
22200136,1610612749,1610612760,108.0,94.0,0.422,0.429,1,2022-11-05,9,9,0,1.0,9,4,5,0.444
22200137,1610612750,1610612745,129.0,117.0,0.613,0.476,1,2022-11-05,10,5,5,0.5,10,1,9,0.1
22200138,1610612743,1610612759,126.0,101.0,0.609,0.488,1,2022-11-05,9,6,3,0.667,10,5,5,0.5
22200139,1610612756,1610612757,102.0,82.0,0.427,0.38,1,2022-11-05,9,7,2,0.778,9,6,3,0.667
22200120,1610612765,1610612739,88.0,112.0,0.373,0.543,0,2022-11-04,10,2,8,0.2,8,7,1,0.875
22200121,1610612754,1610612748,101.0,99.0,0.463,0.383,1,2022-11-04,9,4,5,0.444,10,4,6,0.4
22200122,1610612755,1610612752,104.0,106.0,0.378,0.463,0,2022-11-04,10,4,6,0.4,8,4,4,0.5
22200123,1610612764,1610612751,86.0,128.0,0.361,0.556,0,2022-11-04,9,4,5,0.444,9,3,6,0.333
22200124,1610612738,1610612741,123.0,119.0,0.494,0.518,1,2022-11-04,8,5,3,0.625,10,5,5,0.5
22200125,1610612763,1610612766,130.0,99.0,0.51,0.384,1,2022-11-04,9,6,3,0.667,9,3,6,0.333
22200126,1610612759,1610612746,106.0,113.0,0.477,0.525,0,2022-11-04,9,5,4,0.556,9,5,4,0.556
22200127,1610612742,1610612761,111.0,110.0,0.506,0.443,1,2022-11-04,8,5,3,0.625,9,5,4,0.556
22200128,1610612740,1610612744,114.0,105.0,0.506,0.493,1,2022-11-04,8,5,3,0.625,10,3,7,0.3
22200129,1610612750,1610612749,102.0,115.0,0.424,0.482,0,2022-11-04,9,4,5,0.444,8,8,0,1.0
22200130,1610612756,1610612757,106.0,108.0,0.434,0.506,0,2022-11-04,8,6,2,0.75,8,6,2,0.75
22200131,1610612747,1610612762,116.0,130.0,0.482,0.505,0,2022-11-04,8,2,6,0.25,10,7,3,0.7
22200118,1610612753,1610612744,130.0,129.0,0.538,0.515,1,2022-11-03,9,2,7,0.222,9,3,6,0.333
22200119,1610612760,1610612743,110.0,122.0,0.484,0.536,0,2022-11-03,8,4,4,0.5,8,5,3,0.625
22200108,1610612755,1610612764,111.0,121.0,0.464,0.577,0,2022-11-02,9,4,5,0.444,8,4,4,0.5
22200107,1610612739,1610612738,114.0,113.0,0.42,0.409,1,2022-11-02,7,6,1,0.857,7,4,3,0.571
22200109,1610612748,1610612758,110.0,107.0,0.494,0.477,1,2022-11-02,9,4,5,0.444,7,2,5,0.286
22200110,1610612752,1610612737,99.0,112.0,0.411,0.411,0,2022-11-02,7,3,4,0.429,8,5,3,0.625
22200111,1610612741,1610612766,106.0,88.0,0.432,0.391,1,2022-11-02,9,5,4,0.556,8,3,5,0.375
22200112,1610612745,1610612746,101.0,109.0,0.42,0.488,0,2022-11-02,9,1,8,0.111,8,4,4,0.5
22200113,1610612749,1610612765,116.0,91.0,0.467,0.418,1,2022-11-02,7,7,0,1.0,9,2,7,0.222
22200114,1610612759,1610612761,100.0,143.0,0.394,0.538,0,2022-11-02,8,5,3,0.625,8,5,3,0.625
22200115,1610612742,1610612762,103.0,100.0,0.5,0.464,1,2022-11-02,7,4,3,0.571,9,6,3,0.667
22200116,1610612757,1610612763,106.0,111.0,0.404,0.458,0,2022-11-02,7,5,2,0.714,8,5,3,0.625
22200117,1610612747,1610612740,120.0,117.0,0.459,0.461,1,2022-11-02,7,2,5,0.286,7,4,3,0.571
22200103,1610612751,1610612741,99.0,108.0,0.486,0.438,0,2022-11-01,8,2,6,0.25,8,4,4,0.5
22200104,1610612748,1610612744,116.0,109.0,0.455,0.464,1,2022-11-01,8,3,5,0.375,8,3,5,0.375
22200105,1610612760,1610612753,116.0,108.0,0.474,0.448,1,2022-11-01,7,4,3,0.571,8,1,7,0.125
22200106,1610612756,1610612750,116.0,107.0,0.461,0.425,1,2022-11-01,7,6,1,0.857,8,4,4,0.5
22200096,1610612766,1610612758,108.0,115.0,0.512,0.435,0,2022-10-31,7,3,4,0.429,6,2,4,0.333
22200097,1610612764,1610612755,111.0,118.0,0.469,0.554,0,2022-10-31,7,3,4,0.429,8,4,4,0.5
22200098,1610612751,1610612754,116.0,109.0,0.538,0.471,1,2022-10-31,7,2,5,0.286,8,3,5,0.375
22200099,1610612761,1610612737,139.0,109.0,0.5,0.464,1,2022-10-31,7,4,3,0.571,7,4,3,0.571
22200100,1610612749,1610612765,110.0,108.0,0.437,0.446,1,2022-10-31,6,6,0,1.0,8,2,6,0.25
22200101,1610612762,1610612763,121.0,105.0,0.472,0.413,1,2022-10-31,8,6,2,0.75,7,4,3,0.571
22200102,1610612746,1610612745,95.0,93.0,0.425,0.386,1,2022-10-31,7,3,4,0.429,8,1,7,0.125
22200088,1610612746,1610612740,91.0,112.0,0.419,0.495,0,2022-10-30,6,2,4,0.333,6,4,2,0.667
22200089,1610612738,1610612764,112.0,94.0,0.456,0.388,1,2022-10-30,6,4,2,0.667,6,3,3,0.5
22200090,1610612739,1610612752,121.0,108.0,0.461,0.489,1,2022-10-30,6,5,1,0.833,6,3,3,0.5
22200091,1610612765,1610612744,128.0,114.0,0.482,0.424,1,2022-10-30,7,2,5,0.286,7,3,4,0.429
22200092,1610612759,1610612750,107.0,98.0,0.419,0.404,1,2022-10-30,7,5,2,0.714,7,4,3,0.571
22200093,1610612742,1610612753,114.0,105.0,0.494,0.457,1,2022-10-30,6,3,3,0.5,7,1,6,0.143
22200094,1610612756,1610612745,124.0,109.0,0.536,0.437,1,2022-10-30,6,5,1,0.833,7,1,6,0.143
22200095,1610612747,1610612743,121.0,110.0,0.479,0.427,1,2022-10-30,6,1,5,0.167,7,4,3,0.571
22200081,1610612758,1610612748,119.0,113.0,0.553,0.427,1,2022-10-29,5,1,4,0.2,7,2,5,0.286
22200082,1610612766,1610612744,120.0,113.0,0.422,0.44,1,2022-10-29,6,3,3,0.5,6,3,3,0.5
22200083,1610612751,1610612754,116.0,125.0,0.5,0.426,0,2022-10-29,6,1,5,0.167,7,3,4,0.429
22200084,1610612741,1610612755,109.0,114.0,0.45,0.494,0,2022-10-29,7,3,4,0.429,7,3,4,0.429
22200085,1610612749,1610612737,123.0,115.0,0.489,0.479,1,2022-10-29,5,5,0,1.0,6,4,2,0.667
22200086,1610612742,1610612760,111.0,117.0,0.4,0.494,0,2022-10-29,5,2,3,0.4,6,3,3,0.5
22200087,1610612762,1610612763,124.0,123.0,0.517,0.568,1,2022-10-29,7,5,2,0.714,6,4,2,0.667
22200070,1610612765,1610612737,112.0,136.0,0.43,0.567,0,2022-10-28,6,1,5,0.167,5,4,1,0.8
22200071,1610612753,1610612766,113.0,93.0,0.494,0.384,1,2022-10-28,6,1,5,0.167,5,2,3,0.4
22200072,1610612738,1610612739,123.0,132.0,0.512,0.517,0,2022-10-28,5,3,2,0.6,5,4,1,0.8
22200073,1610612761,1610612755,90.0,112.0,0.384,0.524,0,2022-10-28,6,3,3,0.5,6,2,4,0.333
22200074,1610612764,1610612754,117.0,127.0,0.477,0.506,0,2022-10-28,5,3,2,0.6,6,2,4,0.333
22200075,1610612749,1610612752,119.0,108.0,0.385,0.398,1,2022-10-28,4,4,0,1.0,5,3,2,0.6
22200076,1610612750,1610612747,111.0,102.0,0.414,0.416,1,2022-10-28,6,4,2,0.667,5,0,5,0.0
22200077,1610612759,1610612741,129.0,124.0,0.535,0.475,1,2022-10-28,6,4,2,0.667,6,3,3,0.5
22200078,1610612743,1610612762,117.0,101.0,0.459,0.418,1,2022-10-28,6,4,2,0.667,6,4,2,0.667
22200079,1610612756,1610612740,124.0,111.0,0.522,0.442,1,2022-10-28,5,4,1,0.8,5,3,2,0.6
22200080,1610612757,1610612745,125.0,111.0,0.533,0.426,1,2022-10-28,6,5,1,0.833,6,1,5,0.167
22200066,1610612751,1610612742,125.0,129.0,0.462,0.506,0,2022-10-27,5,1,4,0.2,4,2,2,0.5
22200067,1610612760,1610612746,118.0,110.0,0.495,0.537,1,2022-10-27,5,2,3,0.4,5,2,3,0.4
22200068,1610612744,1610612748,123.0,110.0,0.5,0.443,1,2022-10-27,5,3,2,0.6,6,2,4,0.333
22200069,1610612758,1610612763,110.0,125.0,0.482,0.533,0,2022-10-27,4,0,4,0.0,5,4,1,0.8
22200056,1610612739,1610612753,103.0,92.0,0.414,0.432,1,2022-10-26,4,3,1,0.75,5,0,5,0.0
22200057,1610612765,1610612737,113.0,118.0,0.462,0.495,0,2022-10-26,5,1,4,0.2,4,3,1,0.75
22200058,1610612752,1610612766,134.0,131.0,0.536,0.495,1,2022-10-26,4,3,1,0.75,4,2,2,0.5
22200059,1610612761,1610612755,119.0,109.0,0.548,0.506,1,2022-10-26,5,3,2,0.6,5,1,4,0.2
22200060,1610612749,1610612751,110.0,99.0,0.443,0.395,1,2022-10-26,3,3,0,1.0,4,1,3,0.25
22200061,1610612741,1610612754,124.0,109.0,0.494,0.43,1,2022-10-26,5,3,2,0.6,5,1,4,0.2
22200062,1610612750,1610612759,134.0,122.0,0.65,0.453,1,2022-10-26,5,3,2,0.6,5,3,2,0.6
22200063,1610612762,1610612745,109.0,101.0,0.422,0.383,1,2022-10-26,5,4,1,0.8,5,1,4,0.2
22200064,1610612743,1610612747,110.0,99.0,0.457,0.444,1,2022-10-26,5,3,2,0.6,4,0,4,0.0
22200065,1610612757,1610612748,98.0,119.0,0.436,0.506,0,2022-10-26,5,4,1,0.8,5,2,3,0.4
22200052,1610612764,1610612765,120.0,99.0,0.518,0.409,1,2022-10-25,4,3,1,0.75,4,1,3,0.25
22200053,1610612740,1610612742,113.0,111.0,0.579,0.5,1,2022-10-25,4,3,1,0.75,3,1,2,0.333
22200054,1610612760,1610612746,108.0,94.0,0.382,0.422,1,2022-10-25,4,1,3,0.25,4,2,2,0.5
22200055,1610612756,1610612744,134.0,105.0,0.511,0.451,1,2022-10-25,4,3,1,0.75,4,2,2,0.5
22200044,1610612755,1610612754,120.0,106.0,0.475,0.422,1,2022-10-24,4,1,3,0.25,4,1,3,0.25
22200045,1610612748,1610612761,90.0,98.0,0.349,0.395,0,2022-10-24,4,1,3,0.25,4,2,2,0.5
22200046,1610612752,1610612753,115.0,102.0,0.462,0.419,1,2022-10-24,3,2,1,0.667,4,0,4,0.0
22200047,1610612741,1610612738,120.0,102.0,0.483,0.37,1,2022-10-24,4,2,2,0.5,4,3,1,0.75
22200048,1610612745,1610612762,114.0,108.0,0.422,0.473,1,2022-10-24,4,1,3,0.25,4,3,1,0.75
22200049,1610612763,1610612751,134.0,124.0,0.5,0.54,1,2022-10-24,4,3,1,0.75,3,1,2,0.333
22200050,1610612750,1610612759,106.0,115.0,0.442,0.457,0,2022-10-24,4,2,2,0.5,4,3,1,0.75
22200051,1610612757,1610612743,135.0,110.0,0.578,0.495,1,2022-10-24,4,4,0,1.0,4,2,2,0.5
22200037,1610612747,1610612757,104.0,106.0,0.446,0.44,0,2022-10-23,3,0,3,0.0,3,3,0,1.0
22200038,1610612737,1610612766,109.0,126.0,0.411,0.522,0,2022-10-23,3,2,1,0.667,3,2,1,0.667
22200039,1610612739,1610612764,117.0,107.0,0.427,0.494,1,2022-10-23,3,2,1,0.667,3,2,1,0.667
22200040,1610612740,1610612762,121.0,122.0,0.471,0.439,0,2022-10-23,3,2,1,0.667,3,3,0,1.0
22200041,1610612760,1610612750,106.0,116.0,0.436,0.523,0,2022-10-23,3,0,3,0.0,3,2,1,0.667
22200042,1610612744,1610612758,130.0,125.0,0.517,0.47,1,2022-10-23,3,2,1,0.667,3,0,3,0.0
22200043,1610612746,1610612756,95.0,112.0,0.439,0.462,0,2022-10-23,3,2,1,0.667,3,2,1,0.667
22200028,1610612755,1610612759,105.0,114.0,0.44,0.483,0,2022-10-22,3,0,3,0.0,3,2,1,0.667
22200029,1610612754,1610612765,124.0,115.0,0.437,0.389,1,2022-10-22,3,1,2,0.333,3,1,2,0.333
22200030,1610612753,1610612738,120.0,126.0,0.474,0.483,0,2022-10-22,3,0,3,0.0,3,3,0,1.0
22200031,1610612748,1610612761,112.0,109.0,0.5,0.425,1,2022-10-22,3,1,2,0.333,3,1,2,0.333
22200032,1610612741,1610612739,96.0,128.0,0.405,0.565,0,2022-10-22,3,1,2,0.333,2,1,1,0.5
22200033,1610612749,1610612745,125.0,105.0,0.565,0.387,1,2022-10-22,2,2,0,1.0,3,0,3,0.0
22200034,1610612742,1610612763,137.0,96.0,0.5,0.43,1,2022-10-22,2,1,1,0.5,3,2,1,0.667
22200035,1610612743,1610612760,122.0,117.0,0.494,0.447,1,2022-10-22,3,2,1,0.667,2,0,2,0.0
22200036,1610612758,1610612746,109.0,111.0,0.471,0.506,0,2022-10-22,2,0,2,0.0,2,2,0,1.0
22200017,1610612766,1610612740,112.0,124.0,0.454,0.472,0,2022-10-21,2,1,1,0.5,2,2,0,1.0
22200018,1610612754,1610612759,134.0,137.0,0.49,0.543,0,2022-10-21,2,0,2,0.0,2,1,1,0.5
22200019,1610612764,1610612741,102.0,100.0,0.513,0.418,1,2022-10-21,2,2,0,1.0,2,1,1,0.5
22200020,1610612737,1610612753,108.0,98.0,0.449,0.413,1,2022-10-21,2,2,0,1.0,2,0,2,0.0
22200021,1610612751,1610612761,109.0,105.0,0.475,0.488,1,2022-10-21,2,1,1,0.5,2,1,1,0.5
22200022,1610612748,1610612738,104.0,111.0,0.457,0.519,0,2022-10-21,2,0,2,0.0,2,2,0,1.0
22200023,1610612752,1610612765,130.0,106.0,0.526,0.433,1,2022-10-21,2,1,1,0.5,2,1,1,0.5
22200024,1610612745,1610612763,122.0,129.0,0.473,0.459,0,2022-10-21,2,0,2,0.0,2,2,0,1.0
22200025,1610612750,1610612762,126.0,132.0,0.458,0.441,0,2022-10-21,2,1,1,0.5,2,2,0,1.0
22200026,1610612744,1610612743,123.0,128.0,0.477,0.535,0,2022-10-21,2,1,1,0.5,2,1,1,0.5
22200027,1610612757,1610612756,113.0,111.0,0.439,0.457,1,2022-10-21,2,2,0,1.0,2,1,1,0.5
22200015,1610612755,1610612749,88.0,90.0,0.434,0.405,0,2022-10-20,2,0,2,0.0,1,1,0,1.0
22200016,1610612747,1610612746,97.0,103.0,0.351,0.463,0,2022-10-20,2,0,2,0.0,1,1,0,1.0
22200003,1610612765,1610612753,113.0,109.0,0.426,0.488,1,2022-10-19,1,1,0,1.0,1,0,1,0.0
22200004,1610612754,1610612764,107.0,114.0,0.402,0.457,0,2022-10-19,1,0,1,0.0,1,1,0,1.0
22200005,1610612737,1610612745,117.0,107.0,0.5,0.429,1,2022-10-19,1,1,0,1.0,1,0,1,0.0
22200006,1610612751,1610612740,108.0,130.0,0.449,0.49,0,2022-10-19,1,0,1,0.0,1,1,0,1.0
22200007,1610612748,1610612741,108.0,116.0,0.463,0.441,0,2022-10-19,1,0,1,0.0,1,1,0,1.0
22200008,1610612761,1610612739,108.0,105.0,0.419,0.494,1,2022-10-19,1,1,0,1.0,1,0,1,0.0
22200009,1610612763,1610612752,115.0,112.0,0.389,0.404,1,2022-10-19,1,1,0,1.0,1,0,1,0.0
22200010,1610612750,1610612760,115.0,108.0,0.415,0.384,1,2022-10-19,1,1,0,1.0,1,0,1,0.0
22200011,1610612759,1610612766,102.0,129.0,0.404,0.511,0,2022-10-19,1,0,1,0.0,1,1,0,1.0
22200012,1610612762,1610612743,123.0,102.0,0.506,0.482,1,2022-10-19,1,1,0,1.0,1,0,1,0.0
22200013,1610612756,1610612742,107.0,105.0,0.471,0.467,1,2022-10-19,1,1,0,1.0,1,0,1,0.0
22200014,1610612758,1610612757,108.0,115.0,0.459,0.443,0,2022-10-19,1,0,1,0.0,1,1,0,1.0
22200001,1610612738,1610612755,126.0,117.0,0.561,0.5,1,2022-10-18,1,1,0,1.0,1,0,1,0.0
22200002,1610612744,1610612747,123.0,109.0,0.455,0.426,1,2022-10-18,1,1,0,1.0,1,0,1,0.0
12200062,1610612754,1610612745,114.0,122.0,0.442,0.483,0,2022-10-14,4,2,2,0.5,4,3,1,0.75
12200063,1610612753,1610612739,114.0,108.0,0.438,0.461,1,2022-10-14,5,4,1,0.8,4,1,3,0.25
12200064,1610612761,1610612738,137.0,134.0,0.454,0.44,1,2022-10-14,5,3,2,0.6,4,2,2,0.5
12200065,1610612752,1610612764,105.0,89.0,0.427,0.379,1,2022-10-14,4,3,1,0.75,4,1,3,0.25
12200066,1610612750,1610612751,102.0,112.0,0.439,0.42,0,2022-10-14,5,4,1,0.8,4,2,2,0.5
12200067,1610612740,1610612737,120.0,111.0,0.484,0.483,1,2022-10-14,5,4,1,0.8,4,2,2,0.5
12200068,1610612762,1610612742,101.0,115.0,0.451,0.447,0,2022-10-14,4,1,3,0.25,3,2,1,0.667
12200069,1610612744,1610612743,112.0,119.0,0.435,0.507,0,2022-10-14,5,3,2,0.6,5,3,2,0.6
12200070,1610612758,1610612747,133.0,86.0,0.489,0.358,1,2022-10-14,4,4,0,1.0,6,1,5,0.167
12200060,1610612765,1610612763,111.0,126.0,0.392,0.455,0,2022-10-13,4,0,4,0.0,5,3,2,0.6
12200061,1610612759,1610612760,112.0,118.0,0.466,0.465,0,2022-10-13,5,1,4,0.2,6,5,1,0.833
12200052,1610612739,1610612737,105.0,99.0,0.412,0.341,1,2022-10-12,3,1,2,0.333,3,2,1,0.667
12200053,1610612754,1610612752,109.0,100.0,0.477,0.371,1,2022-10-12,3,2,1,0.667,3,2,1,0.667
12200054,1610612755,1610612766,99.0,94.0,0.393,0.481,1,2022-10-12,4,4,0,1.0,5,0,5,0.0
12200055,1610612748,1610612740,120.0,103.0,0.471,0.393,1,2022-10-12,5,4,1,0.8,4,3,1,0.75
12200056,1610612749,1610612751,97.0,107.0,0.415,0.512,0,2022-10-12,5,0,5,0.0,3,1,2,0.333
12200057,1610612747,1610612750,113.0,118.0,0.446,0.423,0,2022-10-12,5,1,4,0.2,4,4,0,1.0
12200058,1610612756,1610612758,104.0,105.0,0.418,0.409,0,2022-10-12,4,1,3,0.25,3,3,0,1.0
12200059,1610612746,1610612743,115.0,126.0,0.482,0.54,0,2022-10-12,4,2,2,0.5,4,2,2,0.5
12200047,1610612765,1610612760,99.0,115.0,0.412,0.523,0,2022-10-11,3,0,3,0.0,5,4,1,0.8
12200048,1610612753,1610612763,109.0,105.0,0.476,0.402,1,2022-10-11,4,3,1,0.75,4,2,2,0.5
12200049,1610612741,1610612749,127.0,104.0,0.532,0.402,1,2022-10-11,4,3,1,0.75,4,0,4,0.0
12200050,1610612762,1610612759,104.0,111.0,0.408,0.477,0,2022-10-11,3,1,2,0.333,4,1,3,0.25
12200051,1610612744,1610612757,131.0,98.0,0.5,0.386,1,2022-10-11,4,3,1,0.75,5,1,4,0.2
12200043,1610612766,1610612764,107.0,116.0,0.464,0.484,0,2022-10-10,4,0,4,0.0,3,1,2,0.333
12200044,1610612739,1610612755,97.0,113.0,0.436,0.44,0,2022-10-10,2,0,2,0.0,3,3,0,1.0
12200045,1610612748,1610612745,118.0,110.0,0.404,0.451,1,2022-10-10,4,3,1,0.75,3,2,1,0.667
12200046,1610612743,1610612756,107.0,105.0,0.451,0.427,1,2022-10-10,3,1,2,0.333,3,1,2,0.333
12200037,1610612761,1610612741,98.0,115.0,0.354,0.506,0,2022-10-09,4,2,2,0.5,3,2,1,0.667
12200039,1610612759,1610612740,97.0,111.0,0.366,0.44,0,2022-10-09,3,0,3,0.0,3,3,0,1.0
12200040,1610612744,1610612747,121.0,124.0,0.477,0.5,0,2022-10-09,3,2,1,0.667,4,1,3,0.25
12200041,1610612758,1610612757,126.0,94.0,0.506,0.403,1,2022-10-09,2,2,0,1.0,4,1,3,0.25
12200042,1610612746,1610612750,117.0,119.0,0.465,0.495,0,2022-10-09,3,2,1,0.667,3,3,0,1.0
12200036,1610612749,1610612737,109.0,118.0,0.446,0.5,0,2022-10-08,3,0,3,0.0,2,2,0,1.0
12200029,1610612766,1610612738,103.0,112.0,0.382,0.438,0,2022-10-07,3,0,3,0.0,3,2,1,0.667
12200030,1610612752,1610612754,131.0,114.0,0.44,0.446,1,2022-10-07,2,2,0,1.0,2,1,1,0.5
12200031,1610612741,1610612743,131.0,113.0,0.602,0.466,1,2022-10-07,2,1,1,0.5,2,0,2,0.0
12200032,1610612745,1610612761,116.0,100.0,0.437,0.434,1,2022-10-07,2,2,0,1.0,3,2,1,0.667
12200033,1610612763,1610612748,108.0,111.0,0.453,0.425,0,2022-10-07,3,2,1,0.667,3,2,1,0.667
12200034,1610612740,1610612765,107.0,101.0,0.447,0.365,1,2022-10-07,2,2,0,1.0,2,0,2,0.0
12200035,1610612742,1610612753,105.0,110.0,0.432,0.459,0,2022-10-07,2,1,1,0.5,3,2,1,0.667
12200023,1610612737,1610612749,123.0,113.0,0.547,0.423,1,2022-10-06,1,1,0,1.0,2,0,2,0.0
12200024,1610612751,1610612748,80.0,109.0,0.392,0.432,0,2022-10-06,2,0,2,0.0,2,1,1,0.5
12200026,1610612759,1610612753,99.0,102.0,0.447,0.444,0,2022-10-06,2,0,2,0.0,2,1,1,0.5
12200028,1610612747,1610612750,99.0,114.0,0.34,0.442,0,2022-10-06,3,0,3,0.0,2,2,0,1.0
12200018,1610612766,1610612754,97.0,122.0,0.344,0.484,0,2022-10-05,2,0,2,0.0,1,1,0,1.0
12200019,1610612755,1610612739,113.0,112.0,0.479,0.462,1,2022-10-05,2,2,0,1.0,1,0,1,0.0
12200020,1610612738,1610612761,119.0,125.0,0.444,0.459,0,2022-10-05,2,1,1,0.5,2,2,0,1.0
12200021,1610612760,1610612742,96.0,98.0,0.4,0.427,0,2022-10-05,2,1,1,0.5,1,1,0,1.0
12200022,1610612747,1610612756,115.0,119.0,0.427,0.371,0,2022-10-05,2,0,2,0.0,2,1,1,0.5
12200014,1610612752,1610612765,117.0,96.0,0.511,0.407,1,2022-10-04,1,1,0,1.0,1,0,1,0.0
12200015,1610612748,1610612750,111.0,121.0,0.429,0.513,0,2022-10-04,1,0,1,0.0,1,1,0,1.0
12200016,1610612741,1610612740,125.0,129.0,0.483,0.495,0,2022-10-04,1,0,1,0.0,1,1,0,1.0
12200017,1610612757,1610612762,101.0,118.0,0.444,0.481,0,2022-10-04,2,0,2,0.0,2,1,1,0.5
12200009,1610612751,1610612755,108.0,127.0,0.462,0.407,0,2022-10-03,1,0,1,0.0,1,1,0,1.0
12200010,1610612763,1610612753,109.0,97.0,0.439,0.393,1,2022-10-03,2,2,0,1.0,1,0,1,0.0
12200011,1610612743,1610612760,101.0,112.0,0.411,0.488,0,2022-10-03,1,0,1,0.0,1,1,0,1.0
12200012,1610612747,1610612758,75.0,105.0,0.312,0.408,0,2022-10-03,1,0,1,0.0,1,1,0,1.0
12200013,1610612746,1610612757,102.0,97.0,0.383,0.397,1,2022-10-03,2,2,0,1.0,1,0,1,0.0
12200004,1610612744,1610612764,104.0,95.0,0.458,0.353,1,2022-10-02,2,2,0,1.0,2,0,2,0.0
12200005,1610612738,1610612766,134.0,93.0,0.571,0.347,1,2022-10-02,1,1,0,1.0,1,0,1,0.0
12200006,1610612761,1610612762,114.0,82.0,0.483,0.323,1,2022-10-02,1,1,0,1.0,1,0,1,0.0
12200007,1610612745,1610612759,134.0,96.0,0.546,0.355,1,2022-10-02,1,1,0,1.0,1,0,1,0.0
12200003,1610612749,1610612763,102.0,107.0,0.43,0.494,0,2022-10-01,1,0,1,0.0,1,1,0,1.0
12200001,1610612764,1610612744,87.0,96.0,0.369,0.367,0,2022-09-30,1,0,1,0.0,1,1,0,1.0
42100406,1610612738,1610612744,90.0,103.0,0.425,0.413,0,2022-06-16,82,51,31,0.622,82,53,29,0.646
42100405,1610612744,1610612738,104.0,94.0,0.466,0.413,1,2022-06-13,82,53,29,0.646,82,51,31,0.622
42100404,1610612738,1610612744,97.0,107.0,0.4,0.44,0,2022-06-10,82,51,31,0.622,82,53,29,0.646
42100403,1610612738,1610612744,116.0,100.0,0.483,0.462,1,2022-06-08,82,51,31,0.622,82,53,29,0.646
42100402,1610612744,1610612738,107.0,88.0,0.453,0.375,1,2022-06-05,82,53,29,0.646,82,51,31,0.622
42100401,1610612744,1610612738,108.0,120.0,0.443,0.506,0,2022-06-02,82,53,29,0.646,82,51,31,0.622
42100307,1610612748,1610612738,96.0,100.0,0.42,0.412,0,2022-05-29,82,53,29,0.646,82,51,31,0.622
42100306,1610612738,1610612748,103.0,111.0,0.444,0.462,0,2022-05-27,82,51,31,0.622,82,53,29,0.646
42100315,1610612744,1610612742,120.0,110.0,0.511,0.451,1,2022-05-26,82,53,29,0.646,82,52,30,0.634
42100305,1610612748,1610612738,80.0,93.0,0.319,0.465,0,2022-05-25,82,53,29,0.646,82,51,31,0.622
42100314,1610612742,1610612744,119.0,109.0,0.5,0.488,1,2022-05-24,82,52,30,0.634,82,53,29,0.646
42100304,1610612738,1610612748,102.0,82.0,0.397,0.333,1,2022-05-23,82,51,31,0.622,82,53,29,0.646
42100313,1610612742,1610612744,100.0,109.0,0.4,0.469,0,2022-05-22,82,52,30,0.634,82,53,29,0.646
42100303,1610612738,1610612748,103.0,109.0,0.486,0.467,0,2022-05-21,82,51,31,0.622,82,53,29,0.646
42100312,1610612744,1610612742,126.0,117.0,0.561,0.474,1,2022-05-20,82,53,29,0.646,82,52,30,0.634
42100302,1610612748,1610612738,102.0,127.0,0.442,0.512,0,2022-05-19,82,53,29,0.646,82,51,31,0.622
42100311,1610612744,1610612742,112.0,87.0,0.561,0.36,1,2022-05-18,82,53,29,0.646,82,52,30,0.634
42100301,1610612748,1610612738,118.0,107.0,0.488,0.456,1,2022-05-17,82,53,29,0.646,82,51,31,0.622
42100217,1610612738,1610612749,109.0,81.0,0.42,0.367,1,2022-05-15,82,51,31,0.622,82,51,31,0.622
42100227,1610612756,1610612742,90.0,123.0,0.379,0.568,0,2022-05-15,82,64,18,0.78,82,52,30,0.634
42100216,1610612749,1610612738,95.0,108.0,0.409,0.437,0,2022-05-13,82,51,31,0.622,82,51,31,0.622
42100236,1610612744,1610612763,110.0,96.0,0.394,0.354,1,2022-05-13,82,53,29,0.646,82,56,26,0.683
42100206,1610612755,1610612748,90.0,99.0,0.414,0.483,0,2022-05-12,82,51,31,0.622,82,53,29,0.646
42100226,1610612742,1610612756,113.0,86.0,0.455,0.397,1,2022-05-12,82,52,30,0.634,82,64,18,0.78
42100215,1610612738,1610612749,107.0,110.0,0.512,0.435,0,2022-05-11,82,51,31,0.622,82,51,31,0.622
42100235,1610612763,1610612744,134.0,95.0,0.475,0.45,1,2022-05-11,82,56,26,0.683,82,53,29,0.646
42100205,1610612748,1610612755,120.0,85.0,0.536,0.365,1,2022-05-10,82,53,29,0.646,82,51,31,0.622
42100225,1610612756,1610612742,110.0,80.0,0.494,0.38,1,2022-05-10,82,64,18,0.78,82,52,30,0.634
42100214,1610612749,1610612738,108.0,116.0,0.415,0.5,0,2022-05-09,82,51,31,0.622,82,51,31,0.622
42100234,1610612744,1610612763,101.0,98.0,0.4,0.417,1,2022-05-09,82,53,29,0.646,82,56,26,0.683
42100224,1610612742,1610612756,111.0,101.0,0.447,0.464,1,2022-05-08,82,52,30,0.634,82,64,18,0.78
42100204,1610612755,1610612748,116.0,108.0,0.544,0.463,1,2022-05-08,82,51,31,0.622,82,53,29,0.646
42100213,1610612749,1610612738,103.0,101.0,0.404,0.368,1,2022-05-07,82,51,31,0.622,82,51,31,0.622
42100233,1610612744,1610612763,142.0,112.0,0.624,0.435,1,2022-05-07,82,53,29,0.646,82,56,26,0.683
42100203,1610612755,1610612748,99.0,79.0,0.478,0.351,1,2022-05-06,82,51,31,0.622,82,53,29,0.646
42100223,1610612742,1610612756,103.0,94.0,0.444,0.447,1,2022-05-06,82,52,30,0.634,82,64,18,0.78
42100202,1610612748,1610612755,119.0,103.0,0.513,0.452,1,2022-05-04,82,53,29,0.646,82,51,31,0.622
42100222,1610612756,1610612742,129.0,109.0,0.645,0.456,1,2022-05-04,82,64,18,0.78,82,52,30,0.634
42100212,1610612738,1610612749,109.0,86.0,0.475,0.466,1,2022-05-03,82,51,31,0.622,82,51,31,0.622
42100232,1610612763,1610612744,106.0,101.0,0.396,0.421,1,2022-05-03,82,56,26,0.683,82,53,29,0.646
42100201,1610612748,1610612755,106.0,92.0,0.435,0.43,1,2022-05-02,82,53,29,0.646,82,51,31,0.622
42100221,1610612756,1610612742,121.0,114.0,0.505,0.471,1,2022-05-02,82,64,18,0.78,82,52,30,0.634
42100211,1610612738,1610612749,89.0,101.0,0.333,0.411,0,2022-05-01,82,51,31,0.622,82,51,31,0.622
42100231,1610612763,1610612744,116.0,117.0,0.432,0.484,0,2022-05-01,82,56,26,0.683,82,53,29,0.646
42100156,1610612750,1610612763,106.0,114.0,0.452,0.465,0,2022-04-29,82,46,36,0.561,82,56,26,0.683
42100136,1610612761,1610612755,97.0,132.0,0.393,0.58,0,2022-04-28,82,48,34,0.585,82,51,31,0.622
42100146,1610612740,1610612756,109.0,115.0,0.506,0.6,0,2022-04-28,82,36,46,0.439,82,64,18,0.78
42100176,1610612762,1610612742,96.0,98.0,0.429,0.45,0,2022-04-28,82,49,33,0.598,82,52,30,0.634
42100125,1610612749,1610612741,116.0,100.0,0.494,0.424,1,2022-04-27,82,51,31,0.622,82,46,36,0.561
42100165,1610612744,1610612743,102.0,98.0,0.451,0.444,1,2022-04-27,82,53,29,0.646,82,48,34,0.585
42100105,1610612748,1610612737,97.0,94.0,0.451,0.419,1,2022-04-26,82,53,29,0.646,82,43,39,0.524
42100155,1610612763,1610612750,111.0,109.0,0.415,0.446,1,2022-04-26,82,56,26,0.683,82,46,36,0.561
42100145,1610612756,1610612740,112.0,97.0,0.5,0.4,1,2022-04-26,82,64,18,0.78,82,36,46,0.439
42100114,1610612751,1610612738,112.0,116.0,0.506,0.472,0,2022-04-25,82,44,38,0.537,82,51,31,0.622
42100135,1610612755,1610612761,88.0,103.0,0.383,0.512,0,2022-04-25,82,51,31,0.622,82,48,34,0.585
42100175,1610612742,1610612762,102.0,77.0,0.435,0.377,1,2022-04-25,82,52,30,0.634,82,49,33,0.598
42100124,1610612741,1610612749,95.0,119.0,0.389,0.523,0,2022-04-24,82,46,36,0.561,82,51,31,0.622
42100164,1610612743,1610612744,126.0,121.0,0.562,0.5,1,2022-04-24,82,48,34,0.585,82,53,29,0.646
42100104,1610612737,1610612748,86.0,110.0,0.4,0.435,0,2022-04-24,82,43,39,0.524,82,53,29,0.646
42100144,1610612740,1610612756,118.0,103.0,0.471,0.506,1,2022-04-24,82,36,46,0.439,82,64,18,0.78
42100134,1610612761,1610612755,110.0,102.0,0.42,0.425,1,2022-04-23,82,48,34,0.585,82,51,31,0.622
42100174,1610612762,1610612742,100.0,99.0,0.405,0.429,1,2022-04-23,82,49,33,0.598,82,52,30,0.634
42100113,1610612751,1610612738,103.0,109.0,0.506,0.5,0,2022-04-23,82,44,38,0.537,82,51,31,0.622
42100154,1610612750,1610612763,119.0,118.0,0.473,0.488,1,2022-04-23,82,46,36,0.561,82,56,26,0.683
42100103,1610612737,1610612748,111.0,110.0,0.513,0.441,1,2022-04-22,82,43,39,0.524,82,53,29,0.646
42100123,1610612741,1610612749,81.0,111.0,0.393,0.473,0,2022-04-22,82,46,36,0.561,82,51,31,0.622
42100143,1610612740,1610612756,111.0,114.0,0.481,0.506,0,2022-04-22,82,36,46,0.439,82,64,18,0.78
42100153,1610612750,1610612763,95.0,104.0,0.388,0.422,0,2022-04-21,82,46,36,0.561,82,56,26,0.683
42100173,1610612762,1610612742,118.0,126.0,0.565,0.494,0,2022-04-21,82,49,33,0.598,82,52,30,0.634
42100163,1610612743,1610612744,113.0,118.0,0.5,0.554,0,2022-04-21,82,48,34,0.585,82,53,29,0.646
42100112,1610612738,1610612751,114.0,107.0,0.52,0.461,1,2022-04-20,82,51,31,0.622,82,44,38,0.537
42100133,1610612761,1610612755,101.0,104.0,0.442,0.514,0,2022-04-20,82,48,34,0.585,82,51,31,0.622
42100122,1610612749,1610612741,110.0,114.0,0.463,0.494,0,2022-04-20,82,51,31,0.622,82,46,36,0.561
42100102,1610612748,1610612737,115.0,105.0,0.481,0.471,1,2022-04-19,82,53,29,0.646,82,43,39,0.524
42100152,1610612763,1610612750,124.0,96.0,0.478,0.395,1,2022-04-19,82,56,26,0.683,82,46,36,0.561
42100142,1610612756,1610612740,114.0,125.0,0.5,0.548,0,2022-04-19,82,64,18,0.78,82,36,46,0.439
42100132,1610612755,1610612761,112.0,97.0,0.522,0.427,1,2022-04-18,82,51,31,0.622,82,48,34,0.585
42100172,1610612742,1610612762,110.0,104.0,0.47,0.463,1,2022-04-18,82,52,30,0.634,82,49,33,0.598
42100162,1610612744,1610612743,126.0,106.0,0.548,0.425,1,2022-04-18,82,53,29,0.646,82,48,34,0.585
42100101,1610612748,1610612737,115.0,91.0,0.524,0.387,1,2022-04-17,82,53,29,0.646,82,43,39,0.524
42100111,1610612738,1610612751,115.0,114.0,0.472,0.538,1,2022-04-17,82,51,31,0.622,82,44,38,0.537
42100121,1610612749,1610612741,93.0,86.0,0.405,0.323,1,2022-04-17,82,51,31,0.622,82,46,36,0.561
42100141,1610612756,1610612740,110.0,99.0,0.538,0.379,1,2022-04-17,82,64,18,0.78,82,36,46,0.439
42100171,1610612742,1610612762,93.0,99.0,0.382,0.434,0,2022-04-16,82,52,30,0.634,82,49,33,0.598
42100151,1610612763,1610612750,117.0,130.0,0.453,0.5,0,2022-04-16,82,56,26,0.683,82,46,36,0.561
42100131,1610612755,1610612761,131.0,111.0,0.512,0.488,1,2022-04-16,82,51,31,0.622,82,48,34,0.585
42100161,1610612744,1610612743,123.0,107.0,0.524,0.462,1,2022-04-16,82,53,29,0.646,82,48,34,0.585
52100201,1610612739,1610612737,101.0,107.0,0.457,0.488,0,2022-04-15,82,44,38,0.537,82,43,39,0.524
52100211,1610612746,1610612740,101.0,105.0,0.412,0.489,0,2022-04-15,82,42,40,0.512,82,36,46,0.439
52100111,1610612737,1610612766,132.0,103.0,0.521,0.378,1,2022-04-13,82,43,39,0.524,82,43,39,0.524
52100131,1610612740,1610612759,113.0,103.0,0.543,0.407,1,2022-04-13,82,36,46,0.439,82,34,48,0.415
52100101,1610612751,1610612739,115.0,108.0,0.536,0.446,1,2022-04-12,82,44,38,0.537,82,44,38,0.537
52100121,1610612750,1610612746,109.0,104.0,0.434,0.436,1,2022-04-12,82,46,36,0.561,82,42,40,0.512
22101216,1610612751,1610612754,134.0,126.0,0.642,0.452,1,2022-04-10,82,44,38,0.537,82,25,57,0.305
22101217,1610612766,1610612764,124.0,108.0,0.539,0.447,1,2022-04-10,82,43,39,0.524,82,35,47,0.427
22101218,1610612739,1610612749,133.0,115.0,0.543,0.443,1,2022-04-10,82,44,38,0.537,82,51,31,0.622
22101221,1610612745,1610612737,114.0,130.0,0.461,0.517,0,2022-04-10,82,20,62,0.244,82,43,39,0.524
22101223,1610612763,1610612738,110.0,139.0,0.382,0.545,0,2022-04-10,82,56,26,0.683,82,51,31,0.622
22101226,1610612752,1610612761,105.0,94.0,0.46,0.391,1,2022-04-10,82,37,45,0.451,82,48,34,0.585
22101227,1610612753,1610612748,125.0,111.0,0.495,0.426,1,2022-04-10,82,22,60,0.268,82,53,29,0.646
22101228,1610612755,1610612765,118.0,106.0,0.523,0.458,1,2022-04-10,82,51,31,0.622,82,23,59,0.28
22101224,1610612750,1610612741,120.0,124.0,0.505,0.53,0,2022-04-10,82,46,36,0.561,82,46,36,0.561
22101219,1610612742,1610612759,130.0,120.0,0.541,0.483,1,2022-04-10,82,52,30,0.634,82,34,48,0.415
22101220,1610612743,1610612747,141.0,146.0,0.49,0.468,0,2022-04-10,82,48,34,0.585,82,33,49,0.402
22101222,1610612746,1610612760,138.0,88.0,0.557,0.378,1,2022-04-10,82,42,40,0.512,82,24,58,0.293
22101225,1610612740,1610612744,107.0,128.0,0.424,0.605,0,2022-04-10,82,36,46,0.439,82,53,29,0.646
22101229,1610612756,1610612758,109.0,116.0,0.408,0.526,0,2022-04-10,82,64,18,0.78,82,30,52,0.366
22101230,1610612757,1610612762,80.0,111.0,0.373,0.451,0,2022-04-10,82,27,55,0.329,82,49,33,0.598
22101214,1610612755,1610612754,133.0,120.0,0.556,0.526,1,2022-04-09,81,50,31,0.617,81,25,56,0.309
22101213,1610612763,1610612740,141.0,114.0,0.589,0.451,1,2022-04-09,81,56,25,0.691,81,36,45,0.444
22101215,1610612759,1610612744,94.0,100.0,0.4,0.407,0,2022-04-09,81,34,47,0.42,81,52,29,0.642
22101212,1610612746,1610612758,117.0,98.0,0.488,0.442,1,2022-04-09,81,41,40,0.506,81,29,52,0.358
22101203,1610612765,1610612749,101.0,131.0,0.389,0.495,0,2022-04-08,81,23,58,0.284,81,51,30,0.63
22101204,1610612764,1610612752,92.0,114.0,0.507,0.466,0,2022-04-08,81,35,46,0.432,81,36,45,0.444
22101205,1610612751,1610612739,118.0,107.0,0.467,0.488,1,2022-04-08,81,43,38,0.531,81,43,38,0.531
22101206,1610612761,1610612745,117.0,115.0,0.458,0.531,1,2022-04-08,81,48,33,0.593,81,20,61,0.247
22101207,1610612748,1610612737,113.0,109.0,0.556,0.477,1,2022-04-08,81,53,28,0.654,81,42,39,0.519
22101208,1610612741,1610612766,117.0,133.0,0.537,0.605,0,2022-04-08,81,45,36,0.556,81,42,39,0.519
22101209,1610612742,1610612757,128.0,78.0,0.532,0.373,1,2022-04-08,81,51,30,0.63,81,27,54,0.333
22101210,1610612762,1610612756,105.0,111.0,0.398,0.5,0,2022-04-08,81,48,33,0.593,81,64,17,0.79
22101211,1610612747,1610612760,120.0,101.0,0.5,0.455,1,2022-04-08,81,32,49,0.395,81,24,57,0.296
22101196,1610612766,1610612753,128.0,101.0,0.522,0.4,1,2022-04-07,80,41,39,0.513,81,21,60,0.259
22101197,1610612761,1610612755,119.0,114.0,0.495,0.493,1,2022-04-07,80,47,33,0.588,80,49,31,0.613
22101198,1610612749,1610612738,127.0,121.0,0.505,0.494,1,2022-04-07,80,50,30,0.625,81,50,31,0.617
22101199,1610612750,1610612759,127.0,121.0,0.427,0.483,1,2022-04-07,81,46,35,0.568,80,34,46,0.425
22101200,1610612740,1610612757,127.0,94.0,0.473,0.522,1,2022-04-07,80,36,44,0.45,80,27,53,0.338
22101201,1610612743,1610612763,122.0,109.0,0.55,0.472,1,2022-04-07,81,48,33,0.593,80,55,25,0.688
22101202,1610612744,1610612747,128.0,112.0,0.526,0.446,1,2022-04-07,80,51,29,0.638,80,31,49,0.388
22101190,1610612765,1610612742,113.0,131.0,0.427,0.563,0,2022-04-06,80,23,57,0.288,80,50,30,0.625
22101191,1610612752,1610612751,98.0,110.0,0.386,0.441,0,2022-04-06,80,35,45,0.438,80,42,38,0.525
22101192,1610612737,1610612764,118.0,103.0,0.467,0.488,1,2022-04-06,80,42,38,0.525,80,35,45,0.438
22101193,1610612741,1610612738,94.0,117.0,0.438,0.489,0,2022-04-06,80,45,35,0.563,80,50,30,0.625
22101194,1610612762,1610612760,137.0,101.0,0.583,0.411,1,2022-04-06,80,48,32,0.6,80,24,56,0.3
22101195,1610612746,1610612756,113.0,109.0,0.44,0.389,1,2022-04-06,80,40,40,0.5,80,63,17,0.788
22101178,1610612754,1610612755,122.0,131.0,0.474,0.54,0,2022-04-05,80,25,55,0.313,79,49,30,0.62
22101179,1610612753,1610612739,120.0,115.0,0.505,0.488,1,2022-04-05,80,21,59,0.263,80,43,37,0.538
22101180,1610612751,1610612745,118.0,105.0,0.453,0.404,1,2022-04-05,79,41,38,0.519,80,20,60,0.25
22101181,1610612748,1610612766,144.0,115.0,0.571,0.529,1,2022-04-05,80,52,28,0.65,79,40,39,0.506
22101182,1610612761,1610612737,118.0,108.0,0.436,0.457,1,2022-04-05,79,46,33,0.582,79,41,38,0.519
22101183,1610612741,1610612749,106.0,127.0,0.429,0.529,0,2022-04-05,79,45,34,0.57,79,49,30,0.62
22101184,1610612750,1610612764,114.0,132.0,0.451,0.554,0,2022-04-05,80,45,35,0.563,79,35,44,0.443
22101185,1610612760,1610612757,98.0,94.0,0.481,0.422,1,2022-04-05,79,24,55,0.304,79,27,52,0.342
22101186,1610612743,1610612759,97.0,116.0,0.418,0.494,0,2022-04-05,80,47,33,0.588,79,34,45,0.43
22101187,1610612762,1610612763,121.0,115.0,0.417,0.386,1,2022-04-05,79,47,32,0.595,79,55,24,0.696
22101188,1610612758,1610612740,109.0,123.0,0.513,0.511,0,2022-04-05,80,29,51,0.363,79,35,44,0.443
22101189,1610612756,1610612747,121.0,110.0,0.49,0.453,1,2022-04-05,79,63,16,0.797,79,31,48,0.392
22101166,1610612738,1610612764,144.0,102.0,0.615,0.463,1,2022-04-03,79,49,30,0.62,78,34,44,0.436
22101167,1610612749,1610612742,112.0,118.0,0.442,0.513,0,2022-04-03,78,48,30,0.615,79,49,30,0.62
22101168,1610612747,1610612743,118.0,129.0,0.533,0.573,0,2022-04-03,78,31,47,0.397,79,47,32,0.595
22101169,1610612754,1610612765,117.0,121.0,0.479,0.434,0,2022-04-03,79,25,54,0.316,79,23,56,0.291
22101170,1610612739,1610612755,108.0,112.0,0.449,0.413,0,2022-04-03,79,43,36,0.544,78,48,30,0.615
22101171,1610612753,1610612752,88.0,118.0,0.353,0.484,0,2022-04-03,79,20,59,0.253,79,35,44,0.443
22101172,1610612761,1610612748,109.0,114.0,0.422,0.519,0,2022-04-03,78,45,33,0.577,79,51,28,0.646
22101173,1610612745,1610612750,132.0,139.0,0.565,0.593,0,2022-04-03,79,20,59,0.253,79,45,34,0.57
22101174,1610612760,1610612756,117.0,96.0,0.494,0.416,1,2022-04-03,78,23,55,0.295,78,62,16,0.795
22101175,1610612759,1610612757,113.0,92.0,0.452,0.393,1,2022-04-03,78,33,45,0.423,78,27,51,0.346
22101176,1610612758,1610612744,90.0,109.0,0.383,0.519,0,2022-04-03,79,29,50,0.367,79,50,29,0.633
22101177,1610612746,1610612740,119.0,100.0,0.474,0.402,1,2022-04-03,79,39,40,0.494,78,34,44,0.436
22101161,1610612755,1610612766,144.0,114.0,0.609,0.483,1,2022-04-02,77,47,30,0.61,78,40,38,0.513
22101162,1610612752,1610612739,101.0,119.0,0.403,0.543,0,2022-04-02,78,34,44,0.436,78,43,35,0.551
22101163,1610612737,1610612751,122.0,115.0,0.419,0.424,1,2022-04-02,78,41,37,0.526,78,40,38,0.513
22101164,1610612741,1610612748,109.0,127.0,0.43,0.537,0,2022-04-02,78,45,33,0.577,78,50,28,0.641
22101165,1610612744,1610612762,111.0,107.0,0.476,0.427,1,2022-04-02,78,49,29,0.628,78,46,32,0.59
22101151,1610612753,1610612761,89.0,102.0,0.43,0.419,0,2022-04-01,78,20,58,0.256,77,45,32,0.584
22101152,1610612764,1610612742,135.0,103.0,0.544,0.436,1,2022-04-01,77,34,43,0.442,78,48,30,0.615
22101153,1610612738,1610612754,128.0,123.0,0.542,0.519,1,2022-04-01,78,48,30,0.615,78,25,53,0.321
22101154,1610612745,1610612758,117.0,122.0,0.423,0.519,0,2022-04-01,78,20,58,0.256,78,29,49,0.372
22101155,1610612763,1610612756,122.0,114.0,0.451,0.547,1,2022-04-01,78,55,23,0.705,77,62,15,0.805
22101156,1610612749,1610612746,119.0,153.0,0.532,0.609,0,2022-04-01,77,48,29,0.623,78,38,40,0.487
22101157,1610612760,1610612765,101.0,110.0,0.429,0.426,0,2022-04-01,77,22,55,0.286,78,22,56,0.282
22101158,1610612759,1610612757,130.0,111.0,0.568,0.446,1,2022-04-01,77,32,45,0.416,77,27,50,0.351
22101159,1610612743,1610612750,130.0,136.0,0.535,0.5,0,2022-04-01,78,46,32,0.59,78,44,34,0.564
22101160,1610612747,1610612740,111.0,114.0,0.476,0.519,0,2022-04-01,77,31,46,0.403,77,34,43,0.442
22101147,1610612765,1610612755,102.0,94.0,0.5,0.449,1,2022-03-31,77,21,56,0.273,76,46,30,0.605
22100452,1610612737,1610612739,131.0,107.0,0.495,0.433,1,2022-03-31,77,40,37,0.519,77,42,35,0.545
22101148,1610612751,1610612749,119.0,120.0,0.464,0.449,0,2022-03-31,77,40,37,0.519,76,48,28,0.632
22101149,1610612741,1610612746,135.0,130.0,0.49,0.5,1,2022-03-31,77,45,32,0.584,77,37,40,0.481
22101150,1610612762,1610612747,122.0,109.0,0.511,0.494,1,2022-03-31,77,46,31,0.597,76,31,45,0.408
22101136,1610612739,1610612742,112.0,120.0,0.506,0.523,0,2022-03-30,76,42,34,0.553,77,48,29,0.623
22101137,1610612754,1610612743,118.0,125.0,0.454,0.625,0,2022-03-30,77,25,52,0.325,77,46,31,0.597
22101138,1610612764,1610612753,127.0,110.0,0.511,0.417,1,2022-03-30,76,33,43,0.434,77,20,57,0.26
22101139,1610612738,1610612748,98.0,106.0,0.412,0.481,0,2022-03-30,77,47,30,0.61,77,49,28,0.636
22101140,1610612752,1610612766,114.0,125.0,0.471,0.544,0,2022-03-30,77,34,43,0.442,77,40,37,0.519
22101141,1610612761,1610612750,125.0,102.0,0.5,0.402,1,2022-03-30,76,44,32,0.579,77,43,34,0.558
22101142,1610612745,1610612758,118.0,121.0,0.457,0.463,0,2022-03-30,77,20,57,0.26,77,28,49,0.364
22101143,1610612760,1610612737,118.0,136.0,0.471,0.538,0,2022-03-30,76,22,54,0.289,76,39,37,0.513
22101144,1610612759,1610612763,111.0,112.0,0.506,0.484,0,2022-03-30,76,31,45,0.408,77,54,23,0.701
22101145,1610612744,1610612756,103.0,107.0,0.422,0.413,0,2022-03-30,77,48,29,0.623,76,62,14,0.816
22101146,1610612757,1610612740,107.0,117.0,0.459,0.513,0,2022-03-30,76,27,49,0.355,76,33,43,0.434
22101131,1610612755,1610612749,116.0,118.0,0.483,0.5,0,2022-03-29,75,46,29,0.613,75,47,28,0.627
22101132,1610612764,1610612741,94.0,107.0,0.481,0.506,0,2022-03-29,75,32,43,0.427,76,44,32,0.579
22101133,1610612751,1610612765,130.0,123.0,0.553,0.485,1,2022-03-29,76,40,36,0.526,76,20,56,0.263
22101134,1610612742,1610612747,128.0,110.0,0.517,0.449,1,2022-03-29,76,47,29,0.618,75,31,44,0.413
22101135,1610612746,1610612762,121.0,115.0,0.494,0.551,1,2022-03-29,76,37,39,0.487,76,45,31,0.592
22101122,1610612766,1610612743,109.0,113.0,0.473,0.465,0,2022-03-28,76,39,37,0.513,76,45,31,0.592
22101123,1610612739,1610612753,107.0,101.0,0.446,0.483,1,2022-03-28,75,42,33,0.56,76,20,56,0.263
22101124,1610612754,1610612737,123.0,132.0,0.517,0.547,0,2022-03-28,76,25,51,0.329,75,38,37,0.507
22101125,1610612748,1610612758,123.0,100.0,0.544,0.457,1,2022-03-28,76,48,28,0.632,76,27,49,0.355
22101126,1610612752,1610612741,109.0,104.0,0.427,0.43,1,2022-03-28,76,34,42,0.447,75,43,32,0.573
22101127,1610612761,1610612738,115.0,112.0,0.434,0.411,1,2022-03-28,75,43,32,0.573,76,47,29,0.618
22101128,1610612745,1610612759,120.0,123.0,0.413,0.47,0,2022-03-28,76,20,56,0.263,75,31,44,0.413
22101129,1610612763,1610612744,123.0,95.0,0.467,0.407,1,2022-03-28,76,53,23,0.697,76,48,28,0.632
22101130,1610612757,1610612760,131.0,134.0,0.455,0.533,0,2022-03-28,75,27,48,0.36,75,22,53,0.293
22101115,1610612765,1610612752,102.0,104.0,0.459,0.4,0,2022-03-27,75,20,55,0.267,75,33,42,0.44
22101116,1610612738,1610612750,134.0,112.0,0.563,0.536,1,2022-03-27,75,47,28,0.627,76,43,33,0.566
22101117,1610612764,1610612744,123.0,115.0,0.524,0.427,1,2022-03-27,74,32,42,0.432,75,48,27,0.64
22101118,1610612756,1610612755,114.0,104.0,0.517,0.416,1,2022-03-27,75,61,14,0.813,74,46,28,0.622
22101119,1610612740,1610612747,116.0,108.0,0.484,0.525,1,2022-03-27,75,32,43,0.427,74,31,43,0.419
22101120,1610612751,1610612766,110.0,119.0,0.443,0.429,0,2022-03-27,75,39,36,0.52,75,39,36,0.52
22101121,1610612742,1610612762,114.0,100.0,0.519,0.461,1,2022-03-27,75,46,29,0.613,75,45,30,0.6
22101107,1610612740,1610612759,103.0,107.0,0.444,0.424,0,2022-03-26,74,31,43,0.419,74,30,44,0.405
22101108,1610612753,1610612758,110.0,114.0,0.425,0.429,0,2022-03-26,75,20,55,0.267,75,27,48,0.36
22101109,1610612761,1610612754,131.0,91.0,0.607,0.418,1,2022-03-26,74,42,32,0.568,75,25,50,0.333
22101110,1610612739,1610612741,94.0,98.0,0.415,0.48,0,2022-03-26,74,41,33,0.554,74,43,31,0.581
22101111,1610612748,1610612751,95.0,110.0,0.44,0.47,0,2022-03-26,75,47,28,0.627,74,39,35,0.527
22101112,1610612763,1610612749,127.0,102.0,0.48,0.398,1,2022-03-26,75,52,23,0.693,74,46,28,0.622
22101113,1610612743,1610612760,113.0,107.0,0.482,0.464,1,2022-03-26,75,44,31,0.587,74,21,53,0.284
22101114,1610612757,1610612745,98.0,115.0,0.398,0.524,0,2022-03-26,74,27,47,0.365,75,20,55,0.267
22101100,1610612766,1610612762,107.0,101.0,0.466,0.452,1,2022-03-25,74,38,36,0.514,74,45,29,0.608
22101101,1610612765,1610612764,97.0,100.0,0.411,0.434,0,2022-03-25,74,20,54,0.27,73,31,42,0.425
22101102,1610612737,1610612744,121.0,110.0,0.517,0.478,1,2022-03-25,74,37,37,0.5,74,48,26,0.649
22101103,1610612748,1610612752,103.0,111.0,0.5,0.439,0,2022-03-25,74,47,27,0.635,74,32,42,0.432
22101104,1610612750,1610612742,116.0,95.0,0.512,0.389,1,2022-03-25,75,43,32,0.573,74,45,29,0.608
22101105,1610612757,1610612745,106.0,125.0,0.506,0.518,0,2022-03-25,73,27,46,0.37,74,19,55,0.257
22101106,1610612746,1610612755,97.0,122.0,0.4,0.467,0,2022-03-25,75,36,39,0.48,73,46,27,0.63
22101095,1610612761,1610612739,117.0,104.0,0.472,0.468,1,2022-03-24,73,41,32,0.562,73,41,32,0.562
22101096,1610612763,1610612754,133.0,103.0,0.538,0.424,1,2022-03-24,74,51,23,0.689,74,25,49,0.338
22101097,1610612749,1610612764,114.0,102.0,0.519,0.467,1,2022-03-24,73,46,27,0.63,72,30,42,0.417
22101098,1610612740,1610612741,126.0,109.0,0.494,0.513,1,2022-03-24,73,31,42,0.425,73,42,31,0.575
22101099,1610612743,1610612756,130.0,140.0,0.593,0.605,0,2022-03-24,74,43,31,0.581,74,60,14,0.811
22101084,1610612766,1610612752,106.0,121.0,0.472,0.518,0,2022-03-23,73,37,36,0.507,73,31,42,0.425
22101085,1610612765,1610612737,122.0,101.0,0.5,0.402,1,2022-03-23,73,20,53,0.274,73,36,37,0.493
22101086,1610612754,1610612758,109.0,110.0,0.462,0.524,0,2022-03-23,73,25,48,0.342,74,26,48,0.351
22101087,1610612738,1610612762,125.0,97.0,0.595,0.398,1,2022-03-23,74,46,28,0.622,73,45,28,0.616
22101088,1610612748,1610612744,104.0,118.0,0.435,0.519,0,2022-03-23,73,47,26,0.644,73,48,25,0.658
22101089,1610612763,1610612751,132.0,120.0,0.465,0.494,1,2022-03-23,73,50,23,0.685,73,38,35,0.521
22101090,1610612750,1610612756,116.0,125.0,0.442,0.523,0,2022-03-23,74,42,32,0.568,73,59,14,0.808
22101091,1610612760,1610612753,118.0,102.0,0.481,0.387,1,2022-03-23,73,21,52,0.288,74,20,54,0.27
22101092,1610612742,1610612745,110.0,91.0,0.488,0.402,1,2022-03-23,73,45,28,0.616,73,18,55,0.247
22101093,1610612747,1610612755,121.0,126.0,0.515,0.516,0,2022-03-23,73,31,42,0.425,72,45,27,0.625
22101094,1610612757,1610612759,96.0,133.0,0.383,0.489,0,2022-03-23,72,27,45,0.375,73,29,44,0.397
22101080,1610612753,1610612744,94.0,90.0,0.43,0.4,1,2022-03-22,73,20,53,0.274,72,47,25,0.653
22101081,1610612752,1610612737,111.0,117.0,0.488,0.494,0,2022-03-22,72,30,42,0.417,72,36,36,0.5
22101082,1610612749,1610612741,126.0,98.0,0.61,0.424,1,2022-03-22,72,45,27,0.625,72,42,30,0.583
22101083,1610612743,1610612746,127.0,115.0,0.542,0.488,1,2022-03-22,73,43,30,0.589,74,36,38,0.486
22101071,1610612766,1610612740,106.0,103.0,0.506,0.444,1,2022-03-21,72,37,35,0.514,72,30,42,0.417
22101072,1610612739,1610612747,120.0,131.0,0.523,0.564,0,2022-03-21,72,41,31,0.569,72,31,41,0.431
22101073,1610612765,1610612757,115.0,119.0,0.424,0.42,0,2022-03-21,72,19,53,0.264,71,27,44,0.38
22101074,1610612755,1610612748,113.0,106.0,0.5,0.475,1,2022-03-21,71,44,27,0.62,72,47,25,0.653
22101075,1610612751,1610612762,114.0,106.0,0.542,0.446,1,2022-03-21,72,38,34,0.528,72,45,27,0.625
22101076,1610612741,1610612761,113.0,99.0,0.489,0.44,1,2022-03-21,71,42,29,0.592,72,40,32,0.556
22101077,1610612745,1610612764,115.0,97.0,0.494,0.412,1,2022-03-21,72,18,54,0.25,71,30,41,0.423
22101078,1610612760,1610612738,123.0,132.0,0.516,0.512,0,2022-03-21,72,20,52,0.278,73,45,28,0.616
22101079,1610612742,1610612750,110.0,108.0,0.482,0.396,1,2022-03-21,72,44,28,0.611,73,42,31,0.575
22101062,1610612754,1610612757,129.0,98.0,0.571,0.469,1,2022-03-20,72,25,47,0.347,70,26,44,0.371
22101063,1610612745,1610612763,98.0,122.0,0.43,0.479,0,2022-03-20,71,17,54,0.239,72,49,23,0.681
22101064,1610612737,1610612740,112.0,117.0,0.471,0.448,0,2022-03-20,71,35,36,0.493,71,30,41,0.423
22101065,1610612753,1610612760,90.0,85.0,0.386,0.326,1,2022-03-20,72,19,53,0.264,71,20,51,0.282
22101066,1610612758,1610612756,124.0,127.0,0.429,0.5,0,2022-03-20,73,25,48,0.342,72,58,14,0.806
22101067,1610612752,1610612762,93.0,108.0,0.373,0.459,0,2022-03-20,71,30,41,0.423,71,45,26,0.634
22101068,1610612743,1610612738,104.0,124.0,0.402,0.573,0,2022-03-20,72,42,30,0.583,72,44,28,0.611
22101069,1610612755,1610612761,88.0,93.0,0.411,0.376,0,2022-03-20,70,43,27,0.614,71,40,31,0.563
22101070,1610612744,1610612759,108.0,110.0,0.456,0.388,0,2022-03-20,71,47,24,0.662,72,28,44,0.389
22101058,1610612750,1610612749,138.0,119.0,0.511,0.443,1,2022-03-19,72,42,30,0.583,71,44,27,0.62
22101059,1610612766,1610612742,129.0,108.0,0.5,0.438,1,2022-03-19,71,36,35,0.507,71,43,28,0.606
22101060,1610612739,1610612765,113.0,109.0,0.511,0.482,1,2022-03-19,71,41,30,0.577,71,19,52,0.268
22101061,1610612764,1610612747,127.0,119.0,0.518,0.527,1,2022-03-19,70,30,40,0.429,71,30,41,0.423
22101046,1610612755,1610612742,111.0,101.0,0.493,0.463,1,2022-03-18,69,43,26,0.623,70,43,27,0.614
22101047,1610612737,1610612763,120.0,105.0,0.495,0.465,1,2022-03-18,70,35,35,0.5,71,48,23,0.676
22101048,1610612751,1610612757,128.0,123.0,0.584,0.5,1,2022-03-18,71,37,34,0.521,69,26,43,0.377
22101049,1610612739,1610612743,119.0,116.0,0.449,0.5,1,2022-03-18,70,40,30,0.571,71,42,29,0.592
22101050,1610612752,1610612764,100.0,97.0,0.344,0.43,1,2022-03-18,70,30,40,0.429,69,29,40,0.42
22101051,1610612761,1610612747,123.0,128.0,0.505,0.49,0,2022-03-18,70,39,31,0.557,70,30,40,0.429
22101052,1610612748,1610612760,120.0,108.0,0.484,0.476,1,2022-03-18,71,47,24,0.662,70,20,50,0.286
22101053,1610612745,1610612754,118.0,121.0,0.494,0.465,0,2022-03-18,70,17,53,0.243,71,24,47,0.338
22101054,1610612759,1610612740,91.0,124.0,0.36,0.5,0,2022-03-18,71,27,44,0.38,70,29,41,0.414
22101055,1610612762,1610612746,121.0,92.0,0.485,0.36,1,2022-03-18,70,44,26,0.629,73,36,37,0.493
22101056,1610612756,1610612741,129.0,102.0,0.56,0.412,1,2022-03-18,71,57,14,0.803,70,41,29,0.586
22101057,1610612758,1610612738,97.0,126.0,0.418,0.561,0,2022-03-18,72,25,47,0.347,71,43,28,0.606
22101045,1610612753,1610612765,120.0,134.0,0.485,0.5,0,2022-03-17,71,18,53,0.254,70,19,51,0.271
22101033,1610612766,1610612737,116.0,106.0,0.494,0.43,1,2022-03-16,70,35,35,0.5,69,34,35,0.493
22101034,1610612739,1610612755,114.0,118.0,0.488,0.519,0,2022-03-16,69,39,30,0.565,68,42,26,0.618
22101035,1610612764,1610612743,109.0,127.0,0.471,0.511,0,2022-03-16,68,29,39,0.426,70,42,28,0.6
22101036,1610612751,1610612742,111.0,113.0,0.495,0.494,0,2022-03-16,70,36,34,0.514,69,43,26,0.623
22101037,1610612752,1610612757,128.0,98.0,0.5,0.44,1,2022-03-16,69,29,40,0.42,68,26,42,0.382
22101038,1610612745,1610612756,112.0,129.0,0.494,0.558,0,2022-03-16,69,17,52,0.246,70,56,14,0.8
22101039,1610612750,1610612747,124.0,104.0,0.444,0.419,1,2022-03-16,71,41,30,0.577,69,29,40,0.42
22101040,1610612759,1610612760,122.0,120.0,0.439,0.524,1,2022-03-16,70,27,43,0.386,69,20,49,0.29
22101041,1610612762,1610612741,125.0,110.0,0.506,0.473,1,2022-03-16,69,43,26,0.623,69,41,28,0.594
22101042,1610612744,1610612738,88.0,110.0,0.372,0.469,0,2022-03-16,70,47,23,0.671,70,42,28,0.6
22101043,1610612758,1610612749,126.0,135.0,0.489,0.528,0,2022-03-16,71,25,46,0.352,70,44,26,0.629
22101044,1610612746,1610612761,100.0,103.0,0.487,0.458,0,2022-03-16,72,36,36,0.5,69,39,30,0.565
22101029,1610612754,1610612763,102.0,135.0,0.418,0.514,0,2022-03-15,70,23,47,0.329,70,48,22,0.686
22101030,1610612753,1610612751,108.0,150.0,0.379,0.602,0,2022-03-15,70,18,52,0.257,69,36,33,0.522
22101031,1610612748,1610612765,105.0,98.0,0.403,0.463,1,2022-03-15,70,46,24,0.657,69,18,51,0.261
22101032,1610612740,1610612756,115.0,131.0,0.5,0.544,0,2022-03-15,69,28,41,0.406,69,55,14,0.797
22101020,1610612739,1610612746,120.0,111.0,0.477,0.439,1,2022-03-14,68,39,29,0.574,71,36,35,0.507
22101021,1610612737,1610612757,122.0,113.0,0.367,0.5,1,2022-03-14,68,34,34,0.5,67,26,41,0.388
22101022,1610612755,1610612743,110.0,114.0,0.429,0.537,0,2022-03-14,67,41,26,0.612,69,41,28,0.594
22101023,1610612760,1610612766,116.0,134.0,0.467,0.538,0,2022-03-14,68,20,48,0.294,69,34,35,0.493
22101024,1610612759,1610612750,139.0,149.0,0.536,0.578,0,2022-03-14,69,26,43,0.377,70,40,30,0.571
22101025,1610612744,1610612764,126.0,112.0,0.536,0.512,1,2022-03-14,69,47,22,0.681,67,29,38,0.433
22101026,1610612758,1610612741,112.0,103.0,0.476,0.409,1,2022-03-14,70,25,45,0.357,68,41,27,0.603
22101027,1610612762,1610612749,111.0,117.0,0.398,0.465,0,2022-03-14,68,42,26,0.618,69,43,26,0.623
22101028,1610612747,1610612761,103.0,114.0,0.391,0.406,0,2022-03-14,68,29,39,0.426,68,38,30,0.559
22101012,1610612751,1610612752,110.0,107.0,0.494,0.47,1,2022-03-13,68,35,33,0.515,68,28,40,0.412
22101013,1610612765,1610612746,102.0,106.0,0.45,0.449,0,2022-03-13,68,18,50,0.265,70,36,34,0.514
22101014,1610612738,1610612742,92.0,95.0,0.375,0.446,0,2022-03-13,69,41,28,0.594,68,42,26,0.618
22101015,1610612753,1610612755,114.0,116.0,0.451,0.38,0,2022-03-13,69,18,51,0.261,66,41,25,0.621
22101016,1610612737,1610612754,131.0,128.0,0.548,0.517,1,2022-03-13,67,33,34,0.493,69,23,46,0.333
22101017,1610612740,1610612745,130.0,105.0,0.516,0.506,1,2022-03-13,68,28,40,0.412,68,17,51,0.25
22101018,1610612760,1610612763,118.0,125.0,0.423,0.471,0,2022-03-13,67,20,47,0.299,69,47,22,0.681
22101019,1610612756,1610612747,140.0,111.0,0.569,0.444,1,2022-03-13,68,54,14,0.794,67,29,38,0.433
22101005,1610612748,1610612750,104.0,113.0,0.398,0.422,0,2022-03-12,69,45,24,0.652,69,39,30,0.565
22101006,1610612741,1610612739,101.0,91.0,0.443,0.419,1,2022-03-12,67,41,26,0.612,67,38,29,0.567
22101007,1610612759,1610612754,108.0,119.0,0.412,0.489,0,2022-03-12,68,26,42,0.382,68,23,45,0.338
22101008,1610612744,1610612749,122.0,109.0,0.484,0.413,1,2022-03-12,68,46,22,0.676,68,42,26,0.618
22101009,1610612743,1610612761,115.0,127.0,0.551,0.471,0,2022-03-12,68,40,28,0.588,67,37,30,0.552
22101010,1610612762,1610612758,134.0,125.0,0.558,0.5,1,2022-03-12,67,42,25,0.627,69,24,45,0.348
22101011,1610612757,1610612764,127.0,118.0,0.516,0.47,1,2022-03-12,66,26,40,0.394,66,29,37,0.439
22100995,1610612753,1610612750,118.0,110.0,0.465,0.456,1,2022-03-11,68,18,50,0.265,68,38,30,0.559
22100996,1610612737,1610612746,112.0,106.0,0.478,0.488,1,2022-03-11,66,32,34,0.485,69,35,34,0.507
22100997,1610612738,1610612765,114.0,103.0,0.467,0.422,1,2022-03-11,68,41,27,0.603,67,18,49,0.269
22100998,1610612748,1610612739,117.0,105.0,0.477,0.443,1,2022-03-11,68,45,23,0.662,66,38,28,0.576
22100999,1610612745,1610612742,100.0,113.0,0.477,0.455,0,2022-03-11,67,17,50,0.254,67,41,26,0.612
22101000,1610612763,1610612752,118.0,114.0,0.447,0.422,1,2022-03-11,68,46,22,0.676,67,28,39,0.418
22101001,1610612740,1610612766,120.0,142.0,0.5,0.598,0,2022-03-11,67,27,40,0.403,68,33,35,0.485
22101002,1610612759,1610612762,104.0,102.0,0.4,0.402,1,2022-03-11,67,26,41,0.388,66,41,25,0.621
22101003,1610612756,1610612761,112.0,117.0,0.5,0.447,0,2022-03-11,67,53,14,0.791,66,36,30,0.545
22101004,1610612747,1610612764,122.0,109.0,0.527,0.459,1,2022-03-11,66,29,37,0.439,65,29,36,0.446
22100993,1610612755,1610612751,100.0,129.0,0.323,0.56,0,2022-03-10,65,40,25,0.615,67,34,33,0.507
22100994,1610612743,1610612744,102.0,113.0,0.417,0.477,0,2022-03-10,67,40,27,0.597,67,45,22,0.672
22100981,1610612766,1610612738,101.0,115.0,0.424,0.495,0,2022-03-09,67,32,35,0.478,67,40,27,0.597
22100982,1610612765,1610612741,108.0,114.0,0.512,0.526,0,2022-03-09,66,18,48,0.273,66,40,26,0.606
22100983,1610612748,1610612756,90.0,111.0,0.398,0.455,0,2022-03-09,67,44,23,0.657,66,53,13,0.803
22100984,1610612749,1610612737,124.0,115.0,0.5,0.5,1,2022-03-09,67,42,25,0.627,65,31,34,0.477
22100985,1610612745,1610612747,139.0,130.0,0.51,0.465,1,2022-03-09,66,17,49,0.258,65,28,37,0.431
22100986,1610612750,1610612760,132.0,102.0,0.523,0.414,1,2022-03-09,67,38,29,0.567,66,20,46,0.303
22100987,1610612740,1610612753,102.0,108.0,0.441,0.474,0,2022-03-09,66,27,39,0.409,67,17,50,0.254
22100988,1610612742,1610612752,77.0,107.0,0.314,0.429,0,2022-03-09,66,40,26,0.606,66,28,38,0.424
22100989,1610612759,1610612761,104.0,119.0,0.452,0.482,0,2022-03-09,66,25,41,0.379,65,35,30,0.538
22100990,1610612762,1610612757,123.0,85.0,0.519,0.326,1,2022-03-09,65,41,24,0.631,65,25,40,0.385
22100991,1610612758,1610612743,100.0,106.0,0.447,0.488,0,2022-03-09,68,24,44,0.353,66,40,26,0.606
22100992,1610612746,1610612764,115.0,109.0,0.5,0.471,1,2022-03-09,68,35,33,0.515,64,29,35,0.453
22100975,1610612766,1610612751,121.0,132.0,0.489,0.561,0,2022-03-08,66,32,34,0.485,66,33,33,0.5
22100976,1610612754,1610612739,124.0,127.0,0.538,0.5,0,2022-03-08,67,22,45,0.328,65,38,27,0.585
22100977,1610612753,1610612756,99.0,102.0,0.38,0.38,0,2022-03-08,66,16,50,0.242,65,52,13,0.8
22100978,1610612763,1610612740,132.0,111.0,0.475,0.466,1,2022-03-08,67,45,22,0.672,65,27,38,0.415
22100979,1610612760,1610612749,115.0,142.0,0.5,0.53,0,2022-03-08,65,20,45,0.308,66,41,25,0.621
22100980,1610612744,1610612746,112.0,97.0,0.478,0.355,1,2022-03-08,66,44,22,0.667,67,34,33,0.507
22100968,1610612765,1610612737,113.0,110.0,0.462,0.452,1,2022-03-07,65,18,47,0.277,64,31,33,0.484
22100969,1610612755,1610612741,121.0,106.0,0.488,0.448,1,2022-03-07,64,40,24,0.625,65,39,26,0.6
22100970,1610612748,1610612745,123.0,106.0,0.538,0.443,1,2022-03-07,66,44,22,0.667,65,16,49,0.246
22100971,1610612750,1610612757,124.0,81.0,0.413,0.277,1,2022-03-07,66,37,29,0.561,64,25,39,0.391
22100972,1610612742,1610612762,111.0,103.0,0.443,0.434,1,2022-03-07,65,40,25,0.615,64,40,24,0.625
22100973,1610612759,1610612747,117.0,110.0,0.548,0.473,1,2022-03-07,65,25,40,0.385,64,28,36,0.438
22100528,1610612743,1610612744,131.0,124.0,0.548,0.511,1,2022-03-07,65,39,26,0.6,65,43,22,0.662
22100974,1610612758,1610612752,115.0,131.0,0.488,0.511,0,2022-03-07,67,24,43,0.358,65,27,38,0.415
22100960,1610612738,1610612751,126.0,120.0,0.482,0.506,1,2022-03-06,66,39,27,0.591,65,32,33,0.492
22100961,1610612749,1610612756,132.0,122.0,0.54,0.538,1,2022-03-06,65,40,25,0.615,64,51,13,0.797
22100963,1610612764,1610612754,133.0,123.0,0.523,0.518,1,2022-03-06,63,29,34,0.46,66,22,44,0.333
22100964,1610612745,1610612763,123.0,112.0,0.524,0.454,1,2022-03-06,64,16,48,0.25,66,44,22,0.667
22100965,1610612760,1610612762,103.0,116.0,0.424,0.449,0,2022-03-06,64,20,44,0.313,63,40,23,0.635
22100962,1610612739,1610612761,104.0,96.0,0.459,0.394,1,2022-03-06,64,37,27,0.578,64,34,30,0.531
22100967,1610612743,1610612740,138.0,130.0,0.54,0.475,1,2022-03-06,64,38,26,0.594,64,27,37,0.422
22100966,1610612746,1610612752,93.0,116.0,0.375,0.472,0,2022-03-06,66,34,32,0.515,64,26,38,0.406
22100954,1610612742,1610612758,114.0,113.0,0.476,0.489,1,2022-03-05,64,39,25,0.609,66,24,42,0.364
22100955,1610612766,1610612759,123.0,117.0,0.462,0.459,1,2022-03-05,65,32,33,0.492,64,24,40,0.375
22100956,1610612748,1610612755,99.0,82.0,0.486,0.341,1,2022-03-05,65,43,22,0.662,63,39,24,0.619
22100957,1610612763,1610612753,124.0,96.0,0.5,0.43,1,2022-03-05,65,44,21,0.677,65,16,49,0.246
22100958,1610612750,1610612757,135.0,121.0,0.565,0.471,1,2022-03-05,65,36,29,0.554,63,25,38,0.397
22100959,1610612747,1610612744,124.0,116.0,0.494,0.5,1,2022-03-05,63,28,35,0.444,64,43,21,0.672
22100946,1610612765,1610612754,111.0,106.0,0.447,0.39,1,2022-03-04,64,17,47,0.266,65,22,43,0.338
22100947,1610612755,1610612739,125.0,119.0,0.547,0.537,1,2022-03-04,62,39,23,0.629,63,36,27,0.571
22100948,1610612764,1610612737,114.0,117.0,0.541,0.418,0,2022-03-04,62,28,34,0.452,63,31,32,0.492
22100458,1610612761,1610612753,97.0,103.0,0.398,0.379,0,2022-03-04,63,34,29,0.54,64,16,48,0.25
22100949,1610612741,1610612749,112.0,118.0,0.5,0.489,0,2022-03-04,64,39,25,0.609,64,39,25,0.609
22100950,1610612740,1610612762,124.0,90.0,0.515,0.348,1,2022-03-04,63,27,36,0.429,62,39,23,0.629
22100951,1610612760,1610612750,101.0,138.0,0.43,0.538,0,2022-03-04,63,20,43,0.317,64,35,29,0.547
22100952,1610612743,1610612745,116.0,101.0,0.453,0.458,1,2022-03-04,63,37,26,0.587,63,15,48,0.238
22100953,1610612756,1610612752,115.0,114.0,0.447,0.465,1,2022-03-04,63,51,12,0.81,63,25,38,0.397
22100710,1610612737,1610612741,130.0,124.0,0.524,0.591,1,2022-03-03,62,30,32,0.484,63,39,24,0.619
22100940,1610612738,1610612763,120.0,107.0,0.517,0.424,1,2022-03-03,65,38,27,0.585,64,43,21,0.672
22100941,1610612751,1610612748,107.0,113.0,0.47,0.519,0,2022-03-03,64,32,32,0.5,64,42,22,0.656
22100942,1610612761,1610612765,106.0,108.0,0.434,0.452,0,2022-03-03,62,34,28,0.548,63,16,47,0.254
22100943,1610612742,1610612744,122.0,113.0,0.529,0.543,1,2022-03-03,63,38,25,0.603,63,43,20,0.683
22100944,1610612759,1610612758,112.0,115.0,0.495,0.459,0,2022-03-03,63,24,39,0.381,65,24,41,0.369
22100945,1610612746,1610612747,132.0,111.0,0.548,0.488,1,2022-03-03,65,34,31,0.523,62,27,35,0.435
22100932,1610612739,1610612766,98.0,119.0,0.468,0.506,0,2022-03-02,62,36,26,0.581,64,31,33,0.484
22100933,1610612753,1610612754,114.0,122.0,0.454,0.436,0,2022-03-02,63,15,48,0.238,64,22,42,0.344
22100934,1610612755,1610612752,123.0,108.0,0.52,0.429,1,2022-03-02,61,38,23,0.623,62,25,37,0.403
22100935,1610612745,1610612762,127.0,132.0,0.5,0.549,0,2022-03-02,62,15,47,0.242,61,39,22,0.639
22100936,1610612749,1610612748,120.0,119.0,0.451,0.454,1,2022-03-02,63,38,25,0.603,63,41,22,0.651
22100937,1610612740,1610612758,125.0,95.0,0.591,0.393,1,2022-03-02,62,26,36,0.419,64,23,41,0.359
22100938,1610612743,1610612760,107.0,119.0,0.444,0.506,0,2022-03-02,62,36,26,0.581,62,20,42,0.323
22100939,1610612756,1610612757,120.0,90.0,0.5,0.385,1,2022-03-02,62,50,12,0.806,62,25,37,0.403
22100926,1610612764,1610612765,116.0,113.0,0.5,0.478,1,2022-03-01,61,28,33,0.459,62,15,47,0.242
22100927,1610612738,1610612737,107.0,98.0,0.47,0.434,1,2022-03-01,64,37,27,0.578,61,29,32,0.475
22100928,1610612761,1610612751,109.0,108.0,0.456,0.5,1,2022-03-01,61,34,27,0.557,63,32,31,0.508
22100929,1610612745,1610612746,100.0,113.0,0.396,0.438,0,2022-03-01,61,15,46,0.246,64,33,31,0.516
22100930,1610612750,1610612744,129.0,114.0,0.528,0.456,1,2022-03-01,63,34,29,0.54,62,43,19,0.694
22100931,1610612747,1610612742,104.0,109.0,0.451,0.5,0,2022-03-01,61,27,34,0.443,62,37,25,0.597
22100920,1610612739,1610612750,122.0,127.0,0.527,0.547,0,2022-02-28,61,36,25,0.59,62,33,29,0.532
22100921,1610612753,1610612754,119.0,103.0,0.469,0.486,1,2022-02-28,62,15,47,0.242,63,21,42,0.333
22100726,1610612751,1610612761,97.0,133.0,0.384,0.515,0,2022-02-28,62,32,30,0.516,60,33,27,0.55
22100922,1610612748,1610612741,112.0,99.0,0.494,0.488,1,2022-02-28,62,41,21,0.661,62,39,23,0.629
22100923,1610612763,1610612759,118.0,105.0,0.539,0.414,1,2022-02-28,63,43,20,0.683,62,24,38,0.387
22100924,1610612749,1610612766,130.0,106.0,0.44,0.387,1,2022-02-28,62,37,25,0.597,63,30,33,0.476
22100925,1610612760,1610612758,110.0,131.0,0.465,0.563,0,2022-02-28,61,19,42,0.311,63,23,40,0.365
22100912,1610612752,1610612755,109.0,125.0,0.447,0.487,0,2022-02-27,61,25,36,0.41,60,37,23,0.617
22100913,1610612756,1610612762,114.0,118.0,0.512,0.468,0,2022-02-27,61,49,12,0.803,60,38,22,0.633
22100914,1610612754,1610612738,128.0,107.0,0.522,0.429,1,2022-02-27,62,21,41,0.339,63,36,27,0.571
22100915,1610612766,1610612765,126.0,127.0,0.506,0.455,0,2022-02-27,62,30,32,0.484,61,15,46,0.246
22100916,1610612745,1610612746,98.0,99.0,0.38,0.442,0,2022-02-27,60,15,45,0.25,63,32,31,0.508
22100917,1610612744,1610612742,101.0,107.0,0.429,0.5,0,2022-02-27,61,43,18,0.705,61,36,25,0.59
22100918,1610612757,1610612743,92.0,124.0,0.374,0.512,0,2022-02-27,61,25,36,0.41,61,36,25,0.59
22100919,1610612747,1610612740,95.0,123.0,0.417,0.511,0,2022-02-27,60,27,33,0.45,61,25,36,0.41
22100905,1610612765,1610612738,104.0,113.0,0.448,0.477,0,2022-02-26,60,14,46,0.233,62,36,26,0.581
22100906,1610612737,1610612761,127.0,100.0,0.578,0.4,1,2022-02-26,60,29,31,0.483,59,32,27,0.542
22100907,1610612739,1610612764,92.0,86.0,0.386,0.432,1,2022-02-26,60,36,24,0.6,60,27,33,0.45
22100908,1610612748,1610612759,133.0,129.0,0.566,0.556,1,2022-02-26,61,40,21,0.656,61,24,37,0.393
22100909,1610612741,1610612763,110.0,116.0,0.419,0.44,0,2022-02-26,61,39,22,0.639,62,42,20,0.677
22100910,1610612749,1610612751,123.0,126.0,0.526,0.478,0,2022-02-26,61,36,25,0.59,61,32,29,0.525
22100911,1610612743,1610612758,115.0,110.0,0.463,0.427,1,2022-02-26,60,35,25,0.583,62,22,40,0.355
22100896,1610612766,1610612761,125.0,93.0,0.553,0.44,1,2022-02-25,61,30,31,0.492,58,32,26,0.552
22100897,1610612754,1610612760,125.0,129.0,0.485,0.495,0,2022-02-25,61,20,41,0.328,60,19,41,0.317
22100898,1610612753,1610612745,119.0,111.0,0.506,0.468,1,2022-02-25,61,14,47,0.23,59,15,44,0.254
22100899,1610612764,1610612759,153.0,157.0,0.546,0.543,0,2022-02-25,59,27,32,0.458,60,24,36,0.4
22100900,1610612752,1610612748,100.0,115.0,0.4,0.47,0,2022-02-25,60,25,35,0.417,60,39,21,0.65
22100901,1610612750,1610612755,102.0,133.0,0.419,0.512,0,2022-02-25,61,32,29,0.525,59,36,23,0.61
22100902,1610612756,1610612740,102.0,117.0,0.439,0.437,0,2022-02-25,60,49,11,0.817,60,24,36,0.4
22100903,1610612762,1610612742,114.0,109.0,0.541,0.477,1,2022-02-25,59,37,22,0.627,60,35,25,0.583
22100904,1610612747,1610612746,102.0,105.0,0.419,0.494,0,2022-02-25,59,27,32,0.458,62,31,31,0.5
22100889,1610612765,1610612739,106.0,103.0,0.407,0.442,1,2022-02-24,59,14,45,0.237,59,35,24,0.593
22100890,1610612751,1610612738,106.0,129.0,0.415,0.541,0,2022-02-24,60,31,29,0.517,61,35,26,0.574
22100891,1610612741,1610612737,112.0,108.0,0.488,0.423,1,2022-02-24,60,39,21,0.65,59,28,31,0.475
22100892,1610612750,1610612763,119.0,114.0,0.462,0.388,1,2022-02-24,60,32,28,0.533,61,41,20,0.672
22100893,1610612760,1610612756,104.0,124.0,0.473,0.535,0,2022-02-24,59,18,41,0.305,59,49,10,0.831
22100894,1610612757,1610612744,95.0,132.0,0.392,0.511,0,2022-02-24,60,25,35,0.417,60,43,17,0.717
22100895,1610612758,1610612743,110.0,128.0,0.5,0.558,0,2022-02-24,61,22,39,0.361,59,34,25,0.576
22100885,1610612766,1610612748,107.0,111.0,0.4,0.402,0,2022-02-17,60,29,31,0.483,59,38,21,0.644
22100464,1610612751,1610612764,103.0,117.0,0.404,0.554,0,2022-02-17,59,31,28,0.525,58,27,31,0.466
22100886,1610612740,1610612742,118.0,125.0,0.5,0.537,0,2022-02-17,59,23,36,0.39,59,35,24,0.593
22100887,1610612749,1610612755,120.0,123.0,0.442,0.5,0,2022-02-17,60,36,24,0.6,58,35,23,0.603
22100888,1610612746,1610612745,142.0,111.0,0.554,0.462,1,2022-02-17,61,30,31,0.492,58,15,43,0.259
22100874,1610612753,1610612737,109.0,130.0,0.429,0.5,0,2022-02-16,60,13,47,0.217,58,28,30,0.483
22100875,1610612738,1610612765,111.0,112.0,0.545,0.462,0,2022-02-16,60,34,26,0.567,58,13,45,0.224
22100876,1610612754,1610612764,113.0,108.0,0.542,0.429,1,2022-02-16,60,20,40,0.333,57,26,31,0.456
22100877,1610612752,1610612751,106.0,111.0,0.435,0.439,0,2022-02-16,59,25,34,0.424,58,31,27,0.534
22100878,1610612741,1610612758,125.0,118.0,0.5,0.512,1,2022-02-16,59,38,21,0.644,60,22,38,0.367
22100879,1610612763,1610612757,119.0,123.0,0.435,0.506,0,2022-02-16,60,41,19,0.683,59,25,34,0.424
22100880,1610612750,1610612761,91.0,103.0,0.39,0.455,0,2022-02-16,59,31,28,0.525,57,32,25,0.561
22100881,1610612760,1610612759,106.0,114.0,0.39,0.439,0,2022-02-16,58,18,40,0.31,59,23,36,0.39
22100882,1610612756,1610612745,124.0,121.0,0.512,0.433,1,2022-02-16,58,48,10,0.828,57,15,42,0.263
22100883,1610612744,1610612743,116.0,117.0,0.517,0.473,0,2022-02-16,59,42,17,0.712,58,33,25,0.569
22100884,1610612747,1610612762,106.0,101.0,0.477,0.468,1,2022-02-16,58,27,31,0.466,58,36,22,0.621
22100867,1610612737,1610612739,124.0,116.0,0.538,0.511,1,2022-02-15,57,27,30,0.474,58,35,23,0.603
22100868,1610612748,1610612742,99.0,107.0,0.417,0.447,0,2022-02-15,58,37,21,0.638,58,34,24,0.586
22100869,1610612755,1610612738,87.0,135.0,0.288,0.561,0,2022-02-15,57,34,23,0.596,59,34,25,0.576
22100870,1610612749,1610612754,128.0,119.0,0.558,0.505,1,2022-02-15,59,36,23,0.61,59,19,40,0.322
22100871,1610612750,1610612766,126.0,120.0,0.394,0.412,1,2022-02-15,58,31,27,0.534,59,29,30,0.492
22100872,1610612740,1610612763,109.0,121.0,0.5,0.5,0,2022-02-15,58,23,35,0.397,59,41,18,0.695
22100873,1610612756,1610612746,103.0,96.0,0.489,0.412,1,2022-02-15,57,47,10,0.825,60,29,31,0.483
22100858,1610612764,1610612765,103.0,94.0,0.471,0.376,1,2022-02-14,56,26,30,0.464,57,12,45,0.211
22100859,1610612751,1610612758,109.0,85.0,0.512,0.344,1,2022-02-14,57,30,27,0.526,59,22,37,0.373
22100860,1610612752,1610612760,123.0,127.0,0.417,0.5,0,2022-02-14,58,25,33,0.431,57,18,39,0.316
22100861,1610612741,1610612759,120.0,109.0,0.523,0.478,1,2022-02-14,58,37,21,0.638,58,22,36,0.379
22100862,1610612749,1610612757,107.0,122.0,0.427,0.455,0,2022-02-14,58,35,23,0.603,58,24,34,0.414
22100863,1610612740,1610612761,120.0,90.0,0.584,0.305,1,2022-02-14,57,23,34,0.404,56,31,25,0.554
22100864,1610612743,1610612753,121.0,111.0,0.477,0.44,1,2022-02-14,57,32,25,0.561,59,13,46,0.22
22100865,1610612762,1610612745,135.0,101.0,0.551,0.422,1,2022-02-14,57,36,21,0.632,56,15,41,0.268
22100866,1610612746,1610612744,119.0,104.0,0.565,0.453,1,2022-02-14,59,29,30,0.492,58,42,16,0.724
22100856,1610612738,1610612737,105.0,95.0,0.424,0.366,1,2022-02-13,58,33,25,0.569,56,26,30,0.464
22100857,1610612754,1610612750,120.0,129.0,0.441,0.512,0,2022-02-13,58,19,39,0.328,57,30,27,0.526
22100845,1610612757,1610612752,112.0,103.0,0.476,0.383,1,2022-02-12,57,23,34,0.404,57,25,32,0.439
22100846,1610612766,1610612763,118.0,125.0,0.402,0.49,0,2022-02-12,58,29,29,0.5,58,40,18,0.69
22100847,1610612764,1610612758,110.0,123.0,0.466,0.566,0,2022-02-12,55,25,30,0.455,58,22,36,0.379
22100848,1610612740,1610612759,114.0,124.0,0.494,0.505,0,2022-02-12,56,22,34,0.393,57,22,35,0.386
22100849,1610612755,1610612739,103.0,93.0,0.481,0.468,1,2022-02-12,56,34,22,0.607,57,35,22,0.614
22100850,1610612761,1610612743,109.0,110.0,0.489,0.464,0,2022-02-12,55,31,24,0.564,56,31,25,0.554
22100851,1610612748,1610612751,115.0,111.0,0.5,0.452,1,2022-02-12,57,37,20,0.649,56,29,27,0.518
22100852,1610612741,1610612760,106.0,101.0,0.449,0.386,1,2022-02-12,57,36,21,0.632,56,17,39,0.304
22100853,1610612742,1610612746,97.0,99.0,0.412,0.524,0,2022-02-12,57,33,24,0.579,58,28,30,0.483
22100854,1610612744,1610612747,117.0,115.0,0.444,0.466,1,2022-02-12,57,42,15,0.737,57,26,31,0.456
22100855,1610612756,1610612753,132.0,105.0,0.524,0.425,1,2022-02-12,56,46,10,0.821,58,13,45,0.224
22100838,1610612765,1610612766,119.0,141.0,0.471,0.557,0,2022-02-11,56,12,44,0.214,57,29,28,0.509
22100839,1610612754,1610612739,113.0,120.0,0.472,0.531,0,2022-02-11,57,19,38,0.333,56,35,21,0.625
22100840,1610612755,1610612760,100.0,87.0,0.387,0.389,1,2022-02-11,55,33,22,0.6,55,17,38,0.309
22100841,1610612737,1610612759,121.0,136.0,0.456,0.556,0,2022-02-11,55,26,29,0.473,56,21,35,0.375
22100842,1610612738,1610612743,108.0,102.0,0.396,0.433,1,2022-02-11,57,32,25,0.561,55,30,25,0.545
22100843,1610612741,1610612750,134.0,122.0,0.632,0.5,1,2022-02-11,56,35,21,0.625,56,29,27,0.518
22100844,1610612762,1610612753,114.0,99.0,0.449,0.44,1,2022-02-11,56,35,21,0.625,57,13,44,0.228
22100831,1610612765,1610612763,107.0,132.0,0.436,0.478,0,2022-02-10,55,12,43,0.218,57,39,18,0.684
22100832,1610612764,1610612751,113.0,112.0,0.506,0.464,1,2022-02-10,54,25,29,0.463,55,29,26,0.527
22100833,1610612740,1610612748,97.0,112.0,0.424,0.481,0,2022-02-10,55,22,33,0.4,56,36,20,0.643
22100834,1610612745,1610612761,120.0,139.0,0.524,0.546,0,2022-02-10,55,15,40,0.273,54,31,23,0.574
22100835,1610612742,1610612746,112.0,105.0,0.487,0.481,1,2022-02-10,56,33,23,0.589,57,27,30,0.474
22100836,1610612756,1610612749,131.0,107.0,0.567,0.455,1,2022-02-10,55,45,10,0.818,57,35,22,0.614
22100837,1610612744,1610612752,114.0,116.0,0.462,0.433,0,2022-02-10,56,41,15,0.732,56,25,31,0.446
22100825,1610612739,1610612759,105.0,92.0,0.476,0.384,1,2022-02-09,55,34,21,0.618,55,20,35,0.364
22100826,1610612766,1610612741,109.0,121.0,0.43,0.561,0,2022-02-09,56,28,28,0.5,55,34,21,0.618
22100827,1610612760,1610612761,98.0,117.0,0.414,0.511,0,2022-02-09,54,17,37,0.315,53,30,23,0.566
22100828,1610612762,1610612744,111.0,85.0,0.461,0.359,1,2022-02-09,55,34,21,0.618,55,41,14,0.745
22100829,1610612757,1610612747,107.0,105.0,0.472,0.554,1,2022-02-09,56,22,34,0.393,56,26,30,0.464
22100830,1610612758,1610612750,132.0,119.0,0.516,0.449,1,2022-02-09,57,21,36,0.368,55,29,26,0.527
22100815,1610612755,1610612756,109.0,114.0,0.461,0.453,0,2022-02-08,54,32,22,0.593,54,44,10,0.815
22100816,1610612737,1610612754,133.0,112.0,0.578,0.398,1,2022-02-08,54,26,28,0.481,56,19,37,0.339
22100817,1610612751,1610612738,91.0,126.0,0.384,0.549,0,2022-02-08,54,29,25,0.537,56,31,25,0.554
22100818,1610612763,1610612746,135.0,109.0,0.515,0.449,1,2022-02-08,56,38,18,0.679,56,27,29,0.482
22100819,1610612740,1610612745,110.0,97.0,0.525,0.372,1,2022-02-08,54,22,32,0.407,54,15,39,0.278
22100820,1610612742,1610612765,116.0,86.0,0.506,0.379,1,2022-02-08,55,32,23,0.582,54,12,42,0.222
22100821,1610612743,1610612752,132.0,115.0,0.541,0.446,1,2022-02-08,54,30,24,0.556,55,24,31,0.436
22100822,1610612747,1610612749,116.0,131.0,0.518,0.542,0,2022-02-08,55,26,29,0.473,56,35,21,0.625
22100823,1610612757,1610612753,95.0,113.0,0.352,0.489,0,2022-02-08,55,21,34,0.382,56,13,43,0.232
22100824,1610612758,1610612750,114.0,134.0,0.494,0.481,0,2022-02-08,56,20,36,0.357,54,29,25,0.537
22100810,1610612766,1610612761,101.0,116.0,0.411,0.488,0,2022-02-07,55,28,27,0.509,52,29,23,0.558
22100811,1610612764,1610612748,100.0,121.0,0.45,0.566,0,2022-02-07,53,24,29,0.453,55,35,20,0.636
22100812,1610612741,1610612756,124.0,127.0,0.478,0.544,0,2022-02-07,54,33,21,0.611,53,43,10,0.811
22100813,1610612760,1610612744,98.0,110.0,0.411,0.5,0,2022-02-07,53,17,36,0.321,54,41,13,0.759
22100814,1610612762,1610612752,113.0,104.0,0.419,0.379,1,2022-02-07,54,33,21,0.611,54,24,30,0.444
22100802,1610612741,1610612755,108.0,119.0,0.481,0.536,0,2022-02-06,53,33,20,0.623,53,32,21,0.604
22100803,1610612750,1610612765,118.0,105.0,0.462,0.421,1,2022-02-06,53,28,25,0.528,53,12,41,0.226
22100804,1610612743,1610612751,124.0,104.0,0.521,0.414,1,2022-02-06,53,29,24,0.547,53,29,24,0.547
22100805,1610612739,1610612754,98.0,85.0,0.405,0.373,1,2022-02-06,54,33,21,0.611,55,19,36,0.345
22100806,1610612753,1610612738,83.0,116.0,0.358,0.455,0,2022-02-06,55,12,43,0.218,55,30,25,0.545
22100807,1610612742,1610612737,103.0,94.0,0.432,0.389,1,2022-02-06,54,31,23,0.574,53,25,28,0.472
22100808,1610612745,1610612740,107.0,120.0,0.476,0.532,0,2022-02-06,53,15,38,0.283,53,21,32,0.396
22100809,1610612746,1610612749,113.0,137.0,0.417,0.545,0,2022-02-06,55,27,28,0.491,55,34,21,0.618
22100796,1610612753,1610612763,115.0,135.0,0.433,0.505,0,2022-02-05,54,12,42,0.222,55,37,18,0.673
22100797,1610612766,1610612748,86.0,104.0,0.384,0.418,0,2022-02-05,54,28,26,0.519,54,34,20,0.63
22100798,1610612764,1610612756,80.0,95.0,0.353,0.404,0,2022-02-05,52,24,28,0.462,52,42,10,0.808
22100799,1610612747,1610612752,122.0,115.0,0.471,0.398,1,2022-02-05,54,26,28,0.481,53,24,29,0.453
22100800,1610612757,1610612749,108.0,137.0,0.482,0.533,0,2022-02-05,54,21,33,0.389,54,33,21,0.611
22100801,1610612758,1610612760,113.0,103.0,0.518,0.483,1,2022-02-05,55,20,35,0.364,52,17,35,0.327
22100787,1610612766,1610612739,101.0,102.0,0.413,0.4,0,2022-02-04,53,28,25,0.528,53,32,21,0.604
22100788,1610612765,1610612738,93.0,102.0,0.327,0.451,0,2022-02-04,52,12,40,0.231,54,29,25,0.537
22100789,1610612754,1610612741,115.0,122.0,0.495,0.544,0,2022-02-04,54,19,35,0.352,52,33,19,0.635
22100790,1610612761,1610612737,125.0,114.0,0.568,0.462,1,2022-02-04,51,28,23,0.549,52,25,27,0.481
22100792,1610612759,1610612745,131.0,106.0,0.573,0.434,1,2022-02-04,54,20,34,0.37,52,15,37,0.288
22100793,1610612762,1610612751,125.0,102.0,0.565,0.414,1,2022-02-04,53,32,21,0.604,52,29,23,0.558
22100794,1610612743,1610612740,105.0,113.0,0.449,0.56,0,2022-02-04,52,28,24,0.538,52,20,32,0.385
22100791,1610612742,1610612755,107.0,98.0,0.459,0.514,1,2022-02-04,53,30,23,0.566,52,31,21,0.596
22100795,1610612757,1610612760,93.0,96.0,0.396,0.379,0,2022-02-04,53,21,32,0.396,51,17,34,0.333
22100521,1610612759,1610612748,95.0,112.0,0.375,0.506,0,2022-02-03,53,19,34,0.358,53,33,20,0.623
22100782,1610612765,1610612750,117.0,128.0,0.44,0.506,0,2022-02-03,51,12,39,0.235,52,27,25,0.519
22100430,1610612761,1610612741,127.0,120.0,0.425,0.478,1,2022-02-03,50,27,23,0.54,51,32,19,0.627
22100783,1610612737,1610612756,124.0,115.0,0.524,0.523,1,2022-02-03,51,25,26,0.49,51,41,10,0.804
22100785,1610612744,1610612758,126.0,114.0,0.56,0.525,1,2022-02-03,53,40,13,0.755,54,19,35,0.352
22100786,1610612746,1610612747,111.0,110.0,0.517,0.466,1,2022-02-03,54,27,27,0.5,53,25,28,0.472
22100773,1610612754,1610612753,118.0,119.0,0.449,0.442,0,2022-02-02,53,19,34,0.358,53,12,41,0.226
22100774,1610612755,1610612764,103.0,106.0,0.451,0.456,0,2022-02-02,51,31,20,0.608,51,24,27,0.471
22100775,1610612738,1610612766,113.0,107.0,0.512,0.425,1,2022-02-02,53,28,25,0.528,52,28,24,0.538
22100776,1610612752,1610612763,108.0,120.0,0.432,0.431,0,2022-02-02,52,24,28,0.462,54,36,18,0.667
22100777,1610612745,1610612739,115.0,104.0,0.476,0.513,1,2022-02-02,51,15,36,0.294,52,31,21,0.596
22100778,1610612742,1610612760,114.0,120.0,0.469,0.477,0,2022-02-02,52,29,23,0.558,50,16,34,0.32
22100779,1610612762,1610612743,108.0,104.0,0.488,0.532,1,2022-02-02,52,31,21,0.596,51,28,23,0.549
22100780,1610612758,1610612751,112.0,101.0,0.441,0.488,1,2022-02-02,53,19,34,0.358,51,29,22,0.569
22100781,1610612747,1610612757,99.0,94.0,0.423,0.357,1,2022-02-02,52,25,27,0.481,52,21,31,0.404
22100766,1610612765,1610612740,101.0,111.0,0.488,0.438,0,2022-02-01,50,12,38,0.24,51,19,32,0.373
22100768,1610612749,1610612764,112.0,98.0,0.5,0.439,1,2022-02-01,53,32,21,0.604,50,23,27,0.46
22100784,1610612761,1610612748,110.0,106.0,0.481,0.487,1,2022-02-01,49,26,23,0.531,52,32,20,0.615
22100769,1610612741,1610612753,126.0,115.0,0.511,0.495,1,2022-02-01,50,32,18,0.64,52,11,41,0.212
22100770,1610612750,1610612743,130.0,115.0,0.495,0.427,1,2022-02-01,51,26,25,0.51,50,28,22,0.56
22100771,1610612759,1610612744,120.0,124.0,0.554,0.448,0,2022-02-01,52,19,33,0.365,52,39,13,0.75
22100772,1610612756,1610612751,121.0,111.0,0.553,0.494,1,2022-02-01,50,41,9,0.82,50,29,21,0.58
22100759,1610612739,1610612740,93.0,90.0,0.429,0.388,1,2022-01-31,51,31,20,0.608,50,18,32,0.36
22100760,1610612754,1610612746,122.0,116.0,0.526,0.469,1,2022-01-31,52,19,33,0.365,53,26,27,0.491
22100761,1610612755,1610612763,122.0,119.0,0.49,0.461,1,2022-01-31,50,31,19,0.62,53,35,18,0.66
22100762,1610612738,1610612748,122.0,92.0,0.524,0.391,1,2022-01-31,52,27,25,0.519,51,32,19,0.627
22100763,1610612752,1610612758,116.0,96.0,0.5,0.43,1,2022-01-31,51,24,27,0.471,52,18,34,0.346
22100767,1610612737,1610612761,100.0,106.0,0.457,0.427,0,2022-01-31,50,24,26,0.48,48,25,23,0.521
22100764,1610612745,1610612744,108.0,122.0,0.429,0.538,0,2022-01-31,50,14,36,0.28,51,38,13,0.745
22100765,1610612760,1610612757,98.0,81.0,0.407,0.42,1,2022-01-31,49,15,34,0.306,51,21,30,0.412
22100751,1610612737,1610612747,129.0,121.0,0.583,0.54,1,2022-01-30,49,24,25,0.49,51,24,27,0.471
22100752,1610612766,1610612746,90.0,115.0,0.327,0.524,0,2022-01-30,51,28,23,0.549,52,26,26,0.5
22100753,1610612741,1610612757,130.0,116.0,0.556,0.518,1,2022-01-30,49,31,18,0.633,50,21,29,0.42
22100754,1610612765,1610612739,115.0,105.0,0.462,0.463,1,2022-01-30,49,12,37,0.245,50,30,20,0.6
22100755,1610612753,1610612742,110.0,108.0,0.512,0.481,1,2022-01-30,51,11,40,0.216,51,29,22,0.569
22100756,1610612749,1610612743,100.0,136.0,0.474,0.602,0,2022-01-30,52,31,21,0.596,49,28,21,0.571
22100757,1610612750,1610612762,126.0,106.0,0.551,0.469,1,2022-01-30,50,25,25,0.5,51,30,21,0.588
22100758,1610612756,1610612759,115.0,110.0,0.495,0.45,1,2022-01-30,49,40,9,0.816,51,19,32,0.373
22100745,1610612740,1610612738,97.0,107.0,0.439,0.531,0,2022-01-29,49,18,31,0.367,51,26,25,0.51
22100746,1610612742,1610612754,132.0,105.0,0.531,0.44,1,2022-01-29,50,29,21,0.58,51,18,33,0.353
22100747,1610612755,1610612758,103.0,101.0,0.514,0.439,1,2022-01-29,49,30,19,0.612,51,18,33,0.353
22100748,1610612748,1610612761,120.0,124.0,0.409,0.439,0,2022-01-29,50,32,18,0.64,47,24,23,0.511
22100749,1610612763,1610612764,115.0,95.0,0.46,0.417,1,2022-01-29,52,35,17,0.673,49,23,26,0.469
22100750,1610612744,1610612751,110.0,106.0,0.408,0.398,1,2022-01-29,50,37,13,0.74,49,29,20,0.592
22100736,1610612753,1610612765,119.0,103.0,0.494,0.368,1,2022-01-28,50,10,40,0.2,48,11,37,0.229
22100735,1610612766,1610612747,117.0,114.0,0.518,0.418,1,2022-01-28,50,28,22,0.56,50,24,26,0.48
22100737,1610612737,1610612738,108.0,92.0,0.461,0.349,1,2022-01-28,48,23,25,0.479,50,25,25,0.5
22100729,1610612740,1610612743,105.0,116.0,0.389,0.5,0,2022-01-28,48,18,30,0.375,48,27,21,0.563
22100738,1610612748,1610612746,121.0,114.0,0.471,0.446,1,2022-01-28,49,32,17,0.653,51,25,26,0.49
22100739,1610612745,1610612757,110.0,125.0,0.481,0.568,0,2022-01-28,49,14,35,0.286,49,21,28,0.429
22100740,1610612763,1610612762,119.0,109.0,0.561,0.435,1,2022-01-28,51,34,17,0.667,50,30,20,0.6
22100741,1610612760,1610612754,110.0,113.0,0.453,0.432,0,2022-01-28,48,14,34,0.292,50,18,32,0.36
22100742,1610612759,1610612741,131.0,122.0,0.526,0.523,1,2022-01-28,50,19,31,0.38,48,30,18,0.625
22100743,1610612756,1610612750,134.0,124.0,0.512,0.489,1,2022-01-28,48,39,9,0.813,49,24,25,0.49
22100744,1610612749,1610612752,123.0,108.0,0.461,0.464,1,2022-01-28,51,31,20,0.608,50,23,27,0.46
22100733,1610612755,1610612747,105.0,87.0,0.5,0.409,1,2022-01-27,48,29,19,0.604,49,24,25,0.49
22100734,1610612744,1610612750,124.0,115.0,0.537,0.442,1,2022-01-27,49,36,13,0.735,48,24,24,0.5
22100722,1610612739,1610612749,115.0,99.0,0.471,0.463,1,2022-01-26,49,30,19,0.612,50,30,20,0.6
22100723,1610612754,1610612766,126.0,158.0,0.478,0.581,0,2022-01-26,49,17,32,0.347,49,27,22,0.551
22100724,1610612753,1610612746,102.0,111.0,0.452,0.444,0,2022-01-26,49,9,40,0.184,50,25,25,0.5
22100725,1610612737,1610612758,121.0,104.0,0.533,0.419,1,2022-01-26,47,22,25,0.468,50,18,32,0.36
22100727,1610612748,1610612752,110.0,96.0,0.5,0.422,1,2022-01-26,48,31,17,0.646,49,23,26,0.469
22100453,1610612751,1610612743,118.0,124.0,0.489,0.472,0,2022-01-26,48,29,19,0.604,47,26,21,0.553
22100472,1610612741,1610612761,111.0,105.0,0.548,0.481,1,2022-01-26,47,30,17,0.638,46,23,23,0.5
22100728,1610612759,1610612763,110.0,118.0,0.457,0.511,0,2022-01-26,49,18,31,0.367,50,33,17,0.66
22100731,1610612762,1610612756,97.0,105.0,0.43,0.488,0,2022-01-26,49,30,19,0.612,47,38,9,0.809
22100732,1610612757,1610612742,112.0,132.0,0.512,0.545,0,2022-01-26,48,20,28,0.417,49,28,21,0.571
22100454,1610612755,1610612740,117.0,107.0,0.464,0.482,1,2022-01-25,47,28,19,0.596,47,18,29,0.383
22100714,1610612765,1610612743,105.0,110.0,0.423,0.429,0,2022-01-25,47,11,36,0.234,46,25,21,0.543
22100715,1610612761,1610612766,125.0,113.0,0.524,0.488,1,2022-01-25,45,23,22,0.511,48,26,22,0.542
22100716,1610612764,1610612746,115.0,116.0,0.463,0.415,0,2022-01-25,48,23,25,0.479,49,24,25,0.49
22100717,1610612738,1610612758,128.0,75.0,0.495,0.305,1,2022-01-25,49,25,24,0.51,49,18,31,0.367
22100718,1610612751,1610612747,96.0,106.0,0.42,0.472,0,2022-01-25,47,29,18,0.617,48,24,24,0.5
22100719,1610612745,1610612759,104.0,134.0,0.411,0.574,0,2022-01-25,48,14,34,0.292,48,18,30,0.375
22100720,1610612744,1610612742,130.0,92.0,0.533,0.352,1,2022-01-25,48,35,13,0.729,48,27,21,0.563
22100721,1610612757,1610612750,107.0,109.0,0.394,0.439,0,2022-01-25,47,20,27,0.426,47,24,23,0.511
22100709,1610612739,1610612752,95.0,93.0,0.432,0.417,1,2022-01-24,48,29,19,0.604,48,23,25,0.479
22100712,1610612740,1610612754,117.0,113.0,0.466,0.437,1,2022-01-24,46,18,28,0.391,48,17,31,0.354
22100730,1610612760,1610612741,110.0,111.0,0.413,0.461,0,2022-01-24,47,14,33,0.298,46,29,17,0.63
22100713,1610612756,1610612762,115.0,109.0,0.475,0.494,1,2022-01-24,46,37,9,0.804,48,30,18,0.625
22100698,1610612752,1610612746,110.0,102.0,0.429,0.43,1,2022-01-23,47,23,24,0.489,48,23,25,0.479
22100699,1610612764,1610612738,87.0,116.0,0.355,0.444,0,2022-01-23,47,23,24,0.489,48,24,24,0.5
22100700,1610612748,1610612747,113.0,107.0,0.494,0.456,1,2022-01-23,47,30,17,0.638,47,23,24,0.489
22100701,1610612753,1610612741,114.0,95.0,0.525,0.434,1,2022-01-23,48,9,39,0.188,45,28,17,0.622
22100702,1610612761,1610612757,105.0,114.0,0.398,0.529,0,2022-01-23,44,22,22,0.5,46,20,26,0.435
22100703,1610612766,1610612737,91.0,113.0,0.391,0.455,0,2022-01-23,47,26,21,0.553,46,21,25,0.457
22100704,1610612759,1610612755,109.0,115.0,0.472,0.478,0,2022-01-23,47,17,30,0.362,46,27,19,0.587
22100705,1610612742,1610612763,104.0,91.0,0.486,0.374,1,2022-01-23,47,27,20,0.574,49,32,17,0.653
22100706,1610612750,1610612751,136.0,125.0,0.522,0.505,1,2022-01-23,46,23,23,0.5,46,29,17,0.63
22100707,1610612743,1610612765,117.0,111.0,0.518,0.56,1,2022-01-23,45,24,21,0.533,46,11,35,0.239
22100708,1610612744,1610612762,94.0,92.0,0.434,0.383,1,2022-01-23,47,34,13,0.723,47,30,17,0.638
22100696,1610612749,1610612758,133.0,127.0,0.495,0.526,1,2022-01-22,49,30,19,0.612,48,18,30,0.375
22100695,1610612739,1610612760,94.0,87.0,0.461,0.388,1,2022-01-22,47,28,19,0.596,46,14,32,0.304
22100697,1610612756,1610612754,113.0,103.0,0.49,0.44,1,2022-01-22,45,36,9,0.8,47,17,30,0.362
22100684,1610612766,1610612760,121.0,98.0,0.455,0.378,1,2022-01-21,46,26,20,0.565,45,14,31,0.311
22100685,1610612753,1610612747,105.0,116.0,0.444,0.494,0,2022-01-21,47,8,39,0.17,46,23,23,0.5
22100686,1610612755,1610612746,101.0,102.0,0.418,0.46,0,2022-01-21,45,26,19,0.578,47,23,24,0.489
22100687,1610612737,1610612748,110.0,108.0,0.559,0.482,1,2022-01-21,45,20,25,0.444,46,29,17,0.63
22100688,1610612738,1610612757,105.0,109.0,0.451,0.474,0,2022-01-21,47,23,24,0.489,45,19,26,0.422
22100689,1610612764,1610612761,105.0,109.0,0.506,0.467,0,2022-01-21,46,23,23,0.5,43,22,21,0.512
22100690,1610612749,1610612741,94.0,90.0,0.386,0.365,1,2022-01-21,48,29,19,0.604,44,28,16,0.636
22100691,1610612759,1610612751,102.0,117.0,0.389,0.48,0,2022-01-21,46,17,29,0.37,45,29,16,0.644
22100692,1610612743,1610612763,118.0,122.0,0.473,0.524,0,2022-01-21,44,23,21,0.523,48,32,16,0.667
22100693,1610612762,1610612765,111.0,101.0,0.456,0.437,1,2022-01-21,46,30,16,0.652,45,11,34,0.244
22100694,1610612744,1610612745,105.0,103.0,0.481,0.427,1,2022-01-21,46,33,13,0.717,47,14,33,0.298
22100681,1610612752,1610612740,91.0,102.0,0.377,0.5,0,2022-01-20,46,22,24,0.478,45,17,28,0.378
22100682,1610612742,1610612756,101.0,109.0,0.435,0.453,0,2022-01-20,46,26,20,0.565,44,35,9,0.795
22100683,1610612744,1610612754,117.0,121.0,0.447,0.432,0,2022-01-20,45,32,13,0.711,46,17,29,0.37
22100668,1610612755,1610612753,123.0,110.0,0.542,0.444,1,2022-01-19,44,26,18,0.591,46,8,38,0.174
22100669,1610612764,1610612751,118.0,119.0,0.477,0.528,0,2022-01-19,45,23,22,0.511,44,28,16,0.636
22100670,1610612737,1610612750,134.0,122.0,0.523,0.433,1,2022-01-19,44,19,25,0.432,45,22,23,0.489
22100671,1610612738,1610612766,102.0,111.0,0.433,0.488,0,2022-01-19,46,23,23,0.5,45,25,20,0.556
22100672,1610612748,1610612757,104.0,92.0,0.463,0.407,1,2022-01-19,45,29,16,0.644,44,18,26,0.409
22100673,1610612741,1610612739,117.0,104.0,0.547,0.519,1,2022-01-19,43,28,15,0.651,46,27,19,0.587
22100674,1610612749,1610612763,126.0,114.0,0.474,0.415,1,2022-01-19,47,28,19,0.596,47,31,16,0.66
22100675,1610612742,1610612761,102.0,98.0,0.487,0.385,1,2022-01-19,45,26,19,0.578,42,21,21,0.5
22100676,1610612759,1610612760,118.0,96.0,0.49,0.388,1,2022-01-19,45,17,28,0.378,44,14,30,0.318
22100677,1610612762,1610612745,111.0,116.0,0.472,0.427,0,2022-01-19,45,29,16,0.644,46,14,32,0.304
22100678,1610612743,1610612746,130.0,128.0,0.49,0.536,1,2022-01-19,43,23,20,0.535,46,22,24,0.478
22100679,1610612758,1610612765,131.0,133.0,0.524,0.505,0,2022-01-19,47,18,29,0.383,44,11,33,0.25
22100680,1610612747,1610612754,104.0,111.0,0.444,0.489,0,2022-01-19,45,22,23,0.489,45,16,29,0.356
22100666,1610612752,1610612750,110.0,112.0,0.463,0.432,0,2022-01-18,45,22,23,0.489,44,22,22,0.5
22100667,1610612744,1610612765,102.0,86.0,0.41,0.353,1,2022-01-18,44,32,12,0.727,43,10,33,0.233
22100654,1610612738,1610612740,104.0,92.0,0.475,0.414,1,2022-01-17,45,23,22,0.511,44,16,28,0.364
22100655,1610612752,1610612766,87.0,97.0,0.4,0.419,0,2022-01-17,44,22,22,0.5,44,24,20,0.545
22100656,1610612764,1610612755,117.0,98.0,0.483,0.407,1,2022-01-17,44,23,21,0.523,43,25,18,0.581
22100657,1610612739,1610612751,114.0,107.0,0.519,0.494,1,2022-01-17,45,27,18,0.6,43,27,16,0.628
22100658,1610612763,1610612741,119.0,106.0,0.511,0.435,1,2022-01-17,46,31,15,0.674,42,27,15,0.643
22100659,1610612746,1610612754,139.0,133.0,0.549,0.515,1,2022-01-17,45,22,23,0.489,44,15,29,0.341
22100660,1610612737,1610612749,121.0,114.0,0.442,0.443,1,2022-01-17,43,18,25,0.419,46,27,19,0.587
22100661,1610612753,1610612757,88.0,98.0,0.378,0.411,0,2022-01-17,45,8,37,0.178,43,18,25,0.419
22100662,1610612748,1610612761,104.0,99.0,0.458,0.411,1,2022-01-17,44,28,16,0.636,41,21,20,0.512
22100663,1610612742,1610612760,104.0,102.0,0.398,0.434,1,2022-01-17,44,25,19,0.568,43,14,29,0.326
22100664,1610612759,1610612756,107.0,121.0,0.446,0.516,0,2022-01-17,44,16,28,0.364,43,34,9,0.791
22100665,1610612747,1610612762,101.0,95.0,0.442,0.373,1,2022-01-17,44,22,22,0.5,44,29,15,0.659
22100617,1610612765,1610612756,108.0,135.0,0.463,0.586,0,2022-01-16,42,10,32,0.238,42,33,9,0.786
22100651,1610612758,1610612745,112.0,118.0,0.451,0.539,0,2022-01-16,46,18,28,0.391,45,13,32,0.289
22100652,1610612750,1610612744,119.0,99.0,0.495,0.39,1,2022-01-16,43,21,22,0.488,43,31,12,0.721
22100653,1610612743,1610612762,102.0,125.0,0.442,0.524,0,2022-01-16,42,22,20,0.524,43,29,14,0.674
22100641,1610612749,1610612761,96.0,103.0,0.338,0.44,0,2022-01-15,45,27,18,0.6,40,21,19,0.525
22100642,1610612764,1610612757,110.0,115.0,0.433,0.459,0,2022-01-15,43,22,21,0.512,42,17,25,0.405
22100643,1610612737,1610612752,108.0,117.0,0.5,0.506,0,2022-01-15,42,17,25,0.405,43,22,21,0.512
22100644,1610612751,1610612740,120.0,105.0,0.548,0.46,1,2022-01-15,42,27,15,0.643,43,16,27,0.372
22100645,1610612748,1610612755,98.0,109.0,0.384,0.506,0,2022-01-15,43,27,16,0.628,42,25,17,0.595
22100646,1610612760,1610612739,102.0,107.0,0.434,0.46,0,2022-01-15,42,14,28,0.333,44,26,18,0.591
22100647,1610612738,1610612741,114.0,112.0,0.489,0.506,1,2022-01-15,44,22,22,0.5,41,27,14,0.659
22100648,1610612759,1610612746,101.0,94.0,0.41,0.38,1,2022-01-15,43,16,27,0.372,44,21,23,0.477
22100649,1610612743,1610612747,133.0,96.0,0.516,0.439,1,2022-01-15,41,22,19,0.537,43,21,22,0.488
22100650,1610612742,1610612753,108.0,92.0,0.41,0.481,1,2022-01-15,43,24,19,0.558,44,8,36,0.182
22100632,1610612766,1610612753,109.0,116.0,0.412,0.517,0,2022-01-14,43,23,20,0.535,43,8,35,0.186
22100633,1610612765,1610612761,103.0,87.0,0.469,0.322,1,2022-01-14,41,10,31,0.244,39,20,19,0.513
22100634,1610612754,1610612756,94.0,112.0,0.386,0.455,0,2022-01-14,43,15,28,0.349,41,32,9,0.78
22100635,1610612755,1610612738,111.0,99.0,0.447,0.474,1,2022-01-14,41,24,17,0.585,43,21,22,0.488
22100637,1610612741,1610612744,96.0,138.0,0.425,0.564,0,2022-01-14,40,27,13,0.675,42,31,11,0.738
22100636,1610612748,1610612737,124.0,118.0,0.532,0.481,1,2022-01-14,42,27,15,0.643,41,17,24,0.415
22100638,1610612759,1610612739,109.0,114.0,0.457,0.484,0,2022-01-14,42,15,27,0.357,43,25,18,0.581
22100639,1610612763,1610612742,85.0,112.0,0.382,0.516,0,2022-01-14,45,30,15,0.667,42,23,19,0.548
22100640,1610612758,1610612745,126.0,114.0,0.5,0.436,1,2022-01-14,45,18,27,0.4,44,12,32,0.273
22100627,1610612749,1610612744,118.0,99.0,0.512,0.347,1,2022-01-13,44,27,17,0.614,41,30,11,0.732
22100628,1610612763,1610612750,116.0,108.0,0.457,0.427,1,2022-01-13,44,30,14,0.682,42,20,22,0.476
22100629,1610612740,1610612746,113.0,89.0,0.443,0.383,1,2022-01-13,42,16,26,0.381,43,21,22,0.488
22100630,1610612751,1610612760,109.0,130.0,0.418,0.516,0,2022-01-13,41,26,15,0.634,41,14,27,0.341
22100631,1610612743,1610612757,140.0,108.0,0.627,0.453,1,2022-01-13,40,21,19,0.525,41,16,25,0.39
22100618,1610612754,1610612738,100.0,119.0,0.465,0.513,0,2022-01-12,42,15,27,0.357,42,21,21,0.5
22100619,1610612755,1610612766,98.0,109.0,0.466,0.517,0,2022-01-12,40,23,17,0.575,42,23,19,0.548
22100620,1610612764,1610612753,112.0,106.0,0.524,0.414,1,2022-01-12,42,22,20,0.524,42,7,35,0.167
22100621,1610612737,1610612748,91.0,115.0,0.378,0.478,0,2022-01-12,40,17,23,0.425,41,26,15,0.634
22100622,1610612752,1610612742,108.0,85.0,0.467,0.41,1,2022-01-12,42,21,21,0.5,41,22,19,0.537
22100623,1610612759,1610612745,124.0,128.0,0.434,0.549,0,2022-01-12,41,15,26,0.366,43,12,31,0.279
22100624,1610612762,1610612739,91.0,111.0,0.4,0.531,0,2022-01-12,42,28,14,0.667,42,24,18,0.571
22100625,1610612741,1610612751,112.0,138.0,0.469,0.563,0,2022-01-12,39,27,12,0.692,40,26,14,0.65
22100626,1610612758,1610612747,125.0,116.0,0.551,0.429,1,2022-01-12,44,17,27,0.386,42,21,21,0.5
22100612,1610612764,1610612760,122.0,118.0,0.54,0.48,1,2022-01-11,41,21,20,0.512,40,13,27,0.325
22100613,1610612761,1610612756,95.0,99.0,0.404,0.473,0,2022-01-11,38,20,18,0.526,40,31,9,0.775
22100415,1610612741,1610612765,133.0,87.0,0.543,0.337,1,2022-01-11,38,27,11,0.711,40,9,31,0.225
22100614,1610612763,1610612744,116.0,108.0,0.44,0.427,1,2022-01-11,43,29,14,0.674,40,30,10,0.75
22100615,1610612740,1610612750,128.0,125.0,0.553,0.488,1,2022-01-11,41,15,26,0.366,41,20,21,0.488
22100616,1610612746,1610612743,87.0,85.0,0.405,0.4,1,2022-01-11,42,21,21,0.5,39,20,19,0.513
22100607,1610612766,1610612749,103.0,99.0,0.396,0.44,1,2022-01-10,41,22,19,0.537,43,26,17,0.605
22100608,1610612765,1610612762,126.0,116.0,0.516,0.512,1,2022-01-10,39,9,30,0.231,41,28,13,0.683
22100609,1610612738,1610612754,101.0,98.0,0.398,0.383,1,2022-01-10,41,20,21,0.488,41,15,26,0.366
22100610,1610612752,1610612759,111.0,96.0,0.488,0.411,1,2022-01-10,41,20,21,0.488,40,15,25,0.375
22100711,1610612745,1610612755,91.0,111.0,0.39,0.457,0,2022-01-10,42,11,31,0.262,39,23,16,0.59
22100486,1610612757,1610612751,114.0,108.0,0.465,0.462,1,2022-01-10,40,16,24,0.4,39,25,14,0.641
22100611,1610612758,1610612739,108.0,109.0,0.429,0.494,0,2022-01-10,43,16,27,0.372,41,23,18,0.561
22100602,1610612751,1610612759,121.0,119.0,0.48,0.43,1,2022-01-09,38,25,13,0.658,39,15,24,0.385
22100597,1610612746,1610612737,106.0,93.0,0.478,0.449,1,2022-01-09,41,20,21,0.488,39,17,22,0.436
22100598,1610612753,1610612764,100.0,102.0,0.4,0.409,0,2022-01-09,41,7,34,0.171,40,20,20,0.5
22100599,1610612761,1610612740,105.0,101.0,0.424,0.453,1,2022-01-09,37,20,17,0.541,40,14,26,0.35
22100600,1610612745,1610612750,123.0,141.0,0.474,0.509,0,2022-01-09,41,11,30,0.268,40,20,20,0.5
22100601,1610612760,1610612743,95.0,99.0,0.432,0.416,0,2022-01-09,39,13,26,0.333,38,20,18,0.526
22100603,1610612742,1610612741,113.0,99.0,0.5,0.433,1,2022-01-09,40,22,18,0.55,37,26,11,0.703
22100604,1610612744,1610612739,96.0,82.0,0.402,0.427,1,2022-01-09,39,30,9,0.769,40,22,18,0.55
22100605,1610612757,1610612758,103.0,88.0,0.42,0.388,1,2022-01-09,39,15,24,0.385,42,16,26,0.381
22100606,1610612747,1610612763,119.0,127.0,0.464,0.547,0,2022-01-09,41,21,20,0.512,42,28,14,0.667
22100591,1610612746,1610612763,108.0,123.0,0.406,0.44,0,2022-01-08,40,19,21,0.475,41,27,14,0.659
22100592,1610612766,1610612749,114.0,106.0,0.444,0.389,1,2022-01-08,40,21,19,0.525,42,26,16,0.619
22100593,1610612765,1610612753,97.0,92.0,0.437,0.337,1,2022-01-08,38,8,30,0.211,40,7,33,0.175
22100594,1610612754,1610612762,125.0,113.0,0.55,0.476,1,2022-01-08,40,15,25,0.375,40,28,12,0.7
22100595,1610612738,1610612752,99.0,75.0,0.474,0.367,1,2022-01-08,40,19,21,0.475,40,19,21,0.475
22100596,1610612756,1610612748,100.0,123.0,0.38,0.5,0,2022-01-08,39,30,9,0.769,40,25,15,0.625
22100582,1610612755,1610612759,119.0,100.0,0.517,0.413,1,2022-01-07,38,22,16,0.579,38,15,23,0.395
22100583,1610612751,1610612749,109.0,121.0,0.457,0.458,0,2022-01-07,37,24,13,0.649,41,26,15,0.634
22100584,1610612761,1610612762,122.0,108.0,0.45,0.481,1,2022-01-07,36,19,17,0.528,39,28,11,0.718
22100585,1610612741,1610612764,130.0,122.0,0.527,0.511,1,2022-01-07,36,26,10,0.722,39,19,20,0.487
22100586,1610612745,1610612742,106.0,130.0,0.425,0.544,0,2022-01-07,40,11,29,0.275,39,21,18,0.538
22100587,1610612760,1610612750,105.0,135.0,0.404,0.556,0,2022-01-07,38,13,25,0.342,39,19,20,0.487
22100588,1610612743,1610612758,121.0,111.0,0.553,0.435,1,2022-01-07,37,19,18,0.514,41,16,25,0.39
22100589,1610612747,1610612737,134.0,118.0,0.495,0.448,1,2022-01-07,40,21,19,0.525,38,17,21,0.447
22100590,1610612757,1610612739,101.0,114.0,0.402,0.488,0,2022-01-07,38,14,24,0.368,39,22,17,0.564
22100578,1610612752,1610612738,108.0,105.0,0.444,0.475,1,2022-01-06,39,19,20,0.487,39,18,21,0.462
22100579,1610612763,1610612765,118.0,88.0,0.49,0.343,1,2022-01-06,40,26,14,0.65,37,7,30,0.189
22100580,1610612740,1610612744,101.0,96.0,0.422,0.425,1,2022-01-06,39,14,25,0.359,38,29,9,0.763
22100581,1610612756,1610612746,106.0,89.0,0.411,0.36,1,2022-01-06,38,30,8,0.789,39,19,20,0.487
22100567,1610612766,1610612765,140.0,111.0,0.593,0.467,1,2022-01-05,39,20,19,0.513,36,7,29,0.194
22100568,1610612753,1610612755,106.0,116.0,0.444,0.506,0,2022-01-05,39,7,32,0.179,37,21,16,0.568
22100569,1610612764,1610612745,111.0,114.0,0.44,0.471,0,2022-01-05,38,19,19,0.5,39,11,28,0.282
22100570,1610612738,1610612759,97.0,99.0,0.444,0.477,0,2022-01-05,38,18,20,0.474,37,15,22,0.405
22100571,1610612754,1610612751,121.0,129.0,0.5,0.57,0,2022-01-05,39,14,25,0.359,36,24,12,0.667
22100572,1610612742,1610612744,99.0,82.0,0.379,0.407,1,2022-01-05,38,20,18,0.526,37,29,8,0.784
22100573,1610612749,1610612761,111.0,117.0,0.447,0.472,0,2022-01-05,40,25,15,0.625,35,18,17,0.514
22100574,1610612750,1610612760,98.0,90.0,0.4,0.367,1,2022-01-05,38,18,20,0.474,37,13,24,0.351
22100575,1610612743,1610612762,109.0,115.0,0.477,0.467,0,2022-01-05,36,18,18,0.5,38,28,10,0.737
22100576,1610612757,1610612748,109.0,115.0,0.423,0.451,0,2022-01-05,37,14,23,0.378,39,24,15,0.615
22100577,1610612758,1610612737,102.0,108.0,0.422,0.453,0,2022-01-05,40,16,24,0.4,37,17,20,0.459
22100562,1610612739,1610612763,106.0,110.0,0.435,0.467,0,2022-01-04,38,21,17,0.553,39,25,14,0.641
22100563,1610612761,1610612759,129.0,104.0,0.469,0.432,1,2022-01-04,34,17,17,0.5,36,14,22,0.389
22100564,1610612752,1610612754,104.0,94.0,0.488,0.421,1,2022-01-04,38,18,20,0.474,38,14,24,0.368
22100565,1610612740,1610612756,110.0,123.0,0.404,0.541,0,2022-01-04,38,13,25,0.342,37,29,8,0.784
22100566,1610612747,1610612758,122.0,114.0,0.495,0.518,1,2022-01-04,39,20,19,0.513,39,16,23,0.41
22100552,1610612755,1610612745,133.0,113.0,0.521,0.416,1,2022-01-03,36,20,16,0.556,38,10,28,0.263
22100553,1610612764,1610612766,124.0,121.0,0.46,0.481,1,2022-01-03,37,19,18,0.514,38,19,19,0.5
22100554,1610612751,1610612763,104.0,118.0,0.451,0.471,0,2022-01-03,35,23,12,0.657,38,24,14,0.632
22100555,1610612741,1610612753,102.0,98.0,0.43,0.424,1,2022-01-03,35,25,10,0.714,38,7,31,0.184
22100556,1610612749,1610612765,106.0,115.0,0.424,0.484,0,2022-01-03,39,25,14,0.641,35,7,28,0.2
22100557,1610612740,1610612762,104.0,115.0,0.402,0.482,0,2022-01-03,37,13,24,0.351,37,27,10,0.73
22100558,1610612742,1610612743,103.0,89.0,0.449,0.463,1,2022-01-03,37,19,18,0.514,35,18,17,0.514
22100559,1610612744,1610612748,115.0,108.0,0.489,0.411,1,2022-01-03,36,29,7,0.806,38,23,15,0.605
22100560,1610612757,1610612737,136.0,131.0,0.528,0.545,1,2022-01-03,36,14,22,0.389,36,16,20,0.444
22100561,1610612746,1610612750,104.0,122.0,0.5,0.527,0,2022-01-03,38,19,19,0.5,37,17,20,0.459
22100545,1610612761,1610612752,120.0,105.0,0.477,0.449,1,2022-01-02,33,16,17,0.485,37,17,20,0.459
22100546,1610612738,1610612753,116.0,111.0,0.453,0.421,1,2022-01-02,37,18,19,0.486,37,7,30,0.189
22100547,1610612739,1610612754,108.0,104.0,0.466,0.446,1,2022-01-02,37,21,16,0.568,37,14,23,0.378
22100548,1610612758,1610612748,115.0,113.0,0.513,0.438,1,2022-01-02,38,16,22,0.421,37,23,14,0.622
22100549,1610612766,1610612756,99.0,133.0,0.459,0.505,0,2022-01-02,37,19,18,0.514,36,28,8,0.778
22100550,1610612760,1610612742,86.0,95.0,0.412,0.447,0,2022-01-02,36,13,23,0.361,36,18,18,0.5
22100551,1610612747,1610612750,108.0,103.0,0.48,0.446,1,2022-01-02,38,19,19,0.5,36,16,20,0.444
22100539,1610612749,1610612740,136.0,113.0,0.533,0.411,1,2022-01-01,38,25,13,0.658,36,13,23,0.361
22100540,1610612765,1610612759,117.0,116.0,0.406,0.412,1,2022-01-01,34,6,28,0.176,35,14,21,0.4
22100541,1610612764,1610612741,119.0,120.0,0.529,0.488,0,2022-01-01,36,18,18,0.5,34,24,10,0.706
22100542,1610612751,1610612746,116.0,120.0,0.433,0.488,0,2022-01-01,34,23,11,0.676,37,19,18,0.514
22100543,1610612745,1610612743,111.0,124.0,0.435,0.535,0,2022-01-01,37,10,27,0.27,34,18,16,0.529
22100544,1610612762,1610612744,116.0,123.0,0.435,0.535,0,2022-01-01,36,26,10,0.722,35,28,7,0.8
22100529,1610612738,1610612756,123.0,108.0,0.542,0.41,1,2021-12-31,36,17,19,0.472,35,27,8,0.771
22100530,1610612754,1610612741,106.0,108.0,0.418,0.407,0,2021-12-31,36,14,22,0.389,33,23,10,0.697
22100531,1610612758,1610612742,96.0,112.0,0.418,0.519,0,2021-12-31,37,15,22,0.405,35,17,18,0.486
22100532,1610612745,1610612748,110.0,120.0,0.441,0.465,0,2021-12-31,36,10,26,0.278,36,23,13,0.639
22100533,1610612739,1610612737,118.0,121.0,0.571,0.443,0,2021-12-31,36,20,16,0.556,35,16,19,0.457
22100534,1610612761,1610612746,116.0,108.0,0.417,0.487,1,2021-12-31,32,15,17,0.469,36,18,18,0.5
22100535,1610612763,1610612759,118.0,105.0,0.48,0.433,1,2021-12-31,37,23,14,0.622,34,14,20,0.412
22100536,1610612760,1610612752,95.0,80.0,0.414,0.37,1,2021-12-31,35,13,22,0.371,36,17,19,0.472
22100537,1610612762,1610612750,120.0,108.0,0.474,0.43,1,2021-12-31,35,26,9,0.743,35,16,19,0.457
22100538,1610612747,1610612757,139.0,106.0,0.553,0.353,1,2021-12-31,37,18,19,0.486,35,13,22,0.371
22100525,1610612751,1610612755,102.0,110.0,0.457,0.42,0,2021-12-30,33,23,10,0.697,35,19,16,0.543
22100526,1610612753,1610612749,118.0,136.0,0.483,0.495,0,2021-12-30,36,7,29,0.194,37,24,13,0.649
22100527,1610612764,1610612739,110.0,93.0,0.5,0.422,1,2021-12-30,35,18,17,0.514,35,20,15,0.571
22100516,1610612765,1610612752,85.0,94.0,0.37,0.383,0,2021-12-29,33,5,28,0.152,35,17,18,0.486
22100517,1610612754,1610612766,108.0,116.0,0.419,0.518,0,2021-12-29,35,14,21,0.4,36,19,17,0.528
22100518,1610612738,1610612746,82.0,91.0,0.347,0.407,0,2021-12-29,35,16,19,0.457,35,18,17,0.514
22100519,1610612741,1610612737,131.0,117.0,0.619,0.478,1,2021-12-29,32,22,10,0.688,34,15,19,0.441
22100520,1610612763,1610612747,104.0,99.0,0.412,0.453,1,2021-12-29,36,22,14,0.611,36,17,19,0.472
22100522,1610612756,1610612760,115.0,97.0,0.461,0.396,1,2021-12-29,34,27,7,0.794,34,12,22,0.353
22100523,1610612757,1610612762,105.0,120.0,0.42,0.529,0,2021-12-29,34,13,21,0.382,34,25,9,0.735
22100524,1610612758,1610612742,95.0,94.0,0.48,0.469,1,2021-12-29,36,15,21,0.417,34,16,18,0.471
22100508,1610612753,1610612749,110.0,127.0,0.458,0.553,0,2021-12-28,35,7,28,0.2,36,23,13,0.639
22100509,1610612748,1610612764,119.0,112.0,0.446,0.494,1,2021-12-28,35,22,13,0.629,34,17,17,0.5
22100510,1610612761,1610612755,109.0,114.0,0.437,0.442,0,2021-12-28,31,14,17,0.452,34,18,16,0.529
22100511,1610612745,1610612747,123.0,132.0,0.53,0.522,0,2021-12-28,35,10,25,0.286,35,17,18,0.486
22100512,1610612750,1610612752,88.0,96.0,0.4,0.411,0,2021-12-28,34,16,18,0.471,34,16,18,0.471
22100513,1610612740,1610612739,108.0,104.0,0.45,0.42,1,2021-12-28,35,13,22,0.371,34,20,14,0.588
22100514,1610612744,1610612743,86.0,89.0,0.417,0.41,0,2021-12-28,34,27,7,0.794,33,17,16,0.515
22100515,1610612758,1610612760,117.0,111.0,0.421,0.389,1,2021-12-28,35,14,21,0.4,33,12,21,0.364
22100501,1610612766,1610612745,123.0,99.0,0.534,0.414,1,2021-12-27,35,18,17,0.514,34,10,24,0.294
22100502,1610612737,1610612741,118.0,130.0,0.449,0.543,0,2021-12-27,33,15,18,0.455,31,21,10,0.677
22100503,1610612750,1610612738,108.0,103.0,0.444,0.371,1,2021-12-27,33,16,17,0.485,34,16,18,0.471
22100504,1610612759,1610612762,104.0,110.0,0.45,0.453,0,2021-12-27,33,14,19,0.424,33,24,9,0.727
22100505,1610612756,1610612763,113.0,114.0,0.456,0.511,0,2021-12-27,33,26,7,0.788,35,21,14,0.6
22100506,1610612757,1610612742,117.0,132.0,0.427,0.571,0,2021-12-27,33,13,20,0.394,33,16,17,0.485
22100507,1610612746,1610612751,108.0,124.0,0.381,0.568,0,2021-12-27,34,17,17,0.5,32,23,9,0.719
22100493,1610612748,1610612753,93.0,83.0,0.404,0.431,1,2021-12-26,34,21,13,0.618,34,7,27,0.206
22100494,1610612739,1610612761,144.0,99.0,0.528,0.416,1,2021-12-26,33,20,13,0.606,30,14,16,0.467
22100495,1610612764,1610612755,96.0,117.0,0.389,0.5,0,2021-12-26,33,17,16,0.515,33,17,16,0.515
22100496,1610612758,1610612763,102.0,127.0,0.42,0.47,0,2021-12-26,34,13,21,0.382,34,20,14,0.588
22100497,1610612760,1610612740,117.0,112.0,0.477,0.415,1,2021-12-26,32,12,20,0.375,34,12,22,0.353
22100498,1610612759,1610612765,144.0,109.0,0.56,0.388,1,2021-12-26,32,14,18,0.438,32,5,27,0.156
22100499,1610612741,1610612754,113.0,105.0,0.566,0.436,1,2021-12-26,30,20,10,0.667,34,14,20,0.412
22100500,1610612746,1610612743,100.0,103.0,0.465,0.411,0,2021-12-26,33,17,16,0.515,32,16,16,0.5
22100488,1610612752,1610612737,101.0,87.0,0.447,0.379,1,2021-12-25,33,15,18,0.455,32,15,17,0.469
22100489,1610612749,1610612738,117.0,113.0,0.473,0.427,1,2021-12-25,35,22,13,0.629,33,16,17,0.485
22100490,1610612756,1610612744,107.0,116.0,0.482,0.494,0,2021-12-25,32,26,6,0.813,33,27,6,0.818
22100491,1610612747,1610612751,115.0,122.0,0.417,0.483,0,2021-12-25,34,16,18,0.471,31,22,9,0.71
22100492,1610612762,1610612742,120.0,116.0,0.444,0.427,1,2021-12-25,32,23,9,0.719,32,15,17,0.469
22100476,1610612754,1610612745,118.0,106.0,0.523,0.438,1,2021-12-23,33,14,19,0.424,33,10,23,0.303
22100477,1610612753,1610612740,104.0,110.0,0.432,0.43,0,2021-12-23,33,7,26,0.212,33,12,21,0.364
22100478,1610612755,1610612737,96.0,98.0,0.413,0.451,0,2021-12-23,32,16,16,0.5,31,15,16,0.484
22100479,1610612748,1610612765,115.0,112.0,0.489,0.45,1,2021-12-23,33,20,13,0.606,31,5,26,0.161
22100480,1610612752,1610612764,117.0,124.0,0.452,0.56,0,2021-12-23,32,14,18,0.438,32,17,15,0.531
22100481,1610612742,1610612749,95.0,102.0,0.407,0.451,0,2021-12-23,31,15,16,0.484,34,21,13,0.618
22100482,1610612743,1610612766,107.0,115.0,0.417,0.415,0,2021-12-23,31,15,16,0.484,34,17,17,0.5
22100483,1610612756,1610612760,113.0,101.0,0.484,0.385,1,2021-12-23,31,26,5,0.839,31,11,20,0.355
22100484,1610612762,1610612750,128.0,116.0,0.533,0.446,1,2021-12-23,31,22,9,0.71,32,15,17,0.469
22100485,1610612744,1610612763,113.0,104.0,0.488,0.422,1,2021-12-23,32,26,6,0.813,33,19,14,0.576
22100487,1610612747,1610612759,110.0,138.0,0.468,0.484,0,2021-12-23,33,16,17,0.485,31,13,18,0.419
22100470,1610612737,1610612753,98.0,104.0,0.4,0.447,0,2021-12-22,30,14,16,0.467,32,7,25,0.219
22100471,1610612738,1610612739,111.0,101.0,0.467,0.391,1,2021-12-22,32,16,16,0.5,32,19,13,0.594
22100473,1610612749,1610612745,126.0,106.0,0.437,0.419,1,2021-12-22,33,20,13,0.606,32,10,22,0.313
22100474,1610612760,1610612743,108.0,94.0,0.447,0.393,1,2021-12-22,30,11,19,0.367,30,15,15,0.5
22100475,1610612758,1610612746,89.0,105.0,0.4,0.512,0,2021-12-22,33,13,20,0.394,32,17,15,0.531
22100465,1610612748,1610612754,125.0,96.0,0.495,0.356,1,2021-12-21,32,19,13,0.594,32,13,19,0.406
22100466,1610612752,1610612765,105.0,91.0,0.444,0.362,1,2021-12-21,31,14,17,0.452,30,5,25,0.167
22100467,1610612740,1610612757,111.0,97.0,0.525,0.449,1,2021-12-21,32,11,21,0.344,32,13,19,0.406
22100468,1610612742,1610612750,114.0,102.0,0.488,0.456,1,2021-12-21,30,15,15,0.5,31,15,16,0.484
22100469,1610612747,1610612756,90.0,108.0,0.391,0.441,0,2021-12-21,32,16,16,0.5,30,25,5,0.833
22100457,1610612738,1610612755,103.0,108.0,0.463,0.5,0,2021-12-20,31,15,16,0.484,31,16,15,0.516
22100459,1610612741,1610612745,133.0,118.0,0.534,0.564,1,2021-12-20,29,19,10,0.655,31,10,21,0.323
22100460,1610612763,1610612760,99.0,102.0,0.386,0.429,0,2021-12-20,32,19,13,0.594,29,10,19,0.345
22100461,1610612762,1610612766,112.0,102.0,0.354,0.386,1,2021-12-20,30,21,9,0.7,33,16,17,0.485
22100462,1610612744,1610612758,113.0,98.0,0.523,0.446,1,2021-12-20,31,25,6,0.806,32,13,19,0.406
22100463,1610612746,1610612759,92.0,116.0,0.391,0.439,0,2021-12-20,31,16,15,0.516,30,12,18,0.4
22100449,1610612765,1610612748,100.0,90.0,0.467,0.378,1,2021-12-19,29,5,24,0.172,31,18,13,0.581
22100450,1610612763,1610612757,100.0,105.0,0.385,0.473,0,2021-12-19,31,19,12,0.613,31,13,18,0.419
22100451,1610612758,1610612759,121.0,114.0,0.505,0.495,1,2021-12-19,31,13,18,0.419,29,11,18,0.379
22100448,1610612741,1610612747,115.0,110.0,0.43,0.512,1,2021-12-19,28,18,10,0.643,31,16,15,0.516
22100455,1610612750,1610612742,111.0,105.0,0.468,0.439,1,2021-12-19,30,15,15,0.5,29,14,15,0.483
22100456,1610612756,1610612766,137.0,106.0,0.568,0.36,1,2021-12-19,29,24,5,0.828,32,16,16,0.5
22100441,1610612765,1610612745,107.0,116.0,0.462,0.495,0,2021-12-18,28,4,24,0.143,30,10,20,0.333
22100445,1610612738,1610612752,114.0,107.0,0.472,0.438,1,2021-12-18,30,15,15,0.5,30,13,17,0.433
22100442,1610612751,1610612753,93.0,100.0,0.382,0.415,0,2021-12-18,30,21,9,0.7,31,6,25,0.194
22100443,1610612761,1610612744,119.0,100.0,0.5,0.468,1,2021-12-18,29,14,15,0.483,30,24,6,0.8
22100444,1610612760,1610612746,104.0,103.0,0.467,0.446,1,2021-12-18,28,9,19,0.321,30,16,14,0.533
22100446,1610612749,1610612739,90.0,119.0,0.393,0.5,0,2021-12-18,32,19,13,0.594,31,19,12,0.613
22100447,1610612762,1610612764,103.0,109.0,0.432,0.447,0,2021-12-18,29,20,9,0.69,31,16,15,0.516
22100433,1610612753,1610612748,105.0,115.0,0.483,0.5,0,2021-12-17,30,5,25,0.167,30,18,12,0.6
22100434,1610612737,1610612743,115.0,133.0,0.466,0.581,0,2021-12-17,29,14,15,0.483,29,15,14,0.517
22100435,1610612738,1610612744,107.0,111.0,0.439,0.433,0,2021-12-17,29,14,15,0.483,29,24,5,0.828
22100438,1610612740,1610612749,116.0,112.0,0.472,0.433,1,2021-12-17,31,10,21,0.323,31,19,12,0.613
22100437,1610612762,1610612759,126.0,128.0,0.495,0.5,0,2021-12-17,28,20,8,0.714,28,11,17,0.393
22100436,1610612750,1610612747,110.0,92.0,0.418,0.385,1,2021-12-17,29,14,15,0.483,30,16,14,0.533
22100439,1610612757,1610612766,125.0,116.0,0.518,0.478,1,2021-12-17,30,12,18,0.4,31,16,15,0.516
22100440,1610612758,1610612763,105.0,124.0,0.409,0.464,0,2021-12-17,30,12,18,0.4,30,19,11,0.633
22100428,1610612754,1610612765,122.0,113.0,0.495,0.494,1,2021-12-16,31,13,18,0.419,27,4,23,0.148
22100429,1610612751,1610612755,114.0,105.0,0.494,0.438,1,2021-12-16,29,21,8,0.724,30,15,15,0.5
22100431,1610612745,1610612752,103.0,116.0,0.5,0.47,0,2021-12-16,29,9,20,0.31,29,13,16,0.448
22100432,1610612756,1610612764,118.0,98.0,0.532,0.488,1,2021-12-16,28,23,5,0.821,30,15,15,0.5
22100417,1610612739,1610612745,124.0,89.0,0.563,0.385,1,2021-12-15,30,18,12,0.6,28,9,19,0.321
22100418,1610612753,1610612737,99.0,111.0,0.389,0.494,0,2021-12-15,29,5,24,0.172,28,14,14,0.5
22100419,1610612755,1610612748,96.0,101.0,0.443,0.449,0,2021-12-15,29,15,14,0.517,29,17,12,0.586
22100420,1610612742,1610612747,104.0,107.0,0.398,0.433,0,2021-12-15,28,14,14,0.5,29,16,13,0.552
22100421,1610612749,1610612754,114.0,99.0,0.489,0.47,1,2021-12-15,30,19,11,0.633,30,12,18,0.4
22100422,1610612760,1610612740,110.0,113.0,0.419,0.488,0,2021-12-15,27,8,19,0.296,30,9,21,0.3
22100423,1610612759,1610612766,115.0,131.0,0.433,0.593,0,2021-12-15,27,10,17,0.37,30,16,14,0.533
22100424,1610612743,1610612750,107.0,124.0,0.452,0.511,0,2021-12-15,28,14,14,0.5,28,13,15,0.464
22100425,1610612762,1610612746,124.0,103.0,0.528,0.471,1,2021-12-15,27,20,7,0.741,29,16,13,0.552
22100426,1610612757,1610612763,103.0,113.0,0.378,0.476,0,2021-12-15,29,11,18,0.379,29,18,11,0.621
22100427,1610612758,1610612764,119.0,105.0,0.549,0.472,1,2021-12-15,29,12,17,0.414,29,15,14,0.517
22100413,1610612751,1610612761,131.0,129.0,0.485,0.457,1,2021-12-14,28,20,8,0.714,28,13,15,0.464
22100414,1610612752,1610612744,96.0,105.0,0.361,0.455,0,2021-12-14,28,12,16,0.429,28,23,5,0.821
22100416,1610612757,1610612756,107.0,111.0,0.417,0.473,0,2021-12-14,28,11,17,0.393,27,22,5,0.815
22100404,1610612739,1610612748,105.0,94.0,0.444,0.447,1,2021-12-13,29,17,12,0.586,28,16,12,0.571
22100405,1610612754,1610612744,100.0,102.0,0.402,0.5,0,2021-12-13,29,12,17,0.414,27,22,5,0.815
22100406,1610612761,1610612758,124.0,101.0,0.541,0.404,1,2021-12-13,27,13,14,0.481,28,11,17,0.393
22100407,1610612737,1610612745,126.0,132.0,0.494,0.479,0,2021-12-13,27,13,14,0.481,27,9,18,0.333
22100408,1610612738,1610612749,117.0,103.0,0.5,0.444,1,2021-12-13,28,14,14,0.5,29,18,11,0.621
22100409,1610612763,1610612755,126.0,91.0,0.528,0.446,1,2021-12-13,28,17,11,0.607,28,15,13,0.536
22100410,1610612742,1610612766,120.0,96.0,0.518,0.395,1,2021-12-13,27,14,13,0.519,29,15,14,0.517
22100411,1610612743,1610612764,113.0,107.0,0.468,0.456,1,2021-12-13,27,14,13,0.519,28,15,13,0.536
22100412,1610612746,1610612756,111.0,95.0,0.551,0.375,1,2021-12-13,28,16,12,0.571,26,21,5,0.808
22100398,1610612752,1610612749,97.0,112.0,0.427,0.477,0,2021-12-12,27,12,15,0.444,28,18,10,0.643
22100399,1610612765,1610612751,104.0,116.0,0.424,0.471,0,2021-12-12,26,4,22,0.154,27,19,8,0.704
22100400,1610612760,1610612742,84.0,103.0,0.375,0.422,0,2021-12-12,26,8,18,0.308,26,13,13,0.5
22100401,1610612759,1610612740,112.0,97.0,0.495,0.426,1,2021-12-12,26,10,16,0.385,29,8,21,0.276
22100402,1610612757,1610612750,111.0,116.0,0.457,0.447,0,2021-12-12,27,11,16,0.407,27,12,15,0.444
22100403,1610612747,1610612753,106.0,94.0,0.488,0.375,1,2021-12-12,28,15,13,0.536,28,5,23,0.179
22100391,1610612746,1610612753,106.0,104.0,0.457,0.438,1,2021-12-11,27,15,12,0.556,27,5,22,0.185
22100392,1610612764,1610612762,98.0,123.0,0.461,0.516,0,2021-12-11,27,15,12,0.556,26,19,7,0.731
22100393,1610612739,1610612758,117.0,103.0,0.466,0.441,1,2021-12-11,28,16,12,0.571,27,11,16,0.407
22100394,1610612748,1610612741,118.0,92.0,0.495,0.373,1,2021-12-11,27,16,11,0.593,27,17,10,0.63
22100395,1610612763,1610612745,113.0,106.0,0.5,0.494,1,2021-12-11,27,16,11,0.593,26,8,18,0.308
22100396,1610612755,1610612744,102.0,93.0,0.461,0.4,1,2021-12-11,27,15,12,0.556,26,21,5,0.808
22100397,1610612759,1610612743,112.0,127.0,0.461,0.505,0,2021-12-11,25,9,16,0.36,26,13,13,0.5
22100382,1610612766,1610612758,124.0,123.0,0.552,0.475,1,2021-12-10,28,15,13,0.536,26,11,15,0.423
22100383,1610612754,1610612742,106.0,93.0,0.471,0.464,1,2021-12-10,28,12,16,0.429,25,12,13,0.48
22100384,1610612737,1610612751,105.0,113.0,0.394,0.495,0,2021-12-10,26,13,13,0.5,26,18,8,0.692
22100385,1610612761,1610612752,90.0,87.0,0.345,0.358,1,2021-12-10,26,12,14,0.462,26,12,14,0.462
22100386,1610612745,1610612749,114.0,123.0,0.472,0.506,0,2021-12-10,25,8,17,0.32,27,17,10,0.63
22100387,1610612750,1610612739,106.0,123.0,0.391,0.541,0,2021-12-10,26,11,15,0.423,27,15,12,0.556
22100388,1610612740,1610612765,109.0,93.0,0.432,0.389,1,2021-12-10,28,8,20,0.286,25,4,21,0.16
22100389,1610612760,1610612747,95.0,116.0,0.396,0.471,0,2021-12-10,25,8,17,0.32,27,14,13,0.519
22100390,1610612756,1610612738,111.0,90.0,0.448,0.376,1,2021-12-10,25,21,4,0.84,27,13,14,0.481
22100379,1610612755,1610612762,96.0,118.0,0.432,0.473,0,2021-12-09,26,14,12,0.538,25,18,7,0.72
22100380,1610612763,1610612747,108.0,95.0,0.436,0.462,1,2021-12-09,26,15,11,0.577,26,13,13,0.5
22100381,1610612759,1610612743,123.0,111.0,0.523,0.447,1,2021-12-09,24,9,15,0.375,25,12,13,0.48
22100366,1610612766,1610612755,106.0,110.0,0.488,0.48,0,2021-12-08,27,14,13,0.519,25,14,11,0.56
22100367,1610612739,1610612741,115.0,92.0,0.55,0.417,1,2021-12-08,26,14,12,0.538,26,17,9,0.654
22100368,1610612765,1610612764,116.0,119.0,0.468,0.477,0,2021-12-08,24,4,20,0.167,26,15,11,0.577
22100369,1610612754,1610612752,122.0,102.0,0.535,0.419,1,2021-12-08,27,11,16,0.407,25,12,13,0.48
22100370,1610612748,1610612749,113.0,104.0,0.519,0.424,1,2021-12-08,26,15,11,0.577,26,16,10,0.615
22100371,1610612761,1610612760,109.0,110.0,0.452,0.452,0,2021-12-08,25,11,14,0.44,24,8,16,0.333
22100372,1610612745,1610612751,114.0,104.0,0.494,0.393,1,2021-12-08,24,8,16,0.333,25,17,8,0.68
22100373,1610612763,1610612742,96.0,104.0,0.4,0.481,0,2021-12-08,25,14,11,0.56,24,12,12,0.5
22100374,1610612750,1610612762,104.0,136.0,0.4,0.568,0,2021-12-08,25,11,14,0.44,24,17,7,0.708
22100375,1610612740,1610612743,114.0,120.0,0.522,0.511,0,2021-12-08,27,7,20,0.259,24,12,12,0.5
22100376,1610612744,1610612757,104.0,94.0,0.398,0.413,1,2021-12-08,25,21,4,0.84,26,11,15,0.423
22100377,1610612758,1610612753,142.0,130.0,0.546,0.495,1,2021-12-08,25,11,14,0.44,26,5,21,0.192
22100378,1610612746,1610612738,114.0,111.0,0.471,0.477,1,2021-12-08,26,14,12,0.538,26,13,13,0.5
22100363,1610612742,1610612751,99.0,102.0,0.4,0.506,0,2021-12-07,23,11,12,0.478,24,17,7,0.708
22100364,1610612759,1610612752,109.0,121.0,0.446,0.473,0,2021-12-07,23,8,15,0.348,24,12,12,0.5
22100365,1610612747,1610612738,117.0,102.0,0.516,0.439,1,2021-12-07,25,13,12,0.52,25,13,12,0.52
22100353,1610612766,1610612755,124.0,127.0,0.449,0.529,0,2021-12-06,26,14,12,0.538,24,13,11,0.542
22100354,1610612765,1610612760,103.0,114.0,0.414,0.5,0,2021-12-06,23,4,19,0.174,23,7,16,0.304
22100355,1610612754,1610612764,116.0,110.0,0.524,0.531,1,2021-12-06,26,10,16,0.385,25,14,11,0.56
22100356,1610612748,1610612763,90.0,105.0,0.461,0.427,0,2021-12-06,25,14,11,0.56,24,14,10,0.583
22100357,1610612741,1610612743,109.0,97.0,0.451,0.396,1,2021-12-06,25,17,8,0.68,23,11,12,0.478
22100358,1610612749,1610612739,112.0,104.0,0.465,0.389,1,2021-12-06,25,16,9,0.64,25,13,12,0.52
22100359,1610612750,1610612737,110.0,121.0,0.398,0.444,0,2021-12-06,24,11,13,0.458,25,13,12,0.52
22100360,1610612756,1610612759,108.0,104.0,0.457,0.43,1,2021-12-06,24,20,4,0.833,22,8,14,0.364
22100361,1610612744,1610612753,126.0,95.0,0.494,0.434,1,2021-12-06,24,20,4,0.833,25,5,20,0.2
22100362,1610612757,1610612746,90.0,102.0,0.443,0.446,0,2021-12-06,25,11,14,0.44,25,13,12,0.52
22100349,1610612739,1610612762,108.0,109.0,0.462,0.444,0,2021-12-05,24,13,11,0.542,23,16,7,0.696
22100350,1610612737,1610612766,127.0,130.0,0.516,0.535,0,2021-12-05,24,12,12,0.5,25,14,11,0.56
22100351,1610612761,1610612764,102.0,90.0,0.447,0.411,1,2021-12-05,24,11,13,0.458,24,14,10,0.583
22100352,1610612745,1610612740,118.0,108.0,0.494,0.426,1,2021-12-05,23,7,16,0.304,26,7,19,0.269
22100342,1610612752,1610612743,99.0,113.0,0.398,0.524,0,2021-12-04,23,11,12,0.478,22,11,11,0.5
22100343,1610612751,1610612741,107.0,111.0,0.414,0.477,0,2021-12-04,23,16,7,0.696,24,16,8,0.667
22100344,1610612749,1610612748,124.0,102.0,0.449,0.405,1,2021-12-04,24,15,9,0.625,24,14,10,0.583
22100345,1610612742,1610612763,90.0,97.0,0.337,0.487,0,2021-12-04,22,11,11,0.5,23,13,10,0.565
22100346,1610612744,1610612759,107.0,112.0,0.444,0.477,0,2021-12-04,23,19,4,0.826,21,8,13,0.381
22100347,1610612757,1610612738,117.0,145.0,0.472,0.563,0,2021-12-04,24,11,13,0.458,24,13,11,0.542
22100348,1610612758,1610612746,104.0,99.0,0.419,0.382,1,2021-12-04,24,10,14,0.417,24,12,12,0.5
22100333,1610612754,1610612748,104.0,113.0,0.438,0.531,0,2021-12-03,25,9,16,0.36,23,14,9,0.609
22100334,1610612764,1610612739,101.0,116.0,0.463,0.472,0,2021-12-03,23,14,9,0.609,23,13,10,0.565
22100335,1610612737,1610612755,96.0,98.0,0.408,0.469,0,2021-12-03,23,12,11,0.522,23,12,11,0.522
22100336,1610612751,1610612750,110.0,105.0,0.474,0.387,1,2021-12-03,22,16,6,0.727,23,11,12,0.478
22100337,1610612745,1610612753,118.0,116.0,0.478,0.488,1,2021-12-03,22,6,16,0.273,24,5,19,0.208
22100338,1610612742,1610612740,91.0,107.0,0.405,0.411,0,2021-12-03,21,11,10,0.524,25,7,18,0.28
22100339,1610612762,1610612738,137.0,130.0,0.556,0.516,1,2021-12-03,22,15,7,0.682,23,12,11,0.522
22100340,1610612744,1610612756,118.0,96.0,0.489,0.383,1,2021-12-03,22,19,3,0.864,23,19,4,0.826
22100341,1610612747,1610612746,115.0,119.0,0.5,0.506,0,2021-12-03,24,12,12,0.5,23,12,11,0.522
22100328,1610612752,1610612741,115.0,119.0,0.512,0.494,0,2021-12-02,22,11,11,0.5,23,15,8,0.652
22100329,1610612761,1610612749,97.0,93.0,0.42,0.376,1,2021-12-02,23,10,13,0.435,23,14,9,0.609
22100330,1610612763,1610612760,152.0,79.0,0.625,0.329,1,2021-12-02,22,12,10,0.545,22,6,16,0.273
22100331,1610612756,1610612765,114.0,103.0,0.544,0.45,1,2021-12-02,22,19,3,0.864,22,4,18,0.182
22100332,1610612757,1610612759,83.0,114.0,0.354,0.484,0,2021-12-02,23,11,12,0.478,20,7,13,0.35
22100319,1610612754,1610612737,111.0,114.0,0.489,0.512,0,2021-12-01,24,9,15,0.375,22,12,10,0.545
22100320,1610612753,1610612743,108.0,103.0,0.543,0.488,1,2021-12-01,23,5,18,0.217,21,10,11,0.476
22100321,1610612764,1610612750,115.0,107.0,0.495,0.42,1,2021-12-01,22,14,8,0.636,22,11,11,0.5
22100322,1610612738,1610612755,88.0,87.0,0.418,0.371,1,2021-12-01,22,12,10,0.545,22,11,11,0.5
22100323,1610612748,1610612739,85.0,111.0,0.376,0.544,0,2021-12-01,22,13,9,0.591,22,12,10,0.545
22100324,1610612749,1610612766,127.0,125.0,0.489,0.494,1,2021-12-01,22,14,8,0.636,24,13,11,0.542
22100325,1610612740,1610612742,107.0,139.0,0.449,0.687,0,2021-12-01,24,6,18,0.25,20,11,9,0.55
22100326,1610612760,1610612745,110.0,114.0,0.471,0.506,0,2021-12-01,21,6,15,0.286,21,5,16,0.238
22100327,1610612746,1610612758,115.0,124.0,0.47,0.523,0,2021-12-01,22,11,11,0.5,23,9,14,0.391
22100314,1610612751,1610612752,112.0,110.0,0.482,0.484,1,2021-11-30,21,15,6,0.714,21,11,10,0.524
22100315,1610612761,1610612763,91.0,98.0,0.396,0.387,0,2021-11-30,22,9,13,0.409,21,11,10,0.524
22100316,1610612756,1610612744,104.0,96.0,0.494,0.419,1,2021-11-30,21,18,3,0.857,21,18,3,0.857
22100317,1610612757,1610612765,110.0,92.0,0.427,0.382,1,2021-11-30,22,11,11,0.5,21,4,17,0.19
22100318,1610612758,1610612747,92.0,117.0,0.443,0.5,0,2021-11-30,22,8,14,0.364,23,12,11,0.522
22100305,1610612755,1610612753,101.0,96.0,0.402,0.411,1,2021-11-29,21,11,10,0.524,22,4,18,0.182
22100306,1610612748,1610612743,111.0,120.0,0.473,0.581,0,2021-11-29,21,13,8,0.619,20,10,10,0.5
22100307,1610612741,1610612766,133.0,119.0,0.596,0.477,1,2021-11-29,22,14,8,0.636,23,13,10,0.565
22100308,1610612745,1610612760,102.0,89.0,0.417,0.356,1,2021-11-29,20,4,16,0.2,20,6,14,0.3
22100309,1610612750,1610612754,100.0,98.0,0.439,0.396,1,2021-11-29,21,11,10,0.524,23,9,14,0.391
22100310,1610612742,1610612739,96.0,114.0,0.438,0.563,0,2021-11-29,19,10,9,0.526,21,11,10,0.524
22100311,1610612759,1610612764,116.0,99.0,0.533,0.446,1,2021-11-29,19,6,13,0.316,21,13,8,0.619
22100312,1610612762,1610612757,129.0,107.0,0.528,0.462,1,2021-11-29,21,14,7,0.667,21,10,11,0.476
22100313,1610612746,1610612740,104.0,123.0,0.514,0.511,0,2021-11-29,21,11,10,0.524,23,6,17,0.261
22100300,1610612746,1610612744,90.0,105.0,0.4,0.442,0,2021-11-28,20,11,9,0.55,20,18,2,0.9
22100301,1610612754,1610612749,100.0,118.0,0.413,0.511,0,2021-11-28,22,9,13,0.409,21,13,8,0.619
22100302,1610612761,1610612738,97.0,109.0,0.376,0.415,0,2021-11-28,21,9,12,0.429,21,11,10,0.524
22100303,1610612763,1610612758,128.0,101.0,0.481,0.34,1,2021-11-28,20,10,10,0.5,21,8,13,0.381
22100304,1610612747,1610612765,110.0,106.0,0.5,0.427,1,2021-11-28,22,11,11,0.5,20,4,16,0.2
22100292,1610612755,1610612750,120.0,121.0,0.419,0.5,0,2021-11-27,20,10,10,0.5,20,10,10,0.5
22100293,1610612737,1610612752,90.0,99.0,0.355,0.439,0,2021-11-27,21,11,10,0.524,20,11,9,0.55
22100294,1610612751,1610612756,107.0,113.0,0.5,0.446,0,2021-11-27,20,14,6,0.7,20,17,3,0.85
22100295,1610612739,1610612753,105.0,92.0,0.456,0.398,1,2021-11-27,20,10,10,0.5,21,4,17,0.19
22100296,1610612741,1610612748,104.0,107.0,0.469,0.43,0,2021-11-27,21,13,8,0.619,20,13,7,0.65
22100297,1610612745,1610612766,146.0,143.0,0.537,0.466,1,2021-11-27,19,3,16,0.158,22,13,9,0.591
22100298,1610612742,1610612764,114.0,120.0,0.472,0.577,0,2021-11-27,18,10,8,0.556,20,13,7,0.65
22100299,1610612762,1610612740,127.0,105.0,0.563,0.43,1,2021-11-27,20,13,7,0.65,22,5,17,0.227
22100280,1610612746,1610612765,107.0,96.0,0.429,0.367,1,2021-11-26,19,11,8,0.579,19,4,15,0.211
22100281,1610612766,1610612750,133.0,115.0,0.557,0.45,1,2021-11-26,21,13,8,0.619,19,9,10,0.474
22100282,1610612752,1610612756,97.0,118.0,0.37,0.557,0,2021-11-26,19,10,9,0.526,19,16,3,0.842
22100283,1610612753,1610612741,88.0,123.0,0.375,0.558,0,2021-11-26,20,4,16,0.2,20,13,7,0.65
22100284,1610612754,1610612761,114.0,97.0,0.485,0.416,1,2021-11-26,21,9,12,0.429,20,9,11,0.45
22100285,1610612763,1610612737,100.0,132.0,0.407,0.584,0,2021-11-26,19,9,10,0.474,20,11,9,0.55
22100286,1610612760,1610612764,99.0,101.0,0.404,0.481,0,2021-11-26,19,6,13,0.316,19,12,7,0.632
22100287,1610612759,1610612738,96.0,88.0,0.437,0.37,1,2021-11-26,18,5,13,0.278,20,10,10,0.5
22100288,1610612743,1610612749,109.0,120.0,0.435,0.63,0,2021-11-26,19,9,10,0.474,20,12,8,0.6
22100289,1610612762,1610612740,97.0,98.0,0.45,0.427,0,2021-11-26,19,12,7,0.632,21,5,16,0.238
22100290,1610612744,1610612757,118.0,103.0,0.54,0.419,1,2021-11-26,19,17,2,0.895,20,10,10,0.5
22100291,1610612747,1610612758,137.0,141.0,0.5,0.45,0,2021-11-26,21,10,11,0.476,20,8,12,0.4
22100267,1610612739,1610612756,115.0,120.0,0.443,0.523,0,2021-11-24,19,9,10,0.474,18,15,3,0.833
22100268,1610612754,1610612747,116.0,124.0,0.404,0.442,0,2021-11-24,20,8,12,0.4,20,10,10,0.5
22100269,1610612753,1610612766,99.0,106.0,0.409,0.419,0,2021-11-24,19,4,15,0.211,20,12,8,0.6
22100270,1610612738,1610612751,104.0,123.0,0.374,0.506,0,2021-11-24,19,10,9,0.526,19,14,5,0.737
22100271,1610612745,1610612741,118.0,113.0,0.5,0.458,1,2021-11-24,18,2,16,0.111,19,12,7,0.632
22100272,1610612763,1610612761,113.0,126.0,0.512,0.528,0,2021-11-24,18,9,9,0.5,19,9,10,0.474
22100273,1610612749,1610612765,114.0,93.0,0.483,0.358,1,2021-11-24,19,11,8,0.579,18,4,14,0.222
22100274,1610612750,1610612748,113.0,101.0,0.409,0.446,1,2021-11-24,18,9,9,0.5,19,12,7,0.632
22100275,1610612740,1610612764,127.0,102.0,0.458,0.429,1,2021-11-24,20,4,16,0.2,18,11,7,0.611
22100276,1610612760,1610612762,104.0,110.0,0.451,0.453,0,2021-11-24,18,6,12,0.333,18,12,6,0.667
22100277,1610612759,1610612737,106.0,124.0,0.43,0.511,0,2021-11-24,17,4,13,0.235,19,10,9,0.526
22100278,1610612744,1610612755,116.0,96.0,0.525,0.425,1,2021-11-24,18,16,2,0.889,19,10,9,0.526
22100279,1610612758,1610612757,125.0,121.0,0.523,0.468,1,2021-11-24,19,7,12,0.368,19,10,9,0.526
22100263,1610612765,1610612748,92.0,100.0,0.417,0.461,0,2021-11-23,17,4,13,0.235,18,12,6,0.667
22100264,1610612752,1610612747,106.0,100.0,0.451,0.374,1,2021-11-23,18,10,8,0.556,19,9,10,0.474
22100265,1610612757,1610612743,119.0,100.0,0.511,0.487,1,2021-11-23,18,10,8,0.556,18,9,9,0.5
22100266,1610612746,1610612742,104.0,112.0,0.412,0.438,0,2021-11-23,18,10,8,0.556,17,10,7,0.588
22100253,1610612739,1610612751,112.0,117.0,0.387,0.474,0,2021-11-22,18,9,9,0.5,18,13,5,0.722
22100254,1610612764,1610612766,103.0,109.0,0.383,0.44,0,2021-11-22,17,11,6,0.647,19,11,8,0.579
22100255,1610612737,1610612760,113.0,101.0,0.483,0.402,1,2021-11-22,18,9,9,0.5,17,6,11,0.353
22100256,1610612738,1610612745,108.0,90.0,0.424,0.373,1,2021-11-22,18,10,8,0.556,17,1,16,0.059
22100257,1610612741,1610612754,77.0,109.0,0.365,0.444,0,2021-11-22,18,12,6,0.667,19,8,11,0.421
22100258,1610612749,1610612753,123.0,92.0,0.468,0.366,1,2021-11-22,18,10,8,0.556,18,4,14,0.222
22100259,1610612740,1610612750,96.0,110.0,0.42,0.4,0,2021-11-22,19,3,16,0.158,17,8,9,0.471
22100260,1610612759,1610612756,111.0,115.0,0.527,0.511,0,2021-11-22,16,4,12,0.25,17,14,3,0.824
22100261,1610612762,1610612763,118.0,119.0,0.471,0.442,0,2021-11-22,17,11,6,0.647,17,9,8,0.529
22100262,1610612758,1610612755,94.0,102.0,0.413,0.424,0,2021-11-22,18,6,12,0.333,18,10,8,0.556
22100248,1610612746,1610612742,97.0,91.0,0.48,0.41,1,2021-11-21,17,10,7,0.588,16,9,7,0.563
22100249,1610612765,1610612747,116.0,121.0,0.443,0.489,0,2021-11-21,16,4,12,0.25,18,9,9,0.5
22100250,1610612741,1610612752,109.0,103.0,0.42,0.417,1,2021-11-21,17,12,5,0.706,17,9,8,0.529
22100251,1610612756,1610612743,126.0,97.0,0.529,0.367,1,2021-11-21,16,13,3,0.813,17,9,8,0.529
22100252,1610612744,1610612761,119.0,104.0,0.494,0.394,1,2021-11-21,17,15,2,0.882,18,8,10,0.444
22100239,1610612752,1610612745,106.0,99.0,0.423,0.452,1,2021-11-20,16,9,7,0.563,16,1,15,0.063
22100240,1610612754,1610612740,111.0,94.0,0.462,0.398,1,2021-11-20,18,7,11,0.389,18,3,15,0.167
22100241,1610612764,1610612748,103.0,100.0,0.486,0.469,1,2021-11-20,16,11,5,0.688,17,11,6,0.647
22100242,1610612737,1610612766,115.0,105.0,0.524,0.422,1,2021-11-20,17,8,9,0.471,18,10,8,0.556
22100243,1610612738,1610612760,111.0,105.0,0.466,0.406,1,2021-11-20,17,9,8,0.529,16,6,10,0.375
22100244,1610612749,1610612753,117.0,108.0,0.451,0.398,1,2021-11-20,17,9,8,0.529,17,4,13,0.235
22100245,1610612750,1610612763,138.0,95.0,0.538,0.349,1,2021-11-20,16,7,9,0.438,16,8,8,0.5
22100246,1610612757,1610612755,118.0,111.0,0.5,0.506,1,2021-11-20,17,9,8,0.529,17,9,8,0.529
22100247,1610612758,1610612762,105.0,123.0,0.451,0.505,0,2021-11-20,17,6,11,0.353,16,11,5,0.688
22100230,1610612766,1610612754,121.0,118.0,0.543,0.466,1,2021-11-19,17,10,7,0.588,17,6,11,0.353
22100231,1610612765,1610612744,102.0,105.0,0.4,0.475,0,2021-11-19,15,4,11,0.267,16,14,2,0.875
22100232,1610612738,1610612747,130.0,108.0,0.5,0.464,1,2021-11-19,16,8,8,0.5,17,8,9,0.471
22100233,1610612751,1610612753,115.0,113.0,0.451,0.449,1,2021-11-19,17,12,5,0.706,16,4,12,0.25
22100234,1610612749,1610612760,96.0,89.0,0.373,0.352,1,2021-11-19,16,8,8,0.5,15,6,9,0.4
22100235,1610612740,1610612746,94.0,81.0,0.437,0.378,1,2021-11-19,17,3,14,0.176,16,9,7,0.563
22100236,1610612743,1610612741,108.0,114.0,0.476,0.441,0,2021-11-19,16,9,7,0.563,16,11,5,0.688
22100237,1610612756,1610612742,112.0,104.0,0.518,0.411,1,2021-11-19,15,12,3,0.8,15,9,6,0.6
22100238,1610612758,1610612761,89.0,108.0,0.381,0.452,0,2021-11-19,16,6,10,0.375,17,8,9,0.471
22100224,1610612739,1610612744,89.0,104.0,0.425,0.494,0,2021-11-18,17,9,8,0.529,15,13,2,0.867
22100225,1610612748,1610612764,112.0,97.0,0.5,0.494,1,2021-11-18,16,11,5,0.688,15,10,5,0.667
22100226,1610612763,1610612746,120.0,108.0,0.542,0.467,1,2021-11-18,15,8,7,0.533,15,9,6,0.6
22100227,1610612750,1610612759,115.0,90.0,0.477,0.417,1,2021-11-18,15,6,9,0.4,15,4,11,0.267
22100228,1610612743,1610612755,89.0,103.0,0.36,0.506,0,2021-11-18,15,9,6,0.6,16,9,7,0.563
22100229,1610612762,1610612761,119.0,103.0,0.55,0.415,1,2021-11-18,15,10,5,0.667,16,7,9,0.438
22100213,1610612766,1610612764,97.0,87.0,0.438,0.367,1,2021-11-17,16,9,7,0.563,14,10,4,0.714
22100214,1610612765,1610612754,97.0,89.0,0.425,0.418,1,2021-11-17,14,4,10,0.286,16,6,10,0.375
22100215,1610612737,1610612738,110.0,99.0,0.506,0.44,1,2021-11-17,16,7,9,0.438,15,7,8,0.467
22100216,1610612751,1610612739,109.0,99.0,0.458,0.393,1,2021-11-17,16,11,5,0.688,16,9,7,0.563
22100217,1610612748,1610612740,113.0,98.0,0.483,0.44,1,2021-11-17,15,10,5,0.667,16,2,14,0.125
22100218,1610612752,1610612753,98.0,104.0,0.42,0.406,0,2021-11-17,15,8,7,0.533,15,4,11,0.267
22100219,1610612749,1610612747,109.0,102.0,0.46,0.417,1,2021-11-17,15,7,8,0.467,16,8,8,0.5
22100220,1610612750,1610612758,107.0,97.0,0.5,0.366,1,2021-11-17,14,5,9,0.357,15,6,9,0.4
22100221,1610612760,1610612745,101.0,89.0,0.446,0.356,1,2021-11-17,14,6,8,0.429,15,1,14,0.067
22100222,1610612756,1610612742,105.0,98.0,0.441,0.413,1,2021-11-17,14,11,3,0.786,14,9,5,0.643
22100223,1610612757,1610612741,112.0,107.0,0.44,0.47,1,2021-11-17,16,8,8,0.5,15,10,5,0.667
22100210,1610612751,1610612744,99.0,117.0,0.386,0.519,0,2021-11-16,15,10,5,0.667,14,12,2,0.857
22100211,1610612762,1610612755,120.0,85.0,0.517,0.367,1,2021-11-16,14,9,5,0.643,15,8,7,0.533
22100212,1610612746,1610612759,106.0,92.0,0.435,0.432,1,2021-11-16,14,9,5,0.643,14,4,10,0.286
22100199,1610612739,1610612738,92.0,98.0,0.386,0.462,0,2021-11-15,15,9,6,0.6,14,7,7,0.5
22100200,1610612765,1610612758,107.0,129.0,0.406,0.531,0,2021-11-15,13,3,10,0.231,14,6,8,0.429
22100201,1610612764,1610612740,105.0,100.0,0.464,0.405,1,2021-11-15,13,10,3,0.769,15,2,13,0.133
22100202,1610612737,1610612753,129.0,111.0,0.553,0.453,1,2021-11-15,15,6,9,0.4,14,3,11,0.214
22100203,1610612752,1610612754,92.0,84.0,0.43,0.372,1,2021-11-15,14,8,6,0.571,15,6,9,0.4
22100204,1610612742,1610612743,111.0,101.0,0.5,0.476,1,2021-11-15,13,9,4,0.692,14,9,5,0.643
22100205,1610612763,1610612745,136.0,102.0,0.542,0.379,1,2021-11-15,14,7,7,0.5,14,1,13,0.071
22100206,1610612750,1610612756,96.0,99.0,0.365,0.376,0,2021-11-15,13,4,9,0.308,13,10,3,0.769
22100207,1610612760,1610612748,90.0,103.0,0.41,0.451,0,2021-11-15,13,5,8,0.385,14,9,5,0.643
22100208,1610612757,1610612761,118.0,113.0,0.561,0.461,1,2021-11-15,15,7,8,0.467,15,7,8,0.467
22100209,1610612747,1610612741,103.0,121.0,0.456,0.551,0,2021-11-15,15,8,7,0.533,14,10,4,0.714
22100192,1610612747,1610612759,114.0,106.0,0.518,0.444,1,2021-11-14,14,8,6,0.571,13,4,9,0.308
22100193,1610612737,1610612749,120.0,100.0,0.485,0.452,1,2021-11-14,14,5,9,0.357,14,6,8,0.429
22100194,1610612766,1610612744,106.0,102.0,0.477,0.422,1,2021-11-14,15,8,7,0.533,13,11,2,0.846
22100195,1610612745,1610612756,89.0,115.0,0.412,0.433,0,2021-11-14,13,1,12,0.077,12,9,3,0.75
22100196,1610612760,1610612751,96.0,120.0,0.4,0.5,0,2021-11-14,12,5,7,0.417,14,10,4,0.714
22100197,1610612743,1610612757,124.0,95.0,0.522,0.438,1,2021-11-14,13,9,4,0.692,14,6,8,0.429
22100198,1610612746,1610612741,90.0,100.0,0.358,0.442,0,2021-11-14,13,8,5,0.615,13,9,4,0.692
22100185,1610612762,1610612748,105.0,111.0,0.412,0.494,0,2021-11-13,13,8,5,0.615,13,8,5,0.615
22100186,1610612754,1610612755,118.0,113.0,0.573,0.427,1,2021-11-13,14,6,8,0.429,14,8,6,0.571
22100187,1610612753,1610612764,92.0,104.0,0.337,0.5,0,2021-11-13,13,3,10,0.231,12,9,3,0.75
22100188,1610612740,1610612763,112.0,101.0,0.481,0.432,1,2021-11-13,14,2,12,0.143,13,6,7,0.462
22100189,1610612761,1610612765,121.0,127.0,0.506,0.544,0,2021-11-13,14,7,7,0.5,12,3,9,0.25
22100190,1610612739,1610612738,91.0,89.0,0.383,0.423,1,2021-11-13,14,9,5,0.643,13,6,7,0.462
22100191,1610612746,1610612750,129.0,102.0,0.535,0.392,1,2021-11-13,12,8,4,0.667,12,4,8,0.333
22100174,1610612766,1610612752,104.0,96.0,0.433,0.387,1,2021-11-12,14,7,7,0.5,13,7,6,0.538
22100175,1610612738,1610612749,122.0,113.0,0.49,0.449,1,2021-11-12,12,6,6,0.5,13,6,7,0.462
22100176,1610612739,1610612765,98.0,78.0,0.476,0.367,1,2021-11-12,13,8,5,0.615,11,2,9,0.182
22100177,1610612745,1610612757,92.0,104.0,0.4,0.391,0,2021-11-12,12,1,11,0.083,13,6,7,0.462
22100178,1610612763,1610612756,94.0,119.0,0.378,0.489,0,2021-11-12,12,6,6,0.5,11,8,3,0.727
22100179,1610612740,1610612751,112.0,120.0,0.489,0.5,0,2021-11-12,13,1,12,0.077,13,9,4,0.692
22100180,1610612760,1610612758,105.0,103.0,0.424,0.4,1,2021-11-12,11,5,6,0.455,13,5,8,0.385
22100181,1610612759,1610612742,109.0,123.0,0.488,0.46,0,2021-11-12,12,4,8,0.333,12,8,4,0.667
22100182,1610612743,1610612737,105.0,96.0,0.444,0.409,1,2021-11-12,12,8,4,0.667,13,4,9,0.308
22100183,1610612744,1610612741,119.0,93.0,0.484,0.436,1,2021-11-12,12,11,1,0.917,12,8,4,0.667
22100184,1610612747,1610612750,83.0,107.0,0.354,0.457,0,2021-11-12,13,7,6,0.538,11,4,7,0.364
22100171,1610612755,1610612761,109.0,115.0,0.455,0.438,0,2021-11-11,13,8,5,0.615,13,7,6,0.538
22100172,1610612762,1610612754,100.0,111.0,0.47,0.448,0,2021-11-11,12,8,4,0.667,13,5,8,0.385
22100173,1610612746,1610612748,112.0,109.0,0.473,0.443,1,2021-11-11,11,7,4,0.636,12,7,5,0.583
22100158,1610612739,1610612764,94.0,97.0,0.461,0.417,0,2021-11-10,12,7,5,0.583,11,8,3,0.727
22100159,1610612753,1610612751,90.0,123.0,0.38,0.505,0,2021-11-10,12,3,9,0.25,12,8,4,0.667
22100160,1610612738,1610612761,104.0,88.0,0.447,0.429,1,2021-11-10,11,5,6,0.455,12,6,6,0.5
22100161,1610612752,1610612749,100.0,112.0,0.434,0.444,0,2021-11-10,12,7,5,0.583,12,6,6,0.5
22100162,1610612745,1610612765,104.0,112.0,0.427,0.433,0,2021-11-10,11,1,10,0.091,10,2,8,0.2
22100163,1610612741,1610612742,117.0,107.0,0.506,0.458,1,2021-11-10,11,8,3,0.727,11,7,4,0.636
22100164,1610612763,1610612766,108.0,118.0,0.421,0.456,0,2021-11-10,11,6,5,0.545,13,6,7,0.462
22100165,1610612740,1610612760,100.0,108.0,0.351,0.425,0,2021-11-10,12,1,11,0.083,10,4,6,0.4
22100166,1610612759,1610612758,136.0,117.0,0.533,0.516,1,2021-11-10,11,4,7,0.364,12,5,7,0.417
22100167,1610612743,1610612754,101.0,98.0,0.429,0.476,1,2021-11-10,11,7,4,0.636,12,4,8,0.333
22100168,1610612756,1610612757,119.0,109.0,0.521,0.484,1,2021-11-10,10,7,3,0.7,12,5,7,0.417
22100169,1610612744,1610612750,123.0,110.0,0.471,0.411,1,2021-11-10,11,10,1,0.909,10,3,7,0.3
22100170,1610612747,1610612748,120.0,117.0,0.5,0.417,1,2021-11-10,12,7,5,0.583,11,7,4,0.636
22100155,1610612755,1610612749,109.0,118.0,0.408,0.463,0,2021-11-09,12,8,4,0.667,11,5,6,0.455
22100156,1610612762,1610612737,110.0,98.0,0.506,0.435,1,2021-11-09,11,8,3,0.727,12,4,8,0.333
22100157,1610612746,1610612757,117.0,109.0,0.518,0.473,1,2021-11-09,10,6,4,0.6,11,5,6,0.455
22100147,1610612755,1610612752,96.0,103.0,0.385,0.44,0,2021-11-08,11,8,3,0.727,11,7,4,0.636
22100148,1610612741,1610612751,118.0,95.0,0.469,0.395,1,2021-11-08,10,7,3,0.7,11,7,4,0.636
22100149,1610612763,1610612750,125.0,118.0,0.5,0.423,1,2021-11-08,10,6,4,0.6,9,3,6,0.333
22100150,1610612742,1610612740,108.0,92.0,0.506,0.425,1,2021-11-08,10,7,3,0.7,11,1,10,0.091
22100151,1610612743,1610612748,113.0,96.0,0.462,0.397,1,2021-11-08,10,6,4,0.6,10,7,3,0.7
22100152,1610612744,1610612737,127.0,113.0,0.478,0.463,1,2021-11-08,10,9,1,0.9,11,4,7,0.364
22100153,1610612758,1610612756,104.0,109.0,0.451,0.473,0,2021-11-08,11,5,6,0.455,9,6,3,0.667
22100154,1610612747,1610612766,126.0,123.0,0.484,0.434,1,2021-11-08,11,6,5,0.545,12,5,7,0.417
22100139,1610612761,1610612751,103.0,116.0,0.471,0.513,0,2021-11-07,11,6,5,0.545,10,7,3,0.7
22100140,1610612752,1610612739,109.0,126.0,0.459,0.544,0,2021-11-07,10,6,4,0.6,11,7,4,0.636
22100141,1610612753,1610612762,107.0,100.0,0.494,0.382,1,2021-11-07,11,3,8,0.273,10,7,3,0.7
22100142,1610612764,1610612749,101.0,94.0,0.506,0.394,1,2021-11-07,10,7,3,0.7,10,4,6,0.4
22100143,1610612758,1610612754,91.0,94.0,0.369,0.446,0,2021-11-07,10,5,5,0.5,11,4,7,0.364
22100144,1610612760,1610612759,99.0,94.0,0.372,0.41,1,2021-11-07,9,3,6,0.333,10,3,7,0.3
22100145,1610612744,1610612745,120.0,107.0,0.518,0.456,1,2021-11-07,9,8,1,0.889,10,1,9,0.1
22100146,1610612746,1610612766,120.0,106.0,0.477,0.406,1,2021-11-07,9,5,4,0.556,11,5,6,0.455
22100133,1610612743,1610612745,95.0,94.0,0.404,0.467,1,2021-11-06,9,5,4,0.556,9,1,8,0.111
22100134,1610612748,1610612762,118.0,115.0,0.603,0.518,1,2021-11-06,9,7,2,0.778,9,7,2,0.778
22100135,1610612741,1610612755,105.0,114.0,0.402,0.531,0,2021-11-06,9,6,3,0.667,10,8,2,0.8
22100136,1610612742,1610612738,107.0,104.0,0.526,0.488,1,2021-11-06,9,6,3,0.667,10,4,6,0.4
22100137,1610612756,1610612737,121.0,117.0,0.511,0.433,1,2021-11-06,8,5,3,0.625,10,4,6,0.4
22100138,1610612757,1610612747,105.0,90.0,0.379,0.344,1,2021-11-06,10,5,5,0.5,10,5,5,0.5
22100124,1610612765,1610612751,90.0,96.0,0.379,0.45,0,2021-11-05,9,1,8,0.111,9,6,3,0.667
22100125,1610612753,1610612759,89.0,102.0,0.393,0.444,0,2021-11-05,10,2,8,0.2,9,3,6,0.333
22100126,1610612764,1610612763,115.0,87.0,0.583,0.354,1,2021-11-05,9,6,3,0.667,9,5,4,0.556
22100127,1610612761,1610612739,101.0,102.0,0.424,0.458,0,2021-11-05,10,6,4,0.6,10,6,4,0.6
22100128,1610612749,1610612752,98.0,113.0,0.402,0.427,0,2021-11-05,9,4,5,0.444,9,6,3,0.667
22100129,1610612750,1610612746,84.0,104.0,0.348,0.409,0,2021-11-05,8,3,5,0.375,8,4,4,0.5
22100130,1610612744,1610612740,126.0,85.0,0.516,0.352,1,2021-11-05,8,7,1,0.875,10,1,9,0.1
22100131,1610612757,1610612754,110.0,106.0,0.488,0.489,1,2021-11-05,9,4,5,0.444,10,3,7,0.3
22100132,1610612758,1610612766,140.0,110.0,0.552,0.467,1,2021-11-05,9,5,4,0.556,10,5,5,0.5
22100119,1610612765,1610612755,98.0,109.0,0.402,0.494,0,2021-11-04,8,1,7,0.125,9,7,2,0.778
22100120,1610612737,1610612762,98.0,116.0,0.427,0.506,0,2021-11-04,9,4,5,0.444,8,7,1,0.875
22100121,1610612748,1610612738,78.0,95.0,0.346,0.397,0,2021-11-04,8,6,2,0.75,9,4,5,0.444
22100122,1610612756,1610612745,123.0,111.0,0.473,0.432,1,2021-11-04,7,4,3,0.571,8,1,7,0.125
22100123,1610612747,1610612760,104.0,107.0,0.415,0.425,0,2021-11-04,9,5,4,0.556,8,2,6,0.25
22100108,1610612739,1610612757,107.0,104.0,0.527,0.444,1,2021-11-03,9,5,4,0.556,8,3,5,0.375
22100109,1610612754,1610612752,111.0,98.0,0.462,0.414,1,2021-11-03,9,3,6,0.333,8,5,3,0.625
22100110,1610612753,1610612738,79.0,92.0,0.321,0.418,0,2021-11-03,9,2,7,0.222,8,3,5,0.375
22100111,1610612755,1610612741,103.0,98.0,0.494,0.463,1,2021-11-03,8,6,2,0.75,8,6,2,0.75
22100112,1610612764,1610612761,100.0,109.0,0.436,0.466,0,2021-11-03,8,5,3,0.625,9,6,3,0.667
22100113,1610612751,1610612737,117.0,108.0,0.489,0.436,1,2021-11-03,8,5,3,0.625,8,4,4,0.5
22100114,1610612763,1610612743,108.0,106.0,0.519,0.473,1,2021-11-03,8,5,3,0.625,8,4,4,0.5
22100115,1610612750,1610612746,115.0,126.0,0.457,0.603,0,2021-11-03,7,3,4,0.429,7,3,4,0.429
22100116,1610612759,1610612742,108.0,109.0,0.489,0.43,0,2021-11-03,8,2,6,0.25,8,5,3,0.625
22100117,1610612744,1610612766,114.0,92.0,0.488,0.374,1,2021-11-03,7,6,1,0.857,9,5,4,0.556
22100118,1610612758,1610612740,112.0,99.0,0.525,0.43,1,2021-11-03,8,4,4,0.5,9,1,8,0.111
22100103,1610612765,1610612749,89.0,117.0,0.323,0.5,0,2021-11-02,7,1,6,0.143,8,4,4,0.5
22100104,1610612742,1610612748,110.0,125.0,0.44,0.518,0,2021-11-02,7,4,3,0.571,7,6,1,0.857
22100105,1610612762,1610612758,119.0,113.0,0.439,0.452,1,2021-11-02,7,6,1,0.857,7,3,4,0.429
22100106,1610612756,1610612740,112.0,100.0,0.524,0.396,1,2021-11-02,6,3,3,0.5,8,1,7,0.125
22100107,1610612747,1610612745,119.0,117.0,0.527,0.527,1,2021-11-02,8,5,3,0.625,7,1,6,0.143
22100094,1610612766,1610612739,110.0,113.0,0.416,0.433,0,2021-11-01,8,5,3,0.625,8,4,4,0.5
22100095,1610612754,1610612759,131.0,118.0,0.571,0.528,1,2021-11-01,8,2,6,0.25,7,2,5,0.286
22100096,1610612755,1610612757,113.0,103.0,0.518,0.476,1,2021-11-01,7,5,2,0.714,7,3,4,0.429
22100097,1610612737,1610612764,118.0,111.0,0.458,0.477,1,2021-11-01,7,4,3,0.571,7,5,2,0.714
22100098,1610612738,1610612741,114.0,128.0,0.438,0.57,0,2021-11-01,7,2,5,0.286,7,6,1,0.857
22100099,1610612752,1610612761,104.0,113.0,0.461,0.434,0,2021-11-01,7,5,2,0.714,8,5,3,0.625
22100100,1610612763,1610612743,106.0,97.0,0.454,0.443,1,2021-11-01,7,4,3,0.571,7,4,3,0.571
22100101,1610612750,1610612753,97.0,115.0,0.371,0.451,0,2021-11-01,6,3,3,0.5,8,2,6,0.25
22100102,1610612746,1610612760,99.0,94.0,0.38,0.389,1,2021-11-01,6,2,4,0.333,7,1,6,0.143
22100089,1610612742,1610612758,105.0,99.0,0.444,0.396,1,2021-10-31,6,4,2,0.667,6,3,3,0.5
22100090,1610612766,1610612757,125.0,113.0,0.517,0.443,1,2021-10-31,7,5,2,0.714,6,3,3,0.5
22100091,1610612749,1610612762,95.0,107.0,0.406,0.467,0,2021-10-31,7,3,4,0.429,6,5,1,0.833
22100092,1610612751,1610612765,117.0,91.0,0.653,0.405,1,2021-10-31,7,4,3,0.571,6,1,5,0.167
22100093,1610612747,1610612745,95.0,85.0,0.406,0.421,1,2021-10-31,7,4,3,0.571,6,1,5,0.167
22100078,1610612764,1610612738,115.0,112.0,0.365,0.411,1,2021-10-30,6,5,1,0.833,6,2,4,0.333
22100079,1610612765,1610612753,110.0,103.0,0.404,0.437,1,2021-10-30,5,1,4,0.2,7,1,6,0.143
22100080,1610612740,1610612752,117.0,123.0,0.457,0.519,0,2021-10-30,7,1,6,0.143,6,5,1,0.833
22100081,1610612754,1610612761,94.0,97.0,0.432,0.424,0,2021-10-30,7,1,6,0.143,7,4,3,0.571
22100082,1610612755,1610612737,122.0,94.0,0.535,0.379,1,2021-10-30,6,4,2,0.667,6,3,3,0.5
22100083,1610612741,1610612762,107.0,99.0,0.429,0.38,1,2021-10-30,6,5,1,0.833,5,4,1,0.8
22100084,1610612763,1610612748,103.0,129.0,0.386,0.523,0,2021-10-30,6,3,3,0.5,6,5,1,0.833
22100085,1610612749,1610612759,93.0,102.0,0.404,0.411,0,2021-10-30,6,3,3,0.5,6,2,4,0.333
22100086,1610612744,1610612760,103.0,82.0,0.424,0.349,1,2021-10-30,6,5,1,0.833,6,1,5,0.167
22100087,1610612750,1610612743,91.0,93.0,0.393,0.409,0,2021-10-30,5,3,2,0.6,6,4,2,0.667
22100088,1610612756,1610612739,101.0,92.0,0.464,0.396,1,2021-10-30,5,2,3,0.4,7,3,4,0.429
22100071,1610612761,1610612753,110.0,109.0,0.5,0.471,1,2021-10-29,6,3,3,0.5,6,1,5,0.167
22100072,1610612751,1610612754,105.0,98.0,0.447,0.398,1,2021-10-29,6,3,3,0.5,6,1,5,0.167
22100073,1610612748,1610612766,114.0,99.0,0.473,0.389,1,2021-10-29,5,4,1,0.8,6,4,2,0.667
22100074,1610612740,1610612758,109.0,113.0,0.429,0.5,0,2021-10-29,6,1,5,0.167,5,3,2,0.6
22100075,1610612743,1610612742,106.0,75.0,0.518,0.295,1,2021-10-29,5,3,2,0.6,5,3,2,0.6
22100076,1610612757,1610612746,111.0,92.0,0.418,0.391,1,2021-10-29,5,3,2,0.6,5,1,4,0.2
22100077,1610612747,1610612739,113.0,101.0,0.548,0.425,1,2021-10-29,6,3,3,0.5,6,3,3,0.5
22100065,1610612755,1610612765,110.0,102.0,0.5,0.407,1,2021-10-28,5,3,2,0.6,4,0,4,0.0
22100066,1610612764,1610612737,122.0,111.0,0.465,0.545,1,2021-10-28,5,4,1,0.8,5,3,2,0.6
22100067,1610612741,1610612752,103.0,104.0,0.429,0.459,0,2021-10-28,5,4,1,0.8,5,4,1,0.8
22100068,1610612745,1610612762,91.0,122.0,0.326,0.482,0,2021-10-28,5,1,4,0.2,4,4,0,1.0
22100069,1610612742,1610612759,104.0,99.0,0.461,0.443,1,2021-10-28,4,3,1,0.75,5,1,4,0.2
22100070,1610612744,1610612763,101.0,104.0,0.433,0.402,0,2021-10-28,5,4,1,0.8,5,3,2,0.6
22100055,1610612753,1610612766,111.0,120.0,0.489,0.518,0,2021-10-27,5,1,4,0.2,5,4,1,0.8
22100056,1610612738,1610612764,107.0,116.0,0.435,0.512,0,2021-10-27,5,2,3,0.4,4,3,1,0.75
22100057,1610612751,1610612748,93.0,106.0,0.388,0.396,0,2021-10-27,5,2,3,0.4,4,3,1,0.75
22100058,1610612761,1610612754,118.0,100.0,0.46,0.481,1,2021-10-27,5,2,3,0.4,5,1,4,0.2
22100059,1610612740,1610612737,99.0,102.0,0.43,0.417,0,2021-10-27,5,1,4,0.2,4,3,1,0.75
22100060,1610612749,1610612750,108.0,113.0,0.411,0.473,0,2021-10-27,5,3,2,0.6,4,3,1,0.75
22100061,1610612760,1610612747,123.0,115.0,0.5,0.5,1,2021-10-27,5,1,4,0.2,5,2,3,0.4
22100062,1610612756,1610612758,107.0,110.0,0.452,0.442,0,2021-10-27,4,1,3,0.25,4,2,2,0.5
22100063,1610612757,1610612763,116.0,96.0,0.464,0.365,1,2021-10-27,4,2,2,0.5,4,2,2,0.5
22100064,1610612746,1610612739,79.0,92.0,0.356,0.407,0,2021-10-27,4,1,3,0.25,5,3,2,0.6
22100050,1610612752,1610612755,112.0,99.0,0.471,0.439,1,2021-10-26,4,3,1,0.75,4,2,2,0.5
22100051,1610612760,1610612744,98.0,106.0,0.419,0.47,0,2021-10-26,4,0,4,0.0,4,4,0,1.0
22100052,1610612742,1610612745,116.0,106.0,0.462,0.419,1,2021-10-26,3,2,1,0.667,4,1,3,0.25
22100053,1610612759,1610612747,121.0,125.0,0.444,0.476,0,2021-10-26,4,1,3,0.25,4,2,2,0.5
22100054,1610612762,1610612743,122.0,110.0,0.518,0.506,1,2021-10-26,3,3,0,1.0,4,2,2,0.5
22100041,1610612766,1610612738,129.0,140.0,0.447,0.495,0,2021-10-25,4,3,1,0.75,4,2,2,0.5
22100042,1610612754,1610612749,109.0,119.0,0.444,0.482,0,2021-10-25,4,1,3,0.25,4,3,1,0.75
22100043,1610612737,1610612765,122.0,104.0,0.511,0.44,1,2021-10-25,3,2,1,0.667,3,0,3,0.0
22100044,1610612751,1610612764,104.0,90.0,0.426,0.347,1,2021-10-25,4,2,2,0.5,3,2,1,0.667
22100045,1610612748,1610612753,107.0,90.0,0.471,0.407,1,2021-10-25,3,2,1,0.667,4,1,3,0.25
22100046,1610612761,1610612741,108.0,111.0,0.482,0.481,0,2021-10-25,4,1,3,0.25,4,4,0,1.0
22100047,1610612750,1610612740,98.0,107.0,0.344,0.448,0,2021-10-25,3,2,1,0.667,4,1,3,0.25
22100048,1610612743,1610612739,87.0,99.0,0.407,0.463,0,2021-10-25,3,2,1,0.667,4,2,2,0.5
22100049,1610612746,1610612757,116.0,86.0,0.473,0.376,1,2021-10-25,3,1,2,0.333,3,1,2,0.333
22100035,1610612751,1610612766,95.0,111.0,0.437,0.457,0,2021-10-24,3,1,2,0.333,3,3,0,1.0
22100036,1610612752,1610612753,104.0,110.0,0.37,0.409,0,2021-10-24,3,2,1,0.667,3,1,2,0.333
22100037,1610612745,1610612738,97.0,107.0,0.427,0.442,0,2021-10-24,3,1,2,0.333,3,1,2,0.333
22100038,1610612760,1610612755,103.0,115.0,0.476,0.466,0,2021-10-24,3,0,3,0.0,3,2,1,0.667
22100039,1610612758,1610612744,107.0,119.0,0.488,0.443,0,2021-10-24,3,1,2,0.333,3,3,0,1.0
22100040,1610612747,1610612763,121.0,118.0,0.536,0.45,1,2021-10-24,3,1,2,0.333,3,2,1,0.667
22100027,1610612739,1610612737,101.0,95.0,0.416,0.384,1,2021-10-23,3,1,2,0.333,2,1,1,0.5
22100028,1610612754,1610612748,102.0,91.0,0.392,0.385,1,2021-10-23,3,1,2,0.333,2,1,1,0.5
22100029,1610612761,1610612742,95.0,103.0,0.4,0.418,0,2021-10-23,3,1,2,0.333,2,1,1,0.5
22100030,1610612741,1610612765,97.0,82.0,0.417,0.386,1,2021-10-23,3,3,0,1.0,2,0,2,0.0
22100031,1610612750,1610612740,96.0,89.0,0.406,0.348,1,2021-10-23,2,2,0,1.0,3,0,3,0.0
22100032,1610612759,1610612749,111.0,121.0,0.485,0.53,0,2021-10-23,3,1,2,0.333,3,2,1,0.667
22100033,1610612757,1610612756,134.0,105.0,0.543,0.483,1,2021-10-23,2,1,1,0.5,3,1,2,0.333
22100034,1610612746,1610612763,114.0,120.0,0.434,0.467,0,2021-10-23,2,0,2,0.0,2,2,0,1.0
22100017,1610612739,1610612766,112.0,123.0,0.512,0.527,0,2021-10-22,2,0,2,0.0,2,2,0,1.0
22100018,1610612753,1610612752,96.0,121.0,0.398,0.5,0,2021-10-22,2,0,2,0.0,2,2,0,1.0
22100019,1610612764,1610612754,135.0,134.0,0.521,0.536,1,2021-10-22,2,2,0,1.0,2,0,2,0.0
22100020,1610612738,1610612761,83.0,115.0,0.39,0.42,0,2021-10-22,2,0,2,0.0,2,1,1,0.5
22100021,1610612755,1610612751,109.0,114.0,0.473,0.466,0,2021-10-22,2,1,1,0.5,2,1,1,0.5
22100022,1610612741,1610612740,128.0,112.0,0.528,0.483,1,2021-10-22,2,2,0,1.0,2,0,2,0.0
22100023,1610612745,1610612760,124.0,91.0,0.505,0.374,1,2021-10-22,2,1,1,0.5,2,0,2,0.0
22100024,1610612743,1610612759,102.0,96.0,0.512,0.476,1,2021-10-22,2,2,0,1.0,2,1,1,0.5
22100025,1610612747,1610612756,105.0,115.0,0.395,0.488,0,2021-10-22,2,0,2,0.0,2,1,1,0.5
22100026,1610612758,1610612762,101.0,110.0,0.394,0.411,0,2021-10-22,2,1,1,0.5,2,2,0,1.0
22100014,1610612737,1610612742,113.0,87.0,0.479,0.333,1,2021-10-21,1,1,0,1.0,1,0,1,0.0
22100015,1610612748,1610612749,137.0,95.0,0.531,0.381,1,2021-10-21,1,1,0,1.0,2,1,1,0.5
22100016,1610612744,1610612746,115.0,113.0,0.518,0.438,1,2021-10-21,2,2,0,1.0,1,0,1,0.0
22100003,1610612766,1610612754,123.0,122.0,0.43,0.467,1,2021-10-20,1,1,0,1.0,1,0,1,0.0
22100004,1610612765,1610612741,88.0,94.0,0.4,0.43,0,2021-10-20,1,0,1,0.0,1,1,0,1.0
22100005,1610612752,1610612738,138.0,134.0,0.486,0.41,1,2021-10-20,1,1,0,1.0,1,0,1,0.0
22100006,1610612761,1610612764,83.0,98.0,0.309,0.444,0,2021-10-20,1,0,1,0.0,1,1,0,1.0
22100007,1610612763,1610612739,132.0,121.0,0.53,0.505,1,2021-10-20,1,1,0,1.0,1,0,1,0.0
22100008,1610612750,1610612745,124.0,106.0,0.483,0.455,1,2021-10-20,1,1,0,1.0,1,0,1,0.0
22100009,1610612740,1610612755,97.0,117.0,0.419,0.518,0,2021-10-20,1,0,1,0.0,1,1,0,1.0
22100010,1610612759,1610612753,123.0,97.0,0.5,0.407,1,2021-10-20,1,1,0,1.0,1,0,1,0.0
22100011,1610612762,1610612760,107.0,86.0,0.44,0.374,1,2021-10-20,1,1,0,1.0,1,0,1,0.0
22100012,1610612756,1610612743,98.0,110.0,0.414,0.53,0,2021-10-20,1,0,1,0.0,1,1,0,1.0
22100013,1610612757,1610612758,121.0,124.0,0.484,0.457,0,2021-10-20,1,0,1,0.0,1,1,0,1.0
22100001,1610612749,1610612751,127.0,104.0,0.457,0.44,1,2021-10-19,1,1,0,1.0,1,0,1,0.0
22100002,1610612747,1610612744,114.0,121.0,0.474,0.441,0,2021-10-19,1,0,1,0.0,1,1,0,1.0
12100059,1610612748,1610612738,121.0,100.0,0.461,0.444,1,2021-10-15,6,5,1,0.833,4,2,2,0.5
12100060,1610612765,1610612755,112.0,108.0,0.487,0.453,1,2021-10-15,4,2,2,0.5,4,2,2,0.5
12100061,1610612754,1610612739,94.0,110.0,0.41,0.525,0,2021-10-15,4,2,2,0.5,5,2,3,0.4
12100062,1610612752,1610612764,115.0,113.0,0.412,0.494,1,2021-10-15,4,4,0,1.0,4,0,4,0.0
12100063,1610612741,1610612763,118.0,105.0,0.462,0.46,1,2021-10-15,4,4,0,1.0,6,3,3,0.5
12100064,1610612749,1610612742,103.0,114.0,0.448,0.449,0,2021-10-15,5,1,4,0.2,4,4,0,1.0
12100065,1610612759,1610612745,126.0,98.0,0.469,0.34,1,2021-10-15,5,3,2,0.6,4,1,3,0.25
12100066,1610612744,1610612757,119.0,97.0,0.446,0.402,1,2021-10-15,5,5,0,1.0,4,0,4,0.0
12100055,1610612737,1610612748,127.0,92.0,0.485,0.385,1,2021-10-14,4,2,2,0.5,5,4,1,0.8
12100056,1610612751,1610612750,107.0,101.0,0.463,0.413,1,2021-10-14,4,3,1,0.75,4,3,1,0.75
12100057,1610612760,1610612743,107.0,113.0,0.427,0.437,0,2021-10-14,4,1,3,0.25,5,1,4,0.2
12100058,1610612758,1610612747,116.0,112.0,0.398,0.468,1,2021-10-14,4,4,0,1.0,6,0,6,0.0
12100054,1610612756,1610612757,119.0,74.0,0.495,0.298,1,2021-10-13,4,3,1,0.75,3,0,3,0.0
12100048,1610612766,1610612742,59.0,127.0,0.274,0.511,0,2021-10-13,4,1,3,0.25,3,3,0,1.0
12100049,1610612754,1610612763,109.0,107.0,0.442,0.433,1,2021-10-13,3,2,1,0.667,5,3,2,0.6
12100050,1610612753,1610612738,103.0,102.0,0.464,0.429,1,2021-10-13,4,1,3,0.25,3,2,1,0.667
12100051,1610612752,1610612765,108.0,100.0,0.451,0.404,1,2021-10-13,3,3,0,1.0,3,1,2,0.333
12100052,1610612760,1610612743,108.0,99.0,0.488,0.4,1,2021-10-13,3,1,2,0.333,4,0,4,0.0
12100053,1610612762,1610612749,124.0,120.0,0.489,0.466,1,2021-10-13,4,2,2,0.5,4,1,3,0.25
12100046,1610612764,1610612761,108.0,113.0,0.432,0.411,0,2021-10-12,3,0,3,0.0,5,3,2,0.6
12100047,1610612747,1610612744,99.0,111.0,0.414,0.424,0,2021-10-12,5,0,5,0.0,4,4,0,1.0
12100039,1610612761,1610612745,107.0,92.0,0.456,0.436,1,2021-10-11,4,2,2,0.5,3,1,2,0.333
12100040,1610612748,1610612766,104.0,103.0,0.419,0.465,1,2021-10-11,4,4,0,1.0,3,1,2,0.333
12100041,1610612755,1610612751,115.0,104.0,0.494,0.506,1,2021-10-11,3,2,1,0.667,3,2,1,0.667
12100042,1610612763,1610612765,127.0,92.0,0.464,0.42,1,2021-10-11,4,3,1,0.75,2,1,1,0.5
12100043,1610612762,1610612740,127.0,96.0,0.511,0.437,1,2021-10-11,3,1,2,0.333,4,1,3,0.25
12100044,1610612757,1610612758,93.0,107.0,0.479,0.438,0,2021-10-11,2,0,2,0.0,3,3,0,1.0
12100045,1610612746,1610612750,100.0,128.0,0.418,0.516,0,2021-10-11,4,1,3,0.25,3,3,0,1.0
12100035,1610612753,1610612759,100.0,101.0,0.463,0.452,0,2021-10-10,3,0,3,0.0,4,2,2,0.5
12100036,1610612739,1610612741,101.0,102.0,0.477,0.418,0,2021-10-10,4,1,3,0.25,3,3,0,1.0
12100037,1610612749,1610612760,130.0,110.0,0.543,0.418,1,2021-10-10,3,1,2,0.333,2,0,2,0.0
12100038,1610612747,1610612756,94.0,123.0,0.376,0.522,0,2021-10-10,4,0,4,0.0,3,2,1,0.667
12100032,1610612738,1610612761,113.0,111.0,0.469,0.406,1,2021-10-09,2,2,0,1.0,3,1,2,0.333
12100033,1610612764,1610612752,99.0,117.0,0.382,0.452,0,2021-10-09,2,0,2,0.0,2,2,0,1.0
12100034,1610612763,1610612737,87.0,91.0,0.356,0.388,0,2021-10-09,3,2,1,0.667,3,1,2,0.333
12100025,1610612739,1610612754,100.0,109.0,0.424,0.506,0,2021-10-08,3,1,2,0.333,2,1,1,0.5
12100026,1610612751,1610612749,119.0,115.0,0.506,0.494,1,2021-10-08,2,2,0,1.0,2,0,2,0.0
12100027,1610612741,1610612740,121.0,85.0,0.49,0.333,1,2021-10-08,2,2,0,1.0,3,1,2,0.333
12100028,1610612742,1610612746,122.0,114.0,0.469,0.435,1,2021-10-08,2,2,0,1.0,3,1,2,0.333
12100029,1610612759,1610612748,105.0,109.0,0.455,0.457,0,2021-10-08,3,1,2,0.333,3,3,0,1.0
12100030,1610612743,1610612750,112.0,114.0,0.413,0.434,0,2021-10-08,3,0,3,0.0,2,2,0,1.0
12100031,1610612744,1610612747,121.0,114.0,0.454,0.429,1,2021-10-08,3,3,0,1.0,3,0,3,0.0
12100022,1610612766,1610612763,98.0,128.0,0.364,0.5,0,2021-10-07,2,1,1,0.5,2,2,0,1.0
12100023,1610612755,1610612761,125.0,113.0,0.54,0.483,1,2021-10-07,2,1,1,0.5,2,1,1,0.5
12100024,1610612745,1610612748,106.0,113.0,0.409,0.482,0,2021-10-07,2,1,1,0.5,2,2,0,1.0
12100020,1610612756,1610612747,117.0,105.0,0.444,0.464,1,2021-10-06,2,1,1,0.5,2,0,2,0.0
12100015,1610612765,1610612759,115.0,105.0,0.511,0.419,1,2021-10-06,1,1,0,1.0,2,1,1,0.5
12100016,1610612737,1610612739,96.0,99.0,0.396,0.442,0,2021-10-06,2,0,2,0.0,2,1,1,0.5
12100017,1610612740,1610612753,104.0,86.0,0.385,0.36,1,2021-10-06,2,1,1,0.5,2,0,2,0.0
12100018,1610612742,1610612762,111.0,101.0,0.473,0.415,1,2021-10-06,1,1,0,1.0,2,0,2,0.0
12100019,1610612744,1610612743,118.0,116.0,0.476,0.484,1,2021-10-06,2,2,0,1.0,2,0,2,0.0
12100021,1610612746,1610612758,98.0,113.0,0.38,0.449,0,2021-10-06,2,1,1,0.5,2,2,0,1.0
12100011,1610612752,1610612754,125.0,104.0,0.465,0.413,1,2021-10-05,1,1,0,1.0,1,0,1,0.0
12100012,1610612741,1610612739,131.0,95.0,0.468,0.357,1,2021-10-05,1,1,0,1.0,1,0,1,0.0
12100013,1610612745,1610612764,125.0,119.0,0.512,0.438,1,2021-10-05,1,1,0,1.0,1,0,1,0.0
12100014,1610612763,1610612749,87.0,77.0,0.467,0.419,1,2021-10-05,1,1,0,1.0,1,0,1,0.0
12100002,1610612761,1610612755,123.0,107.0,0.5,0.417,1,2021-10-04,1,1,0,1.0,1,0,1,0.0
12100003,1610612738,1610612753,98.0,97.0,0.352,0.404,1,2021-10-04,1,1,0,1.0,1,0,1,0.0
12100004,1610612748,1610612737,125.0,99.0,0.524,0.4,1,2021-10-04,1,1,0,1.0,1,0,1,0.0
12100005,1610612750,1610612740,117.0,114.0,0.457,0.414,1,2021-10-04,1,1,0,1.0,1,0,1,0.0
12100006,1610612760,1610612766,97.0,113.0,0.384,0.494,0,2021-10-04,1,0,1,0.0,1,1,0,1.0
12100007,1610612759,1610612762,111.0,85.0,0.465,0.317,1,2021-10-04,1,1,0,1.0,1,0,1,0.0
12100008,1610612757,1610612744,107.0,121.0,0.446,0.42,0,2021-10-04,1,0,1,0.0,1,1,0,1.0
12100009,1610612758,1610612756,117.0,106.0,0.473,0.467,1,2021-10-04,1,1,0,1.0,1,0,1,0.0
12100010,1610612746,1610612743,103.0,102.0,0.432,0.43,1,2021-10-04,1,1,0,1.0,1,0,1,0.0
12100001,1610612747,1610612751,97.0,123.0,0.364,0.483,0,2021-10-03,1,0,1,0.0,1,1,0,1.0
42000406,1610612749,1610612756,105.0,98.0,0.451,0.442,1,2021-07-20,72,46,26,0.639,72,51,21,0.708
42000405,1610612756,1610612749,119.0,123.0,0.552,0.575,0,2021-07-17,72,51,21,0.708,72,46,26,0.639
42000404,1610612749,1610612756,109.0,103.0,0.402,0.513,1,2021-07-14,72,46,26,0.639,72,51,21,0.708
42000403,1610612749,1610612756,120.0,100.0,0.478,0.482,1,2021-07-11,72,46,26,0.639,72,51,21,0.708
42000402,1610612756,1610612749,118.0,108.0,0.489,0.452,1,2021-07-08,72,51,21,0.708,72,46,26,0.639
42000401,1610612756,1610612749,118.0,105.0,0.466,0.455,1,2021-07-06,72,51,21,0.708,72,46,26,0.639
42000306,1610612737,1610612749,107.0,118.0,0.413,0.461,0,2021-07-03,72,41,31,0.569,72,46,26,0.639
42000305,1610612749,1610612737,123.0,112.0,0.505,0.456,1,2021-07-01,72,46,26,0.639,72,41,31,0.569
42000316,1610612746,1610612756,103.0,130.0,0.418,0.564,0,2021-06-30,72,47,25,0.653,72,51,21,0.708
42000304,1610612737,1610612749,110.0,88.0,0.506,0.393,1,2021-06-29,72,41,31,0.569,72,46,26,0.639
42000315,1610612756,1610612746,102.0,116.0,0.452,0.548,0,2021-06-28,72,51,21,0.708,72,47,25,0.653
42000303,1610612737,1610612749,102.0,113.0,0.464,0.511,0,2021-06-27,72,41,31,0.569,72,46,26,0.639
42000314,1610612746,1610612756,80.0,84.0,0.325,0.36,0,2021-06-26,72,47,25,0.653,72,51,21,0.708
42000302,1610612749,1610612737,125.0,91.0,0.521,0.415,1,2021-06-25,72,46,26,0.639,72,41,31,0.569
42000313,1610612746,1610612756,106.0,92.0,0.451,0.389,1,2021-06-24,72,47,25,0.653,72,51,21,0.708
42000301,1610612749,1610612737,113.0,116.0,0.461,0.495,0,2021-06-23,72,46,26,0.639,72,41,31,0.569
42000312,1610612756,1610612746,104.0,103.0,0.5,0.45,1,2021-06-22,72,51,21,0.708,72,47,25,0.653
42000311,1610612756,1610612746,120.0,114.0,0.551,0.455,1,2021-06-20,72,51,21,0.708,72,47,25,0.653
42000207,1610612755,1610612737,96.0,103.0,0.425,0.444,0,2021-06-20,72,49,23,0.681,72,41,31,0.569
42000217,1610612751,1610612749,111.0,115.0,0.464,0.439,0,2021-06-19,72,48,24,0.667,72,46,26,0.639
42000206,1610612737,1610612755,99.0,104.0,0.413,0.409,0,2021-06-18,72,41,31,0.569,72,49,23,0.681
42000226,1610612746,1610612762,131.0,119.0,0.565,0.488,1,2021-06-18,72,47,25,0.653,72,52,20,0.722
42000216,1610612749,1610612751,104.0,89.0,0.451,0.444,1,2021-06-17,72,46,26,0.639,72,48,24,0.667
42000205,1610612755,1610612737,106.0,109.0,0.467,0.459,0,2021-06-16,72,49,23,0.681,72,41,31,0.569
42000225,1610612762,1610612746,111.0,119.0,0.45,0.513,0,2021-06-16,72,52,20,0.722,72,47,25,0.653
42000215,1610612751,1610612749,114.0,108.0,0.494,0.494,1,2021-06-15,72,48,24,0.667,72,46,26,0.639
42000204,1610612737,1610612755,103.0,100.0,0.366,0.435,1,2021-06-14,72,41,31,0.569,72,49,23,0.681
42000224,1610612746,1610612762,118.0,104.0,0.468,0.429,1,2021-06-14,72,47,25,0.653,72,52,20,0.722
42000214,1610612749,1610612751,107.0,96.0,0.443,0.434,1,2021-06-13,72,46,26,0.639,72,48,24,0.667
42000234,1610612743,1610612756,118.0,125.0,0.459,0.518,0,2021-06-13,72,47,25,0.653,72,51,21,0.708
42000223,1610612746,1610612762,132.0,106.0,0.562,0.429,1,2021-06-12,72,47,25,0.653,72,52,20,0.722
42000203,1610612737,1610612755,111.0,127.0,0.476,0.582,0,2021-06-11,72,41,31,0.569,72,49,23,0.681
42000233,1610612743,1610612756,102.0,116.0,0.411,0.531,0,2021-06-11,72,47,25,0.653,72,51,21,0.708
42000213,1610612749,1610612751,86.0,83.0,0.378,0.362,1,2021-06-10,72,46,26,0.639,72,48,24,0.667
42000222,1610612762,1610612746,117.0,111.0,0.553,0.471,1,2021-06-10,72,52,20,0.722,72,47,25,0.653
42000232,1610612756,1610612743,123.0,98.0,0.479,0.4,1,2021-06-09,72,51,21,0.708,72,47,25,0.653
42000202,1610612755,1610612737,118.0,102.0,0.529,0.458,1,2021-06-08,72,49,23,0.681,72,41,31,0.569
42000221,1610612762,1610612746,112.0,109.0,0.407,0.424,1,2021-06-08,72,52,20,0.722,72,47,25,0.653
42000212,1610612751,1610612749,125.0,86.0,0.521,0.44,1,2021-06-07,72,48,24,0.667,72,46,26,0.639
42000231,1610612756,1610612743,122.0,105.0,0.541,0.467,1,2021-06-07,72,51,21,0.708,72,47,25,0.653
42000201,1610612755,1610612737,124.0,128.0,0.549,0.512,0,2021-06-06,72,49,23,0.681,72,41,31,0.569
42000177,1610612746,1610612742,126.0,111.0,0.5,0.495,1,2021-06-06,72,47,25,0.653,72,42,30,0.583
42000211,1610612751,1610612749,115.0,107.0,0.469,0.446,1,2021-06-05,72,48,24,0.667,72,46,26,0.639
42000176,1610612742,1610612746,97.0,104.0,0.416,0.468,0,2021-06-04,72,42,30,0.583,72,47,25,0.653
42000166,1610612757,1610612743,115.0,126.0,0.506,0.512,0,2021-06-03,72,42,30,0.583,72,47,25,0.653
42000156,1610612747,1610612756,100.0,113.0,0.418,0.507,0,2021-06-03,72,42,30,0.583,72,51,21,0.708
42000105,1610612755,1610612764,129.0,112.0,0.512,0.494,1,2021-06-02,72,49,23,0.681,72,34,38,0.472
42000135,1610612752,1610612737,89.0,103.0,0.378,0.425,0,2021-06-02,72,41,31,0.569,72,41,31,0.569
42000145,1610612762,1610612763,126.0,110.0,0.516,0.463,1,2021-06-02,72,52,20,0.722,72,38,34,0.528
42000175,1610612746,1610612742,100.0,105.0,0.413,0.416,0,2021-06-02,72,47,25,0.653,72,42,30,0.583
42000115,1610612751,1610612738,123.0,109.0,0.512,0.435,1,2021-06-01,72,48,24,0.667,72,36,36,0.5
42000165,1610612743,1610612757,147.0,140.0,0.481,0.456,1,2021-06-01,72,47,25,0.653,72,42,30,0.583
42000155,1610612756,1610612747,115.0,85.0,0.457,0.345,1,2021-06-01,72,51,21,0.708,72,42,30,0.583
42000104,1610612764,1610612755,122.0,114.0,0.455,0.417,1,2021-05-31,72,34,38,0.472,72,49,23,0.681
42000144,1610612763,1610612762,113.0,120.0,0.467,0.459,0,2021-05-31,72,38,34,0.528,72,52,20,0.722
42000134,1610612737,1610612752,113.0,96.0,0.439,0.42,1,2021-05-30,72,41,31,0.569,72,41,31,0.569
42000154,1610612747,1610612756,92.0,100.0,0.395,0.435,0,2021-05-30,72,42,30,0.583,72,51,21,0.708
42000114,1610612738,1610612751,126.0,141.0,0.44,0.578,0,2021-05-30,72,36,36,0.5,72,48,24,0.667
42000174,1610612742,1610612746,81.0,106.0,0.348,0.481,0,2021-05-30,72,42,30,0.583,72,47,25,0.653
42000124,1610612748,1610612749,103.0,120.0,0.44,0.465,0,2021-05-29,72,40,32,0.556,72,46,26,0.639
42000164,1610612757,1610612743,115.0,95.0,0.5,0.34,1,2021-05-29,72,42,30,0.583,72,47,25,0.653
42000103,1610612764,1610612755,103.0,132.0,0.396,0.586,0,2021-05-29,72,34,38,0.472,72,49,23,0.681
42000143,1610612763,1610612762,111.0,121.0,0.43,0.494,0,2021-05-29,72,38,34,0.528,72,52,20,0.722
42000133,1610612737,1610612752,105.0,94.0,0.519,0.358,1,2021-05-28,72,41,31,0.569,72,41,31,0.569
42000113,1610612738,1610612751,125.0,119.0,0.506,0.452,1,2021-05-28,72,36,36,0.5,72,48,24,0.667
42000173,1610612742,1610612746,108.0,118.0,0.442,0.579,0,2021-05-28,72,42,30,0.583,72,47,25,0.653
42000123,1610612748,1610612749,84.0,113.0,0.376,0.483,0,2021-05-27,72,40,32,0.556,72,46,26,0.639
42000153,1610612747,1610612756,109.0,95.0,0.442,0.427,1,2021-05-27,72,42,30,0.583,72,51,21,0.708
42000163,1610612757,1610612743,115.0,120.0,0.45,0.464,0,2021-05-27,72,42,30,0.583,72,47,25,0.653
42000102,1610612755,1610612764,120.0,95.0,0.557,0.402,1,2021-05-26,72,49,23,0.6809999999999999,72,34,38,0.472
42000132,1610612752,1610612737,101.0,92.0,0.3829999999999999,0.369,1,2021-05-26,72,41,31,0.569,72,41,31,0.569
42000142,1610612762,1610612763,141.0,129.0,0.544,0.541,1,2021-05-26,72,52,20,0.722,72,38,34,0.528
42000112,1610612751,1610612738,130.0,108.0,0.523,0.424,1,2021-05-25,72,48,24,0.667,72,36,36,0.5
42000152,1610612756,1610612747,102.0,109.0,0.465,0.45,0,2021-05-25,72,51,21,0.708,72,42,30,0.583
42000172,1610612746,1610612742,121.0,127.0,0.536,0.585,0,2021-05-25,72,47,25,0.653,72,42,30,0.583
42000122,1610612749,1610612748,132.0,98.0,0.489,0.402,1,2021-05-24,72,46,26,0.639,72,40,32,0.556
42000162,1610612743,1610612757,128.0,109.0,0.535,0.479,1,2021-05-24,72,47,25,0.653,72,42,30,0.583
42000101,1610612755,1610612764,125.0,118.0,0.495,0.557,1,2021-05-23,72,49,23,0.6809999999999999,72,34,38,0.472
42000151,1610612756,1610612747,99.0,90.0,0.465,0.434,1,2021-05-23,72,51,21,0.708,72,42,30,0.583
42000131,1610612752,1610612737,105.0,107.0,0.447,0.467,0,2021-05-23,72,41,31,0.569,72,41,31,0.569
42000141,1610612762,1610612763,109.0,112.0,0.42,0.45,0,2021-05-23,72,52,20,0.722,72,38,34,0.528
42000121,1610612749,1610612748,109.0,107.0,0.4379999999999999,0.364,1,2021-05-22,72,46,26,0.639,72,40,32,0.556
42000171,1610612746,1610612742,103.0,113.0,0.44,0.5,0,2021-05-22,72,47,25,0.653,72,42,30,0.583
42000111,1610612751,1610612738,104.0,93.0,0.417,0.369,1,2021-05-22,72,48,24,0.667,72,36,36,0.5
42000161,1610612743,1610612757,109.0,123.0,0.505,0.473,0,2021-05-22,72,47,25,0.653,72,42,30,0.583
52000211,1610612744,1610612763,112.0,117.0,0.447,0.408,0,2021-05-21,72,39,33,0.542,72,38,34,0.528
52000201,1610612764,1610612754,142.0,115.0,0.581,0.41,1,2021-05-20,72,34,38,0.472,72,34,38,0.472
52000131,1610612763,1610612759,100.0,96.0,0.444,0.351,1,2021-05-19,72,38,34,0.528,72,33,39,0.4579999999999999
52000121,1610612747,1610612744,103.0,100.0,0.407,0.446,1,2021-05-19,72,42,30,0.583,72,39,33,0.542
52000111,1610612754,1610612766,144.0,117.0,0.552,0.457,1,2021-05-18,72,34,38,0.472,72,33,39,0.4579999999999999
52000101,1610612738,1610612764,118.0,100.0,0.396,0.435,1,2021-05-18,72,36,36,0.5,72,34,38,0.472
22001073,1610612752,1610612738,96.0,92.0,0.43,0.407,1,2021-05-16,72,41,31,0.569,72,36,36,0.5
22001079,1610612761,1610612754,113.0,125.0,0.402,0.505,0,2021-05-16,72,27,45,0.375,72,34,38,0.472
22001080,1610612764,1610612766,115.0,110.0,0.484,0.3939999999999999,1,2021-05-16,72,34,38,0.472,72,33,39,0.4579999999999999
22001078,1610612759,1610612756,121.0,123.0,0.51,0.51,0,2021-05-16,72,33,39,0.4579999999999999,72,51,21,0.708
22001070,1610612744,1610612763,113.0,101.0,0.494,0.435,1,2021-05-16,72,39,33,0.542,72,38,34,0.528
22001066,1610612737,1610612745,124.0,95.0,0.544,0.337,1,2021-05-16,72,41,31,0.569,72,17,55,0.236
22001067,1610612751,1610612739,123.0,109.0,0.5660000000000001,0.447,1,2021-05-16,72,48,24,0.667,72,22,50,0.306
22001075,1610612755,1610612753,128.0,117.0,0.489,0.474,1,2021-05-16,72,49,23,0.6809999999999999,72,21,51,0.292
22001069,1610612765,1610612748,107.0,120.0,0.465,0.56,0,2021-05-16,72,20,52,0.278,72,40,32,0.556
22001068,1610612741,1610612749,118.0,112.0,0.517,0.422,1,2021-05-16,72,31,41,0.431,72,46,26,0.639
22001071,1610612750,1610612742,136.0,121.0,0.544,0.484,1,2021-05-16,72,23,49,0.319,72,42,30,0.583
22001072,1610612740,1610612747,98.0,110.0,0.474,0.469,0,2021-05-16,72,31,41,0.431,72,42,30,0.583
22001074,1610612760,1610612746,117.0,112.0,0.532,0.425,1,2021-05-16,72,22,50,0.306,72,47,25,0.653
22001076,1610612757,1610612743,132.0,116.0,0.529,0.449,1,2021-05-16,72,42,30,0.583,72,47,25,0.653
22001077,1610612758,1610612762,99.0,121.0,0.467,0.477,0,2021-05-16,72,31,41,0.431,72,52,20,0.722
22001060,1610612751,1610612741,105.0,91.0,0.471,0.347,1,2021-05-15,71,47,24,0.662,71,30,41,0.423
22001061,1610612754,1610612747,115.0,122.0,0.517,0.477,0,2021-05-15,71,33,38,0.465,71,41,30,0.5770000000000001
22001064,1610612752,1610612766,118.0,109.0,0.511,0.382,1,2021-05-15,71,40,31,0.563,71,33,38,0.465
22001063,1610612750,1610612738,108.0,124.0,0.411,0.484,0,2021-05-15,71,22,49,0.31,71,36,35,0.507
22001065,1610612759,1610612756,103.0,140.0,0.4429999999999999,0.5529999999999999,0,2021-05-15,71,33,38,0.465,71,50,21,0.7040000000000001
22001062,1610612749,1610612748,122.0,108.0,0.535,0.417,1,2021-05-15,71,46,25,0.648,71,39,32,0.5489999999999999
22000204,1610612764,1610612739,120.0,105.0,0.461,0.4639999999999999,1,2021-05-14,71,33,38,0.465,71,22,49,0.31
22001054,1610612765,1610612743,91.0,104.0,0.41,0.488,0,2021-05-14,71,20,51,0.282,71,47,24,0.662
22001055,1610612755,1610612753,122.0,97.0,0.473,0.3979999999999999,1,2021-05-14,71,48,23,0.6759999999999999,71,21,50,0.296
22001056,1610612760,1610612762,93.0,109.0,0.429,0.43,0,2021-05-14,71,21,50,0.296,71,51,20,0.718
22000263,1610612763,1610612758,107.0,106.0,0.44,0.385,1,2021-05-14,71,38,33,0.535,71,31,40,0.437
22001057,1610612742,1610612761,114.0,110.0,0.433,0.494,1,2021-05-14,71,42,29,0.5920000000000001,71,27,44,0.38
22001058,1610612745,1610612746,122.0,115.0,0.535,0.484,1,2021-05-14,71,17,54,0.239,71,47,24,0.662
22001059,1610612744,1610612740,125.0,122.0,0.483,0.465,1,2021-05-14,71,38,33,0.535,71,31,40,0.437
22001047,1610612766,1610612746,90.0,113.0,0.3929999999999999,0.5329999999999999,0,2021-05-13,70,33,37,0.471,70,47,23,0.6709999999999999
22001048,1610612754,1610612749,133.0,142.0,0.455,0.574,0,2021-05-13,70,33,37,0.471,70,45,25,0.643
22000458,1610612752,1610612759,102.0,98.0,0.407,0.418,1,2021-05-13,70,39,31,0.557,70,33,37,0.471
22001049,1610612737,1610612753,116.0,93.0,0.436,0.3829999999999999,1,2021-05-13,71,40,31,0.563,70,21,49,0.3
22001050,1610612748,1610612755,106.0,94.0,0.506,0.462,1,2021-05-13,70,39,31,0.557,70,47,23,0.6709999999999999
22000255,1610612763,1610612758,116.0,110.0,0.5,0.4379999999999999,1,2021-05-13,70,37,33,0.529,70,31,39,0.4429999999999999
22001051,1610612741,1610612761,114.0,102.0,0.542,0.444,1,2021-05-13,70,30,40,0.429,70,27,43,0.386
22001052,1610612750,1610612743,103.0,114.0,0.425,0.479,0,2021-05-13,70,22,48,0.314,70,46,24,0.657
22001053,1610612756,1610612757,118.0,117.0,0.466,0.5429999999999999,1,2021-05-13,70,49,21,0.7,71,41,30,0.5770000000000001
22001042,1610612737,1610612764,120.0,116.0,0.512,0.446,1,2021-05-12,70,39,31,0.557,70,32,38,0.457
22001043,1610612751,1610612759,128.0,116.0,0.608,0.426,1,2021-05-12,70,46,24,0.657,69,33,36,0.478
22001044,1610612739,1610612738,102.0,94.0,0.45,0.356,1,2021-05-12,70,22,48,0.314,70,35,35,0.5
22000154,1610612742,1610612740,125.0,107.0,0.49,0.414,1,2021-05-12,70,41,29,0.586,70,31,39,0.4429999999999999
22001045,1610612762,1610612757,98.0,105.0,0.412,0.44,0,2021-05-12,70,50,20,0.7140000000000001,70,41,29,0.586
22001046,1610612747,1610612745,124.0,122.0,0.5710000000000001,0.506,1,2021-05-12,70,40,30,0.5710000000000001,70,16,54,0.2289999999999999
22000448,1610612766,1610612743,112.0,117.0,0.462,0.494,0,2021-05-11,69,33,36,0.478,69,45,24,0.652
22001033,1610612765,1610612750,100.0,119.0,0.467,0.4589999999999999,0,2021-05-11,70,20,50,0.286,69,22,47,0.319
22001032,1610612738,1610612748,121.0,129.0,0.523,0.593,0,2021-05-11,69,35,34,0.507,69,38,31,0.551
22001034,1610612761,1610612746,96.0,115.0,0.407,0.5,0,2021-05-11,69,27,42,0.391,69,46,23,0.667
22001035,1610612754,1610612755,103.0,94.0,0.446,0.437,1,2021-05-11,69,33,36,0.478,69,47,22,0.6809999999999999
22001036,1610612741,1610612751,107.0,115.0,0.406,0.472,0,2021-05-11,69,29,40,0.42,69,45,24,0.652
22001037,1610612763,1610612742,133.0,104.0,0.573,0.42,1,2021-05-11,69,36,33,0.522,69,40,29,0.58
22001038,1610612749,1610612753,114.0,102.0,0.426,0.415,1,2021-05-11,69,44,25,0.638,69,21,48,0.304
22001039,1610612744,1610612756,122.0,116.0,0.495,0.519,1,2021-05-11,70,37,33,0.529,69,48,21,0.696
22001040,1610612758,1610612760,122.0,106.0,0.512,0.4639999999999999,1,2021-05-11,69,31,38,0.449,70,21,49,0.3
22001041,1610612747,1610612752,101.0,99.0,0.416,0.391,1,2021-05-11,69,39,30,0.565,69,38,31,0.551
22001026,1610612737,1610612764,125.0,124.0,0.479,0.51,1,2021-05-10,69,38,31,0.551,69,32,37,0.4639999999999999
22001027,1610612739,1610612754,102.0,111.0,0.355,0.5,0,2021-05-10,69,21,48,0.304,68,32,36,0.471
22001028,1610612763,1610612740,115.0,110.0,0.495,0.4429999999999999,1,2021-05-10,68,35,33,0.515,69,31,38,0.449
22001029,1610612759,1610612749,146.0,125.0,0.596,0.5,1,2021-05-10,68,33,35,0.485,68,43,25,0.632
22001030,1610612744,1610612762,119.0,116.0,0.466,0.451,1,2021-05-10,69,36,33,0.522,69,50,19,0.725
22001031,1610612757,1610612745,140.0,129.0,0.511,0.494,1,2021-05-10,69,40,29,0.58,69,16,53,0.2319999999999999
22000145,1610612738,1610612748,124.0,130.0,0.542,0.573,0,2021-05-09,68,35,33,0.515,68,37,31,0.544
22001019,1610612746,1610612752,100.0,106.0,0.43,0.467,0,2021-05-09,68,45,23,0.662,68,38,30,0.5589999999999999
22001020,1610612766,1610612740,110.0,112.0,0.442,0.469,0,2021-05-09,68,33,35,0.485,68,31,37,0.456
22001021,1610612739,1610612742,97.0,124.0,0.384,0.5379999999999999,0,2021-05-09,68,21,47,0.309,68,40,28,0.588
22001022,1610612753,1610612750,96.0,128.0,0.396,0.485,0,2021-05-09,68,21,47,0.309,68,21,47,0.309
22001023,1610612765,1610612741,96.0,108.0,0.456,0.512,0,2021-05-09,69,20,49,0.29,68,29,39,0.426
22001024,1610612747,1610612756,123.0,110.0,0.488,0.534,1,2021-05-09,68,38,30,0.5589999999999999,68,48,20,0.706
22001025,1610612758,1610612760,126.0,98.0,0.529,0.391,1,2021-05-09,68,30,38,0.441,69,21,48,0.304
22001012,1610612754,1610612764,132.0,133.0,0.481,0.445,0,2021-05-08,67,31,36,0.4629999999999999,68,32,36,0.471
22001013,1610612755,1610612765,118.0,104.0,0.488,0.488,1,2021-05-08,68,47,21,0.691,68,20,48,0.294
22001014,1610612761,1610612763,99.0,109.0,0.3829999999999999,0.447,0,2021-05-08,68,27,41,0.397,67,34,33,0.507
22001015,1610612743,1610612751,119.0,125.0,0.457,0.621,0,2021-05-08,68,44,24,0.647,68,44,24,0.647
22001016,1610612762,1610612745,124.0,116.0,0.529,0.439,1,2021-05-08,68,50,18,0.735,68,16,52,0.235
22001017,1610612744,1610612760,136.0,97.0,0.58,0.4039999999999999,1,2021-05-08,68,35,33,0.515,68,21,47,0.309
22001018,1610612757,1610612759,124.0,102.0,0.4639999999999999,0.3979999999999999,1,2021-05-08,68,39,29,0.574,67,32,35,0.478
22001003,1610612755,1610612740,109.0,107.0,0.447,0.406,1,2021-05-07,67,46,21,0.687,67,30,37,0.4479999999999999
22000160,1610612741,1610612738,121.0,99.0,0.434,0.407,1,2021-05-07,67,28,39,0.418,67,35,32,0.522
22001004,1610612766,1610612753,122.0,112.0,0.494,0.418,1,2021-05-07,67,33,34,0.493,67,21,46,0.313
22001005,1610612748,1610612750,121.0,112.0,0.506,0.482,1,2021-05-07,67,36,31,0.537,67,20,47,0.299
22001006,1610612749,1610612745,141.0,133.0,0.537,0.5,1,2021-05-07,67,43,24,0.642,67,16,51,0.239
22001007,1610612742,1610612739,110.0,90.0,0.494,0.386,1,2021-05-07,67,39,28,0.5820000000000001,67,21,46,0.313
22001008,1610612762,1610612743,127.0,120.0,0.483,0.518,1,2021-05-07,67,49,18,0.731,67,44,23,0.657
22001009,1610612756,1610612752,128.0,105.0,0.467,0.452,1,2021-05-07,67,48,19,0.716,67,37,30,0.552
22001010,1610612757,1610612747,106.0,101.0,0.42,0.416,1,2021-05-07,67,38,29,0.5670000000000001,67,37,30,0.552
22001011,1610612758,1610612759,104.0,113.0,0.488,0.517,0,2021-05-07,67,29,38,0.433,66,32,34,0.485
22000434,1610612766,1610612741,99.0,120.0,0.422,0.505,0,2021-05-06,66,32,34,0.485,66,27,39,0.409
22000997,1610612761,1610612764,129.0,131.0,0.4479999999999999,0.436,0,2021-05-06,67,27,40,0.4029999999999999,67,31,36,0.4629999999999999
22000998,1610612742,1610612751,113.0,109.0,0.449,0.432,1,2021-05-06,66,38,28,0.5760000000000001,67,43,24,0.642
22000999,1610612765,1610612763,111.0,97.0,0.53,0.427,1,2021-05-06,67,20,47,0.299,66,33,33,0.5
22001000,1610612754,1610612737,133.0,126.0,0.621,0.511,1,2021-05-06,66,31,35,0.47,68,37,31,0.544
22001001,1610612744,1610612760,118.0,97.0,0.488,0.409,1,2021-05-06,67,34,33,0.507,67,21,46,0.313
22001002,1610612746,1610612747,118.0,94.0,0.532,0.379,1,2021-05-06,67,45,22,0.672,66,37,29,0.561
22000990,1610612753,1610612738,96.0,132.0,0.3879999999999999,0.531,0,2021-05-05,66,21,45,0.318,66,35,31,0.53
22000991,1610612739,1610612757,105.0,141.0,0.402,0.5760000000000001,0,2021-05-05,66,21,45,0.318,66,37,29,0.561
22000183,1610612750,1610612763,135.0,139.0,0.521,0.536,0,2021-05-05,66,20,46,0.303,65,33,32,0.508
22000235,1610612749,1610612764,135.0,134.0,0.539,0.49,1,2021-05-05,66,42,24,0.636,66,30,36,0.455
22000992,1610612737,1610612756,135.0,103.0,0.631,0.418,1,2021-05-05,67,37,30,0.552,66,47,19,0.7120000000000001
22000993,1610612754,1610612758,93.0,104.0,0.434,0.4529999999999999,0,2021-05-05,65,30,35,0.462,66,29,37,0.439
22000994,1610612745,1610612755,115.0,135.0,0.452,0.532,0,2021-05-05,66,16,50,0.242,66,45,21,0.682
22000995,1610612743,1610612752,113.0,97.0,0.381,0.384,1,2021-05-05,66,44,22,0.667,66,37,29,0.561
22000996,1610612762,1610612759,126.0,94.0,0.557,0.402,1,2021-05-05,66,48,18,0.727,65,31,34,0.477
22000983,1610612739,1610612756,118.0,134.0,0.456,0.524,0,2021-05-04,65,21,44,0.3229999999999999,65,47,18,0.723
22000984,1610612765,1610612766,99.0,102.0,0.4589999999999999,0.409,0,2021-05-04,66,19,47,0.288,65,32,33,0.492
22000985,1610612749,1610612751,124.0,118.0,0.449,0.488,1,2021-05-04,65,41,24,0.631,66,43,23,0.652
22000986,1610612748,1610612742,113.0,127.0,0.4639999999999999,0.529,0,2021-05-04,66,35,31,0.53,65,37,28,0.569
22000987,1610612740,1610612744,108.0,103.0,0.402,0.419,1,2021-05-04,66,30,36,0.455,66,33,33,0.5
22000988,1610612760,1610612758,99.0,103.0,0.357,0.411,0,2021-05-04,66,21,45,0.318,65,28,37,0.431
22000989,1610612746,1610612761,105.0,100.0,0.52,0.46,1,2021-05-04,66,44,22,0.667,66,27,39,0.409
22000975,1610612765,1610612753,112.0,119.0,0.473,0.511,0,2021-05-03,65,19,46,0.292,65,21,44,0.3229999999999999
22000976,1610612764,1610612754,154.0,141.0,0.612,0.495,1,2021-05-03,65,30,35,0.462,64,30,34,0.469
22000977,1610612740,1610612744,108.0,123.0,0.433,0.534,0,2021-05-03,65,29,36,0.446,65,33,32,0.508
22000978,1610612737,1610612757,123.0,114.0,0.524,0.4529999999999999,1,2021-05-03,66,36,30,0.545,65,36,29,0.5539999999999999
22000979,1610612741,1610612755,94.0,106.0,0.414,0.5329999999999999,0,2021-05-03,65,26,39,0.4,65,44,21,0.677
22000980,1610612763,1610612752,104.0,118.0,0.395,0.506,0,2021-05-03,64,32,32,0.5,65,37,28,0.569
22000981,1610612762,1610612759,110.0,99.0,0.5,0.467,1,2021-05-03,65,47,18,0.723,64,31,33,0.484
22000982,1610612747,1610612743,93.0,89.0,0.4379999999999999,0.439,1,2021-05-03,65,37,28,0.569,65,43,22,0.662
22000967,1610612749,1610612751,117.0,114.0,0.49,0.427,1,2021-05-02,64,40,24,0.625,65,43,22,0.662
22000968,1610612738,1610612757,119.0,129.0,0.483,0.518,0,2021-05-02,65,34,31,0.523,64,36,28,0.563
22000969,1610612766,1610612748,111.0,121.0,0.494,0.511,0,2021-05-02,64,31,33,0.484,65,35,30,0.5379999999999999
22000970,1610612742,1610612758,99.0,111.0,0.42,0.556,0,2021-05-02,64,36,28,0.563,64,27,37,0.422
22000971,1610612745,1610612752,97.0,122.0,0.43,0.523,0,2021-05-02,65,16,49,0.246,64,36,28,0.563
22000972,1610612760,1610612756,120.0,123.0,0.489,0.536,0,2021-05-02,65,21,44,0.3229999999999999,64,46,18,0.7190000000000001
22000973,1610612759,1610612755,111.0,113.0,0.4479999999999999,0.447,0,2021-05-02,63,31,32,0.492,64,43,21,0.672
22000974,1610612747,1610612761,114.0,121.0,0.482,0.447,0,2021-05-02,64,36,28,0.563,65,27,38,0.415
22000957,1610612766,1610612765,107.0,94.0,0.483,0.385,1,2021-05-01,63,31,32,0.492,64,19,45,0.297
22000958,1610612745,1610612744,87.0,113.0,0.36,0.4639999999999999,0,2021-05-01,64,16,48,0.25,64,32,32,0.5
22000959,1610612737,1610612741,108.0,97.0,0.5,0.471,1,2021-05-01,65,35,30,0.5379999999999999,64,26,38,0.406
22000960,1610612739,1610612748,107.0,124.0,0.5,0.54,0,2021-05-01,64,21,43,0.3279999999999999,64,34,30,0.531
22000961,1610612753,1610612763,112.0,111.0,0.447,0.4579999999999999,1,2021-05-01,64,20,44,0.313,63,32,31,0.508
22000962,1610612750,1610612740,136.0,140.0,0.4529999999999999,0.511,0,2021-05-01,65,20,45,0.308,64,29,35,0.4529999999999999
22000963,1610612760,1610612754,95.0,152.0,0.342,0.655,0,2021-05-01,64,21,43,0.3279999999999999,63,30,33,0.476
22000964,1610612742,1610612764,125.0,124.0,0.54,0.516,1,2021-05-01,63,36,27,0.5710000000000001,64,29,35,0.4529999999999999
22000965,1610612762,1610612761,106.0,102.0,0.474,0.447,1,2021-05-01,64,46,18,0.7190000000000001,64,26,38,0.406
22000966,1610612746,1610612743,104.0,110.0,0.434,0.488,0,2021-05-01,65,43,22,0.662,64,43,21,0.672
22000949,1610612755,1610612737,126.0,104.0,0.465,0.439,1,2021-04-30,63,42,21,0.667,64,34,30,0.531
22000950,1610612738,1610612759,143.0,140.0,0.467,0.5329999999999999,1,2021-04-30,64,34,30,0.531,62,31,31,0.5
22000951,1610612739,1610612764,93.0,122.0,0.415,0.5,0,2021-04-30,63,21,42,0.3329999999999999,63,29,34,0.46
22000952,1610612751,1610612757,109.0,128.0,0.421,0.516,0,2021-04-30,64,43,21,0.672,63,35,28,0.556
22000953,1610612763,1610612753,92.0,75.0,0.3429999999999999,0.314,1,2021-04-30,62,32,30,0.516,63,19,44,0.302
22000954,1610612741,1610612749,98.0,108.0,0.385,0.467,0,2021-04-30,63,26,37,0.413,63,39,24,0.619
22000955,1610612756,1610612762,121.0,100.0,0.545,0.4379999999999999,1,2021-04-30,63,45,18,0.7140000000000001,63,45,18,0.7140000000000001
22000956,1610612747,1610612758,106.0,110.0,0.506,0.4529999999999999,0,2021-04-30,63,36,27,0.5710000000000001,63,26,37,0.413
22000943,1610612765,1610612742,105.0,115.0,0.507,0.449,0,2021-04-29,63,19,44,0.302,62,35,27,0.565
22000944,1610612754,1610612751,113.0,130.0,0.427,0.528,0,2021-04-29,62,29,33,0.4679999999999999,63,43,20,0.6829999999999999
22000945,1610612745,1610612749,143.0,136.0,0.5,0.527,1,2021-04-29,63,16,47,0.254,62,38,24,0.613
22000946,1610612750,1610612744,126.0,114.0,0.457,0.494,1,2021-04-29,64,20,44,0.313,63,31,32,0.492
22000947,1610612760,1610612740,95.0,109.0,0.382,0.446,0,2021-04-29,63,21,42,0.3329999999999999,63,28,35,0.444
22000948,1610612743,1610612761,121.0,111.0,0.473,0.482,1,2021-04-29,63,42,21,0.667,63,26,37,0.413
22000933,1610612739,1610612753,104.0,109.0,0.402,0.506,0,2021-04-28,62,21,41,0.3389999999999999,62,19,43,0.306
22000934,1610612755,1610612737,127.0,83.0,0.539,0.3329999999999999,1,2021-04-28,62,41,21,0.6609999999999999,63,34,29,0.54
22000935,1610612764,1610612747,116.0,107.0,0.522,0.4379999999999999,1,2021-04-28,62,28,34,0.452,62,36,26,0.581
22000936,1610612738,1610612766,120.0,111.0,0.478,0.425,1,2021-04-28,63,33,30,0.524,62,30,32,0.484
22000937,1610612752,1610612741,113.0,94.0,0.462,0.4589999999999999,1,2021-04-28,63,35,28,0.556,62,26,36,0.419
22000938,1610612748,1610612759,116.0,111.0,0.506,0.466,1,2021-04-28,63,33,30,0.524,61,31,30,0.508
22000939,1610612763,1610612757,109.0,130.0,0.42,0.489,0,2021-04-28,61,31,30,0.508,62,34,28,0.5479999999999999
22000940,1610612743,1610612740,114.0,112.0,0.506,0.494,1,2021-04-28,62,41,21,0.6609999999999999,62,27,35,0.435
22000941,1610612756,1610612746,109.0,101.0,0.473,0.513,1,2021-04-28,62,44,18,0.71,64,43,21,0.672
22000942,1610612758,1610612762,105.0,154.0,0.483,0.64,0,2021-04-28,62,25,37,0.4029999999999999,62,45,17,0.726
22000927,1610612738,1610612760,115.0,119.0,0.423,0.481,0,2021-04-27,62,32,30,0.516,62,21,41,0.3389999999999999
22000928,1610612766,1610612749,104.0,114.0,0.4629999999999999,0.505,0,2021-04-27,61,30,31,0.492,61,38,23,0.623
22000929,1610612754,1610612757,112.0,133.0,0.465,0.472,0,2021-04-27,61,29,32,0.475,61,33,28,0.541
22000930,1610612761,1610612751,103.0,116.0,0.396,0.482,0,2021-04-27,62,26,36,0.419,62,42,20,0.677
22000931,1610612745,1610612750,107.0,114.0,0.488,0.484,0,2021-04-27,62,15,47,0.242,63,19,44,0.302
22000932,1610612744,1610612742,103.0,133.0,0.405,0.522,0,2021-04-27,62,31,31,0.5,61,34,27,0.557
22000916,1610612765,1610612737,100.0,86.0,0.476,0.3879999999999999,1,2021-04-26,62,19,43,0.306,62,34,28,0.5479999999999999
22000917,1610612753,1610612747,103.0,114.0,0.474,0.54,0,2021-04-26,61,18,43,0.295,61,36,25,0.59
22000918,1610612755,1610612760,121.0,90.0,0.547,0.449,1,2021-04-26,61,40,21,0.6559999999999999,61,20,41,0.3279999999999999
22000919,1610612764,1610612759,143.0,146.0,0.532,0.534,0,2021-04-26,61,27,34,0.4429999999999999,60,31,29,0.517
22000920,1610612752,1610612756,110.0,118.0,0.517,0.542,0,2021-04-26,62,34,28,0.5479999999999999,61,43,18,0.705
22000921,1610612761,1610612739,112.0,96.0,0.544,0.434,1,2021-04-26,61,26,35,0.426,61,21,40,0.344
22000922,1610612748,1610612741,102.0,110.0,0.429,0.532,0,2021-04-26,62,32,30,0.516,61,26,35,0.426
22000923,1610612750,1610612762,105.0,104.0,0.446,0.389,1,2021-04-26,62,18,44,0.29,61,44,17,0.721
22000924,1610612740,1610612746,120.0,103.0,0.537,0.4,1,2021-04-26,61,27,34,0.4429999999999999,63,43,20,0.6829999999999999
22000925,1610612743,1610612763,120.0,96.0,0.479,0.42,1,2021-04-26,61,40,21,0.6559999999999999,60,31,29,0.517
22000926,1610612758,1610612742,113.0,106.0,0.519,0.467,1,2021-04-26,61,25,36,0.41,60,33,27,0.55
22000911,1610612766,1610612738,125.0,104.0,0.505,0.386,1,2021-04-25,60,30,30,0.5,61,32,29,0.525
22000912,1610612751,1610612756,128.0,119.0,0.529,0.478,1,2021-04-25,61,41,20,0.672,60,42,18,0.7
22000240,1610612757,1610612763,113.0,120.0,0.371,0.462,0,2021-04-25,60,32,28,0.5329999999999999,59,31,28,0.525
22000197,1610612764,1610612739,119.0,110.0,0.483,0.513,1,2021-04-25,60,27,33,0.45,60,21,39,0.35
22000913,1610612737,1610612749,111.0,104.0,0.455,0.481,1,2021-04-25,61,34,27,0.557,60,37,23,0.617
22000914,1610612753,1610612754,112.0,131.0,0.396,0.5489999999999999,0,2021-04-25,60,18,42,0.3,60,29,31,0.483
22000915,1610612744,1610612758,117.0,113.0,0.484,0.477,1,2021-04-25,61,31,30,0.508,60,24,36,0.4
22000904,1610612752,1610612761,120.0,103.0,0.56,0.434,1,2021-04-24,61,34,27,0.557,60,25,35,0.417
22000905,1610612749,1610612755,132.0,94.0,0.516,0.3779999999999999,1,2021-04-24,59,37,22,0.627,60,39,21,0.65
22000906,1610612754,1610612765,115.0,109.0,0.417,0.406,1,2021-04-24,59,28,31,0.475,61,18,43,0.295
22000264,1610612740,1610612759,108.0,110.0,0.471,0.435,0,2021-04-24,60,26,34,0.433,59,30,29,0.508
22000907,1610612748,1610612741,106.0,101.0,0.45,0.481,1,2021-04-24,61,32,29,0.525,60,25,35,0.417
22000908,1610612742,1610612747,108.0,93.0,0.487,0.384,1,2021-04-24,59,33,26,0.5589999999999999,60,35,25,0.583
22000909,1610612762,1610612750,96.0,101.0,0.402,0.435,0,2021-04-24,60,44,16,0.733,61,17,44,0.2789999999999999
22000910,1610612743,1610612745,129.0,116.0,0.595,0.5,1,2021-04-24,60,39,21,0.65,61,15,46,0.246
22000898,1610612737,1610612748,118.0,103.0,0.5379999999999999,0.481,1,2021-04-23,60,33,27,0.55,60,31,29,0.517
22000899,1610612751,1610612738,109.0,104.0,0.43,0.4039999999999999,1,2021-04-23,60,40,20,0.667,60,32,28,0.5329999999999999
22000900,1610612766,1610612739,108.0,102.0,0.426,0.513,1,2021-04-23,59,29,30,0.492,59,21,38,0.356
22000901,1610612745,1610612746,104.0,109.0,0.4039999999999999,0.402,0,2021-04-23,60,15,45,0.25,62,43,19,0.6940000000000001
22000902,1610612760,1610612764,109.0,129.0,0.419,0.516,0,2021-04-23,60,20,40,0.3329999999999999,59,26,33,0.441
22000225,1610612757,1610612763,128.0,130.0,0.479,0.531,0,2021-04-23,59,32,27,0.542,58,30,28,0.517
22000903,1610612744,1610612743,118.0,97.0,0.536,0.386,1,2021-04-23,60,30,30,0.5,59,38,21,0.644
22000892,1610612738,1610612756,99.0,86.0,0.429,0.409,1,2021-04-22,59,32,27,0.542,59,42,17,0.7120000000000001
22000893,1610612753,1610612740,100.0,135.0,0.367,0.556,0,2021-04-22,59,18,41,0.305,59,26,33,0.441
22000894,1610612749,1610612755,124.0,117.0,0.556,0.505,1,2021-04-22,58,36,22,0.621,59,39,20,0.6609999999999999
22000895,1610612759,1610612765,106.0,91.0,0.4629999999999999,0.455,1,2021-04-22,58,29,29,0.5,60,18,42,0.3
22000896,1610612741,1610612766,108.0,91.0,0.494,0.427,1,2021-04-22,59,25,34,0.424,58,28,30,0.483
22000897,1610612742,1610612747,115.0,110.0,0.488,0.478,1,2021-04-22,58,32,26,0.552,59,35,24,0.593
22000881,1610612739,1610612741,121.0,105.0,0.511,0.494,1,2021-04-21,58,21,37,0.362,58,24,34,0.414
22000882,1610612754,1610612760,122.0,116.0,0.455,0.462,1,2021-04-21,58,27,31,0.466,59,20,39,0.3389999999999999
22000883,1610612755,1610612756,113.0,116.0,0.513,0.477,0,2021-04-21,58,39,19,0.672,58,42,16,0.7240000000000001
22000884,1610612761,1610612751,114.0,103.0,0.433,0.396,1,2021-04-21,59,25,34,0.424,59,39,20,0.6609999999999999
22000885,1610612764,1610612744,118.0,114.0,0.418,0.396,1,2021-04-21,58,25,33,0.431,59,29,30,0.492
22000886,1610612752,1610612737,137.0,127.0,0.5379999999999999,0.48,1,2021-04-21,60,33,27,0.55,59,32,27,0.542
22000887,1610612745,1610612762,89.0,112.0,0.354,0.456,0,2021-04-21,59,15,44,0.254,59,44,15,0.746
22000442,1610612742,1610612765,127.0,117.0,0.5,0.506,1,2021-04-21,57,31,26,0.544,59,18,41,0.305
22000888,1610612759,1610612748,87.0,107.0,0.4029999999999999,0.47,0,2021-04-21,57,28,29,0.491,59,31,28,0.525
22000889,1610612746,1610612763,117.0,105.0,0.452,0.452,1,2021-04-21,61,42,19,0.6890000000000001,57,29,28,0.509
22000890,1610612757,1610612743,105.0,106.0,0.46,0.4429999999999999,0,2021-04-21,58,32,26,0.552,58,38,20,0.655
22000891,1610612758,1610612750,128.0,125.0,0.581,0.529,1,2021-04-21,59,24,35,0.407,60,16,44,0.267
22000876,1610612737,1610612753,112.0,96.0,0.415,0.395,1,2021-04-20,58,32,26,0.552,58,18,40,0.31
22000877,1610612752,1610612766,109.0,97.0,0.482,0.4529999999999999,1,2021-04-20,59,32,27,0.542,57,28,29,0.491
22000878,1610612740,1610612751,129.0,134.0,0.56,0.551,0,2021-04-20,58,25,33,0.431,58,39,19,0.672
22000879,1610612757,1610612746,112.0,113.0,0.447,0.5,0,2021-04-20,57,32,25,0.561,60,41,19,0.6829999999999999
22000880,1610612758,1610612750,120.0,134.0,0.4539999999999999,0.5670000000000001,0,2021-04-20,58,23,35,0.397,59,16,43,0.271
22000868,1610612765,1610612739,109.0,105.0,0.488,0.488,1,2021-04-19,58,18,40,0.31,57,20,37,0.351
22000869,1610612738,1610612741,96.0,102.0,0.4679999999999999,0.451,0,2021-04-19,58,31,27,0.534,57,24,33,0.421
22000870,1610612755,1610612744,96.0,107.0,0.3929999999999999,0.447,0,2021-04-19,57,39,18,0.684,58,29,29,0.5
22000473,1610612754,1610612759,94.0,109.0,0.327,0.429,0,2021-04-19,57,26,31,0.456,56,28,28,0.5
22000871,1610612748,1610612745,113.0,91.0,0.484,0.3879999999999999,1,2021-04-19,58,30,28,0.517,58,15,43,0.259
22000872,1610612764,1610612760,119.0,107.0,0.505,0.434,1,2021-04-19,57,24,33,0.421,58,20,38,0.345
22000873,1610612749,1610612756,127.0,128.0,0.48,0.481,0,2021-04-19,57,35,22,0.614,57,41,16,0.7190000000000001
22000874,1610612743,1610612763,139.0,137.0,0.5,0.477,1,2021-04-19,57,37,20,0.649,56,29,27,0.518
22000875,1610612747,1610612762,97.0,111.0,0.43,0.573,0,2021-04-19,58,35,23,0.603,58,43,15,0.741
22000861,1610612737,1610612754,129.0,117.0,0.489,0.489,1,2021-04-18,57,31,26,0.544,56,26,30,0.4639999999999999
22000862,1610612752,1610612740,122.0,112.0,0.474,0.406,1,2021-04-18,58,31,27,0.534,57,25,32,0.439
22000863,1610612748,1610612751,109.0,107.0,0.437,0.476,1,2021-04-18,57,29,28,0.509,57,38,19,0.667
22000362,1610612766,1610612757,109.0,101.0,0.47,0.396,1,2021-04-18,56,28,28,0.5,56,32,24,0.5710000000000001
22000864,1610612753,1610612745,110.0,114.0,0.451,0.512,0,2021-04-18,57,18,39,0.316,57,15,42,0.263
22000865,1610612761,1610612760,112.0,106.0,0.385,0.451,1,2021-04-18,58,24,34,0.414,57,20,37,0.351
22000866,1610612742,1610612758,107.0,121.0,0.4479999999999999,0.494,0,2021-04-18,56,30,26,0.536,57,23,34,0.4039999999999999
22000867,1610612746,1610612750,124.0,105.0,0.506,0.409,1,2021-04-18,59,40,19,0.6779999999999999,58,15,43,0.259
22000855,1610612747,1610612762,127.0,115.0,0.516,0.416,1,2021-04-17,57,35,22,0.614,57,42,15,0.737
22000856,1610612764,1610612765,121.0,100.0,0.532,0.44,1,2021-04-17,56,23,33,0.411,57,17,40,0.298
22000857,1610612741,1610612739,106.0,96.0,0.5,0.4429999999999999,1,2021-04-17,56,23,33,0.411,56,20,36,0.357
22000858,1610612738,1610612744,119.0,114.0,0.4679999999999999,0.513,1,2021-04-17,57,31,26,0.544,57,28,29,0.491
22000859,1610612749,1610612763,115.0,128.0,0.429,0.5479999999999999,0,2021-04-17,56,35,21,0.625,55,29,26,0.527
22000860,1610612756,1610612759,85.0,111.0,0.4,0.506,0,2021-04-17,56,40,16,0.7140000000000001,55,27,28,0.491
22000844,1610612762,1610612754,119.0,111.0,0.483,0.39,1,2021-04-16,56,42,14,0.75,55,26,29,0.473
22000845,1610612765,1610612760,110.0,104.0,0.422,0.402,1,2021-04-16,56,17,39,0.304,56,20,36,0.357
22000846,1610612755,1610612746,106.0,103.0,0.422,0.451,1,2021-04-16,56,39,17,0.696,58,39,19,0.672
22000847,1610612764,1610612740,117.0,115.0,0.469,0.412,1,2021-04-16,55,22,33,0.4,56,25,31,0.446
22000848,1610612751,1610612766,130.0,115.0,0.5529999999999999,0.53,1,2021-04-16,56,38,18,0.679,55,27,28,0.491
22000849,1610612761,1610612753,113.0,102.0,0.5,0.455,1,2021-04-16,57,23,34,0.4039999999999999,56,18,38,0.321
22000850,1610612741,1610612763,115.0,126.0,0.469,0.523,0,2021-04-16,55,22,33,0.4,54,28,26,0.519
22000851,1610612745,1610612743,99.0,128.0,0.442,0.489,0,2021-04-16,56,14,42,0.25,56,36,20,0.643
22000852,1610612750,1610612748,119.0,111.0,0.519,0.488,1,2021-04-16,57,15,42,0.263,56,28,28,0.5
22000853,1610612759,1610612757,106.0,107.0,0.474,0.461,0,2021-04-16,54,26,28,0.481,55,32,23,0.5820000000000001
22000854,1610612742,1610612752,109.0,117.0,0.44,0.512,0,2021-04-16,55,30,25,0.545,57,30,27,0.526
22000840,1610612737,1610612749,109.0,120.0,0.4529999999999999,0.484,0,2021-04-15,56,30,26,0.536,55,35,20,0.636
22000841,1610612739,1610612744,101.0,119.0,0.432,0.511,0,2021-04-15,55,20,35,0.364,56,28,28,0.5
22000842,1610612747,1610612738,113.0,121.0,0.449,0.565,0,2021-04-15,56,34,22,0.607,56,30,26,0.536
22000843,1610612756,1610612758,122.0,114.0,0.5579999999999999,0.551,1,2021-04-15,55,40,15,0.727,56,22,34,0.3929999999999999
22000834,1610612750,1610612749,105.0,130.0,0.37,0.469,0,2021-04-14,56,14,42,0.25,54,34,20,0.63
22000829,1610612766,1610612739,90.0,103.0,0.405,0.487,0,2021-04-14,54,27,27,0.5,54,20,34,0.37
22000830,1610612755,1610612751,123.0,117.0,0.517,0.518,1,2021-04-14,55,38,17,0.691,55,37,18,0.6729999999999999
22000831,1610612761,1610612759,117.0,112.0,0.466,0.427,1,2021-04-14,56,22,34,0.3929999999999999,53,26,27,0.491
22000832,1610612765,1610612746,98.0,100.0,0.435,0.3979999999999999,0,2021-04-14,55,16,39,0.291,57,39,18,0.684
22000833,1610612741,1610612753,106.0,115.0,0.477,0.494,0,2021-04-14,54,22,32,0.407,55,18,37,0.327
22000835,1610612740,1610612752,106.0,116.0,0.455,0.4539999999999999,0,2021-04-14,55,25,30,0.455,56,29,27,0.518
22000461,1610612745,1610612754,124.0,132.0,0.462,0.532,0,2021-04-14,55,14,41,0.255,54,26,28,0.481
22000836,1610612760,1610612744,109.0,147.0,0.478,0.547,0,2021-04-14,55,20,35,0.364,55,27,28,0.491
22000837,1610612763,1610612742,113.0,114.0,0.467,0.5,0,2021-04-14,53,27,26,0.509,54,30,24,0.556
22000838,1610612743,1610612748,123.0,106.0,0.539,0.494,1,2021-04-14,55,35,20,0.636,55,28,27,0.509
22000839,1610612758,1610612764,111.0,123.0,0.462,0.522,0,2021-04-14,55,22,33,0.4,54,21,33,0.389
22000817,1610612750,1610612751,97.0,127.0,0.345,0.505,0,2021-04-13,55,14,41,0.255,54,37,17,0.685
22000823,1610612754,1610612746,115.0,126.0,0.4579999999999999,0.539,0,2021-04-13,53,25,28,0.472,56,38,18,0.679
22000824,1610612761,1610612737,103.0,108.0,0.477,0.476,0,2021-04-13,55,21,34,0.382,55,30,25,0.545
22000825,1610612766,1610612747,93.0,101.0,0.434,0.415,0,2021-04-13,53,27,26,0.509,55,34,21,0.618
22000826,1610612762,1610612760,106.0,96.0,0.419,0.387,1,2021-04-13,55,41,14,0.745,54,20,34,0.37
22000827,1610612756,1610612748,106.0,86.0,0.4629999999999999,0.3779999999999999,1,2021-04-13,54,39,15,0.722,54,28,26,0.519
22000828,1610612757,1610612738,115.0,116.0,0.478,0.467,0,2021-04-13,54,31,23,0.574,55,29,26,0.527
22000815,1610612752,1610612747,111.0,96.0,0.472,0.4379999999999999,1,2021-04-12,55,28,27,0.509,54,33,21,0.611
22000818,1610612742,1610612755,95.0,113.0,0.422,0.488,0,2021-04-12,53,29,24,0.547,54,37,17,0.685
22000816,1610612753,1610612759,97.0,120.0,0.45,0.516,0,2021-04-12,54,17,37,0.315,52,26,26,0.5
22000278,1610612763,1610612741,101.0,90.0,0.471,0.419,1,2021-04-12,52,27,25,0.519,53,22,31,0.415
22000819,1610612740,1610612758,117.0,110.0,0.545,0.433,1,2021-04-12,54,25,29,0.4629999999999999,54,22,32,0.407
22000820,1610612762,1610612764,121.0,125.0,0.482,0.522,0,2021-04-12,54,40,14,0.741,53,20,33,0.377
22000821,1610612744,1610612743,116.0,107.0,0.481,0.47,1,2021-04-12,54,26,28,0.481,54,34,20,0.63
22000822,1610612756,1610612745,126.0,120.0,0.479,0.506,1,2021-04-12,53,38,15,0.7170000000000001,54,14,40,0.259
22000805,1610612766,1610612737,101.0,105.0,0.4629999999999999,0.452,0,2021-04-11,52,27,25,0.519,54,29,25,0.537
22000806,1610612743,1610612738,87.0,105.0,0.364,0.4479999999999999,0,2021-04-11,53,34,19,0.642,54,28,26,0.519
22000807,1610612739,1610612740,109.0,116.0,0.482,0.512,0,2021-04-11,53,19,34,0.358,53,24,29,0.4529999999999999
22000808,1610612753,1610612749,87.0,124.0,0.372,0.489,0,2021-04-11,53,17,36,0.321,53,33,20,0.623
22000809,1610612752,1610612761,102.0,96.0,0.3979999999999999,0.418,1,2021-04-11,54,27,27,0.5,54,21,33,0.389
22000810,1610612742,1610612759,117.0,119.0,0.479,0.542,0,2021-04-11,52,29,23,0.5579999999999999,51,25,26,0.49
22000811,1610612763,1610612754,125.0,132.0,0.461,0.525,0,2021-04-11,51,26,25,0.51,52,25,27,0.481
22000812,1610612750,1610612741,121.0,117.0,0.494,0.511,1,2021-04-11,54,14,40,0.259,52,22,30,0.423
22000813,1610612746,1610612765,131.0,124.0,0.625,0.529,1,2021-04-11,55,37,18,0.6729999999999999,54,16,38,0.296
22000814,1610612757,1610612748,98.0,107.0,0.481,0.494,0,2021-04-11,53,31,22,0.585,53,28,25,0.528
22000794,1610612739,1610612761,115.0,135.0,0.4529999999999999,0.616,0,2021-04-10,52,19,33,0.365,53,21,32,0.396
22000800,1610612751,1610612747,101.0,126.0,0.4379999999999999,0.505,0,2021-04-10,53,36,17,0.679,53,33,20,0.623
22000199,1610612760,1610612755,93.0,117.0,0.5,0.4679999999999999,0,2021-04-10,53,20,33,0.377,53,36,17,0.679
22000801,1610612762,1610612758,128.0,112.0,0.455,0.477,1,2021-04-10,53,40,13,0.755,53,22,31,0.415
22000802,1610612744,1610612745,125.0,109.0,0.5379999999999999,0.466,1,2021-04-10,53,25,28,0.472,53,14,39,0.264
22000803,1610612756,1610612764,134.0,106.0,0.514,0.4639999999999999,1,2021-04-10,52,37,15,0.7120000000000001,52,19,33,0.365
22000804,1610612757,1610612765,118.0,103.0,0.478,0.446,1,2021-04-10,52,31,21,0.596,53,16,37,0.302
22000790,1610612753,1610612754,106.0,111.0,0.422,0.413,0,2021-04-09,52,17,35,0.327,51,24,27,0.471
22000792,1610612738,1610612750,145.0,136.0,0.54,0.49,1,2021-04-09,53,27,26,0.509,53,13,40,0.245
22000793,1610612752,1610612763,133.0,129.0,0.469,0.5,1,2021-04-09,53,26,27,0.491,50,26,24,0.52
22000791,1610612737,1610612741,120.0,108.0,0.56,0.477,1,2021-04-09,53,28,25,0.528,51,22,29,0.431
22000795,1610612740,1610612755,101.0,94.0,0.433,0.418,1,2021-04-09,52,23,29,0.442,52,35,17,0.6729999999999999
22000796,1610612749,1610612766,119.0,127.0,0.449,0.484,0,2021-04-09,52,32,20,0.615,51,27,24,0.529
22000797,1610612743,1610612759,121.0,119.0,0.544,0.462,1,2021-04-09,52,34,18,0.654,50,24,26,0.48
22000798,1610612744,1610612764,107.0,110.0,0.466,0.483,0,2021-04-09,52,24,28,0.462,51,19,32,0.373
22000799,1610612746,1610612745,126.0,109.0,0.545,0.47,1,2021-04-09,54,36,18,0.667,52,14,38,0.2689999999999999
22000523,1610612761,1610612741,113.0,122.0,0.433,0.54,0,2021-04-08,52,20,32,0.385,50,22,28,0.44
22000784,1610612748,1610612747,110.0,104.0,0.479,0.4429999999999999,1,2021-04-08,52,27,25,0.519,52,32,20,0.615
22000785,1610612760,1610612739,102.0,129.0,0.449,0.511,0,2021-04-08,52,20,32,0.385,51,19,32,0.373
22000786,1610612742,1610612749,116.0,101.0,0.4429999999999999,0.38,1,2021-04-08,51,29,22,0.569,51,32,19,0.627
22000787,1610612762,1610612757,122.0,103.0,0.4529999999999999,0.396,1,2021-04-08,52,39,13,0.75,51,30,21,0.588
22000788,1610612746,1610612756,113.0,103.0,0.5,0.507,1,2021-04-08,53,35,18,0.66,51,36,15,0.706
22000789,1610612758,1610612765,101.0,113.0,0.442,0.524,0,2021-04-08,52,22,30,0.423,52,16,36,0.308
22000776,1610612754,1610612750,141.0,137.0,0.591,0.527,1,2021-04-07,50,23,27,0.46,52,13,39,0.25
22000777,1610612753,1610612764,116.0,131.0,0.473,0.5760000000000001,0,2021-04-07,51,17,34,0.3329999999999999,50,18,32,0.36
22000778,1610612738,1610612752,101.0,99.0,0.419,0.417,1,2021-04-07,52,26,26,0.5,52,25,27,0.481
22000779,1610612751,1610612740,139.0,111.0,0.5539999999999999,0.427,1,2021-04-07,52,36,16,0.6920000000000001,51,22,29,0.431
22000456,1610612745,1610612742,102.0,93.0,0.432,0.379,1,2021-04-07,51,14,37,0.275,50,28,22,0.56
22000780,1610612737,1610612763,113.0,131.0,0.446,0.539,0,2021-04-07,52,27,25,0.519,49,26,23,0.531
22000781,1610612760,1610612766,102.0,113.0,0.435,0.4429999999999999,0,2021-04-07,51,20,31,0.392,50,26,24,0.52
22000782,1610612743,1610612759,106.0,96.0,0.44,0.418,1,2021-04-07,51,33,18,0.647,49,24,25,0.49
22000783,1610612756,1610612762,117.0,113.0,0.446,0.447,1,2021-04-07,50,36,14,0.72,51,38,13,0.745
22000769,1610612754,1610612741,97.0,113.0,0.432,0.4679999999999999,0,2021-04-06,49,22,27,0.449,49,21,28,0.429
22000770,1610612737,1610612740,123.0,107.0,0.5,0.407,1,2021-04-06,51,27,24,0.529,50,22,28,0.44
22000771,1610612738,1610612755,96.0,106.0,0.471,0.466,0,2021-04-06,51,25,26,0.49,51,35,16,0.6859999999999999
22000772,1610612761,1610612747,101.0,110.0,0.396,0.494,0,2021-04-06,51,20,31,0.392,51,32,19,0.627
22000773,1610612748,1610612763,112.0,124.0,0.537,0.5479999999999999,0,2021-04-06,51,26,25,0.51,48,25,23,0.521
22000321,1610612743,1610612765,134.0,119.0,0.596,0.5429999999999999,1,2021-04-06,50,32,18,0.64,51,15,36,0.294
22000774,1610612744,1610612749,122.0,121.0,0.479,0.512,1,2021-04-06,51,24,27,0.471,50,32,18,0.64
22000775,1610612746,1610612757,133.0,116.0,0.517,0.402,1,2021-04-06,52,34,18,0.654,50,30,20,0.6
22000762,1610612751,1610612752,114.0,112.0,0.457,0.465,1,2021-04-05,51,35,16,0.6859999999999999,51,25,26,0.49
22000763,1610612761,1610612764,103.0,101.0,0.4679999999999999,0.3939999999999999,1,2021-04-05,50,20,30,0.4,49,17,32,0.347
22000764,1610612742,1610612762,111.0,103.0,0.451,0.42,1,2021-04-05,49,28,21,0.5710000000000001,50,38,12,0.76
22000765,1610612750,1610612758,116.0,106.0,0.418,0.4429999999999999,1,2021-04-05,51,13,38,0.255,51,22,29,0.431
22000766,1610612760,1610612765,108.0,132.0,0.423,0.516,0,2021-04-05,50,20,30,0.4,50,15,35,0.3
22000767,1610612759,1610612739,101.0,125.0,0.422,0.523,0,2021-04-05,48,24,24,0.5,50,18,32,0.36
22000768,1610612745,1610612756,130.0,133.0,0.544,0.512,0,2021-04-05,50,13,37,0.26,49,35,14,0.7140000000000001
22000755,1610612741,1610612751,115.0,107.0,0.551,0.484,1,2021-04-04,48,20,28,0.417,50,34,16,0.68
22000756,1610612746,1610612747,104.0,86.0,0.477,0.4,1,2021-04-04,51,33,18,0.647,50,31,19,0.62
22000757,1610612738,1610612766,116.0,86.0,0.457,0.4,1,2021-04-04,50,25,25,0.5,49,25,24,0.51
22000758,1610612755,1610612763,100.0,116.0,0.416,0.494,0,2021-04-04,50,34,16,0.68,47,24,23,0.511
22000759,1610612737,1610612744,117.0,111.0,0.432,0.467,1,2021-04-04,50,26,24,0.52,50,23,27,0.46
22000760,1610612745,1610612740,115.0,122.0,0.461,0.462,0,2021-04-04,49,13,36,0.265,49,22,27,0.449
22000761,1610612743,1610612753,119.0,109.0,0.489,0.472,1,2021-04-04,49,31,18,0.633,50,17,33,0.34
22000747,1610612764,1610612742,87.0,109.0,0.407,0.444,0,2021-04-03,48,17,31,0.354,48,27,21,0.563
22000748,1610612765,1610612752,81.0,125.0,0.354,0.544,0,2021-04-03,49,14,35,0.286,50,25,25,0.5
22000749,1610612748,1610612739,115.0,101.0,0.537,0.473,1,2021-04-03,50,26,24,0.52,49,17,32,0.347
22000750,1610612755,1610612750,122.0,113.0,0.506,0.449,1,2021-04-03,49,34,15,0.6940000000000001,50,12,38,0.24
22000751,1610612759,1610612754,133.0,139.0,0.485,0.5529999999999999,0,2021-04-03,47,24,23,0.511,48,22,26,0.4579999999999999
22000752,1610612762,1610612753,137.0,91.0,0.5539999999999999,0.368,1,2021-04-03,49,38,11,0.7759999999999999,49,17,32,0.347
22000753,1610612757,1610612760,133.0,85.0,0.49,0.353,1,2021-04-03,49,30,19,0.612,49,20,29,0.408
22000754,1610612758,1610612749,128.0,129.0,0.495,0.5379999999999999,0,2021-04-03,50,22,28,0.44,49,32,17,0.653
22000737,1610612761,1610612744,130.0,77.0,0.534,0.3289999999999999,1,2021-04-02,49,19,30,0.3879999999999999,49,23,26,0.469
22000738,1610612738,1610612745,118.0,102.0,0.523,0.43,1,2021-04-02,49,24,25,0.49,48,13,35,0.271
22000739,1610612752,1610612742,86.0,99.0,0.36,0.466,0,2021-04-02,49,24,25,0.49,47,26,21,0.5529999999999999
22000740,1610612754,1610612766,97.0,114.0,0.4629999999999999,0.4529999999999999,0,2021-04-02,47,21,26,0.447,48,25,23,0.521
22000741,1610612763,1610612750,120.0,108.0,0.442,0.447,1,2021-04-02,46,23,23,0.5,49,12,37,0.245
22000742,1610612740,1610612737,103.0,126.0,0.432,0.563,0,2021-04-02,48,21,27,0.4379999999999999,49,25,24,0.51
22000743,1610612762,1610612741,113.0,106.0,0.4679999999999999,0.483,1,2021-04-02,48,37,11,0.7709999999999999,47,19,28,0.4039999999999999
22000744,1610612756,1610612760,140.0,103.0,0.6,0.3929999999999999,1,2021-04-02,48,34,14,0.708,48,20,28,0.417
22000745,1610612757,1610612749,109.0,127.0,0.364,0.544,0,2021-04-02,48,29,19,0.604,48,31,17,0.6459999999999999
22000746,1610612758,1610612747,94.0,115.0,0.424,0.473,0,2021-04-02,49,22,27,0.449,49,31,18,0.633
22000179,1610612765,1610612764,120.0,91.0,0.479,0.471,1,2021-04-01,48,14,34,0.292,47,17,30,0.362
22000731,1610612739,1610612755,94.0,114.0,0.425,0.43,0,2021-04-01,48,17,31,0.354,48,33,15,0.688
22000732,1610612751,1610612766,111.0,89.0,0.484,0.349,1,2021-04-01,49,34,15,0.6940000000000001,47,24,23,0.511
22000733,1610612748,1610612744,116.0,109.0,0.476,0.439,1,2021-04-01,49,25,24,0.51,48,23,25,0.479
22000734,1610612740,1610612753,110.0,115.0,0.441,0.425,0,2021-04-01,47,21,26,0.447,48,17,31,0.354
22000735,1610612759,1610612737,129.0,134.0,0.445,0.5,0,2021-04-01,46,24,22,0.522,48,24,24,0.5
22000736,1610612746,1610612743,94.0,101.0,0.412,0.481,0,2021-04-01,50,32,18,0.64,48,30,18,0.625
22000721,1610612765,1610612757,101.0,124.0,0.465,0.512,0,2021-03-31,47,13,34,0.2769999999999999,47,29,18,0.617
22000722,1610612754,1610612748,87.0,92.0,0.4,0.41,0,2021-03-31,46,21,25,0.457,48,24,24,0.5
22000723,1610612738,1610612742,108.0,113.0,0.415,0.494,0,2021-03-31,48,23,25,0.479,46,25,21,0.5429999999999999
22000724,1610612751,1610612745,120.0,108.0,0.489,0.5,1,2021-03-31,48,33,15,0.688,47,13,34,0.2769999999999999
22000725,1610612763,1610612762,107.0,111.0,0.467,0.427,0,2021-03-31,45,22,23,0.489,47,36,11,0.7659999999999999
22000726,1610612750,1610612752,102.0,101.0,0.414,0.476,1,2021-03-31,48,12,36,0.25,48,24,24,0.5
22000727,1610612760,1610612761,113.0,103.0,0.4529999999999999,0.389,1,2021-03-31,47,20,27,0.426,48,18,30,0.375
22000728,1610612759,1610612758,120.0,106.0,0.467,0.424,1,2021-03-31,45,24,21,0.5329999999999999,48,22,26,0.4579999999999999
22000729,1610612747,1610612749,97.0,112.0,0.402,0.532,0,2021-03-31,48,30,18,0.625,47,30,17,0.638
22000730,1610612756,1610612741,121.0,116.0,0.568,0.434,1,2021-03-31,47,33,14,0.7020000000000001,46,19,27,0.413
22000718,1610612764,1610612766,104.0,114.0,0.41,0.467,0,2021-03-30,46,17,29,0.37,46,24,22,0.522
22000719,1610612743,1610612755,104.0,95.0,0.481,0.427,1,2021-03-30,47,29,18,0.617,47,32,15,0.6809999999999999
22000171,1610612756,1610612737,117.0,110.0,0.511,0.482,1,2021-03-30,46,32,14,0.696,47,23,24,0.489
22000720,1610612746,1610612753,96.0,103.0,0.416,0.413,0,2021-03-30,49,32,17,0.653,47,16,31,0.34
22000707,1610612764,1610612754,132.0,124.0,0.556,0.473,1,2021-03-29,45,17,28,0.3779999999999999,45,21,24,0.467
22000708,1610612738,1610612740,109.0,115.0,0.43,0.5,0,2021-03-29,47,23,24,0.489,46,21,25,0.457
22000709,1610612751,1610612750,112.0,107.0,0.471,0.3879999999999999,1,2021-03-29,47,32,15,0.6809999999999999,47,11,36,0.2339999999999999
22000710,1610612752,1610612748,88.0,98.0,0.413,0.43,0,2021-03-29,47,24,23,0.511,47,23,24,0.489
22000711,1610612765,1610612761,118.0,104.0,0.507,0.407,1,2021-03-29,46,13,33,0.283,47,18,29,0.3829999999999999
22000712,1610612745,1610612763,110.0,120.0,0.426,0.541,0,2021-03-29,46,13,33,0.283,44,22,22,0.5
22000713,1610612760,1610612742,106.0,127.0,0.469,0.531,0,2021-03-29,46,19,27,0.413,45,24,21,0.5329999999999999
22000714,1610612759,1610612758,115.0,132.0,0.505,0.56,0,2021-03-29,44,23,21,0.523,47,22,25,0.4679999999999999
22000715,1610612762,1610612739,114.0,75.0,0.4629999999999999,0.349,1,2021-03-29,46,35,11,0.7609999999999999,47,17,30,0.362
22000716,1610612744,1610612741,116.0,102.0,0.5,0.524,1,2021-03-29,47,23,24,0.489,45,19,26,0.422
22000717,1610612746,1610612749,129.0,105.0,0.537,0.469,1,2021-03-29,48,32,16,0.667,46,29,17,0.63
22000703,1610612766,1610612756,97.0,101.0,0.4,0.354,0,2021-03-28,45,23,22,0.511,45,31,14,0.6890000000000001
22000704,1610612761,1610612757,117.0,122.0,0.4479999999999999,0.474,0,2021-03-28,46,18,28,0.391,46,28,18,0.609
22000705,1610612743,1610612737,126.0,102.0,0.5429999999999999,0.474,1,2021-03-28,46,28,18,0.609,46,23,23,0.5
22000706,1610612747,1610612753,96.0,93.0,0.415,0.386,1,2021-03-28,47,30,17,0.638,46,15,31,0.326
22000694,1610612764,1610612765,106.0,92.0,0.484,0.3879999999999999,1,2021-03-27,44,16,28,0.364,45,12,33,0.267
22000695,1610612749,1610612752,96.0,102.0,0.414,0.43,0,2021-03-27,45,29,16,0.644,46,24,22,0.522
22000696,1610612750,1610612745,107.0,129.0,0.424,0.5429999999999999,0,2021-03-27,46,11,35,0.239,45,13,32,0.289
22000697,1610612759,1610612741,120.0,104.0,0.541,0.432,1,2021-03-27,43,23,20,0.535,44,19,25,0.432
22000698,1610612740,1610612742,112.0,103.0,0.519,0.446,1,2021-03-27,45,20,25,0.444,44,23,21,0.523
22000699,1610612760,1610612738,94.0,111.0,0.41,0.4579999999999999,0,2021-03-27,45,19,26,0.422,46,23,23,0.5
22000700,1610612762,1610612763,126.0,110.0,0.5,0.402,1,2021-03-27,45,34,11,0.7559999999999999,43,21,22,0.488
22000701,1610612746,1610612755,122.0,112.0,0.529,0.506,1,2021-03-27,47,31,16,0.66,46,32,14,0.696
22000702,1610612758,1610612739,100.0,98.0,0.513,0.44,1,2021-03-27,46,21,25,0.457,46,17,29,0.37
22000683,1610612765,1610612751,111.0,113.0,0.452,0.44,0,2021-03-26,44,12,32,0.273,46,31,15,0.674
22000684,1610612761,1610612756,100.0,104.0,0.411,0.478,0,2021-03-26,45,18,27,0.4,44,30,14,0.682
22000685,1610612749,1610612738,114.0,122.0,0.444,0.489,0,2021-03-26,44,29,15,0.659,45,22,23,0.489
22000686,1610612766,1610612748,110.0,105.0,0.494,0.46,1,2021-03-26,44,23,21,0.523,46,22,24,0.478
22000687,1610612753,1610612757,105.0,112.0,0.442,0.471,0,2021-03-26,45,15,30,0.3329999999999999,45,27,18,0.6
22000688,1610612750,1610612745,107.0,101.0,0.379,0.425,1,2021-03-26,45,11,34,0.244,44,12,32,0.273
22000689,1610612740,1610612743,108.0,113.0,0.5,0.505,0,2021-03-26,44,19,25,0.432,45,27,18,0.6
22000690,1610612742,1610612754,94.0,109.0,0.411,0.437,0,2021-03-26,43,23,20,0.535,44,21,23,0.477
22000691,1610612762,1610612763,117.0,114.0,0.4589999999999999,0.4539999999999999,1,2021-03-26,44,33,11,0.75,42,21,21,0.5
22000692,1610612744,1610612737,108.0,124.0,0.494,0.5479999999999999,0,2021-03-26,46,22,24,0.478,45,23,22,0.511
22000693,1610612747,1610612739,100.0,86.0,0.487,0.3879999999999999,1,2021-03-26,46,29,17,0.63,45,17,28,0.3779999999999999
22000678,1610612748,1610612757,122.0,125.0,0.56,0.478,0,2021-03-25,45,22,23,0.489,44,26,18,0.591
22000679,1610612752,1610612764,106.0,102.0,0.366,0.4629999999999999,1,2021-03-25,45,23,22,0.511,43,15,28,0.349
22000680,1610612759,1610612746,85.0,98.0,0.402,0.382,0,2021-03-25,42,22,20,0.524,46,30,16,0.652
22000681,1610612747,1610612755,101.0,109.0,0.436,0.488,0,2021-03-25,45,28,17,0.622,45,32,13,0.711
22000682,1610612758,1610612744,141.0,119.0,0.596,0.511,1,2021-03-25,45,20,25,0.444,45,22,23,0.489
22000667,1610612754,1610612765,116.0,111.0,0.4639999999999999,0.53,1,2021-03-24,43,20,23,0.465,43,12,31,0.2789999999999999
22000668,1610612761,1610612743,135.0,111.0,0.506,0.418,1,2021-03-24,44,18,26,0.409,44,26,18,0.591
22000669,1610612749,1610612738,121.0,119.0,0.5,0.479,1,2021-03-24,43,29,14,0.674,44,21,23,0.477
22000670,1610612753,1610612756,112.0,111.0,0.467,0.444,1,2021-03-24,44,15,29,0.341,43,29,14,0.674
22000671,1610612741,1610612739,94.0,103.0,0.446,0.457,0,2021-03-24,43,19,24,0.442,44,17,27,0.386
22000672,1610612745,1610612766,97.0,122.0,0.384,0.513,0,2021-03-24,43,12,31,0.2789999999999999,43,22,21,0.512
22000673,1610612750,1610612742,108.0,128.0,0.442,0.485,0,2021-03-24,44,10,34,0.2269999999999999,42,23,19,0.5479999999999999
22000674,1610612760,1610612763,107.0,116.0,0.4529999999999999,0.475,0,2021-03-24,44,19,25,0.432,41,21,20,0.512
22000675,1610612759,1610612746,101.0,134.0,0.4589999999999999,0.557,0,2021-03-24,41,22,19,0.537,45,29,16,0.644
22000676,1610612762,1610612751,118.0,88.0,0.451,0.361,1,2021-03-24,43,32,11,0.7440000000000001,45,30,15,0.667
22000677,1610612758,1610612737,110.0,108.0,0.476,0.482,1,2021-03-24,44,19,25,0.432,44,22,22,0.5
22000661,1610612753,1610612743,99.0,110.0,0.4429999999999999,0.495,0,2021-03-23,43,14,29,0.326,43,26,17,0.605
22000662,1610612752,1610612764,131.0,113.0,0.511,0.481,1,2021-03-23,44,22,22,0.5,42,15,27,0.357
22000663,1610612740,1610612747,128.0,111.0,0.522,0.424,1,2021-03-23,43,19,24,0.442,44,28,16,0.636
22000664,1610612748,1610612756,100.0,110.0,0.419,0.495,0,2021-03-23,44,22,22,0.5,42,29,13,0.69
22000665,1610612744,1610612755,98.0,108.0,0.434,0.4529999999999999,0,2021-03-23,44,22,22,0.5,44,31,13,0.705
22000666,1610612757,1610612751,112.0,116.0,0.4,0.494,0,2021-03-23,43,25,18,0.581,44,30,14,0.682
22000653,1610612739,1610612758,105.0,119.0,0.427,0.544,0,2021-03-22,43,16,27,0.372,43,18,25,0.419
22000654,1610612750,1610612760,103.0,112.0,0.413,0.471,0,2021-03-22,43,10,33,0.233,43,19,24,0.442
22000655,1610612759,1610612766,97.0,100.0,0.462,0.42,0,2021-03-22,40,22,18,0.55,42,21,21,0.5
22000656,1610612741,1610612762,95.0,120.0,0.406,0.489,0,2021-03-22,42,19,23,0.452,42,31,11,0.738
22000657,1610612745,1610612761,117.0,99.0,0.456,0.425,1,2021-03-22,42,12,30,0.286,43,17,26,0.395
22000658,1610612763,1610612738,132.0,126.0,0.5,0.522,1,2021-03-22,40,20,20,0.5,43,21,22,0.488
22000659,1610612749,1610612754,140.0,113.0,0.564,0.405,1,2021-03-22,42,28,14,0.667,42,19,23,0.452
22000660,1610612746,1610612737,119.0,110.0,0.494,0.4529999999999999,1,2021-03-22,44,28,16,0.636,43,22,21,0.512
22000069,1610612766,1610612763,93.0,108.0,0.407,0.478,0,2021-01-01,5,2,3,0.4,5,2,3,0.4
22000070,1610612765,1610612738,96.0,93.0,0.409,0.47,1,2021-01-01,5,1,4,0.2,6,3,3,0.5
22000071,1610612742,1610612748,93.0,83.0,0.41,0.3720000000000001,1,2021-01-01,5,2,3,0.4,5,2,3,0.4
22000072,1610612751,1610612737,96.0,114.0,0.407,0.462,0,2021-01-01,6,3,3,0.5,5,4,1,0.8
22000073,1610612749,1610612741,126.0,96.0,0.494,0.4370000000000001,1,2021-01-01,6,3,3,0.5,6,2,4,0.333
22000073,1610612749,1610612741,126.0,96.0,0.494,0.4370000000000001,1,2021-01-01,6,3,3,0.5,6,2,4,0.3329999999999999
22000074,1610612750,1610612764,109.0,130.0,0.477,0.551,0,2021-01-01,5,2,3,0.4,6,1,5,0.1669999999999999
22000075,1610612759,1610612747,103.0,109.0,0.424,0.406,0,2021-01-01,5,2,3,0.4,6,4,2,0.667
22000076,1610612743,1610612756,103.0,106.0,0.459,0.487,0,2021-01-01,5,1,4,0.2,6,5,1,0.833
22000077,1610612762,1610612746,106.0,100.0,0.461,0.388,1,2021-01-01,5,3,2,0.6,6,4,2,0.667
22000078,1610612744,1610612757,98.0,123.0,0.392,0.435,0,2021-01-01,5,2,3,0.4,5,3,2,0.6
22000062,1610612754,1610612739,119.0,99.0,0.483,0.451,1,2020-12-31,5,4,1,0.8,5,3,2,0.6
22000063,1610612764,1610612741,130.0,133.0,0.5,0.5429999999999999,0,2020-12-31,5,0,5,0.0,5,2,3,0.4
22000064,1610612753,1610612755,92.0,116.0,0.347,0.484,0,2020-12-31,5,4,1,0.8,5,4,1,0.8
22000065,1610612745,1610612758,122.0,119.0,0.523,0.469,1,2020-12-31,3,1,2,0.333,5,3,2,0.6
22000065,1610612745,1610612758,122.0,119.0,0.523,0.469,1,2020-12-31,3,1,2,0.3329999999999999,5,3,2,0.6
22000066,1610612761,1610612752,100.0,83.0,0.41,0.364,1,2020-12-31,4,1,3,0.25,5,2,3,0.4
22000067,1610612760,1610612740,80.0,113.0,0.375,0.484,0,2020-12-31,4,1,3,0.25,5,3,2,0.6
22000068,1610612762,1610612756,95.0,106.0,0.417,0.488,0,2020-12-31,4,2,2,0.5,5,4,1,0.8
22000056,1610612738,1610612763,126.0,107.0,0.5379999999999999,0.43,1,2020-12-30,5,3,2,0.6,4,1,3,0.25
22000057,1610612751,1610612737,145.0,141.0,0.54,0.475,1,2020-12-30,5,3,2,0.6,4,3,1,0.75
22000058,1610612748,1610612749,119.0,108.0,0.488,0.392,1,2020-12-30,4,2,2,0.5,5,2,3,0.4
22000059,1610612742,1610612766,99.0,118.0,0.391,0.512,0,2020-12-30,4,1,3,0.25,4,2,2,0.5
22000060,1610612759,1610612747,107.0,121.0,0.46,0.561,0,2020-12-30,4,2,2,0.5,5,3,2,0.6
22000061,1610612746,1610612757,128.0,105.0,0.495,0.421,1,2020-12-30,5,4,1,0.8,4,2,2,0.5
22000046,1610612739,1610612752,86.0,95.0,0.364,0.43,0,2020-12-29,4,3,1,0.75,4,2,2,0.5
22000047,1610612765,1610612744,106.0,116.0,0.38,0.5,0,2020-12-29,4,0,4,0.0,4,2,2,0.5
22000048,1610612754,1610612738,111.0,116.0,0.512,0.5,0,2020-12-29,4,3,1,0.75,4,2,2,0.5
22000049,1610612755,1610612761,100.0,93.0,0.381,0.356,1,2020-12-29,4,3,1,0.75,3,0,3,0.0
22000050,1610612764,1610612741,107.0,115.0,0.44,0.4370000000000001,0,2020-12-29,4,0,4,0.0,4,1,3,0.25
22000051,1610612748,1610612749,97.0,144.0,0.468,0.5539999999999999,0,2020-12-29,3,1,2,0.333,4,2,2,0.5
22000051,1610612748,1610612749,97.0,144.0,0.468,0.5539999999999999,0,2020-12-29,3,1,2,0.3329999999999999,4,2,2,0.5
22000052,1610612760,1610612753,107.0,118.0,0.494,0.51,0,2020-12-29,3,1,2,0.333,4,4,0,1.0
22000052,1610612760,1610612753,107.0,118.0,0.494,0.51,0,2020-12-29,3,1,2,0.3329999999999999,4,4,0,1.0
22000053,1610612756,1610612740,111.0,86.0,0.44,0.481,1,2020-12-29,4,3,1,0.75,4,2,2,0.5
22000054,1610612746,1610612750,124.0,101.0,0.534,0.416,1,2020-12-29,4,3,1,0.75,4,2,2,0.5
22000055,1610612758,1610612743,125.0,115.0,0.489,0.5429999999999999,1,2020-12-29,4,3,1,0.75,4,1,3,0.25
22000041,1610612737,1610612765,128.0,120.0,0.488,0.439,1,2020-12-28,3,3,0,1.0,3,0,3,0.0
22000042,1610612751,1610612763,111.0,116.0,0.41,0.429,0,2020-12-28,4,2,2,0.5,3,1,2,0.333
22000042,1610612751,1610612763,111.0,116.0,0.41,0.429,0,2020-12-28,4,2,2,0.5,3,1,2,0.3329999999999999
22000043,1610612760,1610612762,109.0,110.0,0.465,0.5,0,2020-12-28,2,1,1,0.5,3,2,1,0.667
22000044,1610612743,1610612745,124.0,111.0,0.529,0.453,1,2020-12-28,3,1,2,0.333,2,0,2,0.0
22000044,1610612743,1610612745,124.0,111.0,0.529,0.453,1,2020-12-28,3,1,2,0.3329999999999999,2,0,2,0.0
22000045,1610612747,1610612757,107.0,115.0,0.471,0.467,0,2020-12-28,4,2,2,0.5,3,2,1,0.667
22000031,1610612746,1610612742,73.0,124.0,0.342,0.494,0,2020-12-27,3,2,1,0.667,3,1,2,0.333
22000031,1610612746,1610612742,73.0,124.0,0.342,0.494,0,2020-12-27,3,2,1,0.667,3,1,2,0.3329999999999999
22000032,1610612766,1610612751,106.0,104.0,0.448,0.4270000000000001,1,2020-12-27,3,1,2,0.333,3,2,1,0.667
22000032,1610612766,1610612751,106.0,104.0,0.448,0.4270000000000001,1,2020-12-27,3,1,2,0.3329999999999999,3,2,1,0.667
22000033,1610612764,1610612753,113.0,120.0,0.485,0.435,0,2020-12-27,3,0,3,0.0,3,3,0,1.0
22000034,1610612740,1610612759,98.0,95.0,0.383,0.4270000000000001,1,2020-12-27,3,2,1,0.667,3,2,1,0.667
22000035,1610612739,1610612755,118.0,94.0,0.527,0.418,1,2020-12-27,3,3,0,1.0,3,2,1,0.667
22000036,1610612752,1610612749,130.0,110.0,0.541,0.4320000000000001,1,2020-12-27,3,1,2,0.333,3,1,2,0.333
22000036,1610612752,1610612749,130.0,110.0,0.541,0.4320000000000001,1,2020-12-27,3,1,2,0.333,3,1,2,0.3329999999999999
22000036,1610612752,1610612749,130.0,110.0,0.541,0.4320000000000001,1,2020-12-27,3,1,2,0.3329999999999999,3,1,2,0.333
22000036,1610612752,1610612749,130.0,110.0,0.541,0.4320000000000001,1,2020-12-27,3,1,2,0.3329999999999999,3,1,2,0.3329999999999999
22000037,1610612754,1610612738,108.0,107.0,0.511,0.506,1,2020-12-27,3,3,0,1.0,3,1,2,0.333
22000037,1610612754,1610612738,108.0,107.0,0.511,0.506,1,2020-12-27,3,3,0,1.0,3,1,2,0.3329999999999999
22000038,1610612741,1610612744,128.0,129.0,0.512,0.404,0,2020-12-27,3,0,3,0.0,3,1,2,0.333
22000038,1610612741,1610612744,128.0,129.0,0.512,0.404,0,2020-12-27,3,0,3,0.0,3,1,2,0.3329999999999999
22000039,1610612758,1610612756,100.0,116.0,0.474,0.489,0,2020-12-27,3,2,1,0.667,3,2,1,0.667
22000040,1610612747,1610612750,127.0,91.0,0.556,0.369,1,2020-12-27,3,2,1,0.667,3,2,1,0.667
22000021,1610612763,1610612737,112.0,122.0,0.398,0.4270000000000001,0,2020-12-26,2,0,2,0.0,2,2,0,1.0
22000022,1610612766,1610612760,107.0,109.0,0.398,0.455,0,2020-12-26,2,0,2,0.0,1,1,0,1.0
22000023,1610612765,1610612739,119.0,128.0,0.408,0.485,0,2020-12-26,2,0,2,0.0,2,2,0,1.0
22000024,1610612764,1610612753,120.0,130.0,0.484,0.505,0,2020-12-26,2,0,2,0.0,2,2,0,1.0
22000025,1610612752,1610612755,89.0,109.0,0.386,0.466,0,2020-12-26,2,0,2,0.0,2,2,0,1.0
22000026,1610612741,1610612754,106.0,125.0,0.374,0.5589999999999999,0,2020-12-26,2,0,2,0.0,2,2,0,1.0
22000027,1610612759,1610612761,119.0,114.0,0.47,0.458,1,2020-12-26,2,2,0,1.0,2,0,2,0.0
22000028,1610612762,1610612750,111.0,116.0,0.383,0.446,0,2020-12-26,2,1,1,0.5,2,2,0,1.0
22000029,1610612757,1610612745,128.0,126.0,0.461,0.517,1,2020-12-26,2,1,1,0.5,1,0,1,0.0
22000030,1610612758,1610612756,106.0,103.0,0.453,0.418,1,2020-12-26,2,2,0,1.0,2,1,1,0.5
22000005,1610612748,1610612740,111.0,98.0,0.507,0.397,1,2020-12-25,2,1,1,0.5,2,1,1,0.5
22000006,1610612749,1610612744,138.0,99.0,0.556,0.343,1,2020-12-25,2,1,1,0.5,2,0,2,0.0
22000007,1610612738,1610612751,95.0,123.0,0.378,0.539,0,2020-12-25,2,1,1,0.5,2,2,0,1.0
22000008,1610612747,1610612742,138.0,115.0,0.56,0.494,1,2020-12-25,2,1,1,0.5,2,0,2,0.0
22000009,1610612743,1610612746,108.0,121.0,0.457,0.5539999999999999,0,2020-12-25,2,0,2,0.0,2,2,0,1.0
22000010,1610612739,1610612766,121.0,114.0,0.529,0.5,1,2020-12-23,1,1,0,1.0,1,0,1,0.0
22000011,1610612754,1610612752,121.0,107.0,0.489,0.459,1,2020-12-23,1,1,0,1.0,1,0,1,0.0
22000012,1610612753,1610612748,113.0,107.0,0.477,0.506,1,2020-12-23,1,1,0,1.0,1,0,1,0.0
22000013,1610612755,1610612764,113.0,107.0,0.471,0.459,1,2020-12-23,1,1,0,1.0,1,0,1,0.0
22000003,1610612738,1610612749,122.0,121.0,0.475,0.511,1,2020-12-23,1,1,0,1.0,1,0,1,0.0
22000014,1610612761,1610612740,99.0,113.0,0.4270000000000001,0.525,0,2020-12-23,1,0,1,0.0,1,1,0,1.0
22000015,1610612741,1610612737,104.0,124.0,0.414,0.5379999999999999,0,2020-12-23,1,0,1,0.0,1,1,0,1.0
22000017,1610612763,1610612759,119.0,131.0,0.516,0.505,0,2020-12-23,1,0,1,0.0,1,1,0,1.0
22000018,1610612750,1610612765,111.0,101.0,0.4320000000000001,0.484,1,2020-12-23,1,1,0,1.0,1,0,1,0.0
22000019,1610612743,1610612758,122.0,124.0,0.48,0.441,0,2020-12-23,1,0,1,0.0,1,1,0,1.0
22000020,1610612757,1610612762,100.0,120.0,0.402,0.457,0,2020-12-23,1,0,1,0.0,1,1,0,1.0
22000004,1610612756,1610612742,106.0,102.0,0.481,0.424,1,2020-12-23,1,1,0,1.0,1,0,1,0.0
22000001,1610612751,1610612744,125.0,99.0,0.457,0.374,1,2020-12-22,1,1,0,1.0,1,0,1,0.0
22000002,1610612747,1610612746,109.0,116.0,0.469,0.473,0,2020-12-22,1,0,1,0.0,1,1,0,1.0
22000645,1610612748,1610612754,106.0,109.0,0.402,0.3879999999999999,0,2021-03-21,43,22,21,0.512,41,19,22,0.4629999999999999
22000016,1610612745,1610612760,112.0,114.0,0.494,0.462,0,2021-03-21,41,11,30,0.268,42,18,24,0.429
22000646,1610612743,1610612740,108.0,113.0,0.5,0.482,0,2021-03-21,42,25,17,0.595,42,18,24,0.429
22000167,1610612738,1610612753,112.0,96.0,0.455,0.381,1,2021-03-21,42,21,21,0.5,42,14,28,0.3329999999999999
22000647,1610612751,1610612764,113.0,106.0,0.489,0.532,1,2021-03-21,43,29,14,0.674,41,15,26,0.366
22000648,1610612739,1610612761,116.0,105.0,0.506,0.389,1,2021-03-21,42,16,26,0.381,42,17,25,0.405
22000649,1610612765,1610612741,86.0,100.0,0.39,0.4629999999999999,0,2021-03-21,42,12,30,0.286,41,19,22,0.4629999999999999
22000650,1610612752,1610612755,100.0,101.0,0.4320000000000001,0.4629999999999999,0,2021-03-21,43,21,22,0.488,43,30,13,0.698
22000651,1610612756,1610612747,111.0,94.0,0.483,0.412,1,2021-03-21,41,28,13,0.6829999999999999,43,28,15,0.6509999999999999
22000652,1610612757,1610612742,92.0,132.0,0.382,0.5579999999999999,0,2021-03-21,42,25,17,0.595,41,22,19,0.537
22000640,1610612747,1610612737,94.0,99.0,0.42,0.3979999999999999,0,2021-03-20,42,28,14,0.667,42,22,20,0.524
22000641,1610612755,1610612758,129.0,105.0,0.5579999999999999,0.4589999999999999,1,2021-03-20,42,29,13,0.69,42,17,25,0.405
22000642,1610612763,1610612744,111.0,103.0,0.389,0.344,1,2021-03-20,39,19,20,0.487,43,22,21,0.512
22000643,1610612749,1610612759,120.0,113.0,0.489,0.479,1,2021-03-20,41,27,14,0.659,39,22,17,0.564
22000644,1610612746,1610612766,125.0,98.0,0.523,0.3879999999999999,1,2021-03-20,43,27,16,0.628,41,20,21,0.488
22000435,1610612739,1610612759,110.0,116.0,0.4379999999999999,0.466,0,2021-03-19,41,15,26,0.366,38,22,16,0.579
22000631,1610612738,1610612758,96.0,107.0,0.429,0.457,0,2021-03-19,41,20,21,0.488,41,17,24,0.415
22000632,1610612748,1610612754,110.0,137.0,0.446,0.584,0,2021-03-19,42,22,20,0.524,40,18,22,0.45
22000633,1610612753,1610612751,121.0,113.0,0.512,0.473,1,2021-03-19,41,14,27,0.341,42,28,14,0.667
22000634,1610612761,1610612762,112.0,115.0,0.482,0.4589999999999999,0,2021-03-19,41,17,24,0.415,41,30,11,0.732
22000635,1610612745,1610612765,100.0,113.0,0.4429999999999999,0.435,0,2021-03-19,40,11,29,0.275,41,12,29,0.293
22000636,1610612763,1610612744,103.0,116.0,0.4639999999999999,0.484,0,2021-03-19,38,18,20,0.474,42,22,20,0.524
22000637,1610612743,1610612741,131.0,127.0,0.527,0.522,1,2021-03-19,41,25,16,0.61,40,18,22,0.45
22000638,1610612756,1610612750,113.0,101.0,0.5,0.4679999999999999,1,2021-03-19,40,27,13,0.675,42,10,32,0.238
22000639,1610612757,1610612742,125.0,119.0,0.473,0.5429999999999999,1,2021-03-19,41,25,16,0.61,40,21,19,0.525
22000166,1610612764,1610612762,131.0,122.0,0.547,0.4579999999999999,1,2021-03-18,40,15,25,0.375,40,29,11,0.725
22000626,1610612737,1610612760,116.0,93.0,0.54,0.366,1,2021-03-18,41,21,20,0.512,41,17,24,0.415
22000627,1610612752,1610612753,94.0,93.0,0.43,0.4270000000000001,1,2021-03-18,42,21,21,0.5,40,13,27,0.325
22000628,1610612756,1610612750,119.0,123.0,0.529,0.473,0,2021-03-18,39,26,13,0.667,41,10,31,0.244
22000629,1610612757,1610612740,101.0,93.0,0.379,0.3979999999999999,1,2021-03-18,40,24,16,0.6,41,17,24,0.415
22000630,1610612747,1610612766,116.0,105.0,0.478,0.494,1,2021-03-18,41,28,13,0.6829999999999999,40,20,20,0.5
22000616,1610612765,1610612761,116.0,112.0,0.507,0.43,1,2021-03-17,40,11,29,0.275,40,17,23,0.425
22000617,1610612754,1610612751,115.0,124.0,0.512,0.483,0,2021-03-17,39,17,22,0.436,41,28,13,0.6829999999999999
22000618,1610612755,1610612749,105.0,109.0,0.3939999999999999,0.406,0,2021-03-17,41,28,13,0.6829999999999999,40,26,14,0.65
22000619,1610612764,1610612758,119.0,121.0,0.489,0.441,0,2021-03-17,39,14,25,0.359,40,16,24,0.4
22000620,1610612739,1610612738,117.0,110.0,0.541,0.455,1,2021-03-17,40,15,25,0.375,40,20,20,0.5
22000621,1610612741,1610612759,99.0,106.0,0.44,0.4270000000000001,0,2021-03-17,39,18,21,0.462,37,21,16,0.568
22000622,1610612745,1610612744,94.0,108.0,0.413,0.456,0,2021-03-17,39,11,28,0.282,41,21,20,0.512
22000623,1610612763,1610612748,89.0,85.0,0.353,0.36,1,2021-03-17,37,18,19,0.486,41,22,19,0.537
22000624,1610612743,1610612766,129.0,104.0,0.578,0.45,1,2021-03-17,40,24,16,0.6,39,20,19,0.513
22000625,1610612742,1610612746,105.0,89.0,0.506,0.42,1,2021-03-17,39,21,18,0.5379999999999999,42,26,16,0.619
22000609,1610612738,1610612762,109.0,117.0,0.49,0.475,0,2021-03-16,39,20,19,0.513,39,29,10,0.7440000000000001
22000610,1610612748,1610612739,113.0,98.0,0.494,0.4529999999999999,1,2021-03-16,40,22,18,0.55,39,14,25,0.359
22000611,1610612755,1610612752,99.0,96.0,0.411,0.44,1,2021-03-16,40,28,12,0.7,41,20,21,0.488
22000612,1610612741,1610612760,123.0,102.0,0.511,0.467,1,2021-03-16,38,18,20,0.474,40,17,23,0.425
22000613,1610612745,1610612737,107.0,119.0,0.477,0.512,0,2021-03-16,38,11,27,0.289,40,20,20,0.5
22000614,1610612757,1610612740,125.0,124.0,0.521,0.523,1,2021-03-16,39,23,16,0.59,40,17,23,0.425
22000615,1610612747,1610612750,137.0,121.0,0.575,0.522,1,2021-03-16,40,27,13,0.675,40,9,31,0.225
22000602,1610612766,1610612758,122.0,116.0,0.479,0.5579999999999999,1,2021-03-15,38,20,18,0.526,39,15,24,0.385
22000603,1610612764,1610612749,122.0,133.0,0.506,0.5529999999999999,0,2021-03-15,38,14,24,0.368,39,25,14,0.6409999999999999
22000428,1610612765,1610612759,99.0,109.0,0.47,0.5660000000000001,0,2021-03-15,39,10,29,0.256,36,20,16,0.556
22000604,1610612751,1610612752,117.0,112.0,0.579,0.402,1,2021-03-15,40,27,13,0.675,40,20,20,0.5
22000605,1610612742,1610612746,99.0,109.0,0.494,0.5,0,2021-03-15,38,20,18,0.526,41,26,15,0.634
22000606,1610612743,1610612754,121.0,106.0,0.4639999999999999,0.433,1,2021-03-15,39,23,16,0.59,38,17,21,0.447
22000607,1610612756,1610612763,122.0,99.0,0.5660000000000001,0.4370000000000001,1,2021-03-15,38,26,12,0.684,36,17,19,0.472
22000608,1610612744,1610612747,97.0,128.0,0.43,0.628,0,2021-03-15,40,20,20,0.5,39,26,13,0.667
22000593,1610612760,1610612763,128.0,122.0,0.575,0.511,1,2021-03-14,39,17,22,0.436,35,17,18,0.486
22000594,1610612744,1610612762,131.0,119.0,0.562,0.441,1,2021-03-14,39,20,19,0.513,38,28,10,0.737
22000595,1610612755,1610612759,134.0,99.0,0.5710000000000001,0.424,1,2021-03-14,39,27,12,0.6920000000000001,35,19,16,0.5429999999999999
22000596,1610612753,1610612748,97.0,102.0,0.44,0.416,0,2021-03-14,39,13,26,0.3329999999999999,39,21,18,0.5379999999999999
22000597,1610612737,1610612739,100.0,82.0,0.451,0.3829999999999999,1,2021-03-14,39,19,20,0.487,38,14,24,0.368
22000598,1610612745,1610612738,107.0,134.0,0.385,0.5539999999999999,0,2021-03-14,37,11,26,0.297,38,20,18,0.526
22000599,1610612750,1610612757,114.0,112.0,0.493,0.4379999999999999,1,2021-03-14,39,9,30,0.231,38,22,16,0.579
22000600,1610612741,1610612761,118.0,95.0,0.4539999999999999,0.3779999999999999,1,2021-03-14,37,17,20,0.4589999999999999,39,17,22,0.436
22000601,1610612740,1610612746,135.0,115.0,0.654,0.457,1,2021-03-14,39,17,22,0.436,40,25,15,0.625
22000586,1610612760,1610612752,97.0,119.0,0.487,0.489,0,2021-03-13,38,16,22,0.421,39,20,19,0.513
22000587,1610612751,1610612765,100.0,95.0,0.488,0.4039999999999999,1,2021-03-13,39,26,13,0.667,38,10,28,0.263
22000588,1610612766,1610612761,114.0,104.0,0.481,0.385,1,2021-03-13,37,19,18,0.514,38,17,21,0.447
22000589,1610612764,1610612749,119.0,125.0,0.457,0.434,0,2021-03-13,37,14,23,0.3779999999999999,38,24,14,0.632
22000590,1610612737,1610612758,121.0,106.0,0.512,0.439,1,2021-03-13,38,18,20,0.474,38,15,23,0.395
22000591,1610612750,1610612757,121.0,125.0,0.512,0.483,0,2021-03-13,38,8,30,0.211,37,22,15,0.595
22000194,1610612756,1610612754,111.0,122.0,0.473,0.529,0,2021-03-13,37,25,12,0.6759999999999999,37,17,20,0.4589999999999999
22000592,1610612743,1610612742,103.0,116.0,0.411,0.488,0,2021-03-13,38,22,16,0.579,37,20,17,0.541
22000579,1610612764,1610612755,101.0,127.0,0.488,0.544,0,2021-03-12,36,14,22,0.389,38,26,12,0.684
22000580,1610612763,1610612743,102.0,103.0,0.46,0.446,0,2021-03-12,34,17,17,0.5,37,22,15,0.595
22000581,1610612740,1610612739,116.0,82.0,0.465,0.341,1,2021-03-12,38,16,22,0.421,37,14,23,0.3779999999999999
22000582,1610612741,1610612748,90.0,101.0,0.374,0.4629999999999999,0,2021-03-12,36,16,20,0.444,38,20,18,0.526
22000583,1610612759,1610612753,104.0,77.0,0.449,0.363,1,2021-03-12,34,19,15,0.5589999999999999,38,13,25,0.342
22000584,1610612762,1610612745,114.0,99.0,0.481,0.369,1,2021-03-12,37,28,9,0.757,36,11,25,0.306
22000585,1610612747,1610612754,105.0,100.0,0.447,0.42,1,2021-03-12,38,25,13,0.6579999999999999,36,16,20,0.444
22000568,1610612766,1610612765,105.0,102.0,0.4,0.447,1,2021-03-11,36,18,18,0.5,37,10,27,0.27
22000569,1610612751,1610612738,121.0,109.0,0.477,0.451,1,2021-03-11,38,25,13,0.6579999999999999,37,19,18,0.514
22000570,1610612761,1610612737,120.0,121.0,0.4379999999999999,0.433,0,2021-03-11,37,17,20,0.4589999999999999,37,17,20,0.4589999999999999
22000571,1610612748,1610612753,111.0,103.0,0.451,0.406,1,2021-03-11,37,19,18,0.514,37,13,24,0.351
22000572,1610612741,1610612755,105.0,127.0,0.47,0.515,0,2021-03-11,35,16,19,0.457,37,25,12,0.6759999999999999
22000573,1610612749,1610612752,134.0,101.0,0.575,0.42,1,2021-03-11,37,23,14,0.622,38,19,19,0.5
22000574,1610612740,1610612750,105.0,135.0,0.43,0.537,0,2021-03-11,37,15,22,0.405,37,8,29,0.216
22000575,1610612760,1610612742,116.0,108.0,0.451,0.4270000000000001,1,2021-03-11,37,16,21,0.4320000000000001,36,19,17,0.528
22000576,1610612746,1610612744,130.0,104.0,0.4579999999999999,0.4320000000000001,1,2021-03-11,39,25,14,0.6409999999999999,38,19,19,0.5
22000577,1610612757,1610612756,121.0,127.0,0.457,0.59,0,2021-03-11,36,21,15,0.583,36,25,11,0.6940000000000001
22000578,1610612758,1610612745,125.0,105.0,0.489,0.414,1,2021-03-11,37,15,22,0.405,35,11,24,0.314
22000566,1610612763,1610612764,127.0,112.0,0.505,0.4,1,2021-03-10,33,17,16,0.515,35,14,21,0.4
22000567,1610612742,1610612759,115.0,104.0,0.518,0.4579999999999999,1,2021-03-10,35,19,16,0.5429999999999999,33,18,15,0.545
22000552,1610612738,1610612761,132.0,125.0,0.608,0.495,1,2021-03-04,36,19,17,0.528,36,17,19,0.472
22000554,1610612764,1610612746,119.0,117.0,0.455,0.4629999999999999,1,2021-03-04,34,14,20,0.412,38,24,14,0.632
22000565,1610612752,1610612765,114.0,104.0,0.542,0.488,1,2021-03-04,37,19,18,0.514,36,10,26,0.278
22000553,1610612754,1610612743,103.0,113.0,0.456,0.584,0,2021-03-04,35,16,19,0.457,36,21,15,0.583
22000555,1610612763,1610612749,111.0,112.0,0.396,0.442,0,2021-03-04,32,16,16,0.5,36,22,14,0.611
22000557,1610612740,1610612748,93.0,103.0,0.3929999999999999,0.493,0,2021-03-04,36,15,21,0.417,36,18,18,0.5
22000556,1610612759,1610612760,102.0,107.0,0.471,0.435,0,2021-03-04,32,18,14,0.563,36,15,21,0.417
22000185,1610612756,1610612744,120.0,98.0,0.51,0.4320000000000001,1,2021-03-04,35,24,11,0.6859999999999999,37,19,18,0.514
22000558,1610612757,1610612758,123.0,119.0,0.477,0.476,1,2021-03-04,35,21,14,0.6,36,14,22,0.389
22000539,1610612761,1610612765,105.0,129.0,0.442,0.527,0,2021-03-03,35,17,18,0.486,35,10,25,0.286
22000543,1610612739,1610612754,111.0,114.0,0.518,0.5660000000000001,0,2021-03-03,36,14,22,0.389,34,16,18,0.471
22000545,1610612755,1610612762,131.0,123.0,0.516,0.44,1,2021-03-03,36,24,12,0.667,36,27,9,0.75
22000546,1610612745,1610612751,114.0,132.0,0.418,0.5760000000000001,0,2021-03-03,34,11,23,0.324,37,24,13,0.649
22000544,1610612753,1610612737,112.0,115.0,0.429,0.447,0,2021-03-03,36,13,23,0.361,36,16,20,0.444
22000547,1610612750,1610612766,102.0,135.0,0.406,0.52,0,2021-03-03,36,7,29,0.1939999999999999,35,17,18,0.486
22000548,1610612740,1610612741,124.0,128.0,0.5539999999999999,0.511,0,2021-03-03,35,15,20,0.429,34,16,18,0.471
22000549,1610612742,1610612760,87.0,78.0,0.386,0.3329999999999999,1,2021-03-03,34,18,16,0.529,35,14,21,0.4
22000550,1610612757,1610612744,108.0,106.0,0.419,0.423,1,2021-03-03,34,20,14,0.588,36,19,17,0.528
22000551,1610612758,1610612747,123.0,120.0,0.6,0.527,1,2021-03-03,35,14,21,0.4,37,24,13,0.649
22000536,1610612764,1610612763,111.0,125.0,0.506,0.495,0,2021-03-02,33,13,20,0.3939999999999999,31,16,15,0.516
22000537,1610612738,1610612746,117.0,112.0,0.488,0.494,1,2021-03-02,35,18,17,0.514,37,24,13,0.649
22000538,1610612748,1610612737,80.0,94.0,0.373,0.479,0,2021-03-02,35,17,18,0.486,35,15,20,0.429
22000541,1610612759,1610612752,119.0,93.0,0.483,0.407,1,2021-03-02,31,18,13,0.581,36,18,18,0.5
22000540,1610612749,1610612743,97.0,128.0,0.405,0.5579999999999999,0,2021-03-02,35,21,14,0.6,35,20,15,0.5710000000000001
22000542,1610612747,1610612756,104.0,114.0,0.506,0.494,0,2021-03-02,36,24,12,0.667,34,23,11,0.6759999999999999
22000529,1610612753,1610612742,124.0,130.0,0.495,0.522,0,2021-03-01,35,13,22,0.371,33,17,16,0.515
22000530,1610612755,1610612754,130.0,114.0,0.568,0.484,1,2021-03-01,35,23,12,0.657,33,15,18,0.455
22000531,1610612741,1610612743,112.0,118.0,0.447,0.529,0,2021-03-01,33,15,18,0.455,34,19,15,0.5589999999999999
22000533,1610612740,1610612762,129.0,124.0,0.565,0.455,1,2021-03-01,34,15,19,0.441,35,27,8,0.7709999999999999
22000534,1610612759,1610612751,113.0,124.0,0.4539999999999999,0.47,0,2021-03-01,30,17,13,0.5670000000000001,36,23,13,0.639
22000532,1610612745,1610612739,90.0,101.0,0.408,0.493,0,2021-03-01,33,11,22,0.3329999999999999,35,14,21,0.4
22000535,1610612757,1610612766,123.0,111.0,0.535,0.489,1,2021-03-01,33,19,14,0.5760000000000001,34,16,18,0.471
22000520,1610612749,1610612746,105.0,100.0,0.447,0.412,1,2021-02-28,34,21,13,0.618,36,24,12,0.667
22000524,1610612738,1610612764,111.0,110.0,0.472,0.452,1,2021-02-28,34,17,17,0.5,32,13,19,0.406
22000521,1610612765,1610612752,90.0,109.0,0.389,0.512,0,2021-02-28,34,9,25,0.265,35,18,17,0.514
22000522,1610612748,1610612737,109.0,99.0,0.4529999999999999,0.414,1,2021-02-28,34,17,17,0.5,34,14,20,0.412
22000525,1610612745,1610612763,84.0,133.0,0.2769999999999999,0.532,0,2021-02-28,32,11,21,0.344,30,15,15,0.5
22000527,1610612747,1610612744,117.0,91.0,0.471,0.407,1,2021-02-28,35,24,11,0.6859999999999999,35,19,16,0.5429999999999999
22000526,1610612750,1610612756,99.0,118.0,0.376,0.494,0,2021-02-28,35,7,28,0.2,33,22,11,0.667
22000528,1610612758,1610612766,126.0,127.0,0.5429999999999999,0.542,0,2021-02-28,34,13,21,0.382,33,16,17,0.485
22000513,1610612755,1610612739,109.0,112.0,0.4579999999999999,0.423,0,2021-02-27,34,22,12,0.647,34,13,21,0.382
22000517,1610612764,1610612750,128.0,112.0,0.449,0.4320000000000001,1,2021-02-27,31,13,18,0.419,34,7,27,0.206
22000514,1610612759,1610612740,117.0,114.0,0.477,0.44,1,2021-02-27,29,17,12,0.586,33,14,19,0.424
22000515,1610612752,1610612754,110.0,107.0,0.494,0.452,1,2021-02-27,34,17,17,0.5,32,15,17,0.469
22000516,1610612753,1610612762,109.0,124.0,0.4579999999999999,0.529,0,2021-02-27,34,13,21,0.382,34,27,7,0.794
22000518,1610612760,1610612743,96.0,126.0,0.42,0.551,0,2021-02-27,34,14,20,0.412,33,18,15,0.545
22000519,1610612751,1610612742,98.0,115.0,0.407,0.523,0,2021-02-27,35,22,13,0.629,32,16,16,0.5
22000505,1610612738,1610612754,118.0,112.0,0.512,0.3929999999999999,1,2021-02-26,33,16,17,0.485,31,15,16,0.484
22000506,1610612761,1610612745,122.0,111.0,0.449,0.429,1,2021-02-26,34,17,17,0.5,31,11,20,0.355
22000504,1610612765,1610612758,107.0,110.0,0.451,0.416,0,2021-02-26,33,9,24,0.273,33,13,20,0.3939999999999999
22000507,1610612748,1610612762,124.0,116.0,0.512,0.426,1,2021-02-26,33,16,17,0.485,33,26,7,0.7879999999999999
22000508,1610612741,1610612756,97.0,106.0,0.5,0.5,0,2021-02-26,32,15,17,0.469,32,21,11,0.6559999999999999
22000509,1610612763,1610612746,99.0,119.0,0.402,0.55,0,2021-02-26,29,14,15,0.483,35,24,11,0.6859999999999999
22000510,1610612760,1610612737,118.0,109.0,0.523,0.4429999999999999,1,2021-02-26,33,14,19,0.424,33,14,19,0.424
22000511,1610612744,1610612766,130.0,121.0,0.608,0.461,1,2021-02-26,34,19,15,0.5589999999999999,32,15,17,0.469
22000512,1610612747,1610612757,102.0,93.0,0.42,0.386,1,2021-02-26,34,23,11,0.6759999999999999,32,18,14,0.563
22000498,1610612755,1610612742,111.0,97.0,0.433,0.41,1,2021-02-25,33,22,11,0.667,31,15,16,0.484
22000499,1610612751,1610612753,129.0,92.0,0.5329999999999999,0.402,1,2021-02-25,34,22,12,0.647,33,13,20,0.3939999999999999
22000500,1610612752,1610612758,140.0,121.0,0.586,0.494,1,2021-02-25,33,16,17,0.485,32,12,20,0.375
22000501,1610612763,1610612746,122.0,94.0,0.5429999999999999,0.405,1,2021-02-25,28,14,14,0.5,34,23,11,0.6759999999999999
22000502,1610612743,1610612764,110.0,112.0,0.435,0.477,0,2021-02-25,32,17,15,0.531,30,12,18,0.4
22000503,1610612749,1610612740,129.0,125.0,0.542,0.5,1,2021-02-25,33,20,13,0.606,32,14,18,0.4379999999999999
22000489,1610612754,1610612744,107.0,111.0,0.457,0.47,0,2021-02-24,30,15,15,0.5,33,18,15,0.545
22000490,1610612737,1610612738,127.0,112.0,0.529,0.442,1,2021-02-24,32,14,18,0.4379999999999999,32,15,17,0.469
22000491,1610612739,1610612745,112.0,96.0,0.506,0.4,1,2021-02-24,33,12,21,0.364,30,11,19,0.3670000000000001
22000492,1610612748,1610612761,116.0,108.0,0.4629999999999999,0.5,1,2021-02-24,32,15,17,0.469,33,16,17,0.485
22000493,1610612741,1610612750,133.0,126.0,0.591,0.452,1,2021-02-24,31,15,16,0.484,33,7,26,0.212
22000494,1610612740,1610612765,128.0,118.0,0.556,0.528,1,2021-02-24,31,14,17,0.452,32,9,23,0.281
22000495,1610612760,1610612759,102.0,99.0,0.416,0.465,1,2021-02-24,32,13,19,0.406,28,16,12,0.5710000000000001
22000496,1610612756,1610612766,121.0,124.0,0.506,0.489,0,2021-02-24,31,20,11,0.645,31,15,16,0.484
22000497,1610612762,1610612747,114.0,89.0,0.471,0.4,1,2021-02-24,32,26,6,0.813,33,22,11,0.667
22000480,1610612739,1610612737,112.0,111.0,0.526,0.449,1,2021-02-23,32,11,21,0.344,31,13,18,0.419
22000481,1610612753,1610612765,93.0,105.0,0.375,0.466,0,2021-02-23,32,13,19,0.406,31,9,22,0.29
22000482,1610612751,1610612758,127.0,118.0,0.494,0.517,1,2021-02-23,33,21,12,0.636,31,12,19,0.387
22000483,1610612752,1610612744,106.0,114.0,0.392,0.449,0,2021-02-23,32,15,17,0.469,32,17,15,0.531
22000484,1610612761,1610612755,102.0,109.0,0.43,0.413,0,2021-02-23,32,16,16,0.5,32,21,11,0.6559999999999999
22000485,1610612742,1610612738,110.0,107.0,0.472,0.477,1,2021-02-23,30,15,15,0.5,31,15,16,0.484
22000486,1610612749,1610612750,139.0,112.0,0.535,0.429,1,2021-02-23,32,19,13,0.594,32,7,25,0.2189999999999999
22000487,1610612743,1610612757,111.0,106.0,0.426,0.471,1,2021-02-23,31,17,14,0.5479999999999999,31,18,13,0.581
22000488,1610612746,1610612764,135.0,116.0,0.574,0.534,1,2021-02-23,33,23,10,0.6970000000000001,29,11,18,0.379
22000474,1610612745,1610612741,100.0,120.0,0.385,0.5379999999999999,0,2021-02-22,29,11,18,0.379,30,14,16,0.467
22000476,1610612742,1610612763,102.0,92.0,0.4379999999999999,0.3939999999999999,1,2021-02-22,29,14,15,0.483,27,13,14,0.481
22000475,1610612760,1610612748,94.0,108.0,0.4320000000000001,0.444,0,2021-02-22,31,12,19,0.387,31,14,17,0.452
22000477,1610612756,1610612757,132.0,100.0,0.505,0.44,1,2021-02-22,30,20,10,0.667,30,18,12,0.6
22000478,1610612762,1610612766,132.0,110.0,0.529,0.461,1,2021-02-22,31,25,6,0.8059999999999999,30,14,16,0.467
22000479,1610612747,1610612764,124.0,127.0,0.471,0.49,0,2021-02-22,32,22,10,0.688,28,11,17,0.3929999999999999
22000465,1610612740,1610612738,120.0,115.0,0.447,0.3979999999999999,1,2021-02-21,30,13,17,0.433,30,15,15,0.5
22000466,1610612739,1610612760,101.0,117.0,0.4639999999999999,0.544,0,2021-02-21,31,10,21,0.3229999999999999,30,12,18,0.4
22000467,1610612753,1610612765,105.0,96.0,0.4320000000000001,0.374,1,2021-02-21,31,13,18,0.419,30,8,22,0.267
22000468,1610612761,1610612755,110.0,103.0,0.494,0.3879999999999999,1,2021-02-21,31,16,15,0.516,31,20,11,0.645
22000469,1610612752,1610612750,103.0,99.0,0.423,0.402,1,2021-02-21,31,15,16,0.484,31,7,24,0.226
22000470,1610612737,1610612743,123.0,115.0,0.519,0.512,1,2021-02-21,30,13,17,0.433,30,16,14,0.5329999999999999
22000472,1610612746,1610612751,108.0,112.0,0.46,0.478,0,2021-02-21,32,22,10,0.688,32,20,12,0.625
22000471,1610612749,1610612758,128.0,115.0,0.489,0.44,1,2021-02-21,31,18,13,0.581,30,12,18,0.4
22000459,1610612766,1610612744,102.0,100.0,0.493,0.435,1,2021-02-20,29,14,15,0.483,31,16,15,0.516
22000463,1610612747,1610612748,94.0,96.0,0.3929999999999999,0.424,0,2021-02-20,31,22,9,0.71,30,13,17,0.433
22000460,1610612741,1610612758,122.0,114.0,0.598,0.449,1,2021-02-20,29,13,16,0.4479999999999999,29,12,17,0.414
22000462,1610612763,1610612756,97.0,128.0,0.387,0.535,0,2021-02-20,26,13,13,0.5,29,19,10,0.655
22000464,1610612757,1610612764,111.0,118.0,0.359,0.506,0,2021-02-20,29,18,11,0.621,27,10,17,0.37
22000449,1610612753,1610612744,124.0,120.0,0.489,0.474,1,2021-02-19,30,12,18,0.4,30,16,14,0.5329999999999999
22000563,1610612739,1610612743,103.0,120.0,0.47,0.575,0,2021-02-19,30,10,20,0.3329999999999999,29,16,13,0.552
22000450,1610612755,1610612741,112.0,105.0,0.471,0.421,1,2021-02-19,30,20,10,0.667,28,12,16,0.429
22000451,1610612738,1610612737,121.0,109.0,0.556,0.422,1,2021-02-19,29,15,14,0.517,29,12,17,0.414
22000452,1610612763,1610612765,109.0,95.0,0.467,0.419,1,2021-02-19,25,13,12,0.52,29,8,21,0.276
22000453,1610612749,1610612760,98.0,85.0,0.407,0.365,1,2021-02-19,30,17,13,0.5670000000000001,29,11,18,0.379
22000455,1610612740,1610612756,114.0,132.0,0.512,0.58,0,2021-02-19,29,12,17,0.414,28,18,10,0.643
22000454,1610612750,1610612761,81.0,86.0,0.386,0.3289999999999999,0,2021-02-19,30,7,23,0.233,30,15,15,0.5
22000457,1610612746,1610612762,116.0,112.0,0.483,0.477,1,2021-02-19,31,22,9,0.71,30,24,6,0.8
22000445,1610612749,1610612761,96.0,110.0,0.3979999999999999,0.487,0,2021-02-18,29,16,13,0.552,29,14,15,0.483
22000446,1610612747,1610612751,98.0,109.0,0.482,0.494,0,2021-02-18,30,22,8,0.733,31,19,12,0.613
22000447,1610612758,1610612748,110.0,118.0,0.462,0.516,0,2021-02-18,28,12,16,0.429,29,12,17,0.414
22000436,1610612753,1610612752,107.0,89.0,0.457,0.379,1,2021-02-17,29,11,18,0.379,30,14,16,0.467
22000438,1610612738,1610612737,114.0,122.0,0.465,0.5710000000000001,0,2021-02-17,28,14,14,0.5,28,12,16,0.429
22000439,1610612755,1610612745,118.0,113.0,0.481,0.457,1,2021-02-17,29,19,10,0.655,28,11,17,0.3929999999999999
22000437,1610612764,1610612743,130.0,128.0,0.512,0.522,1,2021-02-17,26,9,17,0.346,28,15,13,0.536
22000440,1610612750,1610612754,128.0,134.0,0.421,0.505,0,2021-02-17,29,7,22,0.241,29,15,14,0.517
22000564,1610612741,1610612765,105.0,102.0,0.482,0.451,1,2021-02-17,27,12,15,0.444,28,8,20,0.286
22000441,1610612740,1610612757,124.0,126.0,0.483,0.511,0,2021-02-17,28,12,16,0.429,28,18,10,0.643
22000562,1610612763,1610612760,122.0,113.0,0.506,0.449,1,2021-02-17,24,12,12,0.5,28,11,17,0.3929999999999999
22000443,1610612744,1610612748,120.0,112.0,0.4529999999999999,0.4539999999999999,1,2021-02-17,29,16,13,0.552,28,11,17,0.3929999999999999
22000444,1610612746,1610612762,96.0,114.0,0.442,0.429,0,2021-02-17,30,21,9,0.7,29,24,5,0.828
22000427,1610612738,1610612743,112.0,99.0,0.481,0.452,1,2021-02-16,27,14,13,0.519,27,15,12,0.556
22000429,1610612763,1610612740,113.0,144.0,0.477,0.615,0,2021-02-16,23,11,12,0.478,27,12,15,0.444
22000430,1610612749,1610612761,113.0,124.0,0.482,0.505,0,2021-02-16,28,16,12,0.5710000000000001,28,13,15,0.4639999999999999
22000431,1610612750,1610612747,104.0,112.0,0.419,0.545,0,2021-02-16,28,7,21,0.25,29,22,7,0.759
22000432,1610612760,1610612757,104.0,115.0,0.435,0.4379999999999999,0,2021-02-16,27,11,16,0.407,27,17,10,0.63
22000433,1610612756,1610612751,124.0,128.0,0.545,0.573,0,2021-02-16,27,17,10,0.63,30,18,12,0.6
22000420,1610612754,1610612741,112.0,120.0,0.424,0.431,0,2021-02-15,28,14,14,0.5,26,11,15,0.423
22000421,1610612764,1610612745,131.0,119.0,0.522,0.473,1,2021-02-15,25,8,17,0.32,27,11,16,0.407
22000422,1610612752,1610612737,123.0,112.0,0.506,0.424,1,2021-02-15,29,14,15,0.483,27,11,16,0.407
22000423,1610612762,1610612755,134.0,123.0,0.523,0.5,1,2021-02-15,28,23,5,0.821,28,18,10,0.643
22000424,1610612744,1610612739,129.0,98.0,0.523,0.389,1,2021-02-15,28,15,13,0.536,29,10,19,0.345
22000425,1610612746,1610612748,125.0,118.0,0.5529999999999999,0.505,1,2021-02-15,29,21,8,0.7240000000000001,27,11,16,0.407
22000426,1610612758,1610612751,125.0,136.0,0.531,0.573,0,2021-02-15,27,12,15,0.444,29,17,12,0.586
22000560,1610612764,1610612738,104.0,91.0,0.3979999999999999,0.356,1,2021-02-14,24,7,17,0.292,26,13,13,0.5
22000413,1610612761,1610612750,112.0,116.0,0.418,0.524,0,2021-02-14,27,12,15,0.444,27,7,20,0.259
22000414,1610612766,1610612759,110.0,122.0,0.474,0.5,0,2021-02-14,28,13,15,0.4639999999999999,27,16,11,0.593
22000561,1610612765,1610612740,123.0,112.0,0.536,0.444,1,2021-02-14,27,8,19,0.296,26,11,15,0.423
22000411,1610612742,1610612757,118.0,121.0,0.494,0.529,0,2021-02-14,28,13,15,0.4639999999999999,26,16,10,0.615
22000415,1610612760,1610612749,114.0,109.0,0.474,0.4639999999999999,1,2021-02-14,26,11,15,0.423,27,16,11,0.593
22000417,1610612756,1610612753,109.0,90.0,0.446,0.371,1,2021-02-14,26,17,9,0.654,28,10,18,0.357
22000416,1610612743,1610612747,122.0,105.0,0.4589999999999999,0.46,1,2021-02-14,26,15,11,0.5770000000000001,28,21,7,0.75
22000418,1610612758,1610612763,110.0,124.0,0.5,0.532,0,2021-02-14,26,12,14,0.462,22,11,11,0.5
22000419,1610612746,1610612739,128.0,111.0,0.477,0.462,1,2021-02-14,28,20,8,0.7140000000000001,28,10,18,0.357
22000406,1610612756,1610612755,120.0,111.0,0.608,0.521,1,2021-02-13,25,16,9,0.64,27,18,9,0.667
22000407,1610612737,1610612754,113.0,125.0,0.478,0.506,0,2021-02-13,26,11,15,0.423,27,14,13,0.519
22000408,1610612752,1610612745,121.0,99.0,0.523,0.375,1,2021-02-13,28,13,15,0.4639999999999999,26,11,15,0.423
22000409,1610612744,1610612751,117.0,134.0,0.489,0.5379999999999999,0,2021-02-13,27,14,13,0.519,28,16,12,0.5710000000000001
22000410,1610612762,1610612748,112.0,94.0,0.4589999999999999,0.407,1,2021-02-13,27,22,5,0.815,26,11,15,0.423
22000395,1610612766,1610612750,120.0,114.0,0.489,0.455,1,2021-02-12,27,13,14,0.481,26,6,20,0.231
22000396,1610612764,1610612752,91.0,109.0,0.382,0.449,0,2021-02-12,23,6,17,0.261,27,12,15,0.444
22000397,1610612737,1610612759,114.0,125.0,0.433,0.529,0,2021-02-12,25,11,14,0.44,26,15,11,0.5770000000000001
22000399,1610612742,1610612740,143.0,130.0,0.58,0.5329999999999999,1,2021-02-12,27,13,14,0.481,25,11,14,0.44
22000400,1610612741,1610612746,106.0,125.0,0.471,0.581,0,2021-02-12,25,10,15,0.4,27,19,8,0.7040000000000001
22000412,1610612738,1610612765,102.0,108.0,0.439,0.43,0,2021-02-12,25,13,12,0.52,26,7,19,0.2689999999999999
22000401,1610612743,1610612760,97.0,95.0,0.46,0.4,1,2021-02-12,25,14,11,0.56,25,10,15,0.4
22000402,1610612762,1610612749,129.0,115.0,0.524,0.457,1,2021-02-12,26,21,5,0.8079999999999999,26,16,10,0.615
22000403,1610612747,1610612763,115.0,105.0,0.506,0.488,1,2021-02-12,27,21,6,0.778,21,10,11,0.476
22000404,1610612757,1610612739,129.0,110.0,0.518,0.4370000000000001,1,2021-02-12,25,15,10,0.6,27,10,17,0.37
22000405,1610612758,1610612753,112.0,123.0,0.518,0.505,0,2021-02-12,25,12,13,0.48,27,10,17,0.37
22000392,1610612745,1610612748,94.0,101.0,0.386,0.43,0,2021-02-11,25,11,14,0.44,25,11,14,0.44
22000398,1610612738,1610612761,120.0,106.0,0.4529999999999999,0.494,1,2021-02-11,24,13,11,0.542,26,12,14,0.462
22000391,1610612765,1610612754,95.0,111.0,0.447,0.512,0,2021-02-11,25,6,19,0.24,26,13,13,0.5
22000393,1610612744,1610612753,111.0,105.0,0.466,0.392,1,2021-02-11,26,14,12,0.5379999999999999,26,9,17,0.346
22000394,1610612757,1610612755,118.0,114.0,0.43,0.488,1,2021-02-11,24,14,10,0.583,26,18,8,0.6920000000000001
22000382,1610612764,1610612761,115.0,137.0,0.452,0.527,0,2021-02-10,22,6,16,0.273,25,12,13,0.48
22000384,1610612742,1610612737,118.0,117.0,0.512,0.455,1,2021-02-10,26,12,14,0.462,24,11,13,0.4579999999999999
22000383,1610612751,1610612754,104.0,94.0,0.421,0.391,1,2021-02-10,27,15,12,0.556,25,12,13,0.48
22000386,1610612763,1610612766,130.0,114.0,0.5,0.5489999999999999,1,2021-02-10,20,10,10,0.5,26,12,14,0.462
22000387,1610612750,1610612746,112.0,119.0,0.4320000000000001,0.5,0,2021-02-10,25,6,19,0.24,26,18,8,0.6920000000000001
22000385,1610612741,1610612740,129.0,116.0,0.593,0.506,1,2021-02-10,24,10,14,0.417,24,11,13,0.4579999999999999
22000388,1610612743,1610612739,133.0,95.0,0.6,0.3829999999999999,1,2021-02-10,24,13,11,0.542,26,10,16,0.385
22000389,1610612756,1610612749,125.0,124.0,0.529,0.506,1,2021-02-10,24,15,9,0.625,25,16,9,0.64
22000390,1610612747,1610612760,114.0,113.0,0.472,0.47,1,2021-02-10,26,20,6,0.769,24,10,14,0.417
22000375,1610612765,1610612751,122.0,111.0,0.56,0.5,1,2021-02-09,24,6,18,0.25,26,14,12,0.5379999999999999
22000376,1610612748,1610612752,98.0,96.0,0.371,0.425,1,2021-02-09,24,10,14,0.417,26,11,15,0.423
22000377,1610612740,1610612745,130.0,101.0,0.511,0.418,1,2021-02-09,23,11,12,0.478,24,11,13,0.4579999999999999
22000378,1610612759,1610612744,91.0,114.0,0.3720000000000001,0.462,0,2021-02-09,25,14,11,0.56,25,13,12,0.52
22000379,1610612762,1610612738,122.0,108.0,0.476,0.442,1,2021-02-09,25,20,5,0.8,23,12,11,0.522
22000380,1610612757,1610612753,106.0,97.0,0.389,0.42,1,2021-02-09,23,13,10,0.565,25,9,16,0.36
22000381,1610612758,1610612755,111.0,119.0,0.434,0.482,0,2021-02-09,24,12,12,0.5,25,18,7,0.72
22000367,1610612766,1610612745,119.0,94.0,0.489,0.407,1,2021-02-08,25,12,13,0.48,23,11,12,0.478
22000368,1610612741,1610612764,101.0,105.0,0.424,0.419,0,2021-02-08,23,9,14,0.391,21,6,15,0.286
22000369,1610612763,1610612761,113.0,128.0,0.425,0.545,0,2021-02-08,19,9,10,0.474,24,11,13,0.4579999999999999
22000370,1610612742,1610612750,127.0,122.0,0.517,0.462,1,2021-02-08,25,11,14,0.44,24,6,18,0.25
22000371,1610612759,1610612744,105.0,100.0,0.406,0.442,1,2021-02-08,24,14,10,0.583,24,12,12,0.5
22000372,1610612756,1610612739,119.0,113.0,0.522,0.512,1,2021-02-08,23,14,9,0.609,25,10,15,0.4
22000373,1610612743,1610612749,112.0,125.0,0.436,0.506,0,2021-02-08,23,12,11,0.522,24,16,8,0.667
22000374,1610612747,1610612760,119.0,112.0,0.4629999999999999,0.391,1,2021-02-08,25,19,6,0.76,23,10,13,0.435
22000215,1610612766,1610612764,119.0,97.0,0.424,0.3779999999999999,1,2021-02-07,24,11,13,0.4579999999999999,20,5,15,0.25
22000363,1610612754,1610612762,95.0,103.0,0.3979999999999999,0.413,0,2021-02-07,24,12,12,0.5,24,19,5,0.792
22000364,1610612752,1610612748,103.0,109.0,0.447,0.482,0,2021-02-07,25,11,14,0.44,23,9,14,0.391
22000365,1610612756,1610612738,100.0,91.0,0.488,0.355,1,2021-02-07,22,13,9,0.591,22,12,10,0.545
22000366,1610612746,1610612758,110.0,113.0,0.414,0.489,0,2021-02-07,25,17,8,0.68,23,12,11,0.522
22000351,1610612752,1610612757,110.0,99.0,0.5,0.416,1,2021-02-06,24,11,13,0.4579999999999999,22,12,10,0.545
22000352,1610612758,1610612743,119.0,114.0,0.484,0.4639999999999999,1,2021-02-06,22,11,11,0.5,22,12,10,0.545
22000353,1610612753,1610612741,92.0,118.0,0.389,0.516,0,2021-02-06,24,9,15,0.375,22,9,13,0.409
22000354,1610612755,1610612751,124.0,108.0,0.511,0.4429999999999999,1,2021-02-06,24,17,7,0.708,25,14,11,0.56
22000356,1610612737,1610612761,132.0,121.0,0.568,0.423,1,2021-02-06,23,11,12,0.478,23,10,13,0.435
22000357,1610612739,1610612749,99.0,124.0,0.4529999999999999,0.547,0,2021-02-06,24,10,14,0.417,23,15,8,0.652
22000358,1610612745,1610612759,106.0,111.0,0.4320000000000001,0.425,0,2021-02-06,22,11,11,0.5,23,13,10,0.565
22000359,1610612760,1610612750,120.0,118.0,0.511,0.505,1,2021-02-06,22,10,12,0.455,23,6,17,0.261
22000360,1610612742,1610612744,134.0,132.0,0.4579999999999999,0.535,1,2021-02-06,24,10,14,0.417,23,12,11,0.522
22000355,1610612740,1610612763,118.0,109.0,0.517,0.444,1,2021-02-06,22,10,12,0.455,18,9,9,0.5
22000361,1610612747,1610612765,135.0,129.0,0.56,0.479,1,2021-02-06,24,18,6,0.75,23,5,18,0.217
22000343,1610612754,1610612740,113.0,114.0,0.441,0.539,0,2021-02-05,23,12,11,0.522,21,9,12,0.429
22000344,1610612753,1610612741,123.0,119.0,0.519,0.479,1,2021-02-05,23,9,14,0.391,21,8,13,0.381
22000345,1610612751,1610612761,117.0,123.0,0.488,0.505,0,2021-02-05,24,14,10,0.583,22,10,12,0.455
22000346,1610612739,1610612749,105.0,123.0,0.446,0.515,0,2021-02-05,23,10,13,0.435,22,14,8,0.636
22000342,1610612766,1610612762,121.0,138.0,0.462,0.552,0,2021-02-05,23,10,13,0.435,23,18,5,0.7829999999999999
22000347,1610612748,1610612764,122.0,95.0,0.5,0.371,1,2021-02-05,22,8,14,0.364,19,5,14,0.263
22000348,1610612760,1610612750,103.0,106.0,0.4589999999999999,0.436,0,2021-02-05,21,9,12,0.429,22,6,16,0.273
22000349,1610612756,1610612765,109.0,92.0,0.494,0.374,1,2021-02-05,21,12,9,0.5710000000000001,22,5,17,0.2269999999999999
22000350,1610612746,1610612738,115.0,119.0,0.519,0.478,0,2021-02-05,24,17,7,0.708,21,12,9,0.5710000000000001
22000338,1610612737,1610612762,91.0,112.0,0.327,0.484,0,2021-02-04,22,10,12,0.455,22,17,5,0.773
22000339,1610612742,1610612744,116.0,147.0,0.413,0.573,0,2021-02-04,23,9,14,0.391,22,12,10,0.545
22000337,1610612755,1610612757,105.0,121.0,0.481,0.4589999999999999,0,2021-02-04,23,16,7,0.696,21,12,9,0.5710000000000001
22000340,1610612763,1610612745,103.0,115.0,0.425,0.471,0,2021-02-04,17,9,8,0.529,21,11,10,0.524
22000341,1610612747,1610612743,114.0,93.0,0.568,0.391,1,2021-02-04,23,17,6,0.7390000000000001,21,12,9,0.5710000000000001
22000327,1610612766,1610612755,111.0,118.0,0.4479999999999999,0.519,0,2021-02-03,22,10,12,0.455,22,16,6,0.727
22000329,1610612749,1610612754,130.0,110.0,0.471,0.4529999999999999,1,2021-02-03,21,13,8,0.619,22,12,10,0.545
22000330,1610612737,1610612742,116.0,122.0,0.5,0.462,0,2021-02-03,21,10,11,0.476,22,9,13,0.409
22000328,1610612739,1610612746,99.0,121.0,0.446,0.557,0,2021-02-03,22,10,12,0.455,23,17,6,0.7390000000000001
22000331,1610612748,1610612764,100.0,103.0,0.434,0.417,0,2021-02-03,21,7,14,0.3329999999999999,18,5,13,0.278
22000332,1610612741,1610612752,103.0,107.0,0.489,0.483,0,2021-02-03,20,8,12,0.4,23,10,13,0.435
22000333,1610612760,1610612745,104.0,87.0,0.434,0.384,1,2021-02-03,20,9,11,0.45,20,10,10,0.5
22000334,1610612759,1610612750,111.0,108.0,0.4479999999999999,0.457,1,2021-02-03,22,12,10,0.545,21,5,16,0.238
22000335,1610612740,1610612756,123.0,101.0,0.511,0.4629999999999999,1,2021-02-03,20,8,12,0.4,20,11,9,0.55
22000336,1610612758,1610612738,116.0,111.0,0.457,0.4529999999999999,1,2021-02-03,21,10,11,0.476,20,11,9,0.55
22000323,1610612753,1610612761,108.0,123.0,0.461,0.482,0,2021-02-02,22,8,14,0.364,21,9,12,0.429
22000324,1610612751,1610612746,124.0,120.0,0.57,0.455,1,2021-02-02,23,14,9,0.609,22,16,6,0.727
22000322,1610612754,1610612763,134.0,116.0,0.598,0.452,1,2021-02-02,21,12,9,0.5710000000000001,16,9,7,0.563
22000559,1610612764,1610612757,121.0,132.0,0.5539999999999999,0.4629999999999999,0,2021-02-02,17,4,13,0.235,20,11,9,0.55
22000325,1610612762,1610612765,117.0,105.0,0.4629999999999999,0.419,1,2021-02-02,21,16,5,0.762,21,5,16,0.238
22000326,1610612744,1610612738,107.0,111.0,0.4579999999999999,0.4639999999999999,0,2021-02-02,21,11,10,0.524,19,11,8,0.579
22000313,1610612737,1610612747,99.0,107.0,0.474,0.519,0,2021-02-01,20,10,10,0.5,22,16,6,0.727
22000314,1610612748,1610612766,121.0,129.0,0.473,0.4529999999999999,0,2021-02-01,20,7,13,0.35,21,10,11,0.476
22000312,1610612739,1610612750,100.0,98.0,0.417,0.392,1,2021-02-01,21,10,11,0.476,20,5,15,0.25
22000315,1610612741,1610612752,110.0,102.0,0.477,0.425,1,2021-02-01,19,8,11,0.421,22,9,13,0.409
22000316,1610612749,1610612757,134.0,106.0,0.552,0.375,1,2021-02-01,20,12,8,0.6,19,10,9,0.526
22000317,1610612740,1610612758,109.0,118.0,0.396,0.477,0,2021-02-01,19,7,12,0.368,20,9,11,0.45
22000318,1610612760,1610612745,106.0,136.0,0.4379999999999999,0.48,0,2021-02-01,19,8,11,0.421,19,10,9,0.526
22000319,1610612742,1610612756,108.0,109.0,0.43,0.467,0,2021-02-01,21,8,13,0.381,19,11,8,0.579
22000320,1610612759,1610612763,102.0,133.0,0.416,0.5589999999999999,0,2021-02-01,21,11,10,0.524,15,9,6,0.6
22000308,1610612752,1610612746,115.0,129.0,0.482,0.5429999999999999,0,2021-01-31,21,9,12,0.429,21,16,5,0.762
22000306,1610612743,1610612762,128.0,117.0,0.54,0.4270000000000001,1,2021-01-31,20,12,8,0.6,20,15,5,0.75
22000307,1610612754,1610612755,110.0,119.0,0.488,0.489,0,2021-01-31,20,11,9,0.55,21,15,6,0.7140000000000001
22000309,1610612761,1610612753,115.0,102.0,0.456,0.402,1,2021-01-31,20,8,12,0.4,21,8,13,0.381
22000310,1610612764,1610612751,149.0,146.0,0.519,0.568,1,2021-01-31,16,4,12,0.25,22,13,9,0.591
22000311,1610612750,1610612739,109.0,104.0,0.451,0.488,1,2021-01-31,19,5,14,0.263,20,9,11,0.45
22000298,1610612741,1610612757,122.0,123.0,0.506,0.511,0,2021-01-30,18,7,11,0.389,18,10,8,0.556
22000299,1610612766,1610612749,126.0,114.0,0.478,0.488,1,2021-01-30,20,9,11,0.45,19,11,8,0.579
22000300,1610612740,1610612745,112.0,126.0,0.451,0.489,0,2021-01-30,18,7,11,0.389,18,9,9,0.5
22000301,1610612748,1610612758,105.0,104.0,0.4679999999999999,0.482,1,2021-01-30,19,7,12,0.368,19,8,11,0.421
22000302,1610612738,1610612747,95.0,96.0,0.488,0.44,0,2021-01-30,18,10,8,0.556,21,15,6,0.7140000000000001
22000304,1610612759,1610612763,112.0,129.0,0.47,0.56,0,2021-01-30,20,11,9,0.55,14,8,6,0.5710000000000001
22000303,1610612742,1610612756,105.0,111.0,0.53,0.457,0,2021-01-30,20,8,12,0.4,18,10,8,0.556
22000305,1610612744,1610612765,118.0,91.0,0.528,0.377,1,2021-01-30,20,11,9,0.55,20,5,15,0.25
22000288,1610612766,1610612754,108.0,105.0,0.506,0.483,1,2021-01-29,19,8,11,0.421,19,11,8,0.579
22000290,1610612764,1610612737,100.0,116.0,0.365,0.4479999999999999,0,2021-01-29,15,3,12,0.2,19,10,9,0.526
22000291,1610612752,1610612739,102.0,81.0,0.488,0.345,1,2021-01-29,20,9,11,0.45,19,9,10,0.474
22000292,1610612761,1610612758,124.0,126.0,0.488,0.551,0,2021-01-29,19,7,12,0.368,18,8,10,0.444
22000293,1610612740,1610612749,131.0,126.0,0.469,0.5,1,2021-01-29,17,7,10,0.412,18,11,7,0.611
22000289,1610612753,1610612746,90.0,116.0,0.36,0.489,0,2021-01-29,20,8,12,0.4,20,15,5,0.75
22000294,1610612750,1610612755,94.0,118.0,0.4270000000000001,0.4479999999999999,0,2021-01-29,18,4,14,0.222,20,14,6,0.7
22000295,1610612760,1610612751,125.0,147.0,0.465,0.57,0,2021-01-29,18,8,10,0.444,21,13,8,0.619
22000296,1610612759,1610612743,119.0,109.0,0.5429999999999999,0.526,1,2021-01-29,19,11,8,0.579,19,11,8,0.579
22000297,1610612762,1610612742,120.0,101.0,0.4370000000000001,0.43,1,2021-01-29,19,15,4,0.789,19,8,11,0.421
22000287,1610612745,1610612757,104.0,101.0,0.422,0.419,1,2021-01-28,17,8,9,0.471,17,9,8,0.529
22000284,1610612765,1610612747,107.0,92.0,0.46,0.409,1,2021-01-28,19,5,14,0.263,20,14,6,0.7
22000285,1610612748,1610612746,105.0,109.0,0.444,0.414,0,2021-01-28,18,6,12,0.3329999999999999,19,14,5,0.737
22000286,1610612756,1610612744,114.0,93.0,0.466,0.384,1,2021-01-28,17,9,8,0.529,19,10,9,0.526
22000271,1610612766,1610612754,106.0,116.0,0.411,0.511,0,2021-01-27,18,7,11,0.389,18,11,7,0.611
22000272,1610612739,1610612765,122.0,107.0,0.54,0.451,1,2021-01-27,18,9,9,0.5,18,4,14,0.222
22000273,1610612753,1610612758,107.0,121.0,0.417,0.489,0,2021-01-27,19,8,11,0.421,17,7,10,0.412
22000274,1610612737,1610612751,128.0,132.0,0.479,0.531,0,2021-01-27,18,9,9,0.5,20,12,8,0.6
22000275,1610612748,1610612743,82.0,109.0,0.375,0.457,0,2021-01-27,17,6,11,0.353,18,11,7,0.611
22000276,1610612755,1610612747,107.0,106.0,0.482,0.477,1,2021-01-27,19,13,6,0.684,19,14,5,0.737
22000277,1610612761,1610612749,108.0,115.0,0.4039999999999999,0.43,0,2021-01-27,18,7,11,0.389,17,11,6,0.647
22000280,1610612759,1610612738,110.0,106.0,0.561,0.429,1,2021-01-27,18,10,8,0.556,17,10,7,0.588
22000279,1610612740,1610612764,124.0,106.0,0.517,0.402,1,2021-01-27,16,6,10,0.375,14,3,11,0.214
22000281,1610612756,1610612760,97.0,102.0,0.379,0.447,0,2021-01-27,16,8,8,0.5,17,8,9,0.471
22000282,1610612762,1610612742,116.0,104.0,0.462,0.462,1,2021-01-27,18,14,4,0.778,18,8,10,0.444
22000283,1610612744,1610612750,123.0,111.0,0.529,0.425,1,2021-01-27,18,10,8,0.556,17,4,13,0.235
22000268,1610612737,1610612746,108.0,99.0,0.4629999999999999,0.4039999999999999,1,2021-01-26,17,9,8,0.529,18,13,5,0.722
22000269,1610612745,1610612764,107.0,88.0,0.42,0.3929999999999999,1,2021-01-26,16,7,9,0.4379999999999999,13,3,10,0.231
22000270,1610612762,1610612752,108.0,94.0,0.402,0.434,1,2021-01-26,17,13,4,0.765,19,8,11,0.421
22000257,1610612765,1610612755,119.0,104.0,0.5,0.426,1,2021-01-25,17,4,13,0.235,18,12,6,0.667
22000258,1610612754,1610612761,129.0,114.0,0.513,0.409,1,2021-01-25,17,10,7,0.588,17,7,10,0.412
22000259,1610612753,1610612766,117.0,108.0,0.477,0.4379999999999999,1,2021-01-25,18,8,10,0.444,17,7,10,0.412
22000260,1610612751,1610612748,98.0,85.0,0.4,0.369,1,2021-01-25,19,11,8,0.579,16,6,10,0.375
22000261,1610612739,1610612747,108.0,115.0,0.465,0.483,0,2021-01-25,17,8,9,0.471,18,14,4,0.778
22000265,1610612742,1610612743,113.0,117.0,0.488,0.506,0,2021-01-25,17,8,9,0.471,17,10,7,0.588
22000262,1610612741,1610612738,103.0,119.0,0.466,0.506,0,2021-01-25,17,7,10,0.412,16,10,6,0.625
22000266,1610612744,1610612750,130.0,108.0,0.494,0.415,1,2021-01-25,17,9,8,0.529,16,4,12,0.25
22000267,1610612757,1610612760,122.0,125.0,0.469,0.512,0,2021-01-25,16,9,7,0.563,16,7,9,0.4379999999999999
22000249,1610612754,1610612761,102.0,107.0,0.402,0.411,0,2021-01-24,16,9,7,0.563,16,7,9,0.4379999999999999
22000251,1610612746,1610612760,108.0,100.0,0.446,0.442,1,2021-01-24,17,13,4,0.765,15,6,9,0.4
22000250,1610612738,1610612739,141.0,103.0,0.5589999999999999,0.4,1,2021-01-24,15,9,6,0.6,16,8,8,0.5
22000252,1610612753,1610612766,104.0,107.0,0.4479999999999999,0.477,0,2021-01-24,17,7,10,0.412,16,7,9,0.4379999999999999
22000253,1610612759,1610612764,121.0,101.0,0.5,0.424,1,2021-01-24,17,9,8,0.529,12,3,9,0.25
22000254,1610612749,1610612737,129.0,115.0,0.5489999999999999,0.506,1,2021-01-24,16,10,6,0.625,16,8,8,0.5
22000256,1610612757,1610612752,116.0,113.0,0.47,0.4529999999999999,1,2021-01-24,15,9,6,0.6,18,8,10,0.444
22000243,1610612765,1610612755,110.0,114.0,0.43,0.4579999999999999,0,2021-01-23,16,3,13,0.188,17,12,5,0.706
22000244,1610612751,1610612748,128.0,124.0,0.53,0.472,1,2021-01-23,18,10,8,0.556,15,6,9,0.4
22000246,1610612750,1610612740,120.0,110.0,0.429,0.46,1,2021-01-23,15,4,11,0.267,15,5,10,0.3329999999999999
22000242,1610612762,1610612744,127.0,108.0,0.479,0.452,1,2021-01-23,16,12,4,0.75,16,8,8,0.5
22000245,1610612741,1610612747,90.0,101.0,0.3929999999999999,0.456,0,2021-01-23,16,7,9,0.4379999999999999,17,13,4,0.765
22000247,1610612742,1610612745,108.0,133.0,0.446,0.547,0,2021-01-23,16,8,8,0.5,15,6,9,0.4
22000248,1610612756,1610612743,112.0,120.0,0.402,0.412,0,2021-01-23,15,8,7,0.5329999999999999,16,9,7,0.563
22000229,1610612766,1610612741,110.0,123.0,0.494,0.51,0,2021-01-22,15,6,9,0.4,15,7,8,0.467
22000230,1610612765,1610612745,102.0,103.0,0.3779999999999999,0.389,0,2021-01-22,15,3,12,0.2,14,5,9,0.357
22000231,1610612754,1610612753,120.0,118.0,0.495,0.457,1,2021-01-22,15,9,6,0.6,16,7,9,0.4379999999999999
22000232,1610612739,1610612751,125.0,113.0,0.517,0.483,1,2021-01-22,15,8,7,0.5329999999999999,17,9,8,0.529
22000233,1610612755,1610612738,122.0,110.0,0.556,0.456,1,2021-01-22,16,11,5,0.688,14,8,6,0.5710000000000001
22000234,1610612761,1610612748,101.0,81.0,0.4639999999999999,0.429,1,2021-01-22,15,6,9,0.4,14,6,8,0.429
22000236,1610612750,1610612737,98.0,116.0,0.43,0.4579999999999999,0,2021-01-22,14,3,11,0.214,15,8,7,0.5329999999999999
22000237,1610612759,1610612742,117.0,122.0,0.461,0.484,0,2021-01-22,16,8,8,0.5,15,8,7,0.5329999999999999
22000238,1610612756,1610612743,126.0,130.0,0.5,0.515,0,2021-01-22,14,8,6,0.5710000000000001,15,8,7,0.5329999999999999
22000239,1610612746,1610612760,120.0,106.0,0.512,0.471,1,2021-01-22,16,12,4,0.75,14,6,8,0.429
22000241,1610612758,1610612752,103.0,94.0,0.418,0.3829999999999999,1,2021-01-22,16,6,10,0.375,17,8,9,0.471
22000226,1610612749,1610612747,106.0,113.0,0.506,0.466,0,2021-01-21,15,9,6,0.6,16,12,4,0.75
22000227,1610612762,1610612740,129.0,118.0,0.5,0.494,1,2021-01-21,15,11,4,0.733,14,5,9,0.357
22000228,1610612744,1610612752,104.0,119.0,0.384,0.4629999999999999,0,2021-01-21,15,8,7,0.5329999999999999,16,8,8,0.5
22000216,1610612739,1610612751,147.0,135.0,0.514,0.4529999999999999,1,2021-01-20,14,7,7,0.5,16,9,7,0.563
22000217,1610612754,1610612742,112.0,124.0,0.446,0.526,0,2021-01-20,14,8,6,0.5710000000000001,14,7,7,0.5
22000218,1610612755,1610612738,117.0,109.0,0.462,0.472,1,2021-01-20,15,10,5,0.667,13,8,5,0.615
22000219,1610612737,1610612765,123.0,115.0,0.44,0.4539999999999999,1,2021-01-20,14,7,7,0.5,14,3,11,0.214
22000220,1610612761,1610612748,102.0,111.0,0.3979999999999999,0.488,0,2021-01-20,14,5,9,0.357,13,6,7,0.462
22000221,1610612750,1610612753,96.0,97.0,0.424,0.391,0,2021-01-20,13,3,10,0.231,15,7,8,0.467
22000222,1610612745,1610612756,103.0,109.0,0.42,0.472,0,2021-01-20,13,4,9,0.308,13,8,5,0.615
22000223,1610612744,1610612759,121.0,99.0,0.505,0.3720000000000001,1,2021-01-20,14,8,6,0.5710000000000001,15,8,7,0.5329999999999999
22000224,1610612746,1610612758,115.0,96.0,0.477,0.4529999999999999,1,2021-01-20,15,11,4,0.733,15,5,10,0.3329999999999999
22000213,1610612743,1610612760,119.0,101.0,0.4379999999999999,0.419,1,2021-01-19,14,7,7,0.5,13,6,7,0.462
22000214,1610612762,1610612740,118.0,102.0,0.506,0.4529999999999999,1,2021-01-19,14,10,4,0.7140000000000001,13,5,8,0.385
22000203,1610612752,1610612753,91.0,84.0,0.356,0.337,1,2021-01-18,15,7,8,0.467,14,6,8,0.429
22000205,1610612737,1610612750,108.0,97.0,0.4679999999999999,0.396,1,2021-01-18,13,6,7,0.462,12,3,9,0.25
22000207,1610612757,1610612759,104.0,125.0,0.433,0.5329999999999999,0,2021-01-18,14,8,6,0.5710000000000001,14,8,6,0.5710000000000001
22000208,1610612763,1610612756,108.0,104.0,0.494,0.455,1,2021-01-18,13,7,6,0.5379999999999999,12,7,5,0.583
22000209,1610612751,1610612749,125.0,123.0,0.5479999999999999,0.4379999999999999,1,2021-01-18,15,9,6,0.6,14,9,5,0.643
22000210,1610612761,1610612742,116.0,93.0,0.5,0.3779999999999999,1,2021-01-18,13,5,8,0.385,13,6,7,0.462
22000206,1610612748,1610612765,113.0,107.0,0.573,0.4629999999999999,1,2021-01-18,12,5,7,0.417,13,3,10,0.231
22000211,1610612741,1610612745,125.0,120.0,0.467,0.523,1,2021-01-18,14,6,8,0.429,12,4,8,0.3329999999999999
22000212,1610612747,1610612744,113.0,115.0,0.482,0.506,0,2021-01-18,15,11,4,0.733,13,7,6,0.5379999999999999
22000196,1610612738,1610612752,75.0,105.0,0.298,0.475,0,2021-01-17,12,8,4,0.667,14,6,8,0.429
22000198,1610612742,1610612741,101.0,117.0,0.441,0.506,0,2021-01-17,12,6,6,0.5,13,5,8,0.385
22000200,1610612743,1610612762,105.0,109.0,0.4,0.513,0,2021-01-17,13,6,7,0.462,13,9,4,0.6920000000000001
22000201,1610612758,1610612740,123.0,128.0,0.516,0.529,0,2021-01-17,14,5,9,0.357,12,5,7,0.417
22000202,1610612746,1610612754,129.0,96.0,0.552,0.416,1,2021-01-17,14,10,4,0.7140000000000001,13,8,5,0.615
22000189,1610612759,1610612745,103.0,91.0,0.4,0.369,1,2021-01-16,13,7,6,0.5379999999999999,11,4,7,0.364
22000190,1610612751,1610612753,122.0,115.0,0.5379999999999999,0.4629999999999999,1,2021-01-16,14,8,6,0.5710000000000001,13,6,7,0.462
22000191,1610612761,1610612766,116.0,113.0,0.419,0.4370000000000001,1,2021-01-16,12,4,8,0.3329999999999999,14,6,8,0.429
22000192,1610612748,1610612765,100.0,120.0,0.478,0.505,0,2021-01-16,11,4,7,0.364,12,3,9,0.25
22000193,1610612763,1610612755,106.0,104.0,0.434,0.44,1,2021-01-16,12,6,6,0.5,14,9,5,0.643
22000195,1610612757,1610612737,112.0,106.0,0.3879999999999999,0.4370000000000001,1,2021-01-16,13,8,5,0.615,12,5,7,0.417
22000180,1610612738,1610612753,124.0,97.0,0.511,0.4039999999999999,1,2021-01-15,11,8,3,0.727,12,6,6,0.5
22000181,1610612739,1610612752,106.0,103.0,0.456,0.488,1,2021-01-15,13,6,7,0.462,13,5,8,0.385
22000182,1610612749,1610612742,112.0,109.0,0.4479999999999999,0.4639999999999999,1,2021-01-15,13,9,4,0.6920000000000001,11,6,5,0.545
22000184,1610612760,1610612741,127.0,125.0,0.457,0.473,1,2021-01-15,12,6,6,0.5,12,4,8,0.3329999999999999
22000186,1610612762,1610612737,116.0,92.0,0.467,0.413,1,2021-01-15,12,8,4,0.667,11,5,6,0.455
22000187,1610612747,1610612740,112.0,95.0,0.419,0.477,1,2021-01-15,14,11,3,0.7859999999999999,11,4,7,0.364
22000188,1610612758,1610612746,100.0,138.0,0.471,0.584,0,2021-01-15,13,5,8,0.385,13,9,4,0.6920000000000001
22000174,1610612755,1610612748,125.0,108.0,0.537,0.494,1,2021-01-14,13,9,4,0.6920000000000001,10,4,6,0.4
22000175,1610612761,1610612766,111.0,108.0,0.455,0.483,1,2021-01-14,11,3,8,0.273,13,6,7,0.462
22000176,1610612759,1610612745,105.0,109.0,0.457,0.488,0,2021-01-14,12,6,6,0.5,10,4,6,0.4
22000177,1610612743,1610612744,114.0,104.0,0.456,0.469,1,2021-01-14,12,6,6,0.5,12,6,6,0.5
22000178,1610612757,1610612754,87.0,111.0,0.368,0.478,0,2021-01-14,12,7,5,0.583,12,8,4,0.667
22000164,1610612766,1610612742,93.0,104.0,0.38,0.417,0,2021-01-13,12,6,6,0.5,10,6,4,0.6
22000165,1610612765,1610612749,101.0,110.0,0.391,0.482,0,2021-01-13,11,2,9,0.182,12,8,4,0.667
22000168,1610612752,1610612751,109.0,116.0,0.478,0.484,0,2021-01-13,12,5,7,0.417,13,7,6,0.5379999999999999
22000169,1610612750,1610612763,107.0,118.0,0.433,0.472,0,2021-01-13,11,3,8,0.273,11,5,6,0.455
22000170,1610612760,1610612747,99.0,128.0,0.43,0.495,0,2021-01-13,11,5,6,0.455,13,10,3,0.769
22000172,1610612746,1610612740,111.0,106.0,0.473,0.477,1,2021-01-13,12,8,4,0.667,10,4,6,0.4
22000173,1610612758,1610612757,126.0,132.0,0.524,0.489,0,2021-01-13,12,5,7,0.417,11,7,4,0.636
22000157,1610612755,1610612748,137.0,134.0,0.49,0.462,1,2021-01-12,12,8,4,0.667,9,4,5,0.444
22000158,1610612751,1610612743,122.0,116.0,0.608,0.5,1,2021-01-12,12,6,6,0.5,11,5,6,0.455
22000159,1610612739,1610612762,87.0,117.0,0.389,0.5,0,2021-01-12,12,5,7,0.417,11,7,4,0.636
22000161,1610612745,1610612747,100.0,117.0,0.392,0.5,0,2021-01-12,9,3,6,0.3329999999999999,12,9,3,0.75
22000162,1610612760,1610612759,102.0,112.0,0.434,0.4320000000000001,0,2021-01-12,10,5,5,0.5,11,6,5,0.545
22000163,1610612744,1610612754,95.0,104.0,0.382,0.4429999999999999,0,2021-01-12,11,6,5,0.545,11,7,4,0.636
22000149,1610612766,1610612752,109.0,88.0,0.487,0.391,1,2021-01-11,11,6,5,0.545,11,5,6,0.455
22000150,1610612739,1610612763,91.0,101.0,0.451,0.513,0,2021-01-11,11,5,6,0.455,10,4,6,0.4
22000151,1610612753,1610612749,99.0,121.0,0.429,0.505,0,2021-01-11,11,6,5,0.545,11,7,4,0.636
22000152,1610612764,1610612756,128.0,107.0,0.522,0.4479999999999999,1,2021-01-11,11,3,8,0.273,11,7,4,0.636
22000153,1610612737,1610612755,112.0,94.0,0.374,0.402,1,2021-01-11,10,5,5,0.5,11,7,4,0.636
22000155,1610612757,1610612761,112.0,111.0,0.4579999999999999,0.449,1,2021-01-11,10,6,4,0.6,10,2,8,0.2
22000156,1610612758,1610612754,127.0,122.0,0.56,0.485,1,2021-01-11,11,5,6,0.455,10,6,4,0.6
22000141,1610612765,1610612762,86.0,96.0,0.3329999999999999,0.4270000000000001,0,2021-01-10,10,2,8,0.2,10,6,4,0.6
22000142,1610612746,1610612741,130.0,127.0,0.489,0.61,1,2021-01-10,11,7,4,0.636,11,4,7,0.364
22000143,1610612751,1610612760,116.0,129.0,0.506,0.544,0,2021-01-10,11,5,6,0.455,9,5,4,0.556
22000144,1610612752,1610612743,89.0,114.0,0.4320000000000001,0.536,0,2021-01-10,10,5,5,0.5,10,5,5,0.5
22000146,1610612745,1610612747,102.0,120.0,0.411,0.505,0,2021-01-10,8,3,5,0.375,11,8,3,0.727
22000147,1610612750,1610612759,96.0,88.0,0.42,0.3829999999999999,1,2021-01-10,10,3,7,0.3,10,5,5,0.5
22000148,1610612744,1610612761,106.0,105.0,0.409,0.406,1,2021-01-10,10,6,4,0.6,9,2,7,0.222
22000133,1610612755,1610612743,103.0,115.0,0.417,0.5,0,2021-01-09,10,7,3,0.7,9,4,5,0.444
22000134,1610612766,1610612737,113.0,105.0,0.519,0.382,1,2021-01-09,10,5,5,0.5,9,4,5,0.444
22000135,1610612754,1610612756,117.0,125.0,0.478,0.489,0,2021-01-09,9,6,3,0.667,10,7,3,0.7
22000136,1610612764,1610612748,124.0,128.0,0.444,0.495,0,2021-01-09,10,2,8,0.2,8,4,4,0.5
22000137,1610612749,1610612739,100.0,90.0,0.44,0.414,1,2021-01-09,10,6,4,0.6,10,5,5,0.5
22000138,1610612750,1610612759,122.0,125.0,0.5,0.436,0,2021-01-09,9,2,7,0.222,9,5,4,0.556
22000139,1610612742,1610612753,112.0,98.0,0.494,0.4270000000000001,1,2021-01-09,9,5,4,0.556,10,6,4,0.6
22000140,1610612758,1610612757,99.0,125.0,0.407,0.44,0,2021-01-09,10,4,6,0.4,9,5,4,0.556
22000123,1610612765,1610612756,110.0,105.0,0.411,0.451,1,2021-01-08,9,2,7,0.222,9,6,3,0.667
22000124,1610612738,1610612764,116.0,107.0,0.477,0.466,1,2021-01-08,10,7,3,0.7,9,2,7,0.222
22000125,1610612752,1610612760,89.0,101.0,0.354,0.4370000000000001,0,2021-01-08,9,5,4,0.556,8,4,4,0.5
22000126,1610612740,1610612766,110.0,118.0,0.494,0.471,0,2021-01-08,9,4,5,0.444,9,4,5,0.444
22000127,1610612745,1610612753,132.0,90.0,0.56,0.382,1,2021-01-08,7,3,4,0.429,9,6,3,0.667
22000128,1610612763,1610612751,115.0,110.0,0.4589999999999999,0.469,1,2021-01-08,9,3,6,0.3329999999999999,10,5,5,0.5
22000129,1610612749,1610612762,118.0,131.0,0.449,0.505,0,2021-01-08,9,5,4,0.556,9,5,4,0.556
22000130,1610612744,1610612746,115.0,105.0,0.488,0.482,1,2021-01-08,9,5,4,0.556,10,6,4,0.6
22000131,1610612747,1610612741,117.0,115.0,0.506,0.505,1,2021-01-08,10,7,3,0.7,10,4,6,0.4
22000132,1610612758,1610612761,123.0,144.0,0.568,0.5820000000000001,0,2021-01-08,9,4,5,0.444,8,2,6,0.25
22000118,1610612751,1610612755,122.0,109.0,0.4539999999999999,0.471,1,2021-01-07,9,5,4,0.556,9,7,2,0.778
22000119,1610612763,1610612739,90.0,94.0,0.434,0.456,0,2021-01-07,8,2,6,0.25,9,5,4,0.556
22000120,1610612743,1610612742,117.0,124.0,0.4429999999999999,0.483,0,2021-01-07,8,3,5,0.375,8,4,4,0.5
22000121,1610612747,1610612759,109.0,118.0,0.5,0.467,0,2021-01-07,9,6,3,0.667,8,4,4,0.5
22000122,1610612757,1610612750,135.0,117.0,0.544,0.419,1,2021-01-07,8,4,4,0.5,8,2,6,0.25
22000107,1610612754,1610612745,114.0,107.0,0.472,0.481,1,2021-01-06,8,6,2,0.75,6,2,4,0.3329999999999999
22000108,1610612753,1610612739,105.0,94.0,0.494,0.424,1,2021-01-06,8,6,2,0.75,8,4,4,0.5
22000109,1610612755,1610612764,141.0,136.0,0.617,0.5,1,2021-01-06,8,7,1,0.875,8,2,6,0.25
22000110,1610612737,1610612766,94.0,102.0,0.375,0.376,0,2021-01-06,8,4,4,0.5,8,3,5,0.375
22000111,1610612748,1610612738,105.0,107.0,0.4320000000000001,0.424,0,2021-01-06,7,3,4,0.429,9,6,3,0.667
22000112,1610612752,1610612762,112.0,100.0,0.517,0.44,1,2021-01-06,8,5,3,0.625,8,4,4,0.5
22000113,1610612749,1610612765,130.0,115.0,0.544,0.392,1,2021-01-06,8,5,3,0.625,8,1,7,0.125
22000114,1610612740,1610612760,110.0,111.0,0.494,0.46,0,2021-01-06,8,4,4,0.5,7,3,4,0.429
22000115,1610612756,1610612761,123.0,115.0,0.482,0.494,1,2021-01-06,8,6,2,0.75,7,1,6,0.143
22000116,1610612744,1610612746,101.0,108.0,0.4529999999999999,0.444,0,2021-01-06,8,4,4,0.5,9,6,3,0.667
22000117,1610612758,1610612741,128.0,124.0,0.516,0.527,1,2021-01-06,8,4,4,0.5,9,4,5,0.444
22000102,1610612751,1610612762,130.0,96.0,0.5589999999999999,0.384,1,2021-01-05,8,4,4,0.5,7,4,3,0.5710000000000001
22000103,1610612763,1610612747,92.0,94.0,0.414,0.4370000000000001,0,2021-01-05,7,2,5,0.286,8,6,2,0.75
22000104,1610612743,1610612750,123.0,116.0,0.519,0.462,1,2021-01-05,7,3,4,0.429,7,2,5,0.286
22000105,1610612746,1610612759,113.0,116.0,0.5,0.4579999999999999,0,2021-01-05,8,5,3,0.625,7,3,4,0.429
22000106,1610612757,1610612741,108.0,111.0,0.415,0.44,0,2021-01-05,7,3,4,0.429,8,4,4,0.5
22000093,1610612753,1610612739,103.0,83.0,0.4320000000000001,0.3879999999999999,1,2021-01-04,7,5,2,0.7140000000000001,7,4,3,0.5710000000000001
22000094,1610612755,1610612766,118.0,101.0,0.484,0.419,1,2021-01-04,7,6,1,0.857,7,2,5,0.286
22000095,1610612737,1610612752,108.0,113.0,0.46,0.506,0,2021-01-04,7,4,3,0.5710000000000001,7,4,3,0.5710000000000001
22000096,1610612748,1610612760,118.0,90.0,0.568,0.3670000000000001,1,2021-01-04,6,3,3,0.5,6,2,4,0.3329999999999999
22000097,1610612761,1610612738,114.0,126.0,0.4,0.488,0,2021-01-04,6,1,5,0.1669999999999999,8,5,3,0.625
22000098,1610612745,1610612742,100.0,113.0,0.39,0.476,0,2021-01-04,5,2,3,0.4,7,3,4,0.429
22000099,1610612749,1610612765,125.0,115.0,0.5760000000000001,0.439,1,2021-01-04,7,4,3,0.5710000000000001,7,1,6,0.143
22000100,1610612740,1610612754,116.0,118.0,0.436,0.484,0,2021-01-04,7,4,3,0.5710000000000001,7,5,2,0.7140000000000001
22000101,1610612744,1610612758,137.0,106.0,0.526,0.3779999999999999,1,2021-01-04,7,4,3,0.5710000000000001,7,3,4,0.429
22000085,1610612765,1610612738,120.0,122.0,0.477,0.563,0,2021-01-03,6,1,5,0.1669999999999999,7,4,3,0.5710000000000001
22000086,1610612751,1610612764,122.0,123.0,0.494,0.413,0,2021-01-03,7,3,4,0.429,7,2,5,0.286
22000087,1610612763,1610612747,94.0,108.0,0.411,0.461,0,2021-01-03,6,2,4,0.3329999999999999,7,5,2,0.7140000000000001
22000088,1610612750,1610612743,109.0,124.0,0.518,0.489,0,2021-01-03,6,2,4,0.3329999999999999,6,2,4,0.3329999999999999
22000089,1610612759,1610612762,109.0,130.0,0.419,0.551,0,2021-01-03,6,2,4,0.3329999999999999,6,4,2,0.667
22000090,1610612741,1610612742,118.0,108.0,0.4589999999999999,0.4379999999999999,1,2021-01-03,7,3,4,0.429,6,2,4,0.3329999999999999
22000091,1610612756,1610612746,107.0,112.0,0.493,0.482,0,2021-01-03,7,5,2,0.7140000000000001,7,5,2,0.7140000000000001
22000092,1610612744,1610612757,137.0,122.0,0.557,0.418,1,2021-01-03,6,3,3,0.5,6,3,3,0.5
22000079,1610612745,1610612758,102.0,94.0,0.444,0.389,1,2021-01-02,4,2,2,0.5,6,3,3,0.5
22000080,1610612754,1610612752,102.0,106.0,0.405,0.506,0,2021-01-02,6,4,2,0.667,6,3,3,0.5
22000081,1610612753,1610612760,99.0,108.0,0.37,0.442,0,2021-01-02,6,4,2,0.667,5,2,3,0.4
22000082,1610612755,1610612766,127.0,112.0,0.595,0.413,1,2021-01-02,6,5,1,0.833,6,2,4,0.3329999999999999
22000083,1610612737,1610612739,91.0,96.0,0.412,0.418,0,2021-01-02,6,4,2,0.667,6,4,2,0.667
22000084,1610612740,1610612761,120.0,116.0,0.422,0.418,1,2021-01-02,6,4,2,0.667,5,1,4,0.2
22000070,1610612765,1610612738,96.0,93.0,0.409,0.47,1,2021-01-01,5,1,4,0.2,6,3,3,0.5
22000072,1610612751,1610612737,96.0,114.0,0.407,0.462,0,2021-01-01,6,3,3,0.5,5,4,1,0.8
22000076,1610612743,1610612756,103.0,106.0,0.4529999999999999,0.487,0,2021-01-01,5,1,4,0.2,6,5,1,0.833
22000077,1610612762,1610612746,106.0,100.0,0.461,0.3879999999999999,1,2021-01-01,5,3,2,0.6,6,4,2,0.667
22000065,1610612745,1610612758,122.0,119.0,0.523,0.469,1,2020-12-31,3,1,2,0.333,5,3,2,0.6
22000065,1610612745,1610612758,122.0,119.0,0.523,0.469,1,2020-12-31,3,1,2,0.3329999999999999,5,3,2,0.6
22000067,1610612760,1610612740,80.0,113.0,0.375,0.484,0,2020-12-31,4,1,3,0.25,5,3,2,0.6
22000057,1610612751,1610612737,145.0,141.0,0.54,0.475,1,2020-12-30,5,3,2,0.6,4,3,1,0.75
22000046,1610612739,1610612752,86.0,95.0,0.364,0.43,0,2020-12-29,4,3,1,0.75,4,2,2,0.5
22000049,1610612755,1610612761,100.0,93.0,0.381,0.356,1,2020-12-29,4,3,1,0.75,3,0,3,0.0
22000051,1610612748,1610612749,97.0,144.0,0.4679999999999999,0.5539999999999999,0,2020-12-29,3,1,2,0.333,4,2,2,0.5
22000051,1610612748,1610612749,97.0,144.0,0.4679999999999999,0.5539999999999999,0,2020-12-29,3,1,2,0.3329999999999999,4,2,2,0.5
22000053,1610612756,1610612740,111.0,86.0,0.44,0.481,1,2020-12-29,4,3,1,0.75,4,2,2,0.5
22000055,1610612758,1610612743,125.0,115.0,0.489,0.5429999999999999,1,2020-12-29,4,3,1,0.75,4,1,3,0.25
22000042,1610612751,1610612763,111.0,116.0,0.41,0.429,0,2020-12-28,4,2,2,0.5,3,1,2,0.333
22000042,1610612751,1610612763,111.0,116.0,0.41,0.429,0,2020-12-28,4,2,2,0.5,3,1,2,0.3329999999999999
22000044,1610612743,1610612745,124.0,111.0,0.529,0.4529999999999999,1,2020-12-28,3,1,2,0.333,2,0,2,0.0
22000044,1610612743,1610612745,124.0,111.0,0.529,0.4529999999999999,1,2020-12-28,3,1,2,0.3329999999999999,2,0,2,0.0
22000032,1610612766,1610612751,106.0,104.0,0.4479999999999999,0.4270000000000001,1,2020-12-27,3,1,2,0.333,3,2,1,0.667
22000032,1610612766,1610612751,106.0,104.0,0.4479999999999999,0.4270000000000001,1,2020-12-27,3,1,2,0.3329999999999999,3,2,1,0.667
22000034,1610612740,1610612759,98.0,95.0,0.3829999999999999,0.4270000000000001,1,2020-12-27,3,2,1,0.667,3,2,1,0.667
22000037,1610612754,1610612738,108.0,107.0,0.511,0.506,1,2020-12-27,3,3,0,1.0,3,1,2,0.333
22000037,1610612754,1610612738,108.0,107.0,0.511,0.506,1,2020-12-27,3,3,0,1.0,3,1,2,0.3329999999999999
22000038,1610612741,1610612744,128.0,129.0,0.512,0.4039999999999999,0,2020-12-27,3,0,3,0.0,3,1,2,0.333
22000038,1610612741,1610612744,128.0,129.0,0.512,0.4039999999999999,0,2020-12-27,3,0,3,0.0,3,1,2,0.3329999999999999
22000021,1610612763,1610612737,112.0,122.0,0.3979999999999999,0.4270000000000001,0,2020-12-26,2,0,2,0.0,2,2,0,1.0
22000022,1610612766,1610612760,107.0,109.0,0.3979999999999999,0.455,0,2020-12-26,2,0,2,0.0,1,1,0,1.0
22000027,1610612759,1610612761,119.0,114.0,0.47,0.4579999999999999,1,2020-12-26,2,2,0,1.0,2,0,2,0.0
22000028,1610612762,1610612750,111.0,116.0,0.3829999999999999,0.446,0,2020-12-26,2,1,1,0.5,2,2,0,1.0
22000030,1610612758,1610612756,106.0,103.0,0.4529999999999999,0.418,1,2020-12-26,2,2,0,1.0,2,1,1,0.5
22000006,1610612749,1610612744,138.0,99.0,0.556,0.3429999999999999,1,2020-12-25,2,1,1,0.5,2,0,2,0.0
22000007,1610612738,1610612751,95.0,123.0,0.3779999999999999,0.539,0,2020-12-25,2,1,1,0.5,2,2,0,1.0
22000011,1610612754,1610612752,121.0,107.0,0.489,0.4589999999999999,1,2020-12-23,1,1,0,1.0,1,0,1,0.0
22000013,1610612755,1610612764,113.0,107.0,0.471,0.4589999999999999,1,2020-12-23,1,1,0,1.0,1,0,1,0.0
22000015,1610612741,1610612737,104.0,124.0,0.414,0.5379999999999999,0,2020-12-23,1,0,1,0.0,1,1,0,1.0
22000018,1610612750,1610612765,111.0,101.0,0.4320000000000001,0.484,1,2020-12-23,1,1,0,1.0,1,0,1,0.0
12000047,1610612753,1610612766,120.0,117.0,0.433,0.444,1,2020-12-19,4,2,2,0.5,4,1,3,0.25
12000048,1610612764,1610612765,99.0,96.0,0.4270000000000001,0.402,1,2020-12-19,3,1,2,0.333,4,2,2,0.5
12000049,1610612763,1610612737,116.0,117.0,0.4,0.422,0,2020-12-19,4,3,1,0.75,4,2,2,0.5
12000039,1610612754,1610612755,107.0,113.0,0.371,0.5329999999999999,0,2020-12-18,3,0,3,0.0,2,2,0,1.0
12000040,1610612761,1610612748,105.0,117.0,0.38,0.534,0,2020-12-18,3,2,1,0.667,2,1,1,0.5
12000042,1610612752,1610612739,119.0,83.0,0.513,0.395,1,2020-12-18,4,3,1,0.75,4,2,2,0.5
12000041,1610612738,1610612751,89.0,113.0,0.348,0.4320000000000001,0,2020-12-18,2,0,2,0.0,2,2,0,1.0
12000043,1610612740,1610612749,127.0,113.0,0.512,0.422,1,2020-12-18,2,2,0,1.0,3,0,3,0.0
12000044,1610612760,1610612741,103.0,105.0,0.411,0.424,0,2020-12-18,3,1,2,0.333,4,3,1,0.75
12000045,1610612743,1610612757,129.0,96.0,0.474,0.371,1,2020-12-18,3,2,1,0.667,4,1,3,0.25
12000046,1610612756,1610612747,113.0,114.0,0.477,0.506,0,2020-12-18,4,0,4,0.0,4,4,0,1.0
12000032,1610612753,1610612766,115.0,123.0,0.474,0.475,0,2020-12-17,3,1,2,0.333,3,1,2,0.333
12000033,1610612764,1610612765,86.0,97.0,0.397,0.494,0,2020-12-17,2,0,2,0.0,3,2,1,0.667
12000034,1610612745,1610612759,128.0,106.0,0.527,0.409,1,2020-12-17,4,3,1,0.75,3,0,3,0.0
12000035,1610612763,1610612737,128.0,106.0,0.474,0.381,1,2020-12-17,3,3,0,1.0,3,1,2,0.333
12000036,1610612742,1610612750,127.0,129.0,0.424,0.469,0,2020-12-17,3,2,1,0.667,3,1,2,0.333
12000038,1610612758,1610612744,105.0,113.0,0.3720000000000001,0.424,0,2020-12-17,4,2,2,0.5,3,2,1,0.667
12000037,1610612746,1610612762,105.0,125.0,0.461,0.495,0,2020-12-17,3,0,3,0.0,3,3,0,1.0
12000028,1610612752,1610612739,100.0,93.0,0.458,0.402,1,2020-12-16,3,2,1,0.667,3,2,1,0.667
12000029,1610612760,1610612741,103.0,124.0,0.381,0.542,0,2020-12-16,2,1,1,0.5,3,2,1,0.667
12000030,1610612743,1610612757,126.0,95.0,0.523,0.378,1,2020-12-16,2,1,1,0.5,3,1,2,0.333
12000031,1610612756,1610612747,107.0,112.0,0.407,0.476,0,2020-12-16,3,0,3,0.0,3,3,0,1.0
12000025,1610612755,1610612738,108.0,99.0,0.471,0.434,1,2020-12-15,1,1,0,1.0,1,0,1,0.0
12000026,1610612745,1610612759,112.0,98.0,0.44,0.429,1,2020-12-15,3,2,1,0.667,2,0,2,0.0
12000027,1610612758,1610612744,114.0,113.0,0.467,0.4270000000000001,1,2020-12-15,3,2,1,0.667,2,1,1,0.5
12000019,1610612739,1610612754,116.0,106.0,0.514,0.451,1,2020-12-14,2,2,0,1.0,2,0,2,0.0
12000020,1610612766,1610612761,109.0,112.0,0.457,0.476,0,2020-12-14,2,0,2,0.0,2,2,0,1.0
12000021,1610612748,1610612740,92.0,114.0,0.4270000000000001,0.447,0,2020-12-14,1,0,1,0.0,1,1,0,1.0
12000022,1610612749,1610612742,112.0,128.0,0.5,0.463,0,2020-12-14,2,0,2,0.0,2,2,0,1.0
12000023,1610612750,1610612763,104.0,123.0,0.402,0.5,0,2020-12-14,2,0,2,0.0,2,2,0,1.0
12000024,1610612762,1610612756,111.0,92.0,0.4270000000000001,0.42,1,2020-12-14,2,2,0,1.0,2,0,2,0.0
12000013,1610612737,1610612753,116.0,107.0,0.4270000000000001,0.402,1,2020-12-13,2,1,1,0.5,2,1,1,0.5
12000014,1610612751,1610612764,119.0,114.0,0.514,0.433,1,2020-12-13,1,1,0,1.0,1,0,1,0.0
12000015,1610612765,1610612752,99.0,91.0,0.421,0.393,1,2020-12-13,2,1,1,0.5,2,1,1,0.5
12000016,1610612741,1610612745,104.0,91.0,0.394,0.345,1,2020-12-13,2,1,1,0.5,2,1,1,0.5
12000018,1610612747,1610612746,131.0,106.0,0.568,0.464,1,2020-12-13,2,2,0,1.0,2,0,2,0.0
12000017,1610612757,1610612758,106.0,121.0,0.4,0.4320000000000001,0,2020-12-13,2,1,1,0.5,2,1,1,0.5
12000006,1610612766,1610612761,100.0,111.0,0.395,0.411,0,2020-12-12,1,0,1,0.0,1,1,0,1.0
12000007,1610612739,1610612754,107.0,104.0,0.494,0.425,1,2020-12-12,1,1,0,1.0,1,0,1,0.0
12000008,1610612759,1610612760,108.0,121.0,0.376,0.489,0,2020-12-12,1,0,1,0.0,1,1,0,1.0
12000009,1610612749,1610612742,102.0,112.0,0.404,0.414,0,2020-12-12,1,0,1,0.0,1,1,0,1.0
12000010,1610612750,1610612763,105.0,107.0,0.395,0.426,0,2020-12-12,1,0,1,0.0,1,1,0,1.0
12000011,1610612744,1610612743,107.0,105.0,0.438,0.43,1,2020-12-12,1,1,0,1.0,1,0,1,0.0
12000012,1610612762,1610612756,119.0,105.0,0.5,0.433,1,2020-12-12,1,1,0,1.0,1,0,1,0.0
12000001,1610612737,1610612753,112.0,116.0,0.37,0.457,0,2020-12-11,1,0,1,0.0,1,1,0,1.0
12000002,1610612765,1610612752,84.0,90.0,0.325,0.458,0,2020-12-11,1,0,1,0.0,1,1,0,1.0
12000003,1610612741,1610612745,104.0,125.0,0.413,0.434,0,2020-12-11,1,0,1,0.0,1,1,0,1.0
12000004,1610612747,1610612746,87.0,81.0,0.357,0.357,1,2020-12-11,1,1,0,1.0,1,0,1,0.0
12000005,1610612757,1610612758,127.0,102.0,0.511,0.368,1,2020-12-11,1,1,0,1.0,1,0,1,0.0
41900406,1610612748,1610612747,93.0,106.0,0.443,0.483,0,2020-10-11,73,44,29,0.603,71,52,19,0.732
41900405,1610612747,1610612748,108.0,111.0,0.463,0.458,0,2020-10-09,71,52,19,0.732,73,44,29,0.603
41900404,1610612748,1610612747,96.0,102.0,0.4270000000000001,0.443,0,2020-10-06,73,44,29,0.603,71,52,19,0.732
41900403,1610612748,1610612747,115.0,104.0,0.513,0.43,1,2020-10-04,73,44,29,0.603,71,52,19,0.732
41900402,1610612747,1610612748,124.0,114.0,0.505,0.507,1,2020-10-02,71,52,19,0.732,73,44,29,0.603
41900401,1610612747,1610612748,116.0,98.0,0.452,0.4270000000000001,1,2020-09-30,71,52,19,0.732,73,44,29,0.603
41900306,1610612748,1610612738,125.0,113.0,0.563,0.434,1,2020-09-27,73,44,29,0.603,72,48,24,0.667
41900315,1610612747,1610612743,117.0,107.0,0.545,0.422,1,2020-09-26,71,52,19,0.732,73,46,27,0.63
41900305,1610612738,1610612748,121.0,108.0,0.452,0.453,1,2020-09-25,72,48,24,0.667,73,44,29,0.603
41900314,1610612743,1610612747,108.0,114.0,0.506,0.475,0,2020-09-24,73,46,27,0.63,71,52,19,0.732
41900304,1610612748,1610612738,112.0,109.0,0.429,0.476,1,2020-09-23,73,44,29,0.603,72,48,24,0.667
41900313,1610612743,1610612747,114.0,106.0,0.5479999999999999,0.518,1,2020-09-22,73,46,27,0.63,71,52,19,0.732
41900312,1610612747,1610612743,105.0,103.0,0.446,0.473,1,2020-09-20,71,52,19,0.732,73,46,27,0.63
41900303,1610612748,1610612738,106.0,117.0,0.388,0.482,0,2020-09-19,73,44,29,0.603,72,48,24,0.667
41900311,1610612747,1610612743,126.0,114.0,0.53,0.494,1,2020-09-18,71,52,19,0.732,73,46,27,0.63
41900302,1610612738,1610612748,101.0,106.0,0.5,0.444,0,2020-09-17,72,48,24,0.667,73,44,29,0.603
41900301,1610612738,1610612748,114.0,117.0,0.443,0.471,0,2020-09-15,72,48,24,0.667,73,44,29,0.603
41900237,1610612746,1610612743,89.0,104.0,0.378,0.494,0,2020-09-15,72,49,23,0.6809999999999999,73,46,27,0.63
41900236,1610612743,1610612746,111.0,98.0,0.541,0.41,1,2020-09-13,73,46,27,0.63,72,49,23,0.6809999999999999
41900225,1610612747,1610612745,119.0,96.0,0.527,0.371,1,2020-09-12,71,52,19,0.732,72,44,28,0.611
41900235,1610612746,1610612743,105.0,111.0,0.42,0.481,0,2020-09-11,72,49,23,0.6809999999999999,73,46,27,0.63
41900217,1610612761,1610612738,87.0,92.0,0.413,0.407,0,2020-09-11,72,53,19,0.736,72,48,24,0.667
41900224,1610612745,1610612747,100.0,110.0,0.431,0.489,0,2020-09-10,72,44,28,0.611,71,52,19,0.732
41900216,1610612738,1610612761,122.0,125.0,0.44,0.436,0,2020-09-09,72,48,24,0.667,72,53,19,0.736
41900234,1610612743,1610612746,85.0,96.0,0.397,0.418,0,2020-09-09,73,46,27,0.63,72,49,23,0.6809999999999999
41900205,1610612749,1610612748,94.0,103.0,0.363,0.479,0,2020-09-08,73,56,17,0.767,73,44,29,0.603
41900223,1610612745,1610612747,102.0,112.0,0.469,0.551,0,2020-09-08,72,44,28,0.611,71,52,19,0.732
41900215,1610612761,1610612738,89.0,111.0,0.388,0.494,0,2020-09-07,72,53,19,0.736,72,48,24,0.667
41900233,1610612743,1610612746,107.0,113.0,0.468,0.547,0,2020-09-07,73,46,27,0.63,72,49,23,0.6809999999999999
41900204,1610612748,1610612749,115.0,118.0,0.444,0.489,0,2020-09-06,73,44,29,0.603,73,56,17,0.767
41900222,1610612747,1610612745,117.0,109.0,0.5660000000000001,0.449,1,2020-09-06,71,52,19,0.732,72,44,28,0.611
41900214,1610612738,1610612761,93.0,100.0,0.44,0.395,0,2020-09-05,72,48,24,0.667,72,53,19,0.736
41900232,1610612746,1610612743,101.0,110.0,0.409,0.451,0,2020-09-05,72,49,23,0.6809999999999999,73,46,27,0.63
41900203,1610612748,1610612749,115.0,100.0,0.449,0.42,1,2020-09-04,73,44,29,0.603,73,56,17,0.767
41900221,1610612747,1610612745,97.0,112.0,0.422,0.481,0,2020-09-04,71,52,19,0.732,72,44,28,0.611
41900213,1610612738,1610612761,103.0,104.0,0.47,0.466,0,2020-09-03,72,48,24,0.667,72,53,19,0.736
41900231,1610612746,1610612743,120.0,97.0,0.5710000000000001,0.422,1,2020-09-03,72,49,23,0.6809999999999999,73,46,27,0.63
41900202,1610612749,1610612748,114.0,116.0,0.435,0.457,0,2020-09-02,73,56,17,0.767,73,44,29,0.603
41900177,1610612745,1610612760,104.0,102.0,0.398,0.461,1,2020-09-02,72,44,28,0.611,72,44,28,0.611
41900212,1610612761,1610612738,99.0,102.0,0.4,0.421,0,2020-09-01,72,53,19,0.736,72,48,24,0.667
41900167,1610612743,1610612762,80.0,78.0,0.373,0.38,1,2020-09-01,73,46,27,0.63,72,44,28,0.611
41900201,1610612749,1610612748,104.0,115.0,0.493,0.464,0,2020-08-31,73,56,17,0.767,73,44,29,0.603
41900176,1610612760,1610612745,104.0,100.0,0.4270000000000001,0.452,1,2020-08-31,72,44,28,0.611,72,44,28,0.611
41900211,1610612761,1610612738,94.0,112.0,0.369,0.47,0,2020-08-30,72,53,19,0.736,72,48,24,0.667
41900156,1610612742,1610612746,97.0,111.0,0.422,0.484,0,2020-08-30,75,43,32,0.573,72,49,23,0.6809999999999999
41900166,1610612762,1610612743,107.0,119.0,0.453,0.5489999999999999,0,2020-08-30,72,44,28,0.611,73,46,27,0.63
41900105,1610612749,1610612753,118.0,104.0,0.455,0.394,1,2020-08-29,73,56,17,0.767,73,33,40,0.452
41900175,1610612745,1610612760,114.0,80.0,0.43,0.315,1,2020-08-29,72,44,28,0.611,72,44,28,0.611
41900145,1610612747,1610612757,131.0,122.0,0.545,0.473,1,2020-08-29,71,52,19,0.732,74,35,39,0.473
41900165,1610612743,1610612762,117.0,107.0,0.506,0.5,1,2020-08-25,73,46,27,0.63,72,44,28,0.611
41900155,1610612746,1610612742,154.0,111.0,0.631,0.447,1,2020-08-25,72,49,23,0.6809999999999999,75,43,32,0.573
41900104,1610612753,1610612749,106.0,121.0,0.414,0.495,0,2020-08-24,73,33,40,0.452,73,56,17,0.767
41900174,1610612760,1610612745,117.0,114.0,0.488,0.451,1,2020-08-24,72,44,28,0.611,72,44,28,0.611
41900134,1610612748,1610612754,99.0,87.0,0.44,0.413,1,2020-08-24,73,44,29,0.603,73,45,28,0.616
41900144,1610612757,1610612747,115.0,135.0,0.449,0.563,0,2020-08-24,74,35,39,0.473,71,52,19,0.732
41900124,1610612755,1610612738,106.0,110.0,0.4270000000000001,0.463,0,2020-08-23,73,43,30,0.589,72,48,24,0.667
41900154,1610612742,1610612746,135.0,133.0,0.5,0.464,1,2020-08-23,75,43,32,0.573,72,49,23,0.6809999999999999
41900114,1610612751,1610612761,122.0,150.0,0.398,0.5539999999999999,0,2020-08-23,72,35,37,0.486,72,53,19,0.736
41900164,1610612762,1610612743,129.0,127.0,0.575,0.49,1,2020-08-23,72,44,28,0.611,73,46,27,0.63
41900103,1610612753,1610612749,107.0,121.0,0.452,0.561,0,2020-08-22,73,33,40,0.452,73,56,17,0.767
41900133,1610612748,1610612754,124.0,115.0,0.453,0.488,1,2020-08-22,73,44,29,0.603,73,45,28,0.616
41900173,1610612760,1610612745,119.0,107.0,0.446,0.413,1,2020-08-22,72,44,28,0.611,72,44,28,0.611
41900143,1610612757,1610612747,108.0,116.0,0.411,0.5,0,2020-08-22,74,35,39,0.473,71,52,19,0.732
41900113,1610612751,1610612761,92.0,117.0,0.333,0.505,0,2020-08-21,72,35,37,0.486,72,53,19,0.736
41900163,1610612762,1610612743,124.0,87.0,0.512,0.375,1,2020-08-21,72,44,28,0.611,73,46,27,0.63
41900123,1610612755,1610612738,94.0,102.0,0.295,0.414,0,2020-08-21,73,43,30,0.589,72,48,24,0.667
41900153,1610612742,1610612746,122.0,130.0,0.506,0.522,0,2020-08-21,75,43,32,0.573,72,49,23,0.6809999999999999
41900132,1610612754,1610612748,100.0,109.0,0.444,0.474,0,2020-08-20,73,45,28,0.616,73,44,29,0.603
41900172,1610612745,1610612760,111.0,98.0,0.418,0.443,1,2020-08-20,72,44,28,0.611,72,44,28,0.611
41900102,1610612749,1610612753,111.0,96.0,0.472,0.348,1,2020-08-20,73,56,17,0.767,73,33,40,0.452
41900142,1610612747,1610612757,111.0,88.0,0.478,0.4,1,2020-08-20,71,52,19,0.732,74,35,39,0.473
41900112,1610612761,1610612751,104.0,99.0,0.4370000000000001,0.388,1,2020-08-19,72,53,19,0.736,72,35,37,0.486
41900162,1610612743,1610612762,105.0,124.0,0.457,0.517,0,2020-08-19,73,46,27,0.63,72,44,28,0.611
41900122,1610612738,1610612755,128.0,101.0,0.512,0.418,1,2020-08-19,72,48,24,0.667,73,43,30,0.589
41900152,1610612746,1610612742,114.0,127.0,0.44,0.5,0,2020-08-19,72,49,23,0.6809999999999999,75,43,32,0.573
41900101,1610612749,1610612753,110.0,122.0,0.433,0.494,0,2020-08-18,73,56,17,0.767,73,33,40,0.452
41900131,1610612754,1610612748,101.0,113.0,0.474,0.494,0,2020-08-18,73,45,28,0.616,73,44,29,0.603
41900171,1610612745,1610612760,123.0,108.0,0.483,0.44,1,2020-08-18,72,44,28,0.611,72,44,28,0.611
41900141,1610612747,1610612757,93.0,100.0,0.351,0.392,0,2020-08-18,71,52,19,0.732,74,35,39,0.473
41900161,1610612743,1610612762,135.0,125.0,0.516,0.474,1,2020-08-17,73,46,27,0.63,72,44,28,0.611
41900111,1610612761,1610612751,134.0,110.0,0.471,0.467,1,2020-08-17,72,53,19,0.736,72,35,37,0.486
41900121,1610612738,1610612755,109.0,101.0,0.422,0.463,1,2020-08-17,72,48,24,0.667,73,43,30,0.589
41900151,1610612746,1610612742,118.0,110.0,0.474,0.457,1,2020-08-17,72,49,23,0.6809999999999999,75,43,32,0.573
51900111,1610612757,1610612763,126.0,122.0,0.452,0.489,1,2020-08-15,74,35,39,0.473,73,34,39,0.466
21901318,1610612761,1610612743,117.0,109.0,0.5,0.414,1,2020-08-14,72,53,19,0.736,73,46,27,0.63
21901316,1610612754,1610612748,109.0,92.0,0.483,0.356,1,2020-08-14,73,45,28,0.616,73,44,29,0.603
21901317,1610612746,1610612760,107.0,103.0,0.4,0.358,1,2020-08-14,72,49,23,0.6809999999999999,72,44,28,0.611
21901315,1610612745,1610612755,96.0,134.0,0.438,0.563,0,2020-08-14,72,44,28,0.611,73,43,30,0.589
21901308,1610612738,1610612764,90.0,96.0,0.398,0.386,0,2020-08-13,72,48,24,0.667,72,25,47,0.347
21901310,1610612747,1610612758,122.0,136.0,0.49,0.568,0,2020-08-13,71,52,19,0.732,72,31,41,0.431
21901311,1610612763,1610612749,119.0,106.0,0.5,0.398,1,2020-08-13,73,34,39,0.466,73,56,17,0.767
21901313,1610612756,1610612742,128.0,102.0,0.551,0.438,1,2020-08-13,73,34,39,0.466,75,43,32,0.573
21901314,1610612762,1610612759,118.0,112.0,0.465,0.494,1,2020-08-13,72,44,28,0.611,71,32,39,0.451
21901309,1610612751,1610612757,133.0,134.0,0.552,0.481,0,2020-08-13,72,35,37,0.486,74,35,39,0.473
21901312,1610612753,1610612740,133.0,127.0,0.5710000000000001,0.552,1,2020-08-13,73,33,40,0.452,72,30,42,0.417
21901304,1610612745,1610612754,104.0,108.0,0.3720000000000001,0.4,0,2020-08-12,71,44,27,0.62,72,44,28,0.611
21901305,1610612755,1610612761,121.0,125.0,0.464,0.444,0,2020-08-12,72,42,30,0.583,71,52,19,0.732
21901306,1610612760,1610612748,116.0,115.0,0.438,0.488,1,2020-08-12,71,44,27,0.62,72,44,28,0.611
21901307,1610612743,1610612746,111.0,124.0,0.494,0.541,0,2020-08-12,72,46,26,0.639,71,48,23,0.6759999999999999
21901297,1610612753,1610612751,96.0,108.0,0.386,0.4270000000000001,0,2020-08-11,72,32,40,0.444,71,35,36,0.493
21901298,1610612759,1610612745,123.0,105.0,0.495,0.404,1,2020-08-11,70,32,38,0.457,70,44,26,0.629
21901299,1610612755,1610612756,117.0,130.0,0.495,0.551,0,2020-08-11,71,42,29,0.5920000000000001,72,33,39,0.458
21901301,1610612763,1610612738,107.0,122.0,0.393,0.512,0,2020-08-11,72,33,39,0.458,71,48,23,0.6759999999999999
21901300,1610612742,1610612757,131.0,134.0,0.519,0.469,0,2020-08-11,74,43,31,0.581,73,34,39,0.466
21901302,1610612758,1610612740,112.0,106.0,0.489,0.512,1,2020-08-11,71,30,41,0.423,71,30,41,0.423
21901303,1610612764,1610612749,113.0,126.0,0.411,0.506,0,2020-08-11,71,24,47,0.338,72,56,16,0.778
21901292,1610612756,1610612760,128.0,101.0,0.472,0.389,1,2020-08-10,71,32,39,0.451,70,43,27,0.614
21901293,1610612762,1610612742,114.0,122.0,0.476,0.565,0,2020-08-10,71,43,28,0.606,73,43,30,0.589
21901294,1610612749,1610612761,106.0,114.0,0.393,0.433,0,2020-08-10,71,55,16,0.775,70,51,19,0.7290000000000001
21901295,1610612748,1610612754,114.0,92.0,0.449,0.393,1,2020-08-10,71,44,27,0.62,71,43,28,0.606
21901296,1610612747,1610612743,124.0,121.0,0.5429999999999999,0.584,1,2020-08-10,70,52,18,0.743,71,46,25,0.648
21901285,1610612760,1610612764,121.0,103.0,0.512,0.413,1,2020-08-09,69,43,26,0.623,70,24,46,0.343
21901286,1610612761,1610612763,108.0,99.0,0.479,0.407,1,2020-08-09,69,50,19,0.725,71,33,38,0.465
21901287,1610612740,1610612759,113.0,122.0,0.438,0.449,0,2020-08-09,70,30,40,0.429,69,31,38,0.449
21901288,1610612738,1610612753,122.0,119.0,0.441,0.402,1,2020-08-09,70,47,23,0.6709999999999999,71,32,39,0.451
21901289,1610612757,1610612755,124.0,121.0,0.473,0.485,1,2020-08-09,72,33,39,0.458,70,42,28,0.6
21901290,1610612758,1610612745,112.0,129.0,0.471,0.473,0,2020-08-09,70,29,41,0.414,69,44,25,0.638
21901291,1610612746,1610612751,120.0,129.0,0.484,0.5529999999999999,0,2020-08-09,70,47,23,0.6709999999999999,70,34,36,0.486
21901280,1610612757,1610612746,117.0,122.0,0.489,0.494,0,2020-08-08,71,32,39,0.451,69,47,22,0.6809999999999999
21901281,1610612743,1610612762,134.0,132.0,0.472,0.448,1,2020-08-08,70,46,24,0.657,70,43,27,0.614
21901282,1610612754,1610612747,116.0,111.0,0.524,0.42,1,2020-08-08,70,43,27,0.614,69,51,18,0.7390000000000001
21901283,1610612748,1610612756,112.0,119.0,0.488,0.478,0,2020-08-08,70,43,27,0.614,70,31,39,0.443
21901284,1610612742,1610612749,136.0,132.0,0.417,0.475,1,2020-08-08,72,42,30,0.583,70,55,15,0.7859999999999999
21901274,1610612759,1610612762,119.0,111.0,0.506,0.418,1,2020-08-07,68,30,38,0.441,69,43,26,0.623
21901275,1610612763,1610612760,121.0,92.0,0.5539999999999999,0.351,1,2020-08-07,70,33,37,0.471,68,42,26,0.618
21901276,1610612751,1610612758,119.0,106.0,0.488,0.4270000000000001,1,2020-08-07,69,33,36,0.478,69,29,40,0.42
21901277,1610612755,1610612753,108.0,101.0,0.409,0.42,1,2020-08-07,69,42,27,0.609,70,32,38,0.457
21901278,1610612740,1610612764,118.0,107.0,0.477,0.422,1,2020-08-07,69,30,39,0.435,69,24,45,0.348
21901279,1610612761,1610612738,100.0,122.0,0.4270000000000001,0.49,0,2020-08-07,68,49,19,0.721,69,46,23,0.667
21901268,1610612758,1610612740,140.0,125.0,0.5379999999999999,0.573,1,2020-08-06,68,29,39,0.426,68,29,39,0.426
21901269,1610612749,1610612748,130.0,116.0,0.526,0.422,1,2020-08-06,69,55,14,0.797,69,43,26,0.623
21901270,1610612756,1610612754,114.0,99.0,0.467,0.435,1,2020-08-06,69,30,39,0.435,69,42,27,0.609
21901271,1610612742,1610612746,111.0,126.0,0.448,0.5429999999999999,0,2020-08-06,71,41,30,0.5770000000000001,68,46,22,0.6759999999999999
21901272,1610612743,1610612757,115.0,125.0,0.524,0.467,0,2020-08-06,69,45,24,0.652,70,32,38,0.457
21901273,1610612745,1610612747,113.0,97.0,0.429,0.455,1,2020-08-06,68,43,25,0.632,68,51,17,0.75
21901262,1610612762,1610612763,124.0,115.0,0.452,0.473,1,2020-08-05,68,43,25,0.632,69,32,37,0.464
21901263,1610612764,1610612755,98.0,107.0,0.424,0.463,0,2020-08-05,68,24,44,0.353,68,41,27,0.603
21901264,1610612759,1610612743,126.0,132.0,0.495,0.5489999999999999,0,2020-08-05,67,29,38,0.433,68,45,23,0.662
21901265,1610612747,1610612760,86.0,105.0,0.352,0.43,0,2020-08-05,67,51,16,0.7609999999999999,67,42,25,0.627
21901266,1610612753,1610612761,99.0,109.0,0.402,0.487,0,2020-08-05,69,32,37,0.464,67,49,18,0.731
21901267,1610612738,1610612751,149.0,115.0,0.568,0.474,1,2020-08-05,68,45,23,0.662,68,32,36,0.471
21901256,1610612749,1610612751,116.0,119.0,0.477,0.417,0,2020-08-04,68,54,14,0.794,67,32,35,0.478
21901257,1610612758,1610612742,110.0,114.0,0.413,0.3670000000000001,0,2020-08-04,67,28,39,0.418,70,41,29,0.586
21901258,1610612746,1610612756,115.0,117.0,0.494,0.469,0,2020-08-04,67,45,22,0.672,68,29,39,0.426
21901259,1610612754,1610612753,120.0,109.0,0.5479999999999999,0.476,1,2020-08-04,68,42,26,0.618,68,32,36,0.471
21901260,1610612748,1610612738,112.0,106.0,0.442,0.435,1,2020-08-04,68,43,25,0.632,67,44,23,0.657
21901261,1610612757,1610612745,110.0,102.0,0.411,0.391,1,2020-08-04,69,31,38,0.449,67,42,25,0.627
21901250,1610612748,1610612761,103.0,107.0,0.425,0.433,0,2020-08-03,67,42,25,0.627,66,48,18,0.727
21901251,1610612760,1610612743,113.0,121.0,0.425,0.483,0,2020-08-03,66,41,25,0.621,67,44,23,0.657
21901252,1610612764,1610612754,100.0,111.0,0.436,0.478,0,2020-08-03,67,24,43,0.358,67,41,26,0.612
21901253,1610612740,1610612763,109.0,99.0,0.451,0.398,1,2020-08-03,67,29,38,0.433,68,32,36,0.471
21901254,1610612755,1610612759,132.0,130.0,0.529,0.495,1,2020-08-03,67,40,27,0.597,66,29,37,0.439
21901255,1610612762,1610612747,108.0,116.0,0.446,0.5,0,2020-08-03,67,42,25,0.627,66,51,15,0.773
21901244,1610612751,1610612764,118.0,110.0,0.422,0.455,1,2020-08-02,66,31,35,0.47,66,24,42,0.364
21901245,1610612738,1610612757,128.0,124.0,0.545,0.5,1,2020-08-02,66,44,22,0.667,68,30,38,0.441
21901246,1610612763,1610612759,106.0,108.0,0.462,0.419,0,2020-08-02,67,32,35,0.478,65,29,36,0.446
21901247,1610612753,1610612758,132.0,116.0,0.524,0.495,1,2020-08-02,67,32,35,0.478,66,28,38,0.424
21901248,1610612745,1610612749,120.0,116.0,0.396,0.489,1,2020-08-02,66,42,24,0.636,67,54,13,0.8059999999999999
21901249,1610612756,1610612742,117.0,115.0,0.452,0.409,1,2020-08-02,67,28,39,0.418,69,40,29,0.58
21901239,1610612743,1610612748,105.0,125.0,0.438,0.556,0,2020-08-01,66,43,23,0.652,66,42,24,0.636
21901240,1610612760,1610612762,110.0,94.0,0.532,0.391,1,2020-08-01,65,41,24,0.631,66,42,24,0.636
21901241,1610612746,1610612740,126.0,103.0,0.425,0.447,1,2020-08-01,66,45,21,0.682,66,28,38,0.424
21901242,1610612754,1610612755,127.0,121.0,0.505,0.495,1,2020-08-01,66,40,26,0.606,66,39,27,0.591
21901243,1610612761,1610612747,107.0,92.0,0.417,0.354,1,2020-08-01,65,47,18,0.723,65,50,15,0.769
21901233,1610612751,1610612753,118.0,128.0,0.484,0.529,0,2020-07-31,65,30,35,0.462,66,31,35,0.47
21901234,1610612757,1610612763,140.0,135.0,0.5379999999999999,0.452,1,2020-07-31,67,30,37,0.448,66,32,34,0.485
21901235,1610612764,1610612756,112.0,125.0,0.462,0.525,0,2020-07-31,65,24,41,0.369,66,27,39,0.409
21901236,1610612749,1610612738,119.0,112.0,0.464,0.407,1,2020-07-31,66,54,12,0.818,65,43,22,0.662
21901237,1610612759,1610612758,129.0,120.0,0.5329999999999999,0.484,1,2020-07-31,64,28,36,0.438,65,28,37,0.431
21901238,1610612742,1610612745,149.0,153.0,0.476,0.515,0,2020-07-31,68,40,28,0.588,65,41,24,0.631
21901231,1610612740,1610612762,104.0,106.0,0.426,0.44,0,2020-07-30,65,28,37,0.431,65,42,23,0.6459999999999999
21901232,1610612747,1610612746,103.0,101.0,0.39,0.4320000000000001,1,2020-07-30,64,50,14,0.7809999999999999,65,44,21,0.677
11900128,1610612748,1610612763,110.0,128.0,0.429,0.469,0,2020-07-28,3,1,2,0.333,3,1,2,0.333
11900129,1610612756,1610612761,117.0,106.0,0.429,0.45,1,2020-07-28,3,2,1,0.667,3,2,1,0.667
11900130,1610612754,1610612759,111.0,118.0,0.448,0.484,0,2020-07-28,3,2,1,0.667,3,1,2,0.333
11900131,1610612757,1610612760,120.0,131.0,0.489,0.517,0,2020-07-28,3,0,3,0.0,3,3,0,1.0
11900132,1610612745,1610612738,137.0,112.0,0.462,0.466,1,2020-07-28,3,2,1,0.667,3,1,2,0.333
11900133,1610612755,1610612742,115.0,118.0,0.368,0.402,0,2020-07-28,3,1,2,0.333,3,2,1,0.667
11900123,1610612747,1610612764,123.0,116.0,0.494,0.461,1,2020-07-27,3,2,1,0.667,3,0,3,0.0
11900124,1610612746,1610612758,102.0,106.0,0.359,0.407,0,2020-07-27,3,2,1,0.667,3,1,2,0.333
11900125,1610612751,1610612762,107.0,112.0,0.457,0.447,0,2020-07-27,3,1,2,0.333,3,2,1,0.667
11900126,1610612743,1610612753,110.0,114.0,0.539,0.449,0,2020-07-27,3,1,2,0.333,3,1,2,0.333
11900127,1610612749,1610612740,103.0,124.0,0.395,0.457,0,2020-07-27,3,2,1,0.667,3,3,0,1.0
11900118,1610612760,1610612755,102.0,97.0,0.38,0.383,1,2020-07-26,2,2,0,1.0,2,1,1,0.5
11900119,1610612738,1610612756,117.0,103.0,0.488,0.389,1,2020-07-26,2,1,1,0.5,2,1,1,0.5
11900120,1610612742,1610612754,111.0,118.0,0.433,0.484,0,2020-07-26,2,1,1,0.5,2,2,0,1.0
11900121,1610612761,1610612757,110.0,104.0,0.386,0.419,1,2020-07-26,2,2,0,1.0,2,0,2,0.0
11900122,1610612763,1610612745,104.0,119.0,0.386,0.4270000000000001,0,2020-07-26,2,0,2,0.0,2,1,1,0.5
11900112,1610612753,1610612747,112.0,119.0,0.343,0.569,0,2020-07-25,2,0,2,0.0,2,1,1,0.5
11900113,1610612758,1610612749,123.0,131.0,0.408,0.488,0,2020-07-25,2,0,2,0.0,2,2,0,1.0
11900114,1610612762,1610612748,101.0,99.0,0.444,0.414,1,2020-07-25,2,1,1,0.5,2,1,1,0.5
11900115,1610612759,1610612751,119.0,124.0,0.457,0.4320000000000001,0,2020-07-25,2,0,2,0.0,2,1,1,0.5
11900116,1610612764,1610612746,100.0,105.0,0.356,0.47,0,2020-07-25,2,0,2,0.0,2,2,0,1.0
11900117,1610612740,1610612743,119.0,104.0,0.506,0.393,1,2020-07-25,2,2,0,1.0,2,1,1,0.5
11900109,1610612755,1610612763,90.0,83.0,0.4320000000000001,0.397,1,2020-07-24,1,1,0,1.0,1,0,1,0.0
11900110,1610612738,1610612760,84.0,98.0,0.444,0.521,0,2020-07-24,1,0,1,0.0,1,1,0,1.0
11900111,1610612761,1610612745,94.0,83.0,0.479,0.377,1,2020-07-24,1,1,0,1.0,1,0,1,0.0
11900105,1610612749,1610612759,113.0,92.0,0.468,0.455,1,2020-07-23,1,1,0,1.0,1,0,1,0.0
11900106,1610612754,1610612757,91.0,88.0,0.408,0.413,1,2020-07-23,1,1,0,1.0,1,0,1,0.0
11900107,1610612747,1610612742,104.0,108.0,0.494,0.541,0,2020-07-23,1,0,1,0.0,1,1,0,1.0
11900108,1610612762,1610612756,88.0,101.0,0.508,0.514,0,2020-07-23,1,0,1,0.0,1,1,0,1.0
11900101,1610612746,1610612753,99.0,90.0,0.442,0.421,1,2020-07-22,1,1,0,1.0,1,0,1,0.0
11900102,1610612743,1610612764,89.0,82.0,0.444,0.365,1,2020-07-22,1,1,0,1.0,1,0,1,0.0
11900103,1610612751,1610612740,68.0,99.0,0.352,0.468,0,2020-07-22,1,0,1,0.0,1,1,0,1.0
11900104,1610612748,1610612758,104.0,98.0,0.471,0.515,1,2020-07-22,1,1,0,1.0,1,0,1,0.0
21900971,1610612755,1610612765,124.0,106.0,0.506,0.464,1,2020-03-11,65,39,26,0.6,66,20,46,0.303
21900969,1610612737,1610612752,131.0,136.0,0.453,0.532,0,2020-03-11,67,20,47,0.299,66,21,45,0.318
21900970,1610612748,1610612766,98.0,109.0,0.464,0.451,0,2020-03-11,65,41,24,0.631,65,23,42,0.354
21900973,1610612742,1610612743,113.0,97.0,0.457,0.47,1,2020-03-11,67,40,27,0.597,65,43,22,0.662
21900960,1610612754,1610612738,111.0,114.0,0.495,0.441,0,2020-03-10,65,39,26,0.6,64,43,21,0.672
21900961,1610612764,1610612752,122.0,115.0,0.473,0.519,1,2020-03-10,64,24,40,0.375,65,20,45,0.308
21900962,1610612741,1610612739,108.0,103.0,0.5,0.5,1,2020-03-10,65,22,43,0.338,65,19,46,0.292
21900963,1610612745,1610612750,117.0,111.0,0.513,0.482,1,2020-03-10,64,40,24,0.625,64,19,45,0.297
21900964,1610612763,1610612753,115.0,120.0,0.5,0.467,0,2020-03-10,65,32,33,0.4920000000000001,65,30,35,0.462
21900965,1610612759,1610612742,119.0,109.0,0.517,0.457,1,2020-03-10,63,27,36,0.429,66,39,27,0.591
21900966,1610612757,1610612756,121.0,105.0,0.506,0.402,1,2020-03-10,66,29,37,0.439,65,26,39,0.4
21900967,1610612744,1610612746,107.0,131.0,0.468,0.5,0,2020-03-10,65,15,50,0.231,64,44,20,0.688
21900968,1610612747,1610612751,102.0,104.0,0.46,0.411,0,2020-03-10,63,49,14,0.778,64,30,34,0.469
21900957,1610612737,1610612766,143.0,138.0,0.552,0.471,1,2020-03-09,66,20,46,0.303,64,22,42,0.344
21900958,1610612743,1610612749,109.0,95.0,0.436,0.378,1,2020-03-09,64,43,21,0.672,65,53,12,0.815
21900959,1610612762,1610612761,92.0,101.0,0.398,0.434,0,2020-03-09,64,41,23,0.6409999999999999,64,46,18,0.7190000000000001
21900946,1610612751,1610612741,110.0,107.0,0.5,0.424,1,2020-03-08,63,29,34,0.46,64,21,43,0.328
21900947,1610612750,1610612740,107.0,120.0,0.394,0.489,0,2020-03-08,63,19,44,0.302,64,28,36,0.438
21900948,1610612746,1610612747,103.0,112.0,0.395,0.448,0,2020-03-08,63,43,20,0.6829999999999999,62,49,13,0.79
21900949,1610612738,1610612760,104.0,105.0,0.413,0.443,0,2020-03-08,63,42,21,0.667,64,40,24,0.625
21900950,1610612756,1610612749,140.0,131.0,0.5529999999999999,0.537,1,2020-03-08,64,26,38,0.406,64,53,11,0.828
21900951,1610612764,1610612748,89.0,100.0,0.333,0.485,0,2020-03-08,63,23,40,0.365,64,41,23,0.6409999999999999
21900952,1610612742,1610612754,109.0,112.0,0.429,0.523,0,2020-03-08,65,39,26,0.6,64,39,25,0.609
21900953,1610612745,1610612753,106.0,126.0,0.443,0.484,0,2020-03-08,63,39,24,0.619,64,29,35,0.453
21900954,1610612739,1610612759,132.0,129.0,0.457,0.439,1,2020-03-08,64,19,45,0.297,62,26,36,0.419
21900955,1610612752,1610612765,96.0,84.0,0.439,0.363,1,2020-03-08,64,20,44,0.313,65,20,45,0.308
21900956,1610612758,1610612761,113.0,118.0,0.467,0.476,0,2020-03-08,64,28,36,0.438,63,45,18,0.7140000000000001
21900940,1610612766,1610612745,108.0,99.0,0.529,0.461,1,2020-03-07,63,22,41,0.349,62,39,23,0.629
21900941,1610612765,1610612762,105.0,111.0,0.465,0.519,0,2020-03-07,64,20,44,0.313,63,41,22,0.6509999999999999
21900942,1610612739,1610612743,104.0,102.0,0.5529999999999999,0.506,1,2020-03-07,63,18,45,0.286,63,42,21,0.667
21900943,1610612763,1610612737,118.0,101.0,0.494,0.337,1,2020-03-07,64,32,32,0.5,65,19,46,0.292
21900944,1610612744,1610612755,118.0,114.0,0.55,0.488,1,2020-03-07,64,15,49,0.234,64,38,26,0.594
21900945,1610612757,1610612758,111.0,123.0,0.472,0.482,0,2020-03-07,65,28,37,0.431,63,28,35,0.444
21900930,1610612764,1610612737,118.0,112.0,0.474,0.535,1,2020-03-06,62,23,39,0.371,64,19,45,0.297
21900931,1610612751,1610612759,139.0,120.0,0.531,0.467,1,2020-03-06,62,28,34,0.452,61,26,35,0.426
21900932,1610612752,1610612760,103.0,126.0,0.451,0.49,0,2020-03-06,63,19,44,0.302,63,39,24,0.619
21900933,1610612738,1610612762,94.0,99.0,0.3720000000000001,0.45,0,2020-03-06,62,42,20,0.677,62,40,22,0.645
21900934,1610612741,1610612754,102.0,108.0,0.412,0.507,0,2020-03-06,63,21,42,0.333,63,38,25,0.603
21900935,1610612750,1610612753,118.0,132.0,0.469,0.607,0,2020-03-06,62,19,43,0.306,63,28,35,0.444
21900936,1610612740,1610612748,110.0,104.0,0.418,0.43,1,2020-03-06,63,27,36,0.429,63,40,23,0.635
21900937,1610612742,1610612763,121.0,96.0,0.474,0.464,1,2020-03-06,64,39,25,0.609,63,31,32,0.4920000000000001
21900938,1610612756,1610612757,127.0,117.0,0.495,0.494,1,2020-03-06,63,25,38,0.397,64,28,36,0.438
21900939,1610612747,1610612749,113.0,103.0,0.418,0.416,1,2020-03-06,61,48,13,0.787,63,53,10,0.841
21900926,1610612766,1610612743,112.0,114.0,0.494,0.53,0,2020-03-05,62,21,41,0.339,62,42,20,0.677
21900927,1610612745,1610612746,105.0,120.0,0.361,0.464,0,2020-03-05,61,39,22,0.639,62,43,19,0.6940000000000001
21900928,1610612758,1610612755,108.0,125.0,0.532,0.49,0,2020-03-05,62,27,35,0.435,63,38,25,0.603
21900929,1610612744,1610612761,113.0,121.0,0.408,0.476,0,2020-03-05,63,14,49,0.222,62,44,18,0.71
21900917,1610612739,1610612738,106.0,112.0,0.438,0.465,0,2020-03-04,62,17,45,0.274,61,42,19,0.6890000000000001
21900918,1610612765,1610612760,107.0,114.0,0.465,0.613,0,2020-03-04,63,20,43,0.317,62,38,24,0.613
21900924,1610612749,1610612754,119.0,100.0,0.457,0.433,1,2020-03-04,62,53,9,0.855,62,37,25,0.597
21900919,1610612748,1610612753,116.0,113.0,0.519,0.524,1,2020-03-04,62,40,22,0.645,62,27,35,0.435
21900920,1610612751,1610612763,79.0,118.0,0.333,0.43,0,2020-03-04,61,27,34,0.443,62,31,31,0.5
21900921,1610612752,1610612762,104.0,112.0,0.482,0.506,0,2020-03-04,62,19,43,0.306,61,39,22,0.639
21900922,1610612750,1610612741,115.0,108.0,0.494,0.479,1,2020-03-04,61,19,42,0.311,62,21,41,0.339
21900923,1610612742,1610612740,127.0,123.0,0.463,0.439,1,2020-03-04,63,38,25,0.603,62,26,36,0.419
21900925,1610612757,1610612764,125.0,104.0,0.519,0.388,1,2020-03-04,63,28,35,0.444,61,22,39,0.361
21900909,1610612766,1610612759,103.0,104.0,0.476,0.475,0,2020-03-03,61,21,40,0.344,60,26,34,0.433
21900910,1610612738,1610612751,120.0,129.0,0.4270000000000001,0.43,0,2020-03-03,60,41,19,0.6829999999999999,60,27,33,0.45
21900911,1610612740,1610612750,134.0,139.0,0.52,0.557,0,2020-03-03,61,26,35,0.426,60,18,42,0.3
21900912,1610612760,1610612746,94.0,109.0,0.42,0.452,0,2020-03-03,61,37,24,0.607,61,42,19,0.6890000000000001
21900913,1610612743,1610612744,100.0,116.0,0.448,0.512,0,2020-03-03,61,41,20,0.672,62,14,48,0.226
21900914,1610612756,1610612761,114.0,123.0,0.459,0.465,0,2020-03-03,62,24,38,0.387,61,43,18,0.705
21900915,1610612747,1610612755,120.0,107.0,0.535,0.447,1,2020-03-03,60,47,13,0.7829999999999999,62,37,25,0.597
21900916,1610612758,1610612764,133.0,126.0,0.562,0.513,1,2020-03-03,61,27,34,0.443,60,22,38,0.3670000000000001
21900902,1610612739,1610612762,113.0,126.0,0.462,0.5660000000000001,0,2020-03-02,61,17,44,0.279,60,38,22,0.633
21900903,1610612752,1610612745,125.0,123.0,0.485,0.415,1,2020-03-02,61,19,42,0.311,60,39,21,0.65
21900904,1610612753,1610612757,107.0,130.0,0.385,0.557,0,2020-03-02,61,27,34,0.443,62,27,35,0.435
21900905,1610612737,1610612763,88.0,127.0,0.3229999999999999,0.5,0,2020-03-02,63,19,44,0.302,61,30,31,0.4920000000000001
21900906,1610612748,1610612749,105.0,89.0,0.43,0.407,1,2020-03-02,61,39,22,0.639,61,52,9,0.852
21900907,1610612741,1610612742,109.0,107.0,0.468,0.476,1,2020-03-02,61,21,40,0.344,62,37,25,0.597
21900908,1610612759,1610612754,111.0,116.0,0.519,0.5,0,2020-03-02,59,25,34,0.424,61,37,24,0.607
21900895,1610612766,1610612749,85.0,93.0,0.354,0.402,0,2020-03-01,60,21,39,0.35,60,52,8,0.867
21900896,1610612750,1610612742,91.0,111.0,0.364,0.4679999999999999,0,2020-03-01,59,17,42,0.288,61,37,24,0.607
21900897,1610612746,1610612755,136.0,130.0,0.5920000000000001,0.505,1,2020-03-01,60,41,19,0.6829999999999999,61,37,24,0.607
21900898,1610612743,1610612761,133.0,118.0,0.5660000000000001,0.461,1,2020-03-01,60,41,19,0.6829999999999999,60,42,18,0.7
21900899,1610612758,1610612765,106.0,100.0,0.407,0.413,1,2020-03-01,60,26,34,0.433,62,20,42,0.3229999999999999
21900900,1610612740,1610612747,114.0,122.0,0.421,0.515,0,2020-03-01,60,26,34,0.433,59,46,13,0.78
21900901,1610612744,1610612764,110.0,124.0,0.472,0.488,0,2020-03-01,61,13,48,0.213,59,22,37,0.373
21900887,1610612752,1610612741,125.0,115.0,0.5529999999999999,0.461,1,2020-02-29,60,18,42,0.3,60,20,40,0.3329999999999999
21900888,1610612737,1610612757,129.0,117.0,0.5479999999999999,0.5,1,2020-02-29,62,19,43,0.306,61,26,35,0.426
21900889,1610612748,1610612751,116.0,113.0,0.451,0.465,1,2020-02-29,60,38,22,0.633,59,26,33,0.441
21900890,1610612739,1610612754,104.0,113.0,0.482,0.54,0,2020-02-29,60,17,43,0.283,60,36,24,0.6
21900891,1610612763,1610612747,105.0,88.0,0.4529999999999999,0.409,1,2020-02-29,60,29,31,0.483,58,45,13,0.7759999999999999
21900892,1610612738,1610612745,110.0,111.0,0.39,0.418,0,2020-02-29,59,41,18,0.695,59,39,20,0.6609999999999999
21900893,1610612759,1610612753,114.0,113.0,0.524,0.488,1,2020-02-29,58,25,33,0.431,60,27,33,0.45
21900894,1610612756,1610612744,99.0,115.0,0.41,0.471,0,2020-02-29,61,24,37,0.3929999999999999,60,13,47,0.217
21900877,1610612753,1610612750,136.0,125.0,0.541,0.484,1,2020-02-28,59,27,32,0.4579999999999999,58,17,41,0.293
21900878,1610612737,1610612751,141.0,118.0,0.515,0.457,1,2020-02-28,61,18,43,0.295,58,26,32,0.4479999999999999
21900879,1610612761,1610612766,96.0,99.0,0.347,0.436,0,2020-02-28,59,42,17,0.7120000000000001,59,21,38,0.356
21900880,1610612748,1610612742,126.0,118.0,0.519,0.476,1,2020-02-28,59,37,22,0.627,60,36,24,0.6
21900881,1610612763,1610612758,101.0,104.0,0.429,0.418,0,2020-02-28,59,28,31,0.475,59,25,34,0.424
21900882,1610612749,1610612760,133.0,86.0,0.5,0.363,1,2020-02-28,59,51,8,0.8640000000000001,60,37,23,0.617
21900883,1610612740,1610612739,116.0,104.0,0.545,0.4529999999999999,1,2020-02-28,59,26,33,0.441,59,17,42,0.288
21900884,1610612756,1610612765,111.0,113.0,0.6,0.489,0,2020-02-28,60,24,36,0.4,61,20,41,0.3279999999999999
21900885,1610612762,1610612764,129.0,119.0,0.494,0.4589999999999999,1,2020-02-28,59,37,22,0.627,58,21,37,0.362
21900886,1610612746,1610612743,132.0,103.0,0.539,0.451,1,2020-02-28,59,40,19,0.6779999999999999,59,40,19,0.6779999999999999
21900873,1610612755,1610612752,115.0,106.0,0.495,0.506,1,2020-02-27,60,37,23,0.617,59,17,42,0.288
21900874,1610612754,1610612757,106.0,100.0,0.444,0.461,1,2020-02-27,59,35,24,0.593,60,26,34,0.433
21900875,1610612760,1610612758,112.0,108.0,0.488,0.451,1,2020-02-27,59,37,22,0.627,58,24,34,0.414
21900876,1610612744,1610612747,86.0,116.0,0.425,0.511,0,2020-02-27,59,12,47,0.203,57,45,12,0.789
21900864,1610612766,1610612752,107.0,101.0,0.47,0.506,1,2020-02-26,58,20,38,0.345,58,17,41,0.293
21900865,1610612739,1610612755,108.0,94.0,0.526,0.4039999999999999,1,2020-02-26,58,17,41,0.293,59,36,23,0.61
21900866,1610612764,1610612751,110.0,106.0,0.4270000000000001,0.414,1,2020-02-26,57,21,36,0.368,57,26,31,0.456
21900867,1610612737,1610612753,120.0,130.0,0.447,0.49,0,2020-02-26,60,17,43,0.283,58,26,32,0.4479999999999999
21900868,1610612748,1610612750,126.0,129.0,0.526,0.516,0,2020-02-26,58,36,22,0.621,57,17,40,0.298
21900870,1610612745,1610612763,140.0,112.0,0.5589999999999999,0.3979999999999999,1,2020-02-26,58,38,20,0.655,58,28,30,0.483
21900869,1610612759,1610612742,103.0,109.0,0.424,0.419,0,2020-02-26,57,24,33,0.421,59,36,23,0.61
21900871,1610612756,1610612746,92.0,102.0,0.391,0.44,0,2020-02-26,59,24,35,0.407,58,39,19,0.672
21900872,1610612762,1610612738,103.0,114.0,0.449,0.536,0,2020-02-26,58,36,22,0.621,58,41,17,0.7070000000000001
21900857,1610612754,1610612766,119.0,80.0,0.57,0.3329999999999999,1,2020-02-25,58,34,24,0.586,57,19,38,0.3329999999999999
21900858,1610612761,1610612749,97.0,108.0,0.352,0.381,0,2020-02-25,58,42,16,0.7240000000000001,58,50,8,0.862
21900859,1610612741,1610612760,122.0,124.0,0.536,0.5529999999999999,0,2020-02-25,59,20,39,0.3389999999999999,58,36,22,0.621
21900860,1610612743,1610612765,115.0,98.0,0.579,0.407,1,2020-02-25,58,40,18,0.69,60,19,41,0.317
21900861,1610612747,1610612740,118.0,109.0,0.441,0.4529999999999999,1,2020-02-25,56,44,12,0.7859999999999999,58,25,33,0.431
21900862,1610612757,1610612738,106.0,118.0,0.447,0.478,0,2020-02-25,59,26,33,0.441,57,40,17,0.7020000000000001
21900863,1610612744,1610612758,94.0,112.0,0.4429999999999999,0.526,0,2020-02-25,58,12,46,0.207,57,24,33,0.421
21900849,1610612739,1610612748,125.0,119.0,0.4429999999999999,0.4579999999999999,1,2020-02-24,57,16,41,0.281,57,36,21,0.632
21900850,1610612755,1610612737,129.0,112.0,0.511,0.412,1,2020-02-24,58,36,22,0.621,59,17,42,0.288
21900851,1610612764,1610612749,134.0,137.0,0.48,0.57,0,2020-02-24,56,20,36,0.357,57,49,8,0.86
21900852,1610612751,1610612753,113.0,115.0,0.479,0.494,0,2020-02-24,56,26,30,0.4639999999999999,57,25,32,0.439
21900853,1610612745,1610612752,123.0,112.0,0.5,0.44,1,2020-02-24,57,37,20,0.649,57,17,40,0.298
21900854,1610612742,1610612750,139.0,123.0,0.505,0.442,1,2020-02-24,58,35,23,0.603,56,16,40,0.286
21900855,1610612762,1610612756,111.0,131.0,0.471,0.563,0,2020-02-24,57,36,21,0.632,58,24,34,0.414
21900856,1610612746,1610612763,124.0,97.0,0.5,0.416,1,2020-02-24,57,38,19,0.667,57,28,29,0.491
21900842,1610612747,1610612738,114.0,112.0,0.4529999999999999,0.4579999999999999,1,2020-02-23,55,43,12,0.782,56,39,17,0.696
21900843,1610612761,1610612754,127.0,81.0,0.511,0.326,1,2020-02-23,57,42,15,0.737,57,33,24,0.579
21900844,1610612743,1610612750,128.0,116.0,0.589,0.444,1,2020-02-23,57,39,18,0.684,55,16,39,0.291
21900845,1610612741,1610612764,126.0,117.0,0.556,0.507,1,2020-02-23,58,20,38,0.345,55,20,35,0.364
21900846,1610612760,1610612759,131.0,103.0,0.575,0.369,1,2020-02-23,57,35,22,0.614,56,24,32,0.429
21900847,1610612744,1610612740,101.0,115.0,0.435,0.469,0,2020-02-23,57,12,45,0.211,57,25,32,0.439
21900848,1610612757,1610612765,107.0,104.0,0.488,0.43,1,2020-02-23,58,26,32,0.4479999999999999,59,19,40,0.322
21900835,1610612746,1610612758,103.0,112.0,0.391,0.449,0,2020-02-22,56,37,19,0.6609999999999999,56,23,33,0.411
21900836,1610612766,1610612751,86.0,115.0,0.352,0.483,0,2020-02-22,56,19,37,0.3389999999999999,55,26,29,0.473
21900837,1610612737,1610612742,111.0,107.0,0.439,0.449,1,2020-02-22,58,17,41,0.293,57,34,23,0.596
21900838,1610612748,1610612739,124.0,105.0,0.57,0.481,1,2020-02-22,56,36,20,0.643,56,15,41,0.268
21900839,1610612741,1610612756,104.0,112.0,0.434,0.442,0,2020-02-22,57,19,38,0.3329999999999999,57,23,34,0.4039999999999999
21900840,1610612749,1610612755,119.0,98.0,0.527,0.354,1,2020-02-22,56,48,8,0.857,57,35,22,0.614
21900841,1610612762,1610612745,110.0,120.0,0.467,0.489,0,2020-02-22,56,36,20,0.643,56,36,20,0.643
21900826,1610612753,1610612742,106.0,122.0,0.3939999999999999,0.512,0,2020-02-21,56,24,32,0.429,56,34,22,0.607
21900827,1610612764,1610612739,108.0,113.0,0.387,0.531,0,2020-02-21,54,20,34,0.37,55,15,40,0.273
21900828,1610612752,1610612754,98.0,106.0,0.4320000000000001,0.409,0,2020-02-21,56,17,39,0.304,56,33,23,0.589
21900829,1610612761,1610612756,118.0,101.0,0.525,0.413,1,2020-02-21,56,41,15,0.732,56,22,34,0.3929999999999999
21900830,1610612750,1610612738,117.0,127.0,0.4039999999999999,0.4629999999999999,0,2020-02-21,54,16,38,0.296,55,39,16,0.7090000000000001
21900831,1610612760,1610612743,113.0,101.0,0.46,0.481,1,2020-02-21,56,34,22,0.607,56,38,18,0.679
21900832,1610612762,1610612759,104.0,113.0,0.4270000000000001,0.44,0,2020-02-21,55,36,19,0.655,55,24,31,0.436
21900833,1610612747,1610612763,117.0,105.0,0.477,0.457,1,2020-02-21,54,42,12,0.778,56,28,28,0.5
21900834,1610612757,1610612740,115.0,128.0,0.457,0.536,0,2020-02-21,57,25,32,0.439,56,24,32,0.429
21900820,1610612765,1610612749,106.0,126.0,0.482,0.505,0,2020-02-20,58,19,39,0.3279999999999999,55,47,8,0.855
21900821,1610612737,1610612748,129.0,124.0,0.482,0.408,1,2020-02-20,57,16,41,0.281,55,35,20,0.636
21900822,1610612755,1610612751,112.0,104.0,0.442,0.353,1,2020-02-20,56,35,21,0.625,54,25,29,0.4629999999999999
21900823,1610612741,1610612766,93.0,103.0,0.425,0.473,0,2020-02-20,56,19,37,0.3389999999999999,55,19,36,0.345
21900824,1610612758,1610612763,129.0,125.0,0.506,0.506,1,2020-02-20,55,22,33,0.4,55,28,27,0.509
21900825,1610612744,1610612745,105.0,135.0,0.494,0.529,0,2020-02-20,56,12,44,0.214,55,35,20,0.636
21900818,1610612738,1610612746,141.0,133.0,0.4370000000000001,0.418,1,2020-02-13,54,38,16,0.7040000000000001,55,37,18,0.6729999999999999
21900819,1610612740,1610612760,118.0,123.0,0.488,0.5,0,2020-02-13,55,23,32,0.418,55,33,22,0.6
21900807,1610612739,1610612737,127.0,105.0,0.511,0.429,1,2020-02-12,54,14,40,0.259,56,15,41,0.268
21900808,1610612753,1610612765,116.0,112.0,0.4579999999999999,0.435,1,2020-02-12,55,24,31,0.436,57,19,38,0.3329999999999999
21900809,1610612751,1610612761,101.0,91.0,0.409,0.3779999999999999,1,2020-02-12,53,25,28,0.472,55,40,15,0.727
21900810,1610612754,1610612749,118.0,111.0,0.523,0.407,1,2020-02-12,55,32,23,0.5820000000000001,54,46,8,0.852
21900811,1610612752,1610612764,96.0,114.0,0.409,0.476,0,2020-02-12,55,17,38,0.309,53,20,33,0.377
21900812,1610612763,1610612757,111.0,104.0,0.474,0.371,1,2020-02-12,54,28,26,0.519,56,25,31,0.446
21900813,1610612750,1610612766,108.0,115.0,0.386,0.467,0,2020-02-12,53,16,37,0.302,54,18,36,0.3329999999999999
21900814,1610612742,1610612758,130.0,111.0,0.565,0.414,1,2020-02-12,55,33,22,0.6,54,21,33,0.389
21900815,1610612756,1610612744,112.0,106.0,0.462,0.506,1,2020-02-12,55,22,33,0.4,55,12,43,0.218
21900816,1610612762,1610612748,116.0,101.0,0.482,0.4320000000000001,1,2020-02-12,54,36,18,0.667,54,35,19,0.648
21900817,1610612743,1610612747,116.0,120.0,0.5,0.505,0,2020-02-12,55,38,17,0.691,53,41,12,0.774
21900802,1610612755,1610612746,110.0,103.0,0.4629999999999999,0.444,1,2020-02-11,55,34,21,0.618,54,37,17,0.685
21900803,1610612764,1610612741,126.0,114.0,0.539,0.478,1,2020-02-11,52,19,33,0.365,55,19,36,0.345
21900804,1610612740,1610612757,138.0,117.0,0.5329999999999999,0.473,1,2020-02-11,54,23,31,0.426,55,25,30,0.455
21900805,1610612760,1610612759,106.0,114.0,0.4589999999999999,0.488,0,2020-02-11,54,32,22,0.593,54,23,31,0.426
21900806,1610612745,1610612738,116.0,105.0,0.429,0.435,1,2020-02-11,54,34,20,0.63,53,37,16,0.698
21900793,1610612765,1610612766,76.0,87.0,0.354,0.375,0,2020-02-10,56,19,37,0.3389999999999999,53,17,36,0.321
21900794,1610612754,1610612751,105.0,106.0,0.489,0.402,0,2020-02-10,54,31,23,0.574,52,24,28,0.462
21900795,1610612753,1610612737,135.0,126.0,0.526,0.534,1,2020-02-10,54,23,31,0.426,55,15,40,0.273
21900796,1610612761,1610612750,137.0,126.0,0.573,0.4529999999999999,1,2020-02-10,54,40,14,0.741,52,16,36,0.308
21900797,1610612749,1610612758,123.0,111.0,0.4479999999999999,0.416,1,2020-02-10,53,46,7,0.868,53,21,32,0.396
21900798,1610612742,1610612762,119.0,123.0,0.47,0.59,0,2020-02-10,54,32,22,0.593,53,35,18,0.66
21900799,1610612743,1610612759,127.0,120.0,0.563,0.482,1,2020-02-10,54,38,16,0.7040000000000001,53,22,31,0.415
21900800,1610612744,1610612748,101.0,113.0,0.39,0.494,0,2020-02-10,54,12,42,0.222,53,35,18,0.66
21900801,1610612747,1610612756,125.0,100.0,0.516,0.421,1,2020-02-10,52,40,12,0.769,54,21,33,0.389
21900786,1610612760,1610612738,111.0,112.0,0.4529999999999999,0.452,0,2020-02-09,53,32,21,0.604,52,37,15,0.7120000000000001
21900787,1610612737,1610612752,140.0,135.0,0.4539999999999999,0.473,1,2020-02-09,54,15,39,0.278,54,17,37,0.315
21900788,1610612755,1610612741,118.0,111.0,0.5,0.489,1,2020-02-09,54,33,21,0.611,54,19,35,0.352
21900789,1610612764,1610612763,99.0,106.0,0.35,0.422,0,2020-02-09,51,18,33,0.353,53,27,26,0.509
21900790,1610612745,1610612762,113.0,114.0,0.4629999999999999,0.488,0,2020-02-09,53,33,20,0.623,52,34,18,0.654
21900791,1610612739,1610612746,92.0,133.0,0.368,0.57,0,2020-02-09,53,13,40,0.245,53,37,16,0.698
21900792,1610612757,1610612748,115.0,109.0,0.471,0.3979999999999999,1,2020-02-09,54,25,29,0.4629999999999999,52,34,18,0.654
21900777,1610612753,1610612749,95.0,111.0,0.3779999999999999,0.452,0,2020-02-08,53,22,31,0.415,52,45,7,0.865
21900778,1610612766,1610612742,100.0,116.0,0.4370000000000001,0.506,0,2020-02-08,52,16,36,0.308,53,32,21,0.604
21900779,1610612765,1610612752,92.0,95.0,0.493,0.447,0,2020-02-08,55,19,36,0.345,53,17,36,0.321
21900780,1610612754,1610612740,117.0,124.0,0.53,0.4629999999999999,0,2020-02-08,53,31,22,0.585,53,22,31,0.415
21900781,1610612761,1610612751,119.0,118.0,0.474,0.446,1,2020-02-08,53,39,14,0.736,51,23,28,0.451
21900782,1610612750,1610612746,142.0,115.0,0.547,0.477,1,2020-02-08,51,16,35,0.314,52,36,16,0.6920000000000001
21900783,1610612744,1610612747,120.0,125.0,0.517,0.524,0,2020-02-08,53,12,41,0.226,51,39,12,0.765
21900784,1610612756,1610612743,108.0,117.0,0.4370000000000001,0.5489999999999999,0,2020-02-08,53,21,32,0.396,53,37,16,0.698
21900785,1610612758,1610612759,122.0,102.0,0.523,0.506,1,2020-02-08,52,21,31,0.4039999999999999,52,22,30,0.423
21900769,1610612755,1610612763,119.0,107.0,0.5329999999999999,0.409,1,2020-02-07,53,32,21,0.604,52,26,26,0.5
21900770,1610612764,1610612742,119.0,118.0,0.5,0.462,1,2020-02-07,50,18,32,0.36,52,31,21,0.596
21900771,1610612738,1610612737,112.0,107.0,0.43,0.407,1,2020-02-07,51,36,15,0.706,53,14,39,0.264
21900772,1610612754,1610612761,106.0,115.0,0.4529999999999999,0.477,0,2020-02-07,52,31,21,0.596,52,38,14,0.731
21900773,1610612760,1610612765,108.0,101.0,0.513,0.4270000000000001,1,2020-02-07,52,32,20,0.615,54,19,35,0.352
21900774,1610612756,1610612745,127.0,91.0,0.5579999999999999,0.341,1,2020-02-07,52,21,31,0.4039999999999999,52,33,19,0.635
21900775,1610612758,1610612748,105.0,97.0,0.488,0.442,1,2020-02-07,51,20,31,0.392,51,34,17,0.667
21900776,1610612762,1610612757,117.0,114.0,0.495,0.4539999999999999,1,2020-02-07,51,33,18,0.647,53,24,29,0.4529999999999999
21900764,1610612752,1610612753,105.0,103.0,0.467,0.4529999999999999,1,2020-02-06,52,16,36,0.308,52,22,30,0.423
21900765,1610612741,1610612740,119.0,125.0,0.495,0.563,0,2020-02-06,53,19,34,0.358,52,21,31,0.4039999999999999
21900766,1610612749,1610612755,112.0,101.0,0.4679999999999999,0.374,1,2020-02-06,51,44,7,0.863,52,31,21,0.596
21900767,1610612757,1610612759,125.0,117.0,0.5329999999999999,0.446,1,2020-02-06,52,24,28,0.462,51,22,29,0.431
21900768,1610612747,1610612745,111.0,121.0,0.495,0.506,0,2020-02-06,50,38,12,0.76,51,33,18,0.647
21900755,1610612765,1610612756,116.0,108.0,0.484,0.545,1,2020-02-05,53,19,34,0.358,51,20,31,0.392
21900756,1610612738,1610612753,116.0,100.0,0.535,0.4270000000000001,1,2020-02-05,50,35,15,0.7,51,22,29,0.431
21900757,1610612751,1610612744,129.0,88.0,0.51,0.365,1,2020-02-05,50,23,27,0.46,52,12,40,0.231
21900758,1610612761,1610612754,119.0,118.0,0.5,0.524,1,2020-02-05,51,37,14,0.725,51,31,20,0.608
21900759,1610612750,1610612737,120.0,127.0,0.495,0.524,0,2020-02-05,50,15,35,0.3,52,14,38,0.2689999999999999
21900760,1610612760,1610612739,109.0,103.0,0.469,0.461,1,2020-02-05,51,31,20,0.608,52,13,39,0.25
21900761,1610612742,1610612763,107.0,121.0,0.362,0.528,0,2020-02-05,51,31,20,0.608,51,26,25,0.51
21900762,1610612762,1610612743,95.0,98.0,0.419,0.433,0,2020-02-05,50,32,18,0.64,52,36,16,0.6920000000000001
21900763,1610612746,1610612748,128.0,111.0,0.506,0.43,1,2020-02-05,51,36,15,0.706,50,34,16,0.68
21900751,1610612740,1610612749,108.0,120.0,0.384,0.471,0,2020-02-04,51,20,31,0.392,50,43,7,0.86
21900752,1610612745,1610612766,125.0,110.0,0.4429999999999999,0.47,1,2020-02-04,50,32,18,0.64,51,16,35,0.314
21900753,1610612743,1610612757,127.0,99.0,0.511,0.396,1,2020-02-04,51,35,16,0.6859999999999999,51,23,28,0.451
21900754,1610612747,1610612759,129.0,102.0,0.588,0.44,1,2020-02-04,49,38,11,0.7759999999999999,50,22,28,0.44
21900741,1610612766,1610612753,100.0,112.0,0.461,0.5379999999999999,0,2020-02-03,50,16,34,0.32,50,22,28,0.44
21900742,1610612739,1610612752,134.0,139.0,0.565,0.5589999999999999,0,2020-02-03,51,13,38,0.255,51,15,36,0.294
21900743,1610612754,1610612742,103.0,112.0,0.458,0.419,0,2020-02-03,50,31,19,0.62,50,31,19,0.62
21900744,1610612764,1610612744,117.0,125.0,0.506,0.494,0,2020-02-03,49,17,32,0.347,51,12,39,0.235
21900745,1610612737,1610612738,115.0,123.0,0.5,0.5329999999999999,0,2020-02-03,51,13,38,0.255,49,34,15,0.6940000000000001
21900746,1610612751,1610612756,119.0,97.0,0.483,0.433,1,2020-02-03,49,22,27,0.449,50,20,30,0.4
21900747,1610612748,1610612755,137.0,106.0,0.565,0.434,1,2020-02-03,49,34,15,0.6940000000000001,51,31,20,0.608
21900748,1610612763,1610612765,96.0,82.0,0.467,0.347,1,2020-02-03,50,25,25,0.5,52,18,34,0.346
21900749,1610612758,1610612750,113.0,109.0,0.507,0.435,1,2020-02-03,50,19,31,0.38,49,15,34,0.306
21900750,1610612746,1610612759,108.0,105.0,0.464,0.421,1,2020-02-03,50,35,15,0.7,49,22,27,0.449
21900737,1610612765,1610612743,128.0,123.0,0.511,0.5,1,2020-02-02,51,18,33,0.353,50,34,16,0.68
21900738,1610612745,1610612740,117.0,109.0,0.39,0.447,1,2020-02-02,49,31,18,0.633,50,20,30,0.4
21900739,1610612749,1610612756,129.0,108.0,0.495,0.394,1,2020-02-02,49,42,7,0.857,49,20,29,0.408
21900740,1610612761,1610612741,129.0,102.0,0.56,0.389,1,2020-02-02,50,36,14,0.72,52,19,33,0.365
21900727,1610612746,1610612750,118.0,106.0,0.459,0.405,1,2020-02-01,49,34,15,0.6940000000000001,48,15,33,0.313
21900728,1610612754,1610612752,85.0,92.0,0.421,0.415,0,2020-02-01,49,31,18,0.633,50,14,36,0.28
21900729,1610612753,1610612748,89.0,102.0,0.398,0.429,0,2020-02-01,49,21,28,0.429,48,33,15,0.688
21900730,1610612739,1610612744,112.0,131.0,0.4320000000000001,0.5329999999999999,0,2020-02-01,50,13,37,0.26,50,11,39,0.22
21900731,1610612764,1610612751,113.0,107.0,0.44,0.415,1,2020-02-01,48,17,31,0.354,48,21,27,0.438
21900732,1610612738,1610612755,116.0,95.0,0.475,0.369,1,2020-02-01,48,33,15,0.688,50,31,19,0.62
21900733,1610612742,1610612737,123.0,100.0,0.468,0.407,1,2020-02-01,49,30,19,0.612,50,13,37,0.26
21900734,1610612759,1610612766,114.0,90.0,0.517,0.422,1,2020-02-01,48,22,26,0.458,49,16,33,0.327
21900736,1610612758,1610612747,113.0,129.0,0.429,0.512,0,2020-02-01,49,18,31,0.3670000000000001,48,37,11,0.7709999999999999
21900735,1610612757,1610612762,124.0,107.0,0.511,0.426,1,2020-02-01,50,23,27,0.46,49,32,17,0.653
21900720,1610612765,1610612761,92.0,105.0,0.354,0.518,0,2020-01-31,50,17,33,0.34,49,35,14,0.7140000000000001
21900721,1610612751,1610612741,133.0,118.0,0.625,0.488,1,2020-01-31,47,21,26,0.447,51,19,32,0.373
21900722,1610612745,1610612742,128.0,121.0,0.459,0.478,1,2020-01-31,48,30,18,0.625,48,29,19,0.604
21900723,1610612740,1610612763,139.0,111.0,0.537,0.469,1,2020-01-31,49,20,29,0.408,49,24,25,0.49
21900724,1610612749,1610612743,115.0,127.0,0.453,0.48,0,2020-01-31,48,41,7,0.8540000000000001,49,34,15,0.6940000000000001
21900725,1610612756,1610612760,107.0,111.0,0.474,0.433,0,2020-01-31,48,20,28,0.417,50,30,20,0.6
21900726,1610612747,1610612757,119.0,127.0,0.469,0.505,0,2020-01-31,47,36,11,0.7659999999999999,49,22,27,0.449
21900714,1610612739,1610612761,109.0,115.0,0.467,0.488,0,2020-01-30,49,13,36,0.265,48,34,14,0.708
21900715,1610612764,1610612766,121.0,107.0,0.477,0.434,1,2020-01-30,47,16,31,0.34,48,16,32,0.333
21900716,1610612737,1610612755,127.0,117.0,0.483,0.463,1,2020-01-30,49,13,36,0.265,49,31,18,0.633
21900717,1610612738,1610612744,119.0,104.0,0.477,0.429,1,2020-01-30,47,32,15,0.6809999999999999,49,10,39,0.204
21900718,1610612743,1610612762,106.0,100.0,0.471,0.462,1,2020-01-30,48,33,15,0.688,48,32,16,0.667
21900719,1610612746,1610612758,103.0,124.0,0.38,0.5,0,2020-01-30,48,33,15,0.688,48,18,30,0.375
21900708,1610612754,1610612741,115.0,106.0,0.517,0.529,1,2020-01-29,48,31,17,0.6459999999999999,50,19,31,0.38
21900709,1610612751,1610612765,125.0,115.0,0.506,0.506,1,2020-01-29,46,20,26,0.435,49,17,32,0.347
21900710,1610612752,1610612763,106.0,127.0,0.429,0.5,0,2020-01-29,49,13,36,0.265,48,24,24,0.5
21900711,1610612759,1610612762,127.0,120.0,0.561,0.44,1,2020-01-29,47,21,26,0.447,47,32,15,0.6809999999999999
21900712,1610612757,1610612745,125.0,112.0,0.517,0.426,1,2020-01-29,48,21,27,0.438,47,29,18,0.617
21900713,1610612758,1610612760,100.0,120.0,0.462,0.5,0,2020-01-29,47,17,30,0.362,49,29,20,0.5920000000000001
21900699,1610612766,1610612752,97.0,92.0,0.386,0.442,1,2020-01-28,47,16,31,0.34,48,13,35,0.271
21900702,1610612755,1610612744,115.0,104.0,0.512,0.425,1,2020-01-28,48,31,17,0.6459999999999999,48,10,38,0.208
21900700,1610612739,1610612740,111.0,125.0,0.4379999999999999,0.534,0,2020-01-28,48,13,35,0.271,48,19,29,0.396
21900703,1610612761,1610612737,130.0,114.0,0.495,0.446,1,2020-01-28,47,33,14,0.7020000000000001,48,12,36,0.25
21900701,1610612748,1610612738,101.0,109.0,0.371,0.47,0,2020-01-28,47,32,15,0.6809999999999999,46,31,15,0.674
21900704,1610612763,1610612743,104.0,96.0,0.561,0.3720000000000001,1,2020-01-28,47,23,24,0.489,47,32,15,0.6809999999999999
21900705,1610612749,1610612764,151.0,131.0,0.556,0.4679999999999999,1,2020-01-28,47,41,6,0.872,46,15,31,0.326
21900706,1610612742,1610612756,104.0,133.0,0.446,0.593,0,2020-01-28,47,29,18,0.617,47,20,27,0.426
21900693,1610612765,1610612739,100.0,115.0,0.452,0.5,0,2020-01-27,48,17,31,0.354,47,13,34,0.2769999999999999
21900694,1610612748,1610612753,113.0,92.0,0.532,0.371,1,2020-01-27,46,32,14,0.696,48,21,27,0.4379999999999999
21900695,1610612741,1610612759,110.0,109.0,0.452,0.4629999999999999,1,2020-01-27,49,19,30,0.3879999999999999,46,20,26,0.435
21900696,1610612750,1610612758,129.0,133.0,0.483,0.5,0,2020-01-27,47,15,32,0.319,46,17,29,0.37
21900697,1610612760,1610612742,97.0,107.0,0.395,0.414,0,2020-01-27,48,28,20,0.583,46,29,17,0.63
21900698,1610612762,1610612745,117.0,126.0,0.506,0.469,0,2020-01-27,46,32,14,0.696,46,29,17,0.63
21900685,1610612743,1610612745,117.0,110.0,0.473,0.455,1,2020-01-26,46,32,14,0.696,45,28,17,0.622
21900686,1610612759,1610612761,106.0,110.0,0.415,0.414,0,2020-01-26,45,20,25,0.444,46,32,14,0.696
21900687,1610612737,1610612764,152.0,133.0,0.581,0.477,1,2020-01-26,47,12,35,0.255,45,15,30,0.3329999999999999
21900688,1610612752,1610612751,110.0,97.0,0.5329999999999999,0.42,1,2020-01-26,47,13,34,0.2769999999999999,45,19,26,0.422
21900689,1610612753,1610612746,97.0,112.0,0.358,0.4679999999999999,0,2020-01-26,47,21,26,0.447,47,33,14,0.7020000000000001
21900690,1610612763,1610612756,114.0,109.0,0.524,0.38,1,2020-01-26,46,22,24,0.478,46,19,27,0.413
21900691,1610612740,1610612738,123.0,108.0,0.478,0.461,1,2020-01-26,47,18,29,0.3829999999999999,45,30,15,0.667
21900692,1610612757,1610612754,139.0,129.0,0.544,0.516,1,2020-01-26,47,20,27,0.426,47,30,17,0.638
21900680,1610612762,1610612742,112.0,107.0,0.44,0.433,1,2020-01-25,45,32,13,0.711,45,28,17,0.622
21900681,1610612765,1610612751,111.0,121.0,0.413,0.447,0,2020-01-25,47,17,30,0.362,44,19,25,0.4320000000000001
21900682,1610612739,1610612741,106.0,118.0,0.5,0.518,0,2020-01-25,46,12,34,0.261,48,18,30,0.375
21900683,1610612750,1610612760,104.0,113.0,0.444,0.488,0,2020-01-25,46,15,31,0.326,47,28,19,0.596
21900684,1610612755,1610612747,108.0,91.0,0.526,0.461,1,2020-01-25,47,30,17,0.638,46,36,10,0.7829999999999999
21900669,1610612766,1610612749,103.0,116.0,0.3720000000000001,0.506,0,2020-01-24,46,15,31,0.326,46,40,6,0.87
21900670,1610612765,1610612763,112.0,125.0,0.429,0.544,0,2020-01-24,46,17,29,0.37,45,21,24,0.467
21900671,1610612753,1610612738,98.0,109.0,0.4,0.465,0,2020-01-24,46,21,25,0.457,44,30,14,0.682
21900672,1610612752,1610612761,112.0,118.0,0.494,0.506,0,2020-01-24,46,12,34,0.261,45,31,14,0.6890000000000001
21900673,1610612748,1610612746,117.0,122.0,0.43,0.457,0,2020-01-24,45,31,14,0.6890000000000001,46,32,14,0.696
21900674,1610612741,1610612758,81.0,98.0,0.392,0.4320000000000001,0,2020-01-24,47,17,30,0.362,45,16,29,0.356
21900675,1610612750,1610612745,124.0,131.0,0.49,0.516,0,2020-01-24,45,15,30,0.3329999999999999,44,28,16,0.636
21900676,1610612740,1610612743,106.0,113.0,0.4629999999999999,0.377,0,2020-01-24,46,17,29,0.37,45,31,14,0.6890000000000001
21900677,1610612760,1610612737,140.0,111.0,0.581,0.457,1,2020-01-24,46,27,19,0.5870000000000001,46,11,35,0.239
21900678,1610612759,1610612756,99.0,103.0,0.423,0.4639999999999999,0,2020-01-24,44,20,24,0.455,45,19,26,0.422
21900679,1610612744,1610612754,118.0,129.0,0.488,0.575,0,2020-01-24,47,10,37,0.213,46,30,16,0.652
21900666,1610612739,1610612764,112.0,124.0,0.4579999999999999,0.5529999999999999,0,2020-01-23,45,12,33,0.267,44,15,29,0.341
21900667,1610612751,1610612747,113.0,128.0,0.44,0.5,0,2020-01-23,43,18,25,0.419,45,36,9,0.8
21900668,1610612757,1610612742,125.0,133.0,0.505,0.516,0,2020-01-23,46,19,27,0.413,44,28,16,0.636
21900654,1610612765,1610612758,127.0,106.0,0.534,0.429,1,2020-01-22,45,17,28,0.3779999999999999,44,15,29,0.341
21900655,1610612753,1610612760,114.0,120.0,0.478,0.605,0,2020-01-22,45,21,24,0.467,45,26,19,0.578
21900660,1610612761,1610612755,107.0,95.0,0.465,0.381,1,2020-01-22,44,30,14,0.682,46,29,17,0.63
21900656,1610612737,1610612746,102.0,95.0,0.353,0.423,1,2020-01-22,45,11,34,0.244,45,31,14,0.6890000000000001
21900657,1610612738,1610612763,119.0,95.0,0.506,0.424,1,2020-01-22,43,29,14,0.674,44,20,24,0.455
21900658,1610612748,1610612764,134.0,129.0,0.506,0.505,1,2020-01-22,44,31,13,0.705,43,14,29,0.326
21900659,1610612752,1610612747,92.0,100.0,0.409,0.439,0,2020-01-22,45,12,33,0.267,44,35,9,0.795
21900661,1610612741,1610612750,117.0,110.0,0.4639999999999999,0.477,1,2020-01-22,46,17,29,0.37,44,15,29,0.341
21900662,1610612745,1610612743,121.0,105.0,0.472,0.457,1,2020-01-22,43,27,16,0.628,44,30,14,0.682
21900664,1610612756,1610612754,87.0,112.0,0.357,0.536,0,2020-01-22,44,18,26,0.409,45,29,16,0.644
21900663,1610612740,1610612759,117.0,121.0,0.4639999999999999,0.506,0,2020-01-22,45,17,28,0.3779999999999999,43,20,23,0.465
21900665,1610612744,1610612762,96.0,129.0,0.3979999999999999,0.5379999999999999,0,2020-01-22,46,10,36,0.217,44,31,13,0.705
21900653,1610612742,1610612746,107.0,110.0,0.429,0.371,0,2020-01-21,43,27,16,0.628,44,31,13,0.705
21900639,1610612764,1610612765,106.0,100.0,0.512,0.4270000000000001,1,2020-01-20,42,14,28,0.3329999999999999,44,16,28,0.364
21900640,1610612737,1610612761,117.0,122.0,0.494,0.413,0,2020-01-20,44,10,34,0.2269999999999999,43,29,14,0.674
21900641,1610612751,1610612755,111.0,117.0,0.481,0.447,0,2020-01-20,42,18,24,0.429,45,29,16,0.644
21900642,1610612766,1610612753,83.0,106.0,0.382,0.478,0,2020-01-20,45,15,30,0.3329999999999999,44,21,23,0.477
21900643,1610612739,1610612752,86.0,106.0,0.34,0.482,0,2020-01-20,44,12,32,0.273,44,12,32,0.273
21900644,1610612748,1610612758,118.0,113.0,0.506,0.415,1,2020-01-20,43,30,13,0.698,43,15,28,0.349
21900645,1610612745,1610612760,107.0,112.0,0.4429999999999999,0.435,0,2020-01-20,42,26,16,0.619,44,25,19,0.568
21900646,1610612763,1610612740,116.0,126.0,0.447,0.477,0,2020-01-20,43,20,23,0.465,44,17,27,0.386
21900647,1610612749,1610612741,111.0,98.0,0.584,0.37,1,2020-01-20,45,39,6,0.867,45,16,29,0.356
21900648,1610612738,1610612747,139.0,107.0,0.5589999999999999,0.4379999999999999,1,2020-01-20,42,28,14,0.667,43,34,9,0.7909999999999999
21900649,1610612750,1610612743,100.0,107.0,0.418,0.478,0,2020-01-20,43,15,28,0.349,43,30,13,0.698
21900650,1610612756,1610612759,118.0,120.0,0.525,0.494,0,2020-01-20,43,18,25,0.419,42,19,23,0.452
21900651,1610612762,1610612754,118.0,88.0,0.54,0.419,1,2020-01-20,43,30,13,0.698,44,28,16,0.636
21900652,1610612757,1610612744,129.0,124.0,0.44,0.414,1,2020-01-20,45,19,26,0.422,45,10,35,0.222
21900637,1610612759,1610612748,107.0,102.0,0.424,0.43,1,2020-01-19,41,18,23,0.439,42,29,13,0.69
21900638,1610612743,1610612754,107.0,115.0,0.466,0.5,0,2020-01-19,42,29,13,0.69,43,28,15,0.6509999999999999
21900626,1610612740,1610612746,130.0,133.0,0.535,0.495,0,2020-01-18,43,16,27,0.3720000000000001,43,30,13,0.698
21900627,1610612751,1610612749,97.0,117.0,0.3329999999999999,0.506,0,2020-01-18,41,18,23,0.439,44,38,6,0.8640000000000001
21900628,1610612738,1610612756,119.0,123.0,0.4379999999999999,0.472,0,2020-01-18,41,27,14,0.659,42,18,24,0.429
21900629,1610612737,1610612765,103.0,136.0,0.43,0.593,0,2020-01-18,43,10,33,0.233,43,16,27,0.3720000000000001
21900630,1610612752,1610612755,87.0,90.0,0.3979999999999999,0.436,0,2020-01-18,43,11,32,0.256,44,28,16,0.636
21900631,1610612741,1610612739,118.0,116.0,0.552,0.5479999999999999,1,2020-01-18,44,16,28,0.364,43,12,31,0.2789999999999999
21900632,1610612750,1610612761,112.0,122.0,0.4039999999999999,0.516,0,2020-01-18,42,15,27,0.357,42,28,14,0.667
21900633,1610612745,1610612747,115.0,124.0,0.444,0.484,0,2020-01-18,41,26,15,0.634,42,34,8,0.81
21900634,1610612744,1610612753,109.0,95.0,0.457,0.4529999999999999,1,2020-01-18,44,10,34,0.2269999999999999,43,20,23,0.465
21900635,1610612760,1610612757,119.0,106.0,0.518,0.429,1,2020-01-18,43,24,19,0.5579999999999999,44,18,26,0.409
21900636,1610612762,1610612758,123.0,101.0,0.506,0.488,1,2020-01-18,42,29,13,0.69,42,15,27,0.357
21900619,1610612754,1610612750,116.0,114.0,0.561,0.455,1,2020-01-17,42,27,15,0.643,41,15,26,0.366
21900620,1610612755,1610612741,100.0,89.0,0.488,0.4320000000000001,1,2020-01-17,43,27,16,0.628,43,15,28,0.349
21900621,1610612761,1610612764,140.0,111.0,0.5710000000000001,0.449,1,2020-01-17,41,27,14,0.659,41,13,28,0.317
21900622,1610612763,1610612739,113.0,109.0,0.506,0.446,1,2020-01-17,42,20,22,0.476,42,12,30,0.286
21900623,1610612760,1610612748,108.0,115.0,0.44,0.488,0,2020-01-17,42,23,19,0.5479999999999999,41,29,12,0.7070000000000001
21900624,1610612759,1610612737,120.0,121.0,0.4589999999999999,0.5,0,2020-01-17,40,17,23,0.425,42,10,32,0.238
21900625,1610612742,1610612757,120.0,112.0,0.4379999999999999,0.518,1,2020-01-17,42,27,15,0.643,43,18,25,0.419
21900614,1610612752,1610612756,98.0,121.0,0.411,0.511,0,2020-01-16,42,11,31,0.262,41,17,24,0.415
21900615,1610612749,1610612738,128.0,123.0,0.494,0.439,1,2020-01-16,43,37,6,0.86,40,27,13,0.675
21900616,1610612740,1610612762,138.0,132.0,0.5479999999999999,0.46,1,2020-01-16,42,16,26,0.381,41,28,13,0.6829999999999999
21900617,1610612744,1610612743,131.0,134.0,0.442,0.47,0,2020-01-16,43,9,34,0.209,41,29,12,0.7070000000000001
21900618,1610612746,1610612753,122.0,95.0,0.495,0.391,1,2020-01-16,42,29,13,0.69,42,20,22,0.476
21900604,1610612738,1610612765,103.0,116.0,0.494,0.603,0,2020-01-15,39,27,12,0.6920000000000001,42,15,27,0.357
21900605,1610612755,1610612751,117.0,106.0,0.511,0.4370000000000001,1,2020-01-15,42,26,16,0.619,40,18,22,0.45
21900606,1610612748,1610612759,106.0,100.0,0.466,0.4379999999999999,1,2020-01-15,40,28,12,0.7,39,17,22,0.436
21900607,1610612741,1610612764,115.0,106.0,0.506,0.4679999999999999,1,2020-01-15,42,15,27,0.357,40,13,27,0.325
21900608,1610612750,1610612754,99.0,104.0,0.4320000000000001,0.518,0,2020-01-15,40,15,25,0.375,41,26,15,0.634
21900609,1610612760,1610612761,121.0,130.0,0.506,0.612,0,2020-01-15,41,23,18,0.561,40,26,14,0.65
21900610,1610612743,1610612766,100.0,86.0,0.481,0.407,1,2020-01-15,40,28,12,0.7,44,15,29,0.341
21900611,1610612745,1610612757,107.0,117.0,0.396,0.4320000000000001,0,2020-01-15,40,26,14,0.65,42,18,24,0.429
21900612,1610612758,1610612742,123.0,127.0,0.521,0.511,0,2020-01-15,41,15,26,0.366,41,26,15,0.634
21900613,1610612747,1610612753,118.0,119.0,0.495,0.457,0,2020-01-15,41,33,8,0.805,41,20,21,0.488
21900598,1610612737,1610612756,123.0,110.0,0.495,0.46,1,2020-01-14,41,9,32,0.22,40,16,24,0.4
21900599,1610612751,1610612762,107.0,118.0,0.5,0.5,0,2020-01-14,39,18,21,0.462,40,28,12,0.7
21900600,1610612763,1610612745,121.0,110.0,0.505,0.43,1,2020-01-14,41,19,22,0.4629999999999999,39,26,13,0.667
21900601,1610612749,1610612752,128.0,102.0,0.489,0.353,1,2020-01-14,42,36,6,0.857,41,11,30,0.268
21900602,1610612744,1610612742,97.0,124.0,0.4479999999999999,0.51,0,2020-01-14,42,9,33,0.214,40,25,15,0.625
21900603,1610612746,1610612739,128.0,103.0,0.521,0.418,1,2020-01-14,41,28,13,0.6829999999999999,41,12,29,0.293
21900591,1610612765,1610612740,110.0,117.0,0.4039999999999999,0.417,0,2020-01-13,41,14,27,0.341,41,15,26,0.366
21900592,1610612754,1610612755,101.0,95.0,0.384,0.416,1,2020-01-13,40,25,15,0.625,41,25,16,0.61
21900593,1610612738,1610612741,113.0,101.0,0.47,0.457,1,2020-01-13,38,27,11,0.711,41,14,27,0.341
21900594,1610612750,1610612760,104.0,117.0,0.418,0.5,0,2020-01-13,39,15,24,0.385,40,23,17,0.575
21900595,1610612757,1610612766,115.0,112.0,0.506,0.444,1,2020-01-13,41,17,24,0.415,43,15,28,0.349
21900596,1610612758,1610612753,112.0,114.0,0.517,0.435,0,2020-01-13,40,15,25,0.375,40,19,21,0.475
21900597,1610612747,1610612739,128.0,99.0,0.545,0.447,1,2020-01-13,40,33,7,0.825,40,12,28,0.3
21900584,1610612752,1610612748,124.0,121.0,0.511,0.5379999999999999,1,2020-01-12,40,11,29,0.275,39,27,12,0.6920000000000001
21900585,1610612764,1610612762,116.0,127.0,0.505,0.5329999999999999,0,2020-01-12,39,13,26,0.3329999999999999,39,27,12,0.6920000000000001
21900586,1610612751,1610612737,108.0,86.0,0.532,0.33,1,2020-01-12,38,18,20,0.474,40,8,32,0.2
21900587,1610612761,1610612759,104.0,105.0,0.406,0.4370000000000001,0,2020-01-12,39,25,14,0.6409999999999999,38,17,21,0.447
21900588,1610612763,1610612744,122.0,102.0,0.45,0.38,1,2020-01-12,40,18,22,0.45,41,9,32,0.22
21900589,1610612743,1610612746,114.0,104.0,0.481,0.452,1,2020-01-12,39,27,12,0.6920000000000001,40,27,13,0.675
21900590,1610612756,1610612766,100.0,92.0,0.5,0.419,1,2020-01-12,39,16,23,0.41,42,15,27,0.357
21900577,1610612745,1610612750,139.0,109.0,0.516,0.379,1,2020-01-11,38,26,12,0.684,38,15,23,0.395
21900578,1610612738,1610612740,140.0,105.0,0.55,0.4,1,2020-01-11,37,26,11,0.703,40,14,26,0.35
21900579,1610612765,1610612741,99.0,108.0,0.462,0.506,0,2020-01-11,40,14,26,0.35,40,14,26,0.35
21900580,1610612760,1610612747,110.0,125.0,0.467,0.515,0,2020-01-11,39,22,17,0.564,39,32,7,0.821
21900581,1610612742,1610612755,109.0,91.0,0.506,0.3779999999999999,1,2020-01-11,39,24,15,0.615,40,25,15,0.625
21900582,1610612743,1610612739,103.0,111.0,0.4320000000000001,0.494,0,2020-01-11,38,26,12,0.684,39,12,27,0.308
21900583,1610612757,1610612749,101.0,122.0,0.389,0.456,0,2020-01-11,40,16,24,0.4,41,35,6,0.8540000000000001
21900567,1610612764,1610612737,111.0,101.0,0.375,0.461,1,2020-01-10,38,13,25,0.342,39,8,31,0.205
21900569,1610612752,1610612740,111.0,123.0,0.46,0.5579999999999999,0,2020-01-10,39,10,29,0.256,39,14,25,0.359
21900568,1610612751,1610612748,117.0,113.0,0.484,0.518,1,2020-01-10,37,17,20,0.4589999999999999,38,27,11,0.711
21900570,1610612741,1610612754,105.0,116.0,0.4629999999999999,0.5710000000000001,0,2020-01-10,39,13,26,0.3329999999999999,39,24,15,0.615
21900571,1610612763,1610612759,134.0,121.0,0.52,0.483,1,2020-01-10,39,17,22,0.436,37,16,21,0.4320000000000001
21900573,1610612756,1610612753,98.0,94.0,0.418,0.371,1,2020-01-10,38,15,23,0.395,39,18,21,0.462
21900574,1610612762,1610612766,109.0,92.0,0.506,0.467,1,2020-01-10,38,26,12,0.684,41,15,26,0.366
21900572,1610612742,1610612747,114.0,129.0,0.406,0.528,0,2020-01-10,38,23,15,0.605,38,31,7,0.816
21900575,1610612758,1610612749,106.0,127.0,0.4579999999999999,0.495,0,2020-01-10,39,15,24,0.385,40,34,6,0.85
21900576,1610612746,1610612744,109.0,100.0,0.488,0.385,1,2020-01-10,39,27,12,0.6920000000000001,40,9,31,0.225
21900563,1610612765,1610612739,112.0,115.0,0.49,0.527,0,2020-01-09,39,14,25,0.359,38,11,27,0.289
21900564,1610612755,1610612738,109.0,98.0,0.489,0.4320000000000001,1,2020-01-09,39,25,14,0.6409999999999999,36,25,11,0.6940000000000001
21900565,1610612750,1610612757,116.0,102.0,0.494,0.365,1,2020-01-09,37,15,22,0.405,39,16,23,0.41
21900566,1610612760,1610612745,113.0,92.0,0.494,0.382,1,2020-01-09,38,22,16,0.579,37,25,12,0.6759999999999999
21900554,1610612738,1610612759,114.0,129.0,0.416,0.552,0,2020-01-08,35,25,10,0.7140000000000001,36,16,20,0.444
21900555,1610612766,1610612761,110.0,112.0,0.442,0.447,0,2020-01-08,40,15,25,0.375,38,25,13,0.6579999999999999
21900556,1610612754,1610612748,108.0,122.0,0.476,0.531,0,2020-01-08,38,23,15,0.605,37,27,10,0.73
21900557,1610612753,1610612764,123.0,89.0,0.494,0.429,1,2020-01-08,38,18,20,0.474,37,12,25,0.324
21900558,1610612737,1610612745,115.0,122.0,0.368,0.424,0,2020-01-08,38,8,30,0.211,36,25,11,0.6940000000000001
21900559,1610612742,1610612743,106.0,107.0,0.506,0.482,0,2020-01-08,37,23,14,0.622,37,26,11,0.703
21900560,1610612740,1610612741,123.0,108.0,0.471,0.446,1,2020-01-08,38,13,25,0.342,38,13,25,0.342
21900561,1610612762,1610612752,128.0,104.0,0.544,0.433,1,2020-01-08,37,25,12,0.6759999999999999,38,10,28,0.263
21900562,1610612744,1610612749,98.0,107.0,0.379,0.402,0,2020-01-08,39,9,30,0.231,39,33,6,0.846
21900548,1610612739,1610612765,113.0,115.0,0.494,0.462,0,2020-01-07,37,10,27,0.27,38,14,24,0.368
21900549,1610612761,1610612757,99.0,101.0,0.365,0.4320000000000001,0,2020-01-07,37,24,13,0.649,38,16,22,0.421
21900550,1610612751,1610612760,103.0,111.0,0.408,0.413,0,2020-01-07,36,16,20,0.444,37,21,16,0.568
21900551,1610612763,1610612750,119.0,112.0,0.517,0.444,1,2020-01-07,38,16,22,0.421,36,14,22,0.389
21900552,1610612756,1610612758,103.0,114.0,0.481,0.44,0,2020-01-07,37,14,23,0.3779999999999999,38,15,23,0.395
21900553,1610612747,1610612752,117.0,87.0,0.5,0.389,1,2020-01-07,37,30,7,0.8109999999999999,37,10,27,0.27
21900539,1610612766,1610612754,104.0,115.0,0.457,0.528,0,2020-01-06,39,15,24,0.385,37,23,14,0.622
21900540,1610612753,1610612751,101.0,89.0,0.4320000000000001,0.3329999999999999,1,2020-01-06,37,17,20,0.4589999999999999,35,16,19,0.457
21900541,1610612755,1610612760,120.0,113.0,0.511,0.449,1,2020-01-06,38,24,14,0.632,36,20,16,0.556
21900542,1610612764,1610612738,99.0,94.0,0.4639999999999999,0.347,1,2020-01-06,36,12,24,0.3329999999999999,34,25,9,0.735
21900543,1610612737,1610612743,115.0,123.0,0.455,0.511,0,2020-01-06,37,8,29,0.216,36,25,11,0.6940000000000001
21900544,1610612740,1610612762,126.0,128.0,0.479,0.511,0,2020-01-06,37,12,25,0.324,36,24,12,0.667
21900545,1610612742,1610612741,118.0,110.0,0.524,0.469,1,2020-01-06,36,23,13,0.639,37,13,24,0.351
21900546,1610612759,1610612749,126.0,104.0,0.511,0.4,1,2020-01-06,35,15,20,0.429,38,32,6,0.8420000000000001
21900547,1610612758,1610612744,111.0,98.0,0.481,0.395,1,2020-01-06,37,14,23,0.3779999999999999,38,9,29,0.237
21900534,1610612746,1610612752,135.0,132.0,0.542,0.5710000000000001,1,2020-01-05,38,26,12,0.684,36,10,26,0.278
21900535,1610612748,1610612757,122.0,111.0,0.522,0.46,1,2020-01-05,36,26,10,0.722,37,15,22,0.405
21900536,1610612739,1610612750,103.0,118.0,0.476,0.495,0,2020-01-05,36,10,26,0.278,35,14,21,0.4
21900537,1610612756,1610612763,114.0,121.0,0.4529999999999999,0.542,0,2020-01-05,36,14,22,0.389,37,15,22,0.405
21900538,1610612747,1610612765,106.0,99.0,0.457,0.3720000000000001,1,2020-01-05,36,29,7,0.8059999999999999,37,13,24,0.351
21900523,1610612746,1610612763,114.0,140.0,0.446,0.51,0,2020-01-04,37,25,12,0.6759999999999999,36,14,22,0.389
21900524,1610612751,1610612761,102.0,121.0,0.478,0.4539999999999999,0,2020-01-04,34,16,18,0.471,36,24,12,0.667
21900525,1610612753,1610612762,96.0,109.0,0.447,0.452,0,2020-01-04,36,16,20,0.444,35,23,12,0.657
21900526,1610612737,1610612754,116.0,111.0,0.512,0.414,1,2020-01-04,36,8,28,0.222,36,22,14,0.611
21900527,1610612739,1610612760,106.0,121.0,0.4589999999999999,0.4479999999999999,0,2020-01-04,35,10,25,0.286,35,20,15,0.5710000000000001
21900528,1610612764,1610612743,128.0,114.0,0.5489999999999999,0.46,1,2020-01-04,35,11,24,0.314,35,24,11,0.6859999999999999
21900529,1610612741,1610612738,104.0,111.0,0.425,0.524,0,2020-01-04,36,13,23,0.361,33,25,8,0.758
21900530,1610612742,1610612766,120.0,123.0,0.47,0.494,0,2020-01-04,35,22,13,0.629,38,15,23,0.395
21900531,1610612749,1610612759,127.0,118.0,0.494,0.413,1,2020-01-04,37,32,5,0.865,34,14,20,0.412
21900532,1610612744,1610612765,104.0,111.0,0.402,0.518,0,2020-01-04,37,9,28,0.243,36,13,23,0.361
21900533,1610612758,1610612740,115.0,117.0,0.447,0.4370000000000001,0,2020-01-04,36,13,23,0.361,36,12,24,0.3329999999999999
21900517,1610612738,1610612737,109.0,106.0,0.441,0.419,1,2020-01-03,32,24,8,0.75,35,7,28,0.2
21900518,1610612753,1610612748,105.0,85.0,0.407,0.375,1,2020-01-03,35,16,19,0.457,35,25,10,0.7140000000000001
21900519,1610612764,1610612757,103.0,122.0,0.422,0.511,0,2020-01-03,34,10,24,0.294,36,15,21,0.417
21900520,1610612745,1610612755,118.0,108.0,0.477,0.457,1,2020-01-03,35,24,11,0.6859999999999999,37,23,14,0.622
21900521,1610612756,1610612752,120.0,112.0,0.467,0.446,1,2020-01-03,35,14,21,0.4,35,10,25,0.286
21900522,1610612747,1610612740,123.0,113.0,0.5,0.471,1,2020-01-03,35,28,7,0.8,35,11,24,0.314
21900508,1610612739,1610612766,106.0,109.0,0.506,0.446,0,2020-01-02,34,10,24,0.294,37,14,23,0.3779999999999999
21900509,1610612754,1610612743,116.0,124.0,0.524,0.529,0,2020-01-02,35,22,13,0.629,34,24,10,0.706
21900510,1610612748,1610612761,84.0,76.0,0.407,0.315,1,2020-01-02,34,25,9,0.735,35,23,12,0.657
21900511,1610612741,1610612762,98.0,102.0,0.3939999999999999,0.487,0,2020-01-02,35,13,22,0.371,34,22,12,0.647
21900512,1610612750,1610612744,99.0,84.0,0.4,0.429,1,2020-01-02,34,13,21,0.382,36,9,27,0.25
21900513,1610612742,1610612751,123.0,111.0,0.506,0.462,1,2020-01-02,34,22,12,0.647,33,16,17,0.485
21900514,1610612759,1610612760,103.0,109.0,0.435,0.483,0,2020-01-02,33,14,19,0.424,34,19,15,0.5589999999999999
21900515,1610612758,1610612763,128.0,123.0,0.489,0.484,1,2020-01-02,35,13,22,0.371,35,13,22,0.371
21900516,1610612746,1610612765,126.0,112.0,0.5429999999999999,0.426,1,2020-01-02,36,25,11,0.6940000000000001,35,12,23,0.3429999999999999
21900504,1610612764,1610612753,101.0,122.0,0.379,0.474,0,2020-01-01,33,10,23,0.303,34,15,19,0.441
21900505,1610612752,1610612757,117.0,93.0,0.48,0.394,1,2020-01-01,34,10,24,0.294,35,14,21,0.4
21900506,1610612749,1610612750,106.0,104.0,0.426,0.374,1,2020-01-01,36,31,5,0.861,33,12,21,0.364
21900507,1610612747,1610612756,117.0,107.0,0.478,0.488,1,2020-01-01,34,27,7,0.794,34,13,21,0.382
21900497,1610612766,1610612738,92.0,109.0,0.395,0.454,0,2019-12-31,36,13,23,0.361,31,23,8,0.742
21900498,1610612754,1610612755,115.0,97.0,0.488,0.407,1,2019-12-31,34,22,12,0.647,36,23,13,0.639
21900499,1610612758,1610612746,87.0,105.0,0.413,0.409,0,2019-12-31,34,12,22,0.353,35,24,11,0.6859999999999999
21900500,1610612761,1610612739,117.0,97.0,0.476,0.425,1,2019-12-31,34,23,11,0.6759999999999999,33,10,23,0.303
21900501,1610612745,1610612743,130.0,104.0,0.529,0.464,1,2019-12-31,34,23,11,0.6759999999999999,33,23,10,0.6970000000000001
21900502,1610612759,1610612744,117.0,113.0,0.469,0.458,1,2019-12-31,32,14,18,0.438,35,9,26,0.257
21900503,1610612760,1610612742,106.0,101.0,0.429,0.355,1,2019-12-31,33,18,15,0.545,33,21,12,0.636
21900491,1610612753,1610612737,93.0,101.0,0.416,0.481,0,2019-12-30,33,14,19,0.424,34,7,27,0.206
21900492,1610612764,1610612748,123.0,105.0,0.512,0.452,1,2019-12-30,32,10,22,0.313,33,24,9,0.727
21900493,1610612741,1610612749,102.0,123.0,0.374,0.5479999999999999,0,2019-12-30,34,13,21,0.382,35,30,5,0.857
21900494,1610612750,1610612751,122.0,115.0,0.404,0.404,1,2019-12-30,32,12,20,0.375,32,16,16,0.5
21900495,1610612762,1610612765,104.0,81.0,0.47,0.38,1,2019-12-30,33,21,12,0.636,34,12,22,0.353
21900496,1610612757,1610612756,116.0,122.0,0.458,0.478,0,2019-12-30,34,14,20,0.412,33,13,20,0.394
21900486,1610612761,1610612760,97.0,98.0,0.422,0.436,0,2019-12-29,33,22,11,0.667,32,17,15,0.531
21900487,1610612763,1610612766,117.0,104.0,0.489,0.43,1,2019-12-29,34,13,21,0.382,35,13,22,0.371
21900488,1610612740,1610612745,127.0,112.0,0.49,0.519,1,2019-12-29,34,11,23,0.324,33,22,11,0.667
21900489,1610612743,1610612758,120.0,115.0,0.519,0.529,1,2019-12-29,32,23,9,0.7190000000000001,33,12,21,0.364
21900490,1610612747,1610612742,108.0,95.0,0.487,0.36,1,2019-12-29,33,26,7,0.7879999999999999,32,21,11,0.6559999999999999
21900472,1610612743,1610612763,119.0,110.0,0.484,0.488,1,2019-12-28,31,22,9,0.71,33,12,21,0.364
21900473,1610612738,1610612761,97.0,113.0,0.397,0.524,0,2019-12-28,30,22,8,0.733,32,22,10,0.688
21900474,1610612740,1610612754,120.0,98.0,0.462,0.3879999999999999,1,2019-12-28,33,10,23,0.303,33,21,12,0.636
21900475,1610612748,1610612755,117.0,116.0,0.447,0.472,1,2019-12-28,32,24,8,0.75,35,23,12,0.657
21900476,1610612764,1610612752,100.0,107.0,0.344,0.447,0,2019-12-28,31,9,22,0.29,33,9,24,0.273
21900477,1610612741,1610612737,116.0,81.0,0.494,0.3720000000000001,1,2019-12-28,33,13,20,0.3939999999999999,33,6,27,0.182
21900478,1610612745,1610612751,108.0,98.0,0.436,0.402,1,2019-12-28,32,22,10,0.688,31,16,15,0.516
21900479,1610612750,1610612739,88.0,94.0,0.355,0.416,0,2019-12-28,31,11,20,0.355,32,10,22,0.313
21900480,1610612749,1610612753,111.0,100.0,0.512,0.402,1,2019-12-28,34,29,5,0.853,32,14,18,0.4379999999999999
21900481,1610612759,1610612765,136.0,109.0,0.57,0.444,1,2019-12-28,31,13,18,0.419,33,12,21,0.364
21900482,1610612744,1610612742,121.0,141.0,0.489,0.522,0,2019-12-28,34,9,25,0.265,31,21,10,0.677
21900483,1610612758,1610612756,110.0,112.0,0.488,0.517,0,2019-12-28,32,12,20,0.375,32,12,20,0.375
21900484,1610612757,1610612747,120.0,128.0,0.477,0.516,0,2019-12-28,33,14,19,0.424,32,25,7,0.7809999999999999
21900485,1610612746,1610612762,107.0,120.0,0.368,0.523,0,2019-12-28,34,23,11,0.6759999999999999,32,20,12,0.625
21900466,1610612738,1610612739,129.0,117.0,0.516,0.518,1,2019-12-27,29,22,7,0.759,31,9,22,0.29
21900467,1610612766,1610612760,102.0,104.0,0.416,0.449,0,2019-12-27,34,13,21,0.382,31,16,15,0.516
21900468,1610612753,1610612755,98.0,97.0,0.42,0.402,1,2019-12-27,31,14,17,0.452,34,23,11,0.6759999999999999
21900469,1610612737,1610612749,86.0,112.0,0.363,0.505,0,2019-12-27,32,6,26,0.188,33,28,5,0.848
21900470,1610612748,1610612754,113.0,112.0,0.449,0.489,1,2019-12-27,31,23,8,0.742,32,21,11,0.6559999999999999
21900471,1610612744,1610612756,105.0,96.0,0.413,0.467,1,2019-12-27,33,9,24,0.273,31,11,20,0.355
21900460,1610612765,1610612764,132.0,102.0,0.535,0.413,1,2019-12-26,32,12,20,0.375,30,9,21,0.3
21900461,1610612751,1610612752,82.0,94.0,0.2689999999999999,0.402,0,2019-12-26,30,16,14,0.5329999999999999,32,8,24,0.25
21900462,1610612760,1610612763,97.0,110.0,0.413,0.5479999999999999,0,2019-12-26,30,15,15,0.5,32,12,20,0.375
21900463,1610612742,1610612759,102.0,98.0,0.422,0.482,1,2019-12-26,30,20,10,0.667,30,12,18,0.4
21900464,1610612758,1610612750,104.0,105.0,0.346,0.346,0,2019-12-26,31,12,19,0.387,30,11,19,0.3670000000000001
21900465,1610612762,1610612757,121.0,115.0,0.568,0.483,1,2019-12-26,31,19,12,0.613,32,14,18,0.4379999999999999
21900455,1610612761,1610612738,102.0,118.0,0.475,0.5,0,2019-12-25,31,21,10,0.677,28,21,7,0.75
21900456,1610612755,1610612749,121.0,109.0,0.436,0.474,1,2019-12-25,33,23,10,0.6970000000000001,32,27,5,0.8440000000000001
21900457,1610612744,1610612745,116.0,104.0,0.471,0.37,1,2019-12-25,32,8,24,0.25,31,21,10,0.677
21900458,1610612747,1610612746,106.0,111.0,0.406,0.4589999999999999,0,2019-12-25,31,24,7,0.774,33,23,10,0.6970000000000001
21900459,1610612743,1610612740,100.0,112.0,0.402,0.456,0,2019-12-25,30,21,9,0.7,32,9,23,0.281
21900444,1610612739,1610612737,121.0,118.0,0.521,0.474,1,2019-12-23,30,9,21,0.3,31,6,25,0.1939999999999999
21900445,1610612765,1610612755,109.0,125.0,0.512,0.547,0,2019-12-23,31,11,20,0.355,32,22,10,0.688
21900446,1610612754,1610612761,120.0,115.0,0.474,0.457,1,2019-12-23,31,21,10,0.677,30,21,9,0.7
21900447,1610612752,1610612764,115.0,121.0,0.473,0.47,0,2019-12-23,31,7,24,0.226,29,9,20,0.31
21900448,1610612753,1610612741,103.0,95.0,0.481,0.3979999999999999,1,2019-12-23,30,13,17,0.433,32,12,20,0.375
21900449,1610612748,1610612762,107.0,104.0,0.411,0.433,1,2019-12-23,30,22,8,0.733,30,18,12,0.6
21900450,1610612763,1610612759,115.0,145.0,0.469,0.674,0,2019-12-23,31,11,20,0.355,29,12,17,0.414
21900451,1610612756,1610612743,111.0,113.0,0.483,0.551,0,2019-12-23,30,11,19,0.3670000000000001,29,21,8,0.7240000000000001
21900452,1610612757,1610612740,94.0,102.0,0.407,0.409,0,2019-12-23,31,14,17,0.452,31,8,23,0.258
21900453,1610612758,1610612745,104.0,113.0,0.471,0.4479999999999999,0,2019-12-23,30,12,18,0.4,30,21,9,0.7
21900454,1610612744,1610612750,113.0,104.0,0.4370000000000001,0.402,1,2019-12-23,31,7,24,0.226,29,10,19,0.345
21900439,1610612761,1610612742,110.0,107.0,0.3939999999999999,0.389,1,2019-12-22,29,21,8,0.7240000000000001,29,19,10,0.655
21900440,1610612738,1610612766,119.0,93.0,0.523,0.402,1,2019-12-22,27,20,7,0.741,33,13,20,0.3939999999999999
21900441,1610612749,1610612754,117.0,89.0,0.423,0.37,1,2019-12-22,31,27,4,0.871,30,20,10,0.667
21900442,1610612760,1610612746,118.0,112.0,0.474,0.465,1,2019-12-22,29,15,14,0.517,32,22,10,0.688
21900443,1610612747,1610612743,104.0,128.0,0.47,0.489,0,2019-12-22,30,24,6,0.8,28,20,8,0.7140000000000001
21900430,1610612766,1610612762,107.0,114.0,0.4589999999999999,0.52,0,2019-12-21,32,13,19,0.406,29,18,11,0.621
21900431,1610612751,1610612737,122.0,112.0,0.46,0.371,1,2019-12-21,29,16,13,0.552,30,6,24,0.2
21900432,1610612765,1610612741,107.0,119.0,0.46,0.519,0,2019-12-21,30,11,19,0.3670000000000001,31,12,19,0.387
21900433,1610612755,1610612764,125.0,108.0,0.521,0.409,1,2019-12-21,31,21,10,0.677,28,8,20,0.286
21900434,1610612752,1610612749,102.0,123.0,0.402,0.482,0,2019-12-21,30,7,23,0.233,30,26,4,0.867
21900435,1610612763,1610612758,119.0,115.0,0.482,0.43,1,2019-12-21,30,11,19,0.3670000000000001,29,12,17,0.414
21900436,1610612759,1610612746,109.0,134.0,0.512,0.545,0,2019-12-21,28,11,17,0.3929999999999999,31,22,9,0.71
21900437,1610612756,1610612745,125.0,139.0,0.516,0.586,0,2019-12-21,29,11,18,0.379,29,20,9,0.69
21900438,1610612757,1610612750,113.0,106.0,0.426,0.4370000000000001,1,2019-12-21,30,14,16,0.467,28,10,18,0.357
21900420,1610612739,1610612763,114.0,107.0,0.435,0.431,1,2019-12-20,29,8,21,0.276,29,10,19,0.345
21900421,1610612754,1610612758,119.0,105.0,0.523,0.451,1,2019-12-20,29,20,9,0.69,28,12,16,0.429
21900422,1610612738,1610612765,114.0,93.0,0.523,0.4,1,2019-12-20,26,19,7,0.731,29,11,18,0.379
21900423,1610612761,1610612764,122.0,118.0,0.487,0.46,1,2019-12-20,28,20,8,0.7140000000000001,27,8,19,0.296
21900424,1610612748,1610612752,129.0,114.0,0.5579999999999999,0.436,1,2019-12-20,29,21,8,0.7240000000000001,29,7,22,0.241
21900425,1610612755,1610612742,98.0,117.0,0.422,0.518,0,2019-12-20,30,20,10,0.667,28,19,9,0.679
21900426,1610612760,1610612756,126.0,108.0,0.563,0.4370000000000001,1,2019-12-20,28,14,14,0.5,28,11,17,0.3929999999999999
21900427,1610612743,1610612750,109.0,100.0,0.494,0.414,1,2019-12-20,27,19,8,0.7040000000000001,27,10,17,0.37
21900428,1610612757,1610612753,118.0,103.0,0.5,0.368,1,2019-12-20,29,13,16,0.4479999999999999,29,12,17,0.414
21900429,1610612744,1610612740,106.0,102.0,0.434,0.419,1,2019-12-20,30,6,24,0.2,30,7,23,0.233
21900416,1610612737,1610612762,106.0,111.0,0.433,0.47,0,2019-12-19,29,6,23,0.207,28,17,11,0.607
21900417,1610612749,1610612747,111.0,104.0,0.4679999999999999,0.4629999999999999,1,2019-12-19,29,25,4,0.862,29,24,5,0.828
21900418,1610612759,1610612751,118.0,105.0,0.4479999999999999,0.422,1,2019-12-19,27,11,16,0.407,28,15,13,0.536
21900419,1610612746,1610612745,117.0,122.0,0.5,0.5,0,2019-12-19,30,21,9,0.7,28,19,9,0.679
21900407,1610612739,1610612766,100.0,98.0,0.541,0.407,1,2019-12-18,28,7,21,0.25,31,13,18,0.419
21900408,1610612765,1610612761,99.0,112.0,0.4479999999999999,0.429,0,2019-12-18,28,11,17,0.3929999999999999,27,19,8,0.7040000000000001
21900409,1610612764,1610612741,109.0,110.0,0.358,0.402,0,2019-12-18,26,8,18,0.308,30,11,19,0.3670000000000001
21900410,1610612755,1610612748,104.0,108.0,0.422,0.471,0,2019-12-18,29,20,9,0.69,28,20,8,0.7140000000000001
21900411,1610612750,1610612740,99.0,107.0,0.379,0.442,0,2019-12-18,26,10,16,0.385,29,7,22,0.241
21900412,1610612760,1610612763,126.0,122.0,0.5479999999999999,0.505,1,2019-12-18,27,13,14,0.481,28,10,18,0.357
21900414,1610612743,1610612753,113.0,104.0,0.476,0.425,1,2019-12-18,26,18,8,0.6920000000000001,28,12,16,0.429
21900413,1610612742,1610612738,103.0,109.0,0.391,0.407,0,2019-12-18,27,18,9,0.667,25,18,7,0.72
21900415,1610612757,1610612744,122.0,112.0,0.4539999999999999,0.3979999999999999,1,2019-12-18,28,12,16,0.429,29,5,24,0.172
21900401,1610612766,1610612758,110.0,102.0,0.481,0.418,1,2019-12-17,30,13,17,0.433,27,12,15,0.444
21900402,1610612754,1610612747,105.0,102.0,0.482,0.473,1,2019-12-17,28,19,9,0.679,28,24,4,0.857
21900403,1610612752,1610612737,143.0,120.0,0.5579999999999999,0.455,1,2019-12-17,28,7,21,0.25,28,6,22,0.214
21900404,1610612740,1610612751,101.0,108.0,0.346,0.417,0,2019-12-17,28,6,22,0.214,27,15,12,0.556
21900405,1610612762,1610612753,109.0,102.0,0.467,0.452,1,2019-12-17,27,16,11,0.593,27,12,15,0.444
21900406,1610612746,1610612756,120.0,99.0,0.506,0.402,1,2019-12-17,29,21,8,0.7240000000000001,27,11,16,0.407
21900394,1610612765,1610612764,119.0,133.0,0.477,0.557,0,2019-12-16,27,11,16,0.407,25,8,17,0.32
21900395,1610612761,1610612739,133.0,113.0,0.584,0.489,1,2019-12-16,26,18,8,0.6920000000000001,27,6,21,0.222
21900396,1610612745,1610612759,109.0,107.0,0.408,0.429,1,2019-12-16,27,18,9,0.667,26,10,16,0.385
21900397,1610612763,1610612748,118.0,111.0,0.488,0.457,1,2019-12-16,27,10,17,0.37,27,19,8,0.7040000000000001
21900398,1610612749,1610612742,116.0,120.0,0.419,0.466,0,2019-12-16,28,24,4,0.857,26,18,8,0.6920000000000001
21900399,1610612760,1610612741,109.0,106.0,0.507,0.494,1,2019-12-16,26,12,14,0.462,29,10,19,0.345
21900400,1610612756,1610612757,110.0,111.0,0.456,0.476,0,2019-12-16,26,11,15,0.423,27,11,16,0.407
21900388,1610612740,1610612753,119.0,130.0,0.534,0.517,0,2019-12-15,27,6,21,0.222,26,12,14,0.462
21900389,1610612754,1610612766,107.0,85.0,0.455,0.308,1,2019-12-15,27,18,9,0.667,29,12,17,0.414
21900390,1610612737,1610612747,96.0,101.0,0.36,0.429,0,2019-12-15,27,6,21,0.222,27,24,3,0.889
21900391,1610612751,1610612755,109.0,89.0,0.457,0.43,1,2019-12-15,26,14,12,0.5379999999999999,28,20,8,0.7140000000000001
21900392,1610612743,1610612752,111.0,105.0,0.4679999999999999,0.4679999999999999,1,2019-12-15,25,17,8,0.68,27,6,21,0.222
21900393,1610612744,1610612758,79.0,100.0,0.395,0.603,0,2019-12-15,28,5,23,0.179,26,12,14,0.462
21900380,1610612756,1610612759,119.0,121.0,0.4370000000000001,0.415,0,2019-12-14,25,11,14,0.44,25,10,15,0.4
21900381,1610612761,1610612751,110.0,102.0,0.3879999999999999,0.386,1,2019-12-14,25,17,8,0.68,25,13,12,0.52
21900382,1610612741,1610612746,109.0,106.0,0.471,0.4379999999999999,1,2019-12-14,28,10,18,0.357,28,20,8,0.7140000000000001
21900383,1610612763,1610612764,128.0,111.0,0.5710000000000001,0.424,1,2019-12-14,26,9,17,0.346,24,7,17,0.292
21900384,1610612742,1610612748,118.0,122.0,0.446,0.429,0,2019-12-14,25,17,8,0.68,26,19,7,0.731
21900385,1610612749,1610612739,125.0,108.0,0.541,0.456,1,2019-12-14,27,24,3,0.889,26,6,20,0.231
21900386,1610612745,1610612765,107.0,115.0,0.402,0.446,0,2019-12-14,26,17,9,0.654,26,11,15,0.423
21900387,1610612743,1610612760,110.0,102.0,0.506,0.469,1,2019-12-14,24,16,8,0.667,25,11,14,0.44
21900371,1610612753,1610612745,107.0,130.0,0.44,0.5579999999999999,0,2019-12-13,25,11,14,0.44,25,17,8,0.68
21900372,1610612755,1610612740,116.0,109.0,0.494,0.4320000000000001,1,2019-12-13,27,20,7,0.741,26,6,20,0.231
21900374,1610612748,1610612747,110.0,113.0,0.4589999999999999,0.494,0,2019-12-13,25,18,7,0.72,26,23,3,0.885
21900373,1610612737,1610612754,100.0,110.0,0.415,0.5,0,2019-12-13,26,6,20,0.231,26,17,9,0.654
21900375,1610612741,1610612766,73.0,83.0,0.3,0.38,0,2019-12-13,27,9,18,0.3329999999999999,28,12,16,0.429
21900376,1610612763,1610612749,114.0,127.0,0.3879999999999999,0.506,0,2019-12-13,25,8,17,0.32,26,23,3,0.885
21900379,1610612762,1610612744,114.0,106.0,0.4679999999999999,0.451,1,2019-12-13,26,15,11,0.5770000000000001,27,5,22,0.185
21900377,1610612750,1610612746,117.0,124.0,0.447,0.494,0,2019-12-13,25,10,15,0.4,27,20,7,0.741
21900378,1610612758,1610612752,101.0,103.0,0.47,0.4629999999999999,0,2019-12-13,25,11,14,0.44,26,6,20,0.231
21900367,1610612738,1610612755,109.0,115.0,0.462,0.5,0,2019-12-12,24,17,7,0.708,26,19,7,0.731
21900368,1610612759,1610612739,109.0,117.0,0.488,0.4579999999999999,0,2019-12-12,24,9,15,0.375,25,6,19,0.24
21900369,1610612765,1610612742,111.0,122.0,0.449,0.511,0,2019-12-12,25,10,15,0.4,24,17,7,0.708
21900370,1610612743,1610612757,114.0,99.0,0.477,0.477,1,2019-12-12,23,15,8,0.652,26,10,16,0.385
21900356,1610612739,1610612745,110.0,116.0,0.517,0.494,0,2019-12-11,24,5,19,0.208,24,16,8,0.667
21900357,1610612754,1610612738,122.0,117.0,0.482,0.494,1,2019-12-11,25,16,9,0.64,23,17,6,0.7390000000000001
21900358,1610612753,1610612747,87.0,96.0,0.42,0.425,0,2019-12-11,24,11,13,0.4579999999999999,25,22,3,0.88
21900359,1610612761,1610612746,92.0,112.0,0.352,0.442,0,2019-12-11,24,16,8,0.667,26,19,7,0.731
21900360,1610612751,1610612766,108.0,113.0,0.4320000000000001,0.409,0,2019-12-11,24,13,11,0.542,27,11,16,0.407
21900361,1610612741,1610612737,136.0,102.0,0.574,0.422,1,2019-12-11,26,9,17,0.346,25,6,19,0.24
21900362,1610612750,1610612762,116.0,127.0,0.44,0.5660000000000001,0,2019-12-11,24,10,14,0.417,25,14,11,0.56
21900363,1610612756,1610612763,108.0,115.0,0.3979999999999999,0.483,0,2019-12-11,24,11,13,0.4579999999999999,24,8,16,0.3329999999999999
21900364,1610612749,1610612740,127.0,112.0,0.5379999999999999,0.4429999999999999,1,2019-12-11,25,22,3,0.88,25,6,19,0.24
21900365,1610612758,1610612760,94.0,93.0,0.4429999999999999,0.43,1,2019-12-11,24,11,13,0.4579999999999999,24,11,13,0.4579999999999999
21900366,1610612744,1610612752,122.0,124.0,0.433,0.478,0,2019-12-11,26,5,21,0.192,25,5,20,0.2
21900352,1610612766,1610612764,114.0,107.0,0.447,0.422,1,2019-12-10,26,10,16,0.385,23,7,16,0.304
21900353,1610612755,1610612743,97.0,92.0,0.416,0.435,1,2019-12-10,25,18,7,0.72,22,14,8,0.636
21900354,1610612748,1610612737,135.0,121.0,0.515,0.474,1,2019-12-10,24,18,6,0.75,24,6,18,0.25
21900355,1610612757,1610612752,115.0,87.0,0.433,0.352,1,2019-12-10,25,10,15,0.4,24,4,20,0.1669999999999999
21900343,1610612754,1610612746,99.0,110.0,0.351,0.412,0,2019-12-09,24,15,9,0.625,25,18,7,0.72
21900344,1610612738,1610612739,110.0,88.0,0.5770000000000001,0.396,1,2019-12-09,22,17,5,0.773,23,5,18,0.217
21900345,1610612741,1610612761,92.0,93.0,0.3929999999999999,0.3779999999999999,0,2019-12-09,25,8,17,0.32,23,16,7,0.696
21900346,1610612745,1610612758,118.0,119.0,0.488,0.455,0,2019-12-09,23,15,8,0.652,23,10,13,0.435
21900347,1610612749,1610612753,110.0,101.0,0.467,0.38,1,2019-12-09,24,21,3,0.875,23,11,12,0.478
21900348,1610612740,1610612765,103.0,105.0,0.44,0.424,0,2019-12-09,24,6,18,0.25,24,10,14,0.417
21900349,1610612756,1610612750,125.0,109.0,0.495,0.471,1,2019-12-09,23,11,12,0.478,23,10,13,0.435
21900350,1610612762,1610612760,90.0,104.0,0.4039999999999999,0.471,0,2019-12-09,24,13,11,0.542,23,11,12,0.478
21900351,1610612744,1610612763,102.0,110.0,0.376,0.5,0,2019-12-09,25,5,20,0.2,23,7,16,0.304
21900335,1610612751,1610612743,105.0,102.0,0.46,0.4039999999999999,1,2019-12-08,23,13,10,0.565,21,14,7,0.667
21900336,1610612766,1610612737,107.0,122.0,0.4,0.484,0,2019-12-08,25,9,16,0.36,23,6,17,0.261
21900337,1610612748,1610612741,110.0,105.0,0.416,0.4379999999999999,1,2019-12-08,23,17,6,0.7390000000000001,24,8,16,0.3329999999999999
21900338,1610612755,1610612761,110.0,104.0,0.506,0.4320000000000001,1,2019-12-08,24,17,7,0.708,22,15,7,0.682
21900339,1610612764,1610612746,119.0,135.0,0.455,0.521,0,2019-12-08,22,7,15,0.318,24,17,7,0.708
21900340,1610612742,1610612758,106.0,110.0,0.477,0.518,0,2019-12-08,23,16,7,0.696,22,9,13,0.409
21900341,1610612757,1610612760,96.0,108.0,0.36,0.412,0,2019-12-08,24,9,15,0.375,22,10,12,0.455
21900342,1610612747,1610612750,142.0,125.0,0.585,0.524,1,2019-12-08,24,21,3,0.875,22,10,12,0.455
21900330,1610612742,1610612740,130.0,84.0,0.535,0.36,1,2019-12-07,22,16,6,0.727,23,6,17,0.261
21900331,1610612752,1610612754,103.0,104.0,0.406,0.482,0,2019-12-07,23,4,19,0.174,23,15,8,0.652
21900332,1610612755,1610612739,141.0,94.0,0.633,0.375,1,2019-12-07,23,16,7,0.696,22,5,17,0.2269999999999999
21900333,1610612745,1610612756,115.0,109.0,0.451,0.417,1,2019-12-07,22,15,7,0.682,22,10,12,0.455
21900334,1610612762,1610612763,126.0,112.0,0.563,0.531,1,2019-12-07,23,13,10,0.565,22,6,16,0.273
21900320,1610612766,1610612751,104.0,111.0,0.434,0.477,0,2019-12-06,24,9,15,0.375,22,12,10,0.545
21900321,1610612739,1610612753,87.0,93.0,0.422,0.39,0,2019-12-06,21,5,16,0.238,22,11,11,0.5
21900322,1610612765,1610612754,108.0,101.0,0.4479999999999999,0.4579999999999999,1,2019-12-06,23,9,14,0.391,22,14,8,0.636
21900323,1610612738,1610612743,108.0,95.0,0.537,0.415,1,2019-12-06,21,16,5,0.762,20,14,6,0.7
21900324,1610612748,1610612764,112.0,103.0,0.488,0.429,1,2019-12-06,22,16,6,0.727,21,7,14,0.3329999999999999
21900325,1610612741,1610612744,98.0,100.0,0.4429999999999999,0.535,0,2019-12-06,23,8,15,0.348,24,5,19,0.208
21900326,1610612760,1610612750,139.0,127.0,0.557,0.521,1,2019-12-06,21,9,12,0.429,21,10,11,0.476
21900327,1610612749,1610612746,119.0,91.0,0.4679999999999999,0.351,1,2019-12-06,23,20,3,0.87,23,16,7,0.696
21900328,1610612759,1610612758,105.0,104.0,0.4270000000000001,0.392,1,2019-12-06,23,9,14,0.391,21,8,13,0.381
21900329,1610612757,1610612747,113.0,136.0,0.4529999999999999,0.541,0,2019-12-06,23,9,14,0.391,23,20,3,0.87
21900316,1610612764,1610612755,119.0,113.0,0.456,0.532,1,2019-12-05,20,7,13,0.35,22,15,7,0.682
21900317,1610612752,1610612743,92.0,129.0,0.41,0.563,0,2019-12-05,22,4,18,0.182,19,14,5,0.737
21900318,1610612761,1610612745,109.0,119.0,0.4320000000000001,0.408,0,2019-12-05,21,15,6,0.7140000000000001,21,14,7,0.667
21900319,1610612740,1610612756,132.0,139.0,0.506,0.472,0,2019-12-05,22,6,16,0.273,21,10,11,0.476
21900306,1610612766,1610612744,106.0,91.0,0.46,0.462,1,2019-12-04,23,9,14,0.391,23,4,19,0.174
21900307,1610612765,1610612749,103.0,127.0,0.419,0.489,0,2019-12-04,22,8,14,0.364,22,19,3,0.8640000000000001
21900308,1610612753,1610612756,128.0,114.0,0.5760000000000001,0.489,1,2019-12-04,21,10,11,0.476,20,9,11,0.45
21900309,1610612737,1610612751,118.0,130.0,0.5329999999999999,0.495,0,2019-12-04,22,5,17,0.2269999999999999,21,11,10,0.524
21900310,1610612738,1610612748,112.0,93.0,0.4429999999999999,0.442,1,2019-12-04,20,15,5,0.75,21,15,6,0.7140000000000001
21900311,1610612741,1610612763,106.0,99.0,0.429,0.385,1,2019-12-04,22,8,14,0.364,21,6,15,0.286
21900312,1610612760,1610612754,100.0,107.0,0.488,0.483,0,2019-12-04,20,8,12,0.4,21,14,7,0.667
21900313,1610612742,1610612750,121.0,114.0,0.5,0.416,1,2019-12-04,21,15,6,0.7140000000000001,20,10,10,0.5
21900314,1610612762,1610612747,96.0,121.0,0.41,0.511,0,2019-12-04,22,12,10,0.545,22,19,3,0.8640000000000001
21900315,1610612757,1610612758,127.0,116.0,0.56,0.4629999999999999,1,2019-12-04,22,9,13,0.409,20,8,12,0.4
21900299,1610612739,1610612765,94.0,127.0,0.422,0.5429999999999999,0,2019-12-03,20,5,15,0.25,21,8,13,0.381
21900300,1610612764,1610612753,120.0,127.0,0.506,0.511,0,2019-12-03,19,6,13,0.316,20,9,11,0.45
21900301,1610612761,1610612748,110.0,121.0,0.385,0.455,0,2019-12-03,20,15,5,0.75,20,15,5,0.75
21900302,1610612740,1610612742,97.0,118.0,0.4039999999999999,0.4320000000000001,0,2019-12-03,21,6,15,0.286,20,14,6,0.7
21900303,1610612759,1610612745,135.0,133.0,0.472,0.3779999999999999,1,2019-12-03,22,8,14,0.364,20,13,7,0.65
21900304,1610612743,1610612747,96.0,105.0,0.407,0.4639999999999999,0,2019-12-03,18,13,5,0.722,21,18,3,0.857
21900305,1610612746,1610612757,117.0,97.0,0.457,0.429,1,2019-12-03,22,16,6,0.727,21,8,13,0.381
41300405,1610612759,1610612748,104.0,87.0,0.474,0.4,1,2014-06-15,82,62,20,0.7559999999999999,82,54,28,0.659
41300404,1610612748,1610612759,86.0,107.0,0.451,0.5710000000000001,0,2014-06-12,82,54,28,0.659,82,62,20,0.7559999999999999
41300403,1610612748,1610612759,92.0,111.0,0.516,0.594,0,2014-06-10,82,54,28,0.659,82,62,20,0.7559999999999999
41300402,1610612759,1610612748,96.0,98.0,0.439,0.529,0,2014-06-08,82,62,20,0.7559999999999999,82,54,28,0.659
41300401,1610612759,1610612748,110.0,95.0,0.588,0.474,1,2014-06-05,82,62,20,0.7559999999999999,82,54,28,0.659
41300316,1610612760,1610612759,107.0,112.0,0.4270000000000001,0.4039999999999999,0,2014-05-31,82,59,23,0.72,82,62,20,0.7559999999999999
41300306,1610612748,1610612754,117.0,92.0,0.579,0.4639999999999999,1,2014-05-30,82,54,28,0.659,82,56,26,0.6829999999999999
41300315,1610612759,1610612760,117.0,89.0,0.513,0.4320000000000001,1,2014-05-29,82,62,20,0.7559999999999999,82,59,23,0.72
41300305,1610612754,1610612748,93.0,90.0,0.474,0.4529999999999999,1,2014-05-28,82,56,26,0.6829999999999999,82,54,28,0.659
41300314,1610612760,1610612759,105.0,92.0,0.487,0.3979999999999999,1,2014-05-27,82,59,23,0.72,82,62,20,0.7559999999999999
41300304,1610612748,1610612754,102.0,90.0,0.4639999999999999,0.493,1,2014-05-26,82,54,28,0.659,82,56,26,0.6829999999999999
41300313,1610612760,1610612759,106.0,97.0,0.457,0.396,1,2014-05-25,82,59,23,0.72,82,62,20,0.7559999999999999
41300303,1610612748,1610612754,99.0,87.0,0.544,0.477,1,2014-05-24,82,54,28,0.659,82,56,26,0.6829999999999999
41300312,1610612759,1610612760,112.0,77.0,0.5,0.3929999999999999,1,2014-05-21,82,62,20,0.7559999999999999,82,59,23,0.72
41300302,1610612754,1610612748,83.0,87.0,0.4,0.507,0,2014-05-20,82,56,26,0.6829999999999999,82,54,28,0.659
41300311,1610612759,1610612760,122.0,105.0,0.575,0.4629999999999999,1,2014-05-19,82,62,20,0.7559999999999999,82,59,23,0.72
41300301,1610612754,1610612748,107.0,96.0,0.515,0.513,1,2014-05-18,82,56,26,0.6829999999999999,82,54,28,0.659
41300206,1610612764,1610612754,80.0,93.0,0.392,0.514,0,2014-05-15,82,44,38,0.537,82,56,26,0.6829999999999999
41300236,1610612746,1610612760,98.0,104.0,0.421,0.4579999999999999,0,2014-05-15,82,57,25,0.695,82,59,23,0.72
41300215,1610612748,1610612751,96.0,94.0,0.433,0.474,1,2014-05-14,82,54,28,0.659,82,44,38,0.537
41300225,1610612759,1610612757,104.0,82.0,0.472,0.407,1,2014-05-14,82,62,20,0.7559999999999999,82,54,28,0.659
41300205,1610612754,1610612764,79.0,102.0,0.39,0.5,0,2014-05-13,82,56,26,0.6829999999999999,82,44,38,0.537
41300235,1610612760,1610612746,105.0,104.0,0.429,0.4320000000000001,1,2014-05-13,82,59,23,0.72,82,57,25,0.695
41300214,1610612751,1610612748,96.0,102.0,0.436,0.529,0,2014-05-12,82,44,38,0.537,82,54,28,0.659
41300224,1610612757,1610612759,103.0,92.0,0.439,0.4429999999999999,1,2014-05-12,82,54,28,0.659,82,62,20,0.7559999999999999
41300234,1610612746,1610612760,101.0,99.0,0.419,0.44,1,2014-05-11,82,57,25,0.695,82,59,23,0.72
41300204,1610612764,1610612754,92.0,95.0,0.456,0.452,0,2014-05-11,82,44,38,0.537,82,56,26,0.6829999999999999
41300213,1610612751,1610612748,104.0,90.0,0.528,0.456,1,2014-05-10,82,44,38,0.537,82,54,28,0.659
41300223,1610612757,1610612759,103.0,118.0,0.429,0.483,0,2014-05-10,82,54,28,0.659,82,62,20,0.7559999999999999
41300203,1610612764,1610612754,63.0,85.0,0.3289999999999999,0.419,0,2014-05-09,82,44,38,0.537,82,56,26,0.6829999999999999
41300233,1610612746,1610612760,112.0,118.0,0.452,0.557,0,2014-05-09,82,57,25,0.695,82,59,23,0.72
41300212,1610612748,1610612751,94.0,82.0,0.493,0.423,1,2014-05-08,82,54,28,0.659,82,44,38,0.537
41300222,1610612759,1610612757,114.0,97.0,0.5329999999999999,0.43,1,2014-05-08,82,62,20,0.7559999999999999,82,54,28,0.659
41300202,1610612754,1610612764,86.0,82.0,0.444,0.45,1,2014-05-07,82,56,26,0.6829999999999999,82,44,38,0.537
41300232,1610612760,1610612746,112.0,101.0,0.506,0.446,1,2014-05-07,82,59,23,0.72,82,57,25,0.695
41300211,1610612748,1610612751,107.0,86.0,0.568,0.471,1,2014-05-06,82,54,28,0.659,82,44,38,0.537
41300221,1610612759,1610612757,116.0,92.0,0.506,0.3779999999999999,1,2014-05-06,82,62,20,0.7559999999999999,82,54,28,0.659
41300201,1610612754,1610612764,96.0,102.0,0.407,0.417,0,2014-05-05,82,56,26,0.6829999999999999,82,44,38,0.537
41300231,1610612760,1610612746,105.0,122.0,0.4589999999999999,0.5489999999999999,0,2014-05-05,82,59,23,0.72,82,57,25,0.695
41300127,1610612761,1610612751,103.0,104.0,0.479,0.457,0,2014-05-04,82,48,34,0.585,82,44,38,0.537
41300147,1610612759,1610612742,119.0,96.0,0.568,0.409,1,2014-05-04,82,62,20,0.7559999999999999,82,49,33,0.598
41300107,1610612754,1610612737,92.0,80.0,0.471,0.304,1,2014-05-03,82,56,26,0.6829999999999999,82,38,44,0.4629999999999999
41300157,1610612760,1610612763,120.0,109.0,0.609,0.446,1,2014-05-03,82,59,23,0.72,82,50,32,0.61
41300167,1610612746,1610612744,126.0,121.0,0.5539999999999999,0.494,1,2014-05-03,82,57,25,0.695,82,51,31,0.622
41300126,1610612751,1610612761,97.0,83.0,0.4679999999999999,0.385,1,2014-05-02,82,44,38,0.537,82,48,34,0.585
41300146,1610612742,1610612759,113.0,111.0,0.517,0.5329999999999999,1,2014-05-02,82,49,33,0.598,82,62,20,0.7559999999999999
41300176,1610612757,1610612745,99.0,98.0,0.4270000000000001,0.4529999999999999,1,2014-05-02,82,54,28,0.659,82,54,28,0.659
41300106,1610612737,1610612754,88.0,95.0,0.358,0.429,0,2014-05-01,82,38,44,0.4629999999999999,82,56,26,0.6829999999999999
41300156,1610612763,1610612760,84.0,104.0,0.373,0.493,0,2014-05-01,82,50,32,0.61,82,59,23,0.72
41300166,1610612744,1610612746,100.0,99.0,0.3929999999999999,0.3720000000000001,1,2014-05-01,82,51,31,0.622,82,57,25,0.695
41300145,1610612759,1610612742,109.0,103.0,0.466,0.4379999999999999,1,2014-04-30,82,62,20,0.7559999999999999,82,49,33,0.598
41300125,1610612761,1610612751,115.0,113.0,0.481,0.5329999999999999,1,2014-04-30,82,48,34,0.585,82,44,38,0.537
41300175,1610612745,1610612757,108.0,98.0,0.473,0.434,1,2014-04-30,82,54,28,0.659,82,54,28,0.659
41300135,1610612741,1610612764,69.0,75.0,0.3329999999999999,0.405,0,2014-04-29,82,48,34,0.585,82,44,38,0.537
41300155,1610612760,1610612763,99.0,100.0,0.391,0.425,0,2014-04-29,82,59,23,0.72,82,50,32,0.61
41300165,1610612746,1610612744,113.0,103.0,0.487,0.471,1,2014-04-29,82,57,25,0.695,82,51,31,0.622
41300114,1610612766,1610612748,98.0,109.0,0.507,0.5,0,2014-04-28,82,43,39,0.524,82,54,28,0.659
41300105,1610612754,1610612737,97.0,107.0,0.462,0.5,0,2014-04-28,82,56,26,0.6829999999999999,82,38,44,0.4629999999999999
41300144,1610612742,1610612759,89.0,93.0,0.381,0.45,0,2014-04-28,82,49,33,0.598,82,62,20,0.7559999999999999
41300134,1610612764,1610612741,98.0,89.0,0.407,0.449,1,2014-04-27,82,44,38,0.537,82,48,34,0.585
41300164,1610612744,1610612746,118.0,97.0,0.5539999999999999,0.429,1,2014-04-27,82,51,31,0.622,82,57,25,0.695
41300124,1610612751,1610612761,79.0,87.0,0.412,0.413,0,2014-04-27,82,44,38,0.537,82,48,34,0.585
41300174,1610612757,1610612745,123.0,120.0,0.495,0.488,1,2014-04-27,82,54,28,0.659,82,54,28,0.659
41300104,1610612737,1610612754,88.0,91.0,0.357,0.481,0,2014-04-26,82,38,44,0.4629999999999999,82,56,26,0.6829999999999999
41300143,1610612742,1610612759,109.0,108.0,0.512,0.5429999999999999,1,2014-04-26,82,49,33,0.598,82,62,20,0.7559999999999999
41300113,1610612766,1610612748,85.0,98.0,0.415,0.434,0,2014-04-26,82,43,39,0.524,82,54,28,0.659
41300154,1610612763,1610612760,89.0,92.0,0.3720000000000001,0.3670000000000001,0,2014-04-26,82,50,32,0.61,82,59,23,0.72
41300123,1610612751,1610612761,102.0,98.0,0.493,0.4629999999999999,1,2014-04-25,82,44,38,0.537,82,48,34,0.585
41300133,1610612764,1610612741,97.0,100.0,0.43,0.479,0,2014-04-25,82,44,38,0.537,82,48,34,0.585
41300173,1610612757,1610612745,116.0,121.0,0.456,0.429,0,2014-04-25,82,54,28,0.659,82,54,28,0.659
41300103,1610612737,1610612754,98.0,85.0,0.384,0.376,1,2014-04-24,82,38,44,0.4629999999999999,82,56,26,0.6829999999999999
41300153,1610612763,1610612760,98.0,95.0,0.446,0.391,1,2014-04-24,82,50,32,0.61,82,59,23,0.72
41300163,1610612744,1610612746,96.0,98.0,0.416,0.465,0,2014-04-24,82,51,31,0.622,82,57,25,0.695
41300112,1610612748,1610612766,101.0,97.0,0.522,0.42,1,2014-04-23,82,54,28,0.659,82,43,39,0.524
41300142,1610612759,1610612742,92.0,113.0,0.5,0.489,0,2014-04-23,82,62,20,0.7559999999999999,82,49,33,0.598
41300172,1610612745,1610612757,105.0,112.0,0.433,0.476,0,2014-04-23,82,54,28,0.659,82,54,28,0.659
41300102,1610612754,1610612737,101.0,85.0,0.529,0.392,1,2014-04-22,82,56,26,0.6829999999999999,82,38,44,0.4629999999999999
41300122,1610612761,1610612751,100.0,95.0,0.474,0.442,1,2014-04-22,82,48,34,0.585,82,44,38,0.537
41300132,1610612741,1610612764,99.0,101.0,0.4320000000000001,0.475,0,2014-04-22,82,48,34,0.585,82,44,38,0.537
41300152,1610612760,1610612763,105.0,111.0,0.3979999999999999,0.494,0,2014-04-21,82,59,23,0.72,82,50,32,0.61
41300162,1610612746,1610612744,138.0,98.0,0.5660000000000001,0.474,1,2014-04-21,82,57,25,0.695,82,51,31,0.622
41300141,1610612759,1610612742,90.0,85.0,0.4320000000000001,0.412,1,2014-04-20,82,62,20,0.7559999999999999,82,49,33,0.598
41300111,1610612748,1610612766,99.0,88.0,0.461,0.456,1,2014-04-20,82,54,28,0.659,82,43,39,0.524
41300131,1610612741,1610612764,93.0,102.0,0.42,0.486,0,2014-04-20,82,48,34,0.585,82,44,38,0.537
41300171,1610612745,1610612757,120.0,122.0,0.41,0.433,0,2014-04-20,82,54,28,0.659,82,54,28,0.659
41300121,1610612761,1610612751,87.0,94.0,0.3939999999999999,0.425,0,2014-04-19,82,48,34,0.585,82,44,38,0.537
41300161,1610612746,1610612744,105.0,109.0,0.424,0.444,0,2014-04-19,82,57,25,0.695,82,51,31,0.622
41300101,1610612754,1610612737,93.0,101.0,0.42,0.434,0,2014-04-19,82,56,26,0.6829999999999999,82,38,44,0.4629999999999999
41300151,1610612760,1610612763,100.0,86.0,0.447,0.363,1,2014-04-19,82,59,23,0.72,82,50,32,0.61
21301223,1610612766,1610612741,91.0,86.0,0.4,0.395,1,2014-04-16,82,43,39,0.524,82,48,34,0.585
21301227,1610612753,1610612754,86.0,101.0,0.405,0.466,0,2014-04-16,82,23,59,0.28,82,56,26,0.6829999999999999
21301216,1610612763,1610612742,106.0,105.0,0.489,0.478,1,2014-04-16,82,50,32,0.61,82,49,33,0.598
21301217,1610612749,1610612737,103.0,111.0,0.519,0.539,0,2014-04-16,82,15,67,0.183,82,38,44,0.4629999999999999
21301218,1610612750,1610612762,130.0,136.0,0.412,0.491,0,2014-04-16,82,40,42,0.488,82,25,57,0.305
21301219,1610612740,1610612745,105.0,100.0,0.524,0.4320000000000001,1,2014-04-16,82,34,48,0.415,82,54,28,0.659
21301220,1610612760,1610612765,112.0,111.0,0.442,0.506,1,2014-04-16,82,59,23,0.72,82,29,53,0.354
21301221,1610612759,1610612747,100.0,113.0,0.414,0.495,0,2014-04-16,82,62,20,0.7559999999999999,82,27,55,0.3289999999999999
21301222,1610612738,1610612764,102.0,118.0,0.4639999999999999,0.568,0,2014-04-16,82,25,57,0.305,82,44,38,0.537
21301224,1610612739,1610612751,114.0,85.0,0.529,0.38,1,2014-04-16,82,33,49,0.402,82,44,38,0.537
21301225,1610612748,1610612755,87.0,100.0,0.411,0.514,0,2014-04-16,82,54,28,0.659,82,19,63,0.2319999999999999
21301226,1610612752,1610612761,95.0,92.0,0.457,0.45,1,2014-04-16,82,37,45,0.451,82,48,34,0.585
21301228,1610612757,1610612746,110.0,104.0,0.416,0.405,1,2014-04-16,82,54,28,0.659,82,57,25,0.695
21301229,1610612758,1610612756,99.0,104.0,0.43,0.465,0,2014-04-16,82,28,54,0.341,82,48,34,0.585
21301230,1610612743,1610612744,112.0,116.0,0.44,0.489,0,2014-04-16,82,36,46,0.439,82,51,31,0.622
21301214,1610612751,1610612752,98.0,109.0,0.44,0.478,0,2014-04-15,81,44,37,0.5429999999999999,81,36,45,0.444
21301215,1610612746,1610612743,117.0,105.0,0.53,0.4270000000000001,1,2014-04-15,81,57,24,0.7040000000000001,81,36,45,0.444
21301204,1610612755,1610612738,113.0,108.0,0.544,0.465,1,2014-04-14,81,18,63,0.222,81,25,56,0.309
21301205,1610612761,1610612749,110.0,100.0,0.469,0.521,1,2014-04-14,81,48,33,0.593,81,15,66,0.185
21301206,1610612764,1610612748,114.0,93.0,0.59,0.45,1,2014-04-14,81,43,38,0.531,81,54,27,0.667
21301207,1610612737,1610612766,93.0,95.0,0.43,0.4379999999999999,0,2014-04-14,81,37,44,0.457,81,42,39,0.519
21301208,1610612741,1610612753,108.0,95.0,0.506,0.5,1,2014-04-14,81,48,33,0.593,81,23,58,0.284
21301209,1610612745,1610612759,104.0,98.0,0.447,0.4379999999999999,1,2014-04-14,81,54,27,0.667,81,62,19,0.765
21301210,1610612740,1610612760,101.0,89.0,0.4429999999999999,0.4029999999999999,1,2014-04-14,81,33,48,0.407,81,58,23,0.716
21301211,1610612762,1610612747,104.0,119.0,0.519,0.5489999999999999,0,2014-04-14,81,24,57,0.296,81,26,55,0.321
21301212,1610612756,1610612763,91.0,97.0,0.475,0.519,0,2014-04-14,81,47,34,0.58,81,49,32,0.605
21301213,1610612744,1610612750,130.0,120.0,0.485,0.531,1,2014-04-14,81,50,31,0.617,81,40,41,0.494
21301200,1610612754,1610612760,102.0,97.0,0.528,0.429,1,2014-04-13,81,55,26,0.679,80,58,22,0.725
21301198,1610612765,1610612761,107.0,116.0,0.417,0.481,0,2014-04-13,81,29,52,0.358,80,47,33,0.588
21301199,1610612751,1610612753,97.0,88.0,0.466,0.473,1,2014-04-13,80,44,36,0.55,80,23,57,0.288
21301197,1610612752,1610612741,100.0,89.0,0.457,0.392,1,2014-04-13,80,35,45,0.4379999999999999,80,47,33,0.588
21301201,1610612757,1610612744,119.0,117.0,0.5,0.484,1,2014-04-13,81,53,28,0.654,80,49,31,0.613
21301202,1610612758,1610612750,106.0,103.0,0.5,0.3979999999999999,1,2014-04-13,81,28,53,0.346,80,40,40,0.5
21301203,1610612747,1610612763,90.0,102.0,0.4379999999999999,0.477,0,2014-04-13,80,25,55,0.313,80,48,32,0.6
21301189,1610612746,1610612758,117.0,101.0,0.506,0.4270000000000001,1,2014-04-12,80,56,24,0.7,80,27,53,0.3379999999999999
21301190,1610612766,1610612755,111.0,105.0,0.542,0.441,1,2014-04-12,80,41,39,0.513,80,17,63,0.213
21301191,1610612764,1610612749,104.0,91.0,0.476,0.471,1,2014-04-12,80,42,38,0.525,80,15,65,0.188
21301192,1610612737,1610612748,98.0,85.0,0.462,0.479,1,2014-04-12,80,37,43,0.4629999999999999,80,54,26,0.675
21301193,1610612739,1610612738,99.0,111.0,0.411,0.467,0,2014-04-12,81,32,49,0.395,80,25,55,0.313
21301194,1610612745,1610612740,111.0,104.0,0.473,0.4429999999999999,1,2014-04-12,80,53,27,0.6629999999999999,80,32,48,0.4
21301195,1610612742,1610612756,101.0,98.0,0.494,0.462,1,2014-04-12,81,49,32,0.605,80,47,33,0.588
21301196,1610612743,1610612762,101.0,94.0,0.417,0.43,1,2014-04-12,80,36,44,0.45,80,24,56,0.3
21301176,1610612753,1610612764,86.0,96.0,0.416,0.4270000000000001,0,2014-04-11,79,23,56,0.291,79,41,38,0.519
21301177,1610612761,1610612752,100.0,108.0,0.395,0.479,0,2014-04-11,79,46,33,0.5820000000000001,79,34,45,0.43
21301178,1610612738,1610612766,106.0,103.0,0.519,0.506,1,2014-04-11,79,24,55,0.304,79,40,39,0.506
21301179,1610612751,1610612737,88.0,93.0,0.425,0.456,0,2014-04-11,79,43,36,0.544,79,36,43,0.456
21301180,1610612748,1610612754,98.0,86.0,0.467,0.477,1,2014-04-11,79,54,25,0.684,80,54,26,0.675
21301181,1610612741,1610612765,106.0,98.0,0.494,0.465,1,2014-04-11,79,47,32,0.595,80,29,51,0.363
21301182,1610612763,1610612755,117.0,95.0,0.5429999999999999,0.4429999999999999,1,2014-04-11,79,47,32,0.595,79,17,62,0.215
21301183,1610612750,1610612745,112.0,110.0,0.436,0.434,1,2014-04-11,79,40,39,0.506,79,52,27,0.6579999999999999
21301184,1610612760,1610612740,116.0,94.0,0.537,0.407,1,2014-04-11,79,58,21,0.7340000000000001,79,32,47,0.405
21301185,1610612749,1610612739,119.0,116.0,0.524,0.494,1,2014-04-11,79,15,64,0.19,80,32,48,0.4
21301186,1610612759,1610612756,112.0,104.0,0.4479999999999999,0.476,1,2014-04-11,80,62,18,0.775,79,47,32,0.595
21301187,1610612762,1610612757,99.0,111.0,0.465,0.46,0,2014-04-11,79,24,55,0.304,80,52,28,0.65
21301188,1610612747,1610612744,95.0,112.0,0.3929999999999999,0.489,0,2014-04-11,79,25,54,0.316,79,49,30,0.62
21301174,1610612742,1610612759,100.0,109.0,0.47,0.4320000000000001,0,2014-04-10,80,48,32,0.6,79,61,18,0.772
21301175,1610612744,1610612743,99.0,100.0,0.455,0.375,0,2014-04-10,78,48,30,0.615,79,35,44,0.4429999999999999
21301162,1610612739,1610612765,122.0,100.0,0.57,0.354,1,2014-04-09,79,32,47,0.405,79,29,50,0.3670000000000001
21301163,1610612753,1610612751,115.0,111.0,0.5579999999999999,0.481,1,2014-04-09,78,23,55,0.295,78,43,35,0.551
21301164,1610612761,1610612755,125.0,114.0,0.5,0.518,1,2014-04-09,78,46,32,0.59,78,17,61,0.218
21301165,1610612764,1610612766,88.0,94.0,0.451,0.38,0,2014-04-09,78,40,38,0.513,78,40,38,0.513
21301166,1610612737,1610612738,105.0,97.0,0.526,0.44,1,2014-04-09,78,35,43,0.449,78,23,55,0.295
21301167,1610612763,1610612748,107.0,102.0,0.551,0.521,1,2014-04-09,78,46,32,0.59,78,53,25,0.679
21301168,1610612749,1610612754,102.0,104.0,0.4370000000000001,0.482,0,2014-04-09,78,14,64,0.179,79,54,25,0.684
21301169,1610612750,1610612741,87.0,102.0,0.425,0.5,0,2014-04-09,78,39,39,0.5,78,46,32,0.59
21301170,1610612740,1610612756,88.0,94.0,0.425,0.488,0,2014-04-09,78,32,46,0.41,78,47,31,0.603
21301171,1610612743,1610612745,123.0,116.0,0.495,0.435,1,2014-04-09,78,34,44,0.436,78,52,26,0.667
21301172,1610612757,1610612758,100.0,99.0,0.507,0.429,1,2014-04-09,79,51,28,0.6459999999999999,79,27,52,0.342
21301173,1610612746,1610612760,101.0,107.0,0.419,0.422,0,2014-04-09,79,55,24,0.696,78,57,21,0.731
21300677,1610612737,1610612765,95.0,102.0,0.382,0.43,0,2014-04-08,77,34,43,0.442,78,29,49,0.3720000000000001
21300275,1610612750,1610612759,110.0,91.0,0.462,0.444,1,2014-04-08,77,39,38,0.506,78,60,18,0.769
21301158,1610612748,1610612751,87.0,88.0,0.478,0.529,0,2014-04-08,77,53,24,0.688,77,43,34,0.5579999999999999
21301159,1610612762,1610612742,83.0,95.0,0.414,0.556,0,2014-04-08,78,24,54,0.308,79,48,31,0.608
21301160,1610612758,1610612760,92.0,107.0,0.415,0.475,0,2014-04-08,78,27,51,0.346,77,56,21,0.727
21301161,1610612747,1610612745,130.0,145.0,0.4629999999999999,0.5770000000000001,0,2014-04-08,78,25,53,0.321,77,52,25,0.675
21301149,1610612748,1610612752,102.0,91.0,0.557,0.375,1,2014-04-06,76,53,23,0.6970000000000001,78,33,45,0.423
21301150,1610612746,1610612747,120.0,97.0,0.5660000000000001,0.419,1,2014-04-06,78,55,23,0.705,77,25,52,0.325
21301151,1610612758,1610612742,91.0,93.0,0.474,0.4039999999999999,0,2014-04-06,77,27,50,0.351,78,47,31,0.603
21301152,1610612754,1610612737,88.0,107.0,0.41,0.562,0,2014-04-06,78,53,25,0.679,76,34,42,0.447
21301153,1610612745,1610612743,130.0,125.0,0.4589999999999999,0.477,1,2014-04-06,76,51,25,0.6709999999999999,77,33,44,0.429
21301154,1610612759,1610612763,112.0,92.0,0.5579999999999999,0.442,1,2014-04-06,77,60,17,0.779,77,45,32,0.584
21301155,1610612744,1610612762,130.0,102.0,0.578,0.4529999999999999,1,2014-04-06,77,48,29,0.623,77,24,53,0.312
21301156,1610612756,1610612760,122.0,115.0,0.584,0.476,1,2014-04-06,77,46,31,0.597,76,55,21,0.7240000000000001
21301157,1610612757,1610612740,100.0,94.0,0.471,0.422,1,2014-04-06,78,50,28,0.6409999999999999,77,32,45,0.416
21301143,1610612753,1610612750,100.0,92.0,0.544,0.4679999999999999,1,2014-04-05,77,22,55,0.286,76,38,38,0.5
21301144,1610612764,1610612741,78.0,96.0,0.395,0.4429999999999999,0,2014-04-05,77,40,37,0.519,77,45,32,0.584
21301145,1610612739,1610612766,94.0,96.0,0.365,0.374,0,2014-04-05,78,31,47,0.397,77,39,38,0.506
21301146,1610612765,1610612738,115.0,111.0,0.481,0.477,1,2014-04-05,77,28,49,0.364,77,23,54,0.299
21301147,1610612755,1610612751,101.0,105.0,0.456,0.513,0,2014-04-05,77,17,60,0.221,76,42,34,0.5529999999999999
21301148,1610612749,1610612761,98.0,102.0,0.481,0.444,0,2014-04-05,77,14,63,0.182,77,45,32,0.584
21301129,1610612763,1610612743,100.0,92.0,0.386,0.363,1,2014-04-04,76,45,31,0.5920000000000001,76,33,43,0.434
21301130,1610612766,1610612753,91.0,80.0,0.423,0.356,1,2014-04-04,76,38,38,0.5,76,21,55,0.276
21301131,1610612761,1610612754,102.0,94.0,0.476,0.423,1,2014-04-04,76,44,32,0.579,77,53,24,0.688
21301132,1610612737,1610612739,117.0,98.0,0.585,0.396,1,2014-04-04,75,33,42,0.44,77,31,46,0.4029999999999999
21301133,1610612738,1610612755,102.0,111.0,0.4370000000000001,0.506,0,2014-04-04,76,23,53,0.303,76,17,59,0.2239999999999999
21301134,1610612751,1610612765,116.0,104.0,0.605,0.466,1,2014-04-04,75,41,34,0.547,76,27,49,0.355
21301135,1610612748,1610612750,121.0,122.0,0.434,0.462,0,2014-04-04,75,52,23,0.693,75,38,37,0.507
21301136,1610612752,1610612764,89.0,90.0,0.447,0.487,0,2014-04-04,77,33,44,0.429,76,40,36,0.526
21301137,1610612741,1610612749,102.0,90.0,0.369,0.456,1,2014-04-04,76,44,32,0.579,76,14,62,0.184
21301138,1610612762,1610612740,100.0,96.0,0.516,0.466,1,2014-04-04,76,24,52,0.316,76,32,44,0.421
21301139,1610612745,1610612760,111.0,107.0,0.423,0.447,1,2014-04-04,75,50,25,0.667,75,55,20,0.733
21301140,1610612757,1610612756,93.0,109.0,0.4320000000000001,0.402,0,2014-04-04,77,49,28,0.636,76,45,31,0.5920000000000001
21301141,1610612744,1610612758,102.0,69.0,0.452,0.321,1,2014-04-04,76,47,29,0.618,76,27,49,0.355
21301142,1610612747,1610612742,95.0,107.0,0.422,0.478,0,2014-04-04,76,25,51,0.3289999999999999,77,46,31,0.597
21301127,1610612760,1610612759,106.0,94.0,0.494,0.4320000000000001,1,2014-04-03,74,55,19,0.743,76,59,17,0.7759999999999999
21301128,1610612746,1610612742,107.0,113.0,0.429,0.5,0,2014-04-03,77,54,23,0.701,76,45,31,0.5920000000000001
21301114,1610612754,1610612765,101.0,94.0,0.494,0.366,1,2014-04-02,76,53,23,0.6970000000000001,75,27,48,0.36
21301115,1610612752,1610612751,110.0,81.0,0.6,0.4,1,2014-04-02,76,33,43,0.434,74,40,34,0.541
21301116,1610612753,1610612739,98.0,119.0,0.4429999999999999,0.5770000000000001,0,2014-04-02,75,21,54,0.28,76,31,45,0.408
21301117,1610612755,1610612766,93.0,123.0,0.422,0.532,0,2014-04-02,75,16,59,0.213,75,37,38,0.493
21301118,1610612761,1610612745,107.0,103.0,0.4529999999999999,0.414,1,2014-04-02,75,43,32,0.573,74,49,25,0.662
21301119,1610612764,1610612738,118.0,92.0,0.625,0.395,1,2014-04-02,75,39,36,0.52,75,23,52,0.307
21301120,1610612737,1610612741,92.0,105.0,0.444,0.513,0,2014-04-02,74,32,42,0.4320000000000001,75,43,32,0.573
21301121,1610612748,1610612749,96.0,77.0,0.506,0.4379999999999999,1,2014-04-02,74,52,22,0.703,75,14,61,0.187
21301122,1610612750,1610612763,102.0,88.0,0.531,0.421,1,2014-04-02,74,37,37,0.5,75,44,31,0.5870000000000001
21301123,1610612759,1610612744,111.0,90.0,0.53,0.424,1,2014-04-02,75,59,16,0.787,75,46,29,0.613
21301124,1610612743,1610612740,137.0,107.0,0.565,0.473,1,2014-04-02,75,33,42,0.44,75,32,43,0.4270000000000001
21301125,1610612756,1610612746,108.0,112.0,0.462,0.4679999999999999,0,2014-04-02,75,44,31,0.5870000000000001,76,54,22,0.711
21301126,1610612758,1610612747,107.0,102.0,0.488,0.385,1,2014-04-02,75,27,48,0.36,75,25,50,0.3329999999999999
21301111,1610612751,1610612745,105.0,96.0,0.53,0.381,1,2014-04-01,73,40,33,0.5479999999999999,73,49,24,0.6709999999999999
21301112,1610612742,1610612744,120.0,122.0,0.49,0.5710000000000001,0,2014-04-01,75,44,31,0.5870000000000001,74,46,28,0.622
21301113,1610612747,1610612757,112.0,124.0,0.446,0.465,0,2014-04-01,74,25,49,0.3379999999999999,76,49,27,0.645
21301101,1610612766,1610612764,100.0,94.0,0.436,0.481,1,2014-03-31,74,36,38,0.486,74,38,36,0.514
21301102,1610612754,1610612759,77.0,103.0,0.377,0.4629999999999999,0,2014-03-31,75,52,23,0.693,74,58,16,0.784
21301103,1610612737,1610612755,103.0,95.0,0.429,0.4679999999999999,1,2014-03-31,73,32,41,0.4379999999999999,74,16,58,0.216
21301104,1610612765,1610612749,116.0,111.0,0.474,0.4429999999999999,1,2014-03-31,74,27,47,0.365,74,14,60,0.1889999999999999
21301105,1610612748,1610612761,93.0,83.0,0.515,0.5,1,2014-03-31,73,51,22,0.6990000000000001,74,42,32,0.568
21301106,1610612741,1610612738,94.0,80.0,0.475,0.4029999999999999,1,2014-03-31,74,42,32,0.568,74,23,51,0.311
21301107,1610612750,1610612746,104.0,114.0,0.4270000000000001,0.4629999999999999,0,2014-03-31,73,36,37,0.493,75,53,22,0.7070000000000001
21301108,1610612740,1610612758,97.0,102.0,0.493,0.475,0,2014-03-31,74,32,42,0.4320000000000001,74,26,48,0.351
21301109,1610612743,1610612763,92.0,94.0,0.493,0.447,0,2014-03-31,74,32,42,0.4320000000000001,74,44,30,0.595
21301110,1610612762,1610612752,83.0,92.0,0.3879999999999999,0.471,0,2014-03-31,75,23,52,0.307,75,32,43,0.4270000000000001
21301093,1610612760,1610612762,116.0,96.0,0.5539999999999999,0.419,1,2014-03-30,73,54,19,0.74,74,23,51,0.311
21301094,1610612739,1610612754,90.0,76.0,0.447,0.3720000000000001,1,2014-03-30,75,30,45,0.4,74,52,22,0.703
21301095,1610612751,1610612750,114.0,99.0,0.5,0.47,1,2014-03-30,72,39,33,0.542,72,36,36,0.5
21301096,1610612753,1610612761,93.0,98.0,0.551,0.452,0,2014-03-30,74,21,53,0.284,73,42,31,0.575
21301097,1610612738,1610612741,102.0,107.0,0.46,0.529,0,2014-03-30,73,23,50,0.315,73,41,32,0.562
21301098,1610612744,1610612752,84.0,89.0,0.354,0.4,0,2014-03-30,73,45,28,0.616,74,31,43,0.419
21301099,1610612757,1610612763,105.0,98.0,0.52,0.461,1,2014-03-30,75,48,27,0.64,73,43,30,0.589
21301100,1610612747,1610612756,115.0,99.0,0.53,0.385,1,2014-03-30,73,25,48,0.342,74,44,30,0.595
21301087,1610612755,1610612765,123.0,98.0,0.522,0.3879999999999999,1,2014-03-29,73,16,57,0.2189999999999999,73,26,47,0.356
21301088,1610612745,1610612746,107.0,118.0,0.405,0.472,0,2014-03-29,72,49,23,0.6809999999999999,74,52,22,0.703
21301089,1610612764,1610612737,101.0,97.0,0.494,0.425,1,2014-03-29,73,38,35,0.521,72,31,41,0.431
21301090,1610612742,1610612758,103.0,100.0,0.486,0.519,1,2014-03-29,74,44,30,0.595,73,25,48,0.342
21301091,1610612749,1610612748,67.0,88.0,0.342,0.4320000000000001,0,2014-03-29,73,14,59,0.192,72,50,22,0.6940000000000001
21301092,1610612759,1610612740,96.0,80.0,0.474,0.395,1,2014-03-29,73,57,16,0.7809999999999999,73,32,41,0.4379999999999999
21301075,1610612753,1610612766,110.0,105.0,0.4479999999999999,0.4429999999999999,1,2014-03-28,73,21,52,0.288,73,35,38,0.479
21301076,1610612761,1610612738,105.0,103.0,0.465,0.526,1,2014-03-28,72,41,31,0.569,72,23,49,0.319
21301077,1610612764,1610612754,91.0,78.0,0.391,0.354,1,2014-03-28,72,37,35,0.514,73,52,21,0.7120000000000001
21301078,1610612751,1610612739,108.0,97.0,0.5489999999999999,0.425,1,2014-03-28,71,38,33,0.535,74,29,45,0.392
21301079,1610612765,1610612748,78.0,110.0,0.38,0.544,0,2014-03-28,72,26,46,0.361,71,49,22,0.69
21301080,1610612741,1610612757,74.0,91.0,0.3929999999999999,0.4379999999999999,0,2014-03-28,72,40,32,0.556,74,47,27,0.635
21301081,1610612750,1610612747,143.0,107.0,0.6709999999999999,0.431,1,2014-03-28,71,36,35,0.507,72,24,48,0.3329999999999999
21301082,1610612740,1610612762,102.0,95.0,0.507,0.485,1,2014-03-28,72,32,40,0.444,73,23,50,0.315
21301083,1610612760,1610612758,94.0,81.0,0.478,0.365,1,2014-03-28,72,53,19,0.736,72,25,47,0.347
21301084,1610612743,1610612759,102.0,133.0,0.402,0.561,0,2014-03-28,73,32,41,0.4379999999999999,72,56,16,0.778
21301085,1610612756,1610612752,112.0,88.0,0.455,0.402,1,2014-03-28,73,44,29,0.603,73,30,43,0.411
21301086,1610612744,1610612763,100.0,93.0,0.494,0.506,1,2014-03-28,72,45,27,0.625,72,43,29,0.597
21301071,1610612737,1610612757,85.0,100.0,0.405,0.4629999999999999,0,2014-03-27,71,31,40,0.4370000000000001,73,46,27,0.63
21301072,1610612745,1610612755,120.0,98.0,0.489,0.389,1,2014-03-27,71,49,22,0.69,72,15,57,0.208
21301073,1610612749,1610612747,108.0,105.0,0.557,0.494,1,2014-03-27,72,14,58,0.1939999999999999,71,24,47,0.3379999999999999
21301074,1610612742,1610612746,103.0,109.0,0.4679999999999999,0.4629999999999999,0,2014-03-27,73,43,30,0.589,73,51,22,0.6990000000000001
21301061,1610612766,1610612751,116.0,111.0,0.5,0.482,1,2014-03-26,72,35,37,0.486,70,37,33,0.529
21301062,1610612764,1610612756,93.0,99.0,0.457,0.493,0,2014-03-26,71,36,35,0.507,72,43,29,0.597
21301063,1610612738,1610612761,90.0,99.0,0.405,0.45,0,2014-03-26,71,23,48,0.324,71,40,31,0.563
21301064,1610612765,1610612739,96.0,97.0,0.4639999999999999,0.435,0,2014-03-26,71,26,45,0.366,73,29,44,0.397
21301065,1610612750,1610612737,107.0,83.0,0.5,0.3779999999999999,1,2014-03-26,70,35,35,0.5,70,31,39,0.4429999999999999
21301066,1610612740,1610612746,98.0,96.0,0.422,0.413,1,2014-03-26,71,31,40,0.4370000000000001,72,50,22,0.6940000000000001
21301067,1610612754,1610612748,84.0,83.0,0.37,0.4589999999999999,1,2014-03-26,72,52,20,0.722,70,48,22,0.6859999999999999
21301068,1610612759,1610612743,108.0,103.0,0.489,0.4579999999999999,1,2014-03-26,71,55,16,0.775,72,32,40,0.444
21301069,1610612758,1610612752,99.0,107.0,0.478,0.5479999999999999,0,2014-03-26,71,25,46,0.352,72,30,42,0.417
21301070,1610612762,1610612763,87.0,91.0,0.4639999999999999,0.456,0,2014-03-26,72,23,49,0.319,71,43,28,0.606
21301057,1610612739,1610612761,102.0,100.0,0.514,0.3979999999999999,1,2014-03-25,72,28,44,0.389,70,39,31,0.557
21301058,1610612753,1610612757,95.0,85.0,0.435,0.3720000000000001,1,2014-03-25,72,20,52,0.278,72,45,27,0.625
21301059,1610612742,1610612760,128.0,119.0,0.5,0.495,1,2014-03-25,72,43,29,0.597,71,52,19,0.732
21301060,1610612747,1610612752,127.0,96.0,0.578,0.486,1,2014-03-25,70,24,46,0.3429999999999999,71,29,42,0.408
21301047,1610612766,1610612745,89.0,100.0,0.3720000000000001,0.476,0,2014-03-24,71,34,37,0.479,70,48,22,0.6859999999999999
21301048,1610612737,1610612756,95.0,102.0,0.417,0.514,0,2014-03-24,69,31,38,0.449,71,42,29,0.5920000000000001
21301049,1610612748,1610612757,93.0,91.0,0.44,0.3779999999999999,1,2014-03-24,69,48,21,0.696,71,45,26,0.634
21301050,1610612741,1610612754,89.0,77.0,0.417,0.37,1,2014-03-24,71,40,31,0.563,71,51,20,0.718
21301051,1610612763,1610612750,109.0,92.0,0.527,0.3779999999999999,1,2014-03-24,70,42,28,0.6,69,34,35,0.493
21301052,1610612740,1610612751,109.0,104.0,0.471,0.3670000000000001,1,2014-03-24,70,30,40,0.429,69,37,32,0.536
21301053,1610612760,1610612743,117.0,96.0,0.506,0.39,1,2014-03-24,70,52,18,0.743,71,32,39,0.451
21301054,1610612759,1610612755,113.0,91.0,0.557,0.409,1,2014-03-24,70,54,16,0.7709999999999999,71,15,56,0.211
21301055,1610612762,1610612765,94.0,114.0,0.41,0.5539999999999999,0,2014-03-24,71,23,48,0.324,70,26,44,0.371
21301056,1610612746,1610612749,106.0,98.0,0.487,0.482,1,2014-03-24,71,50,21,0.7040000000000001,71,13,58,0.183
21301040,1610612761,1610612737,96.0,86.0,0.425,0.434,1,2014-03-23,69,39,30,0.565,68,31,37,0.456
21301041,1610612750,1610612756,120.0,127.0,0.44,0.575,0,2014-03-23,68,34,34,0.5,70,41,29,0.586
21301042,1610612743,1610612764,105.0,102.0,0.44,0.482,1,2014-03-23,70,32,38,0.457,70,36,34,0.514
21301043,1610612758,1610612749,124.0,107.0,0.512,0.494,1,2014-03-23,70,25,45,0.357,70,13,57,0.186
21301044,1610612742,1610612751,104.0,107.0,0.385,0.405,0,2014-03-23,71,42,29,0.5920000000000001,68,37,31,0.544
21301045,1610612752,1610612739,100.0,106.0,0.455,0.609,0,2014-03-23,70,29,41,0.414,71,27,44,0.38
21301046,1610612747,1610612753,103.0,94.0,0.4629999999999999,0.451,1,2014-03-23,69,23,46,0.3329999999999999,71,19,52,0.268
21301032,1610612766,1610612757,124.0,94.0,0.521,0.405,1,2014-03-22,70,34,36,0.486,70,45,25,0.643
21301033,1610612739,1610612745,111.0,118.0,0.5,0.481,0,2014-03-22,70,26,44,0.371,69,47,22,0.6809999999999999
21301034,1610612741,1610612755,91.0,81.0,0.4429999999999999,0.345,1,2014-03-22,70,39,31,0.557,70,15,55,0.214
21301035,1610612763,1610612754,82.0,71.0,0.44,0.365,1,2014-03-22,69,41,28,0.594,70,51,19,0.7290000000000001
21301036,1610612740,1610612748,105.0,95.0,0.512,0.507,1,2014-03-22,69,29,40,0.42,68,47,21,0.691
21301037,1610612762,1610612753,89.0,88.0,0.387,0.392,1,2014-03-22,70,23,47,0.3289999999999999,70,19,51,0.271
21301038,1610612744,1610612759,90.0,99.0,0.4029999999999999,0.3929999999999999,0,2014-03-22,71,44,27,0.62,69,53,16,0.768
21301039,1610612746,1610612765,112.0,103.0,0.542,0.452,1,2014-03-22,70,49,21,0.7,69,25,44,0.362
21301022,1610612754,1610612741,91.0,79.0,0.43,0.364,1,2014-03-21,69,51,18,0.7390000000000001,69,38,31,0.551
21301023,1610612755,1610612752,92.0,93.0,0.374,0.415,0,2014-03-21,69,15,54,0.217,69,29,40,0.42
21301024,1610612761,1610612760,118.0,119.0,0.406,0.3879999999999999,0,2014-03-21,68,38,30,0.5589999999999999,69,51,18,0.7390000000000001
21301025,1610612737,1610612740,105.0,111.0,0.447,0.514,0,2014-03-21,67,31,36,0.4629999999999999,68,28,40,0.412
21301026,1610612751,1610612738,114.0,98.0,0.564,0.422,1,2014-03-21,67,36,31,0.537,70,23,47,0.3289999999999999
21301027,1610612748,1610612763,91.0,86.0,0.467,0.456,1,2014-03-21,67,47,20,0.701,68,40,28,0.588
21301028,1610612742,1610612743,122.0,106.0,0.539,0.494,1,2014-03-21,70,42,28,0.6,69,31,38,0.449
21301029,1610612756,1610612765,98.0,92.0,0.452,0.433,1,2014-03-21,69,40,29,0.58,68,25,43,0.368
21301030,1610612758,1610612759,79.0,99.0,0.4,0.387,0,2014-03-21,69,24,45,0.348,68,52,16,0.765
21301031,1610612747,1610612764,107.0,117.0,0.473,0.483,0,2014-03-21,68,22,46,0.324,69,36,33,0.522
21301018,1610612739,1610612760,95.0,102.0,0.444,0.4270000000000001,0,2014-03-20,69,26,43,0.377,68,50,18,0.735
21301019,1610612745,1610612750,129.0,106.0,0.5760000000000001,0.4370000000000001,1,2014-03-20,68,46,22,0.6759999999999999,67,34,33,0.507
21301020,1610612757,1610612764,116.0,103.0,0.506,0.422,1,2014-03-20,69,45,24,0.652,68,35,33,0.515
21301021,1610612744,1610612749,115.0,110.0,0.5379999999999999,0.488,1,2014-03-20,70,44,26,0.629,69,13,56,0.188
21301008,1610612755,1610612741,94.0,102.0,0.457,0.434,0,2014-03-19,68,15,53,0.221,68,38,30,0.5589999999999999
21301009,1610612738,1610612748,101.0,96.0,0.506,0.494,1,2014-03-19,69,23,46,0.3329999999999999,66,46,20,0.6970000000000001
21301010,1610612751,1610612766,104.0,99.0,0.493,0.471,1,2014-03-19,66,35,31,0.53,69,33,36,0.478
21301011,1610612763,1610612762,96.0,86.0,0.444,0.44,1,2014-03-19,67,40,27,0.597,69,22,47,0.319
21301012,1610612740,1610612761,100.0,107.0,0.537,0.419,0,2014-03-19,67,27,40,0.4029999999999999,67,38,29,0.5670000000000001
21301013,1610612752,1610612754,92.0,86.0,0.39,0.425,1,2014-03-19,68,28,40,0.412,68,50,18,0.735
21301014,1610612742,1610612750,122.0,123.0,0.495,0.478,0,2014-03-19,69,41,28,0.594,66,34,32,0.515
21301015,1610612743,1610612765,118.0,109.0,0.512,0.4529999999999999,1,2014-03-19,68,31,37,0.456,67,25,42,0.373
21301016,1610612756,1610612753,109.0,93.0,0.506,0.4,1,2014-03-19,68,39,29,0.574,69,19,50,0.275
21301017,1610612747,1610612759,109.0,125.0,0.429,0.526,0,2014-03-19,67,22,45,0.3279999999999999,67,51,16,0.7609999999999999
21301003,1610612739,1610612748,96.0,100.0,0.514,0.4529999999999999,0,2014-03-18,68,26,42,0.382,65,46,19,0.708
21301004,1610612737,1610612761,118.0,113.0,0.426,0.494,1,2014-03-18,66,31,35,0.47,66,37,29,0.561
21301005,1610612757,1610612749,120.0,115.0,0.433,0.4589999999999999,1,2014-03-18,68,44,24,0.647,68,13,55,0.191
21301006,1610612758,1610612764,117.0,111.0,0.46,0.44,1,2014-03-18,68,24,44,0.353,67,35,32,0.522
21301007,1610612744,1610612753,103.0,89.0,0.451,0.455,1,2014-03-18,69,43,26,0.623,68,19,49,0.2789999999999999
21300996,1610612766,1610612737,83.0,97.0,0.353,0.4589999999999999,0,2014-03-17,68,33,35,0.485,65,30,35,0.462
21300997,1610612754,1610612755,99.0,90.0,0.3829999999999999,0.4320000000000001,1,2014-03-17,67,50,17,0.746,67,15,52,0.2239999999999999
21300998,1610612751,1610612756,108.0,95.0,0.586,0.4629999999999999,1,2014-03-17,65,34,31,0.523,67,38,29,0.5670000000000001
21300999,1610612741,1610612760,85.0,97.0,0.345,0.413,0,2014-03-17,67,37,30,0.552,67,49,18,0.731
21301000,1610612745,1610612762,124.0,86.0,0.5820000000000001,0.41,1,2014-03-17,67,45,22,0.672,68,22,46,0.324
21301001,1610612742,1610612738,94.0,89.0,0.423,0.366,1,2014-03-17,68,41,27,0.603,68,22,46,0.324
21301002,1610612743,1610612746,110.0,100.0,0.409,0.391,1,2014-03-17,67,30,37,0.4479999999999999,69,48,21,0.696
21300987,1610612749,1610612766,92.0,101.0,0.416,0.574,0,2014-03-16,67,13,54,0.1939999999999999,67,33,34,0.493
21300988,1610612761,1610612756,113.0,121.0,0.494,0.507,0,2014-03-16,65,37,28,0.569,66,38,28,0.5760000000000001
21300989,1610612748,1610612745,113.0,104.0,0.513,0.493,1,2014-03-16,64,45,19,0.703,66,44,22,0.667
21300990,1610612740,1610612738,121.0,120.0,0.5,0.4639999999999999,1,2014-03-16,66,27,39,0.409,67,22,45,0.3279999999999999
21300991,1610612750,1610612758,104.0,102.0,0.436,0.482,1,2014-03-16,65,33,32,0.508,67,23,44,0.3429999999999999
21300992,1610612760,1610612742,86.0,109.0,0.3670000000000001,0.5329999999999999,0,2014-03-16,66,48,18,0.727,67,40,27,0.597
21300993,1610612759,1610612762,122.0,104.0,0.628,0.462,1,2014-03-16,66,50,16,0.758,67,22,45,0.3279999999999999
21300994,1610612757,1610612744,112.0,113.0,0.42,0.477,0,2014-03-16,67,43,24,0.642,68,42,26,0.618
21300995,1610612746,1610612739,102.0,80.0,0.447,0.349,1,2014-03-16,68,48,20,0.706,67,26,41,0.3879999999999999
21300981,1610612752,1610612749,115.0,94.0,0.5529999999999999,0.4320000000000001,1,2014-03-15,67,27,40,0.4029999999999999,66,13,53,0.1969999999999999
21300982,1610612764,1610612751,101.0,94.0,0.4679999999999999,0.479,1,2014-03-15,66,35,31,0.53,64,33,31,0.516
21300983,1610612737,1610612743,97.0,92.0,0.407,0.41,1,2014-03-15,64,29,35,0.4529999999999999,66,29,37,0.439
21300984,1610612765,1610612754,104.0,112.0,0.407,0.3939999999999999,0,2014-03-15,66,25,41,0.379,66,49,17,0.742
21300985,1610612755,1610612763,77.0,103.0,0.373,0.5429999999999999,0,2014-03-15,66,15,51,0.2269999999999999,66,39,27,0.591
21300986,1610612741,1610612758,94.0,87.0,0.397,0.365,1,2014-03-15,66,37,29,0.561,66,23,43,0.348
21300971,1610612766,1610612750,105.0,93.0,0.484,0.4270000000000001,1,2014-03-14,66,32,34,0.485,64,32,32,0.5
21300972,1610612753,1610612764,101.0,105.0,0.4429999999999999,0.4,0,2014-03-14,67,19,48,0.284,65,34,31,0.523
21300973,1610612755,1610612754,94.0,101.0,0.389,0.5820000000000001,0,2014-03-14,65,15,50,0.231,65,48,17,0.738
21300974,1610612761,1610612763,99.0,86.0,0.507,0.446,1,2014-03-14,64,37,27,0.578,65,38,27,0.585
21300975,1610612738,1610612756,80.0,87.0,0.309,0.425,0,2014-03-14,66,22,44,0.3329999999999999,65,37,28,0.569
21300976,1610612748,1610612743,107.0,111.0,0.519,0.476,0,2014-03-14,63,44,19,0.698,65,29,36,0.446
21300977,1610612740,1610612757,103.0,111.0,0.477,0.487,0,2014-03-14,65,26,39,0.4,66,43,23,0.652
21300978,1610612759,1610612747,119.0,85.0,0.49,0.341,1,2014-03-14,65,49,16,0.754,66,22,44,0.3329999999999999
21300979,1610612762,1610612746,87.0,96.0,0.455,0.487,0,2014-03-14,66,22,44,0.3329999999999999,67,47,20,0.701
21300980,1610612744,1610612739,94.0,103.0,0.455,0.488,0,2014-03-14,67,41,26,0.612,66,26,40,0.3939999999999999
21300968,1610612741,1610612745,111.0,87.0,0.5,0.354,1,2014-03-13,65,36,29,0.5539999999999999,65,44,21,0.677
21300969,1610612737,1610612749,102.0,97.0,0.486,0.416,1,2014-03-13,63,28,35,0.444,65,13,52,0.2
21300970,1610612760,1610612747,131.0,102.0,0.506,0.3939999999999999,1,2014-03-13,65,48,17,0.738,65,22,43,0.3379999999999999
21300957,1610612748,1610612751,95.0,96.0,0.485,0.436,0,2014-03-12,62,44,18,0.71,63,33,30,0.524
21300958,1610612753,1610612743,112.0,120.0,0.484,0.511,0,2014-03-12,66,19,47,0.288,64,28,36,0.4379999999999999
21300959,1610612755,1610612758,98.0,115.0,0.3929999999999999,0.4589999999999999,0,2014-03-12,64,15,49,0.2339999999999999,65,23,42,0.354
21300960,1610612761,1610612765,101.0,87.0,0.42,0.436,1,2014-03-12,63,36,27,0.5710000000000001,65,25,40,0.385
21300961,1610612764,1610612766,85.0,98.0,0.4270000000000001,0.487,0,2014-03-12,64,33,31,0.516,65,31,34,0.477
21300962,1610612738,1610612752,92.0,116.0,0.42,0.525,0,2014-03-12,65,22,43,0.3379999999999999,66,26,40,0.3939999999999999
21300963,1610612740,1610612763,88.0,90.0,0.413,0.4320000000000001,0,2014-03-12,64,26,38,0.406,64,38,26,0.594
21300964,1610612762,1610612742,101.0,108.0,0.471,0.532,0,2014-03-12,65,22,43,0.3379999999999999,66,39,27,0.591
21300965,1610612759,1610612757,103.0,90.0,0.4320000000000001,0.386,1,2014-03-12,64,48,16,0.75,65,42,23,0.6459999999999999
21300966,1610612756,1610612739,101.0,110.0,0.433,0.469,0,2014-03-12,64,36,28,0.563,65,25,40,0.385
21300967,1610612746,1610612744,111.0,98.0,0.489,0.439,1,2014-03-12,66,46,20,0.6970000000000001,66,41,25,0.621
21300950,1610612754,1610612738,94.0,83.0,0.5479999999999999,0.352,1,2014-03-11,64,47,17,0.7340000000000001,64,22,42,0.344
21300951,1610612765,1610612758,99.0,89.0,0.4370000000000001,0.405,1,2014-03-11,64,25,39,0.391,64,22,42,0.344
21300952,1610612741,1610612759,96.0,104.0,0.4270000000000001,0.506,0,2014-03-11,64,35,29,0.547,63,47,16,0.746
21300953,1610612763,1610612757,109.0,99.0,0.56,0.407,1,2014-03-11,63,37,26,0.5870000000000001,64,42,22,0.6559999999999999
21300954,1610612750,1610612749,112.0,101.0,0.482,0.527,1,2014-03-11,63,32,31,0.508,64,13,51,0.203
21300955,1610612760,1610612745,106.0,98.0,0.425,0.418,1,2014-03-11,64,47,17,0.7340000000000001,64,44,20,0.688
21300956,1610612744,1610612742,108.0,85.0,0.513,0.366,1,2014-03-11,65,41,24,0.631,65,38,27,0.585
21300943,1610612766,1610612743,105.0,98.0,0.457,0.434,1,2014-03-10,64,30,34,0.469,63,27,36,0.429
21300944,1610612751,1610612761,101.0,97.0,0.486,0.493,1,2014-03-10,62,32,30,0.516,62,35,27,0.565
21300945,1610612748,1610612764,99.0,90.0,0.5,0.4039999999999999,1,2014-03-10,61,44,17,0.721,63,33,30,0.524
21300946,1610612752,1610612755,123.0,110.0,0.5429999999999999,0.512,1,2014-03-10,65,25,40,0.385,63,15,48,0.238
21300947,1610612749,1610612753,105.0,98.0,0.452,0.477,1,2014-03-10,63,13,50,0.206,65,19,46,0.292
21300948,1610612762,1610612737,110.0,112.0,0.488,0.487,0,2014-03-10,64,22,42,0.344,62,27,35,0.435
21300949,1610612746,1610612756,112.0,105.0,0.551,0.4589999999999999,1,2014-03-10,65,45,20,0.6920000000000001,63,36,27,0.5710000000000001
21300934,1610612741,1610612748,95.0,88.0,0.422,0.405,1,2014-03-09,63,35,28,0.556,60,43,17,0.7170000000000001
21300935,1610612747,1610612760,114.0,110.0,0.469,0.42,1,2014-03-09,64,22,42,0.344,63,46,17,0.73
21300936,1610612740,1610612743,111.0,107.0,0.456,0.471,1,2014-03-09,63,26,37,0.413,62,27,35,0.435
21300937,1610612738,1610612765,118.0,111.0,0.485,0.465,1,2014-03-09,63,22,41,0.349,63,24,39,0.381
21300938,1610612751,1610612758,104.0,89.0,0.532,0.444,1,2014-03-09,61,31,30,0.508,63,22,41,0.349
21300939,1610612745,1610612757,118.0,113.0,0.4270000000000001,0.406,1,2014-03-09,63,44,19,0.698,63,42,21,0.667
21300940,1610612750,1610612761,104.0,111.0,0.4320000000000001,0.487,0,2014-03-09,62,31,31,0.5,61,35,26,0.574
21300941,1610612742,1610612754,105.0,94.0,0.444,0.478,1,2014-03-09,64,38,26,0.594,63,46,17,0.73
21300942,1610612744,1610612756,113.0,107.0,0.529,0.48,1,2014-03-09,64,40,24,0.625,62,36,26,0.581
21300928,1610612739,1610612752,97.0,107.0,0.414,0.4320000000000001,0,2014-03-08,64,24,40,0.375,64,24,40,0.375
21300929,1610612755,1610612762,92.0,104.0,0.474,0.4629999999999999,0,2014-03-08,62,15,47,0.242,63,22,41,0.349
21300930,1610612763,1610612766,111.0,89.0,0.506,0.3979999999999999,1,2014-03-08,62,36,26,0.581,63,29,34,0.46
21300932,1610612759,1610612753,121.0,112.0,0.531,0.479,1,2014-03-08,62,46,16,0.742,64,19,45,0.297
21300931,1610612749,1610612764,107.0,114.0,0.4479999999999999,0.5379999999999999,0,2014-03-08,62,12,50,0.1939999999999999,62,33,29,0.532
21300933,1610612746,1610612737,109.0,108.0,0.532,0.5,1,2014-03-08,64,44,20,0.688,61,26,35,0.426
21300917,1610612741,1610612763,77.0,85.0,0.413,0.449,0,2014-03-07,62,34,28,0.5479999999999999,61,35,26,0.574
21300918,1610612766,1610612739,101.0,92.0,0.4679999999999999,0.43,1,2014-03-07,62,29,33,0.4679999999999999,63,24,39,0.381
21300919,1610612761,1610612758,99.0,87.0,0.466,0.417,1,2014-03-07,60,34,26,0.5670000000000001,62,22,40,0.355
21300920,1610612738,1610612751,91.0,84.0,0.4429999999999999,0.363,1,2014-03-07,62,21,41,0.3389999999999999,60,30,30,0.5
21300921,1610612752,1610612762,108.0,81.0,0.494,0.411,1,2014-03-07,63,23,40,0.365,62,21,41,0.3389999999999999
21300922,1610612750,1610612765,114.0,101.0,0.451,0.4039999999999999,1,2014-03-07,61,31,30,0.508,62,24,38,0.387
21300923,1610612740,1610612749,112.0,104.0,0.5,0.449,1,2014-03-07,62,25,37,0.4029999999999999,61,12,49,0.1969999999999999
21300924,1610612742,1610612757,103.0,98.0,0.4679999999999999,0.4579999999999999,1,2014-03-07,63,37,26,0.5870000000000001,62,42,20,0.677
21300925,1610612743,1610612747,134.0,126.0,0.545,0.4639999999999999,1,2014-03-07,61,27,34,0.4429999999999999,63,21,42,0.3329999999999999
21300926,1610612745,1610612754,112.0,86.0,0.526,0.4589999999999999,1,2014-03-07,62,43,19,0.6940000000000001,62,46,16,0.742
21300927,1610612744,1610612737,111.0,97.0,0.5379999999999999,0.4529999999999999,1,2014-03-07,63,39,24,0.619,60,26,34,0.433
21300914,1610612759,1610612748,111.0,87.0,0.506,0.43,1,2014-03-06,61,45,16,0.738,59,43,16,0.7290000000000001
21300915,1610612756,1610612760,128.0,122.0,0.525,0.5,1,2014-03-06,61,36,25,0.59,62,46,16,0.742
21300916,1610612747,1610612746,94.0,142.0,0.395,0.5529999999999999,0,2014-03-06,62,21,41,0.3389999999999999,63,43,20,0.6829999999999999
21300904,1610612766,1610612754,109.0,87.0,0.512,0.408,1,2014-03-05,61,28,33,0.4589999999999999,61,46,15,0.754
21300905,1610612753,1610612745,89.0,101.0,0.452,0.488,0,2014-03-05,63,19,44,0.302,61,42,19,0.6890000000000001
21300906,1610612764,1610612762,104.0,91.0,0.5429999999999999,0.449,1,2014-03-05,61,32,29,0.525,61,21,40,0.344
21300907,1610612738,1610612744,88.0,108.0,0.395,0.469,0,2014-03-05,61,20,41,0.3279999999999999,62,38,24,0.613
21300908,1610612751,1610612763,103.0,94.0,0.514,0.43,1,2014-03-05,59,30,29,0.508,60,34,26,0.5670000000000001
21300909,1610612765,1610612741,94.0,105.0,0.4479999999999999,0.5379999999999999,0,2014-03-05,61,24,37,0.3929999999999999,61,34,27,0.557
21300910,1610612749,1610612758,102.0,116.0,0.439,0.518,0,2014-03-05,60,12,48,0.2,61,22,39,0.361
21300911,1610612750,1610612752,106.0,118.0,0.433,0.522,0,2014-03-05,60,30,30,0.5,62,22,40,0.355
21300912,1610612743,1610612742,115.0,110.0,0.4679999999999999,0.529,1,2014-03-05,60,26,34,0.433,62,36,26,0.581
21300913,1610612757,1610612737,102.0,78.0,0.4429999999999999,0.33,1,2014-03-05,61,42,19,0.6890000000000001,59,26,33,0.441
21300898,1610612739,1610612759,101.0,122.0,0.481,0.478,0,2014-03-04,62,24,38,0.387,60,44,16,0.733
21300899,1610612754,1610612744,96.0,98.0,0.419,0.44,0,2014-03-04,60,46,14,0.767,61,37,24,0.607
21300900,1610612745,1610612748,106.0,103.0,0.513,0.475,1,2014-03-04,60,41,19,0.6829999999999999,58,43,15,0.741
21300901,1610612760,1610612755,125.0,92.0,0.5660000000000001,0.34,1,2014-03-04,61,46,15,0.754,61,15,46,0.246
21300902,1610612756,1610612746,96.0,104.0,0.4529999999999999,0.513,0,2014-03-04,60,35,25,0.583,62,42,20,0.677
21300903,1610612747,1610612740,125.0,132.0,0.541,0.597,0,2014-03-04,61,21,40,0.344,61,24,37,0.3929999999999999
21300890,1610612764,1610612763,104.0,110.0,0.481,0.544,0,2014-03-03,60,31,29,0.517,59,34,25,0.5760000000000001
21300891,1610612751,1610612741,96.0,80.0,0.466,0.462,1,2014-03-03,58,29,29,0.5,60,33,27,0.55
21300892,1610612765,1610612752,96.0,85.0,0.422,0.386,1,2014-03-03,60,24,36,0.4,61,21,40,0.344
21300893,1610612748,1610612766,124.0,107.0,0.5539999999999999,0.512,1,2014-03-03,57,43,14,0.754,60,27,33,0.45
21300894,1610612749,1610612762,114.0,88.0,0.568,0.392,1,2014-03-03,59,12,47,0.203,60,21,39,0.35
21300895,1610612743,1610612750,128.0,132.0,0.526,0.475,0,2014-03-03,59,25,34,0.424,59,30,29,0.508
21300896,1610612757,1610612747,106.0,107.0,0.4479999999999999,0.457,0,2014-03-03,60,41,19,0.6829999999999999,60,21,39,0.35
21300897,1610612758,1610612740,96.0,89.0,0.471,0.4270000000000001,1,2014-03-03,60,21,39,0.35,60,23,37,0.3829999999999999
21300883,1610612741,1610612752,109.0,90.0,0.4639999999999999,0.4429999999999999,1,2014-03-02,59,33,26,0.5589999999999999,60,21,39,0.35
21300884,1610612761,1610612744,104.0,98.0,0.481,0.42,1,2014-03-02,59,33,26,0.5589999999999999,60,36,24,0.6
21300885,1610612754,1610612762,94.0,91.0,0.415,0.462,1,2014-03-02,59,46,13,0.78,59,21,38,0.356
21300886,1610612753,1610612755,92.0,81.0,0.422,0.3720000000000001,1,2014-03-02,62,19,43,0.306,60,15,45,0.25
21300887,1610612760,1610612766,116.0,99.0,0.5,0.441,1,2014-03-02,60,45,15,0.75,59,27,32,0.4579999999999999
21300888,1610612759,1610612742,112.0,106.0,0.4639999999999999,0.4639999999999999,1,2014-03-02,59,43,16,0.7290000000000001,61,36,25,0.59
21300889,1610612756,1610612737,129.0,120.0,0.55,0.524,1,2014-03-02,59,35,24,0.593,58,26,32,0.4479999999999999
21300874,1610612748,1610612753,112.0,98.0,0.581,0.434,1,2014-03-01,56,42,14,0.75,61,18,43,0.295
21300875,1610612755,1610612764,103.0,122.0,0.452,0.506,0,2014-03-01,59,15,44,0.254,59,31,28,0.525
21300876,1610612745,1610612765,118.0,110.0,0.5,0.45,1,2014-03-01,59,40,19,0.6779999999999999,59,23,36,0.39
21300877,1610612738,1610612754,97.0,102.0,0.4270000000000001,0.506,0,2014-03-01,60,20,40,0.3329999999999999,58,45,13,0.7759999999999999
21300878,1610612749,1610612751,98.0,107.0,0.4589999999999999,0.446,0,2014-03-01,58,11,47,0.19,57,28,29,0.491
21300879,1610612763,1610612739,110.0,96.0,0.5429999999999999,0.494,1,2014-03-01,58,33,25,0.569,61,24,37,0.3929999999999999
21300880,1610612757,1610612743,102.0,96.0,0.457,0.3979999999999999,1,2014-03-01,59,41,18,0.695,58,25,33,0.431
21300881,1610612758,1610612750,97.0,108.0,0.451,0.457,0,2014-03-01,59,20,39,0.3389999999999999,58,29,29,0.5
21300882,1610612746,1610612740,108.0,76.0,0.469,0.3289999999999999,1,2014-03-01,61,41,20,0.672,59,23,36,0.39
21300867,1610612739,1610612762,99.0,79.0,0.489,0.35,1,2014-02-28,60,24,36,0.4,58,21,37,0.362
21300868,1610612760,1610612763,113.0,107.0,0.494,0.513,1,2014-02-28,59,44,15,0.746,57,32,25,0.561
21300869,1610612752,1610612744,103.0,126.0,0.379,0.478,0,2014-02-28,59,21,38,0.356,59,36,23,0.61
21300870,1610612742,1610612741,91.0,100.0,0.4,0.507,0,2014-02-28,60,36,24,0.6,58,32,26,0.552
21300871,1610612759,1610612766,92.0,82.0,0.466,0.3670000000000001,1,2014-02-28,58,42,16,0.7240000000000001,58,27,31,0.466
21300872,1610612747,1610612758,126.0,122.0,0.6,0.505,1,2014-02-28,59,20,39,0.3389999999999999,58,20,38,0.345
21300873,1610612756,1610612740,116.0,104.0,0.541,0.5379999999999999,1,2014-02-28,58,34,24,0.586,58,23,35,0.397
21300863,1610612754,1610612749,101.0,96.0,0.514,0.4370000000000001,1,2014-02-27,57,44,13,0.772,57,11,46,0.193
21300864,1610612761,1610612764,129.0,134.0,0.45,0.472,0,2014-02-27,58,32,26,0.552,58,30,28,0.517
21300865,1610612748,1610612752,108.0,82.0,0.608,0.373,1,2014-02-27,55,41,14,0.745,58,21,37,0.362
21300866,1610612743,1610612751,89.0,112.0,0.37,0.476,0,2014-02-27,57,25,32,0.439,56,27,29,0.482
21300853,1610612755,1610612753,90.0,101.0,0.368,0.415,0,2014-02-26,58,15,43,0.259,60,18,42,0.3
21300854,1610612738,1610612737,115.0,104.0,0.478,0.5,1,2014-02-26,59,20,39,0.3389999999999999,57,26,31,0.456
21300855,1610612741,1610612744,103.0,83.0,0.446,0.357,1,2014-02-26,57,31,26,0.544,58,35,23,0.603
21300856,1610612742,1610612740,108.0,89.0,0.519,0.507,1,2014-02-26,59,36,23,0.61,57,23,34,0.4039999999999999
21300857,1610612763,1610612747,108.0,103.0,0.489,0.494,1,2014-02-26,56,32,24,0.5710000000000001,58,19,39,0.3279999999999999
21300858,1610612760,1610612739,104.0,114.0,0.488,0.465,0,2014-02-26,58,43,15,0.741,59,23,36,0.39
21300859,1610612759,1610612765,120.0,110.0,0.537,0.5,1,2014-02-26,57,41,16,0.7190000000000001,58,23,35,0.397
21300860,1610612762,1610612756,109.0,86.0,0.568,0.3879999999999999,1,2014-02-26,57,21,36,0.368,57,33,24,0.579
21300861,1610612757,1610612751,124.0,80.0,0.535,0.395,1,2014-02-26,58,40,18,0.69,55,26,29,0.473
21300862,1610612746,1610612745,101.0,93.0,0.441,0.442,1,2014-02-26,60,40,20,0.667,58,39,19,0.672
21300846,1610612739,1610612761,93.0,99.0,0.405,0.4429999999999999,0,2014-02-25,58,22,36,0.379,57,32,25,0.561
21300847,1610612754,1610612747,118.0,98.0,0.465,0.433,1,2014-02-25,56,43,13,0.768,57,19,38,0.3329999999999999
21300848,1610612764,1610612753,115.0,106.0,0.525,0.5,1,2014-02-25,57,29,28,0.509,59,17,42,0.288
21300849,1610612737,1610612741,103.0,107.0,0.452,0.42,0,2014-02-25,56,26,30,0.4639999999999999,56,30,26,0.536
21300850,1610612743,1610612757,95.0,100.0,0.359,0.368,0,2014-02-25,56,25,31,0.446,57,39,18,0.684
21300851,1610612756,1610612750,101.0,110.0,0.442,0.483,0,2014-02-25,56,33,23,0.589,57,28,29,0.491
21300852,1610612758,1610612745,103.0,129.0,0.4,0.569,0,2014-02-25,57,20,37,0.351,57,39,18,0.684
21300841,1610612755,1610612749,110.0,130.0,0.489,0.5710000000000001,0,2014-02-24,57,15,42,0.263,56,11,45,0.196
21300842,1610612765,1610612744,96.0,104.0,0.4039999999999999,0.4629999999999999,0,2014-02-24,57,23,34,0.4039999999999999,57,35,22,0.614
21300843,1610612752,1610612742,108.0,110.0,0.526,0.477,0,2014-02-24,57,21,36,0.368,58,35,23,0.603
21300844,1610612740,1610612746,110.0,123.0,0.425,0.518,0,2014-02-24,56,23,33,0.411,59,39,20,0.6609999999999999
21300845,1610612762,1610612738,110.0,98.0,0.55,0.44,1,2014-02-24,56,20,36,0.357,58,19,39,0.3279999999999999
21300833,1610612760,1610612746,117.0,125.0,0.462,0.519,0,2014-02-23,57,43,14,0.754,58,38,20,0.655
21300834,1610612748,1610612741,93.0,79.0,0.42,0.358,1,2014-02-23,54,40,14,0.741,55,29,26,0.527
21300835,1610612739,1610612764,83.0,96.0,0.385,0.4270000000000001,0,2014-02-23,57,22,35,0.386,56,28,28,0.5
21300836,1610612761,1610612753,105.0,90.0,0.523,0.414,1,2014-02-23,56,31,25,0.5539999999999999,58,17,41,0.293
21300837,1610612743,1610612758,95.0,109.0,0.375,0.474,0,2014-02-23,55,25,30,0.455,56,20,36,0.357
21300838,1610612756,1610612745,112.0,115.0,0.488,0.526,0,2014-02-23,55,33,22,0.6,56,38,18,0.679
21300839,1610612747,1610612751,102.0,108.0,0.513,0.474,0,2014-02-23,56,19,37,0.3389999999999999,54,26,28,0.481
21300840,1610612757,1610612750,108.0,97.0,0.482,0.3939999999999999,1,2014-02-23,56,38,18,0.679,56,27,29,0.482
21300825,1610612766,1610612763,92.0,89.0,0.366,0.43,1,2014-02-22,57,27,30,0.474,55,31,24,0.564
21300826,1610612764,1610612740,94.0,93.0,0.486,0.4320000000000001,1,2014-02-22,55,27,28,0.491,55,23,32,0.418
21300827,1610612737,1610612752,107.0,98.0,0.4320000000000001,0.4379999999999999,1,2014-02-22,55,26,29,0.473,56,21,35,0.375
21300828,1610612765,1610612742,102.0,113.0,0.488,0.489,0,2014-02-22,56,23,33,0.411,57,34,23,0.596
21300829,1610612749,1610612754,100.0,110.0,0.422,0.45,0,2014-02-22,55,10,45,0.182,55,42,13,0.764
21300830,1610612762,1610612750,104.0,121.0,0.4679999999999999,0.512,0,2014-02-22,55,19,36,0.345,55,27,28,0.491
21300831,1610612758,1610612738,105.0,98.0,0.521,0.391,1,2014-02-22,55,19,36,0.345,57,19,38,0.3329999999999999
21300832,1610612744,1610612751,93.0,86.0,0.435,0.41,1,2014-02-22,56,34,22,0.607,53,25,28,0.472
21300815,1610612766,1610612740,90.0,87.0,0.3879999999999999,0.422,1,2014-02-21,56,26,30,0.4639999999999999,54,23,31,0.426
21300816,1610612753,1610612752,129.0,121.0,0.495,0.474,1,2014-02-21,57,17,40,0.298,55,21,34,0.382
21300817,1610612755,1610612742,112.0,124.0,0.447,0.623,0,2014-02-21,56,15,41,0.268,56,33,23,0.589
21300818,1610612761,1610612739,98.0,91.0,0.43,0.39,1,2014-02-21,55,30,25,0.545,56,22,34,0.3929999999999999
21300819,1610612765,1610612737,115.0,107.0,0.54,0.455,1,2014-02-21,55,23,32,0.418,54,25,29,0.4629999999999999
21300820,1610612741,1610612743,117.0,89.0,0.5,0.402,1,2014-02-21,54,29,25,0.537,54,25,29,0.4629999999999999
21300821,1610612763,1610612746,102.0,96.0,0.483,0.3879999999999999,1,2014-02-21,54,31,23,0.574,57,37,20,0.649
21300822,1610612756,1610612759,106.0,85.0,0.512,0.349,1,2014-02-21,54,33,21,0.611,56,40,16,0.7140000000000001
21300823,1610612757,1610612762,102.0,94.0,0.429,0.451,1,2014-02-21,55,37,18,0.6729999999999999,54,19,35,0.352
21300824,1610612747,1610612738,101.0,92.0,0.482,0.392,1,2014-02-21,55,19,36,0.345,56,19,37,0.3389999999999999
21300812,1610612749,1610612743,90.0,101.0,0.4270000000000001,0.513,0,2014-02-20,54,10,44,0.185,53,25,28,0.472
21300813,1610612760,1610612748,81.0,103.0,0.3779999999999999,0.547,0,2014-02-20,56,43,13,0.768,53,39,14,0.736
21300814,1610612744,1610612745,102.0,99.0,0.3979999999999999,0.366,1,2014-02-20,55,33,22,0.6,55,37,18,0.6729999999999999
21300801,1610612766,1610612765,116.0,98.0,0.512,0.422,1,2014-02-19,55,25,30,0.455,54,22,32,0.407
21300802,1610612739,1610612753,101.0,93.0,0.413,0.3929999999999999,1,2014-02-19,55,22,33,0.4,56,16,40,0.286
21300803,1610612761,1610612741,92.0,94.0,0.422,0.5,0,2014-02-19,54,29,25,0.537,53,28,25,0.528
21300804,1610612737,1610612764,97.0,114.0,0.452,0.517,0,2014-02-19,53,25,28,0.472,54,26,28,0.481
21300805,1610612750,1610612754,104.0,91.0,0.482,0.402,1,2014-02-19,54,26,28,0.481,54,41,13,0.759
21300806,1610612740,1610612752,91.0,98.0,0.467,0.446,0,2014-02-19,53,23,30,0.434,54,21,33,0.389
21300807,1610612756,1610612738,100.0,94.0,0.439,0.391,1,2014-02-19,53,32,21,0.604,55,19,36,0.345
21300808,1610612762,1610612751,99.0,105.0,0.451,0.5,0,2014-02-19,53,19,34,0.358,52,25,27,0.481
21300809,1610612757,1610612759,109.0,111.0,0.452,0.489,0,2014-02-19,54,36,18,0.667,55,40,15,0.727
21300810,1610612758,1610612744,92.0,101.0,0.418,0.4529999999999999,0,2014-02-19,54,18,36,0.3329999999999999,54,32,22,0.593
21300811,1610612747,1610612745,108.0,134.0,0.488,0.5,0,2014-02-19,54,18,36,0.3329999999999999,54,37,17,0.685
21300792,1610612754,1610612737,108.0,98.0,0.494,0.481,1,2014-02-18,53,41,12,0.774,52,25,27,0.481
21300793,1610612755,1610612739,85.0,114.0,0.356,0.46,0,2014-02-18,55,15,40,0.273,54,21,33,0.389
21300794,1610612764,1610612761,93.0,103.0,0.469,0.568,0,2014-02-18,53,25,28,0.472,53,29,24,0.547
21300795,1610612765,1610612766,96.0,108.0,0.3979999999999999,0.52,0,2014-02-18,53,22,31,0.415,54,24,30,0.444
21300796,1610612763,1610612752,98.0,93.0,0.493,0.412,1,2014-02-18,53,30,23,0.5660000000000001,53,20,33,0.377
21300797,1610612749,1610612753,104.0,100.0,0.4270000000000001,0.5,1,2014-02-18,53,10,43,0.1889999999999999,55,16,39,0.291
21300798,1610612742,1610612748,106.0,117.0,0.4,0.5710000000000001,0,2014-02-18,55,32,23,0.5820000000000001,52,38,14,0.731
21300799,1610612743,1610612756,107.0,112.0,0.384,0.376,0,2014-02-18,52,24,28,0.462,52,31,21,0.596
21300800,1610612746,1610612759,103.0,113.0,0.4320000000000001,0.5,0,2014-02-18,56,37,19,0.6609999999999999,54,39,15,0.722
21300790,1610612741,1610612751,92.0,76.0,0.5,0.3879999999999999,1,2014-02-13,52,27,25,0.519,51,24,27,0.471
21300791,1610612747,1610612760,103.0,107.0,0.482,0.4429999999999999,0,2014-02-13,53,18,35,0.34,55,43,12,0.782
21300777,1610612754,1610612742,73.0,81.0,0.321,0.357,0,2014-02-12,52,40,12,0.769,54,32,22,0.593
21300778,1610612753,1610612763,81.0,86.0,0.41,0.4679999999999999,0,2014-02-12,54,16,38,0.296,52,29,23,0.5579999999999999
21300779,1610612761,1610612737,104.0,83.0,0.4039999999999999,0.385,1,2014-02-12,52,28,24,0.5379999999999999,51,25,26,0.49
21300780,1610612738,1610612759,92.0,104.0,0.4629999999999999,0.5,0,2014-02-12,54,19,35,0.352,53,38,15,0.7170000000000001
21300781,1610612751,1610612766,105.0,89.0,0.5,0.414,1,2014-02-12,50,24,26,0.48,53,23,30,0.434
21300782,1610612765,1610612739,89.0,93.0,0.3979999999999999,0.405,0,2014-02-12,52,22,30,0.423,53,20,33,0.377
21300783,1610612752,1610612758,101.0,106.0,0.456,0.471,0,2014-02-12,52,20,32,0.385,53,18,35,0.34
21300784,1610612745,1610612764,113.0,112.0,0.531,0.4539999999999999,1,2014-02-12,53,36,17,0.679,52,25,27,0.481
21300785,1610612749,1610612740,98.0,102.0,0.488,0.519,0,2014-02-12,52,9,43,0.173,52,23,29,0.442
21300786,1610612750,1610612743,117.0,90.0,0.523,0.3929999999999999,1,2014-02-12,53,25,28,0.472,51,24,27,0.471
21300787,1610612762,1610612755,105.0,100.0,0.425,0.4629999999999999,1,2014-02-12,52,19,33,0.365,54,15,39,0.278
21300788,1610612744,1610612748,110.0,111.0,0.482,0.5379999999999999,0,2014-02-12,53,31,22,0.585,51,37,14,0.725
21300789,1610612746,1610612757,122.0,117.0,0.5820000000000001,0.512,1,2014-02-12,55,37,18,0.6729999999999999,53,36,17,0.679
21300770,1610612766,1610612742,114.0,89.0,0.5489999999999999,0.451,1,2014-02-11,52,23,29,0.442,53,31,22,0.585
21300771,1610612739,1610612758,109.0,99.0,0.477,0.4589999999999999,1,2014-02-11,52,19,33,0.365,52,17,35,0.327
21300772,1610612741,1610612737,100.0,85.0,0.506,0.4379999999999999,1,2014-02-11,51,26,25,0.51,50,25,25,0.5
21300773,1610612763,1610612764,92.0,89.0,0.471,0.4589999999999999,1,2014-02-11,51,28,23,0.5489999999999999,51,25,26,0.49
21300774,1610612756,1610612748,97.0,103.0,0.461,0.474,0,2014-02-11,51,30,21,0.588,50,36,14,0.72
21300775,1610612757,1610612760,95.0,98.0,0.376,0.482,0,2014-02-11,52,36,16,0.6920000000000001,54,42,12,0.778
21300776,1610612747,1610612762,79.0,96.0,0.3879999999999999,0.435,0,2014-02-11,52,18,34,0.346,51,18,33,0.353
21300764,1610612754,1610612743,119.0,80.0,0.575,0.315,1,2014-02-10,51,40,11,0.784,50,24,26,0.48
21300765,1610612761,1610612740,108.0,101.0,0.474,0.506,1,2014-02-10,51,27,24,0.529,51,22,29,0.431
21300766,1610612765,1610612759,109.0,100.0,0.478,0.524,1,2014-02-10,51,22,29,0.431,52,37,15,0.7120000000000001
21300767,1610612749,1610612738,86.0,102.0,0.431,0.477,0,2014-02-10,51,9,42,0.176,53,19,34,0.358
21300768,1610612750,1610612745,89.0,107.0,0.356,0.476,0,2014-02-10,52,24,28,0.462,52,35,17,0.6729999999999999
21300769,1610612744,1610612755,123.0,80.0,0.489,0.3670000000000001,1,2014-02-10,52,31,21,0.596,53,15,38,0.283
21300756,1610612760,1610612752,112.0,100.0,0.5479999999999999,0.442,1,2014-02-09,53,41,12,0.774,51,20,31,0.392
21300757,1610612747,1610612741,86.0,92.0,0.439,0.425,0,2014-02-09,51,18,33,0.353,50,25,25,0.5
21300758,1610612738,1610612742,91.0,102.0,0.359,0.451,0,2014-02-09,52,18,34,0.346,52,31,21,0.596
21300759,1610612751,1610612740,93.0,81.0,0.53,0.361,1,2014-02-09,49,23,26,0.469,50,22,28,0.44
21300760,1610612739,1610612763,91.0,83.0,0.3979999999999999,0.384,1,2014-02-09,51,18,33,0.353,50,27,23,0.54
21300761,1610612753,1610612754,93.0,92.0,0.41,0.4429999999999999,1,2014-02-09,53,16,37,0.302,50,39,11,0.78
21300762,1610612764,1610612758,93.0,84.0,0.43,0.354,1,2014-02-09,50,25,25,0.5,51,17,34,0.3329999999999999
21300763,1610612746,1610612755,123.0,78.0,0.562,0.27,1,2014-02-09,54,36,18,0.667,52,15,37,0.288
21300749,1610612766,1610612759,100.0,104.0,0.4379999999999999,0.4679999999999999,0,2014-02-08,51,22,29,0.431,51,37,14,0.725
21300750,1610612737,1610612763,76.0,79.0,0.429,0.411,0,2014-02-08,49,25,24,0.51,49,27,22,0.551
21300751,1610612765,1610612743,126.0,109.0,0.51,0.466,1,2014-02-08,50,21,29,0.42,49,24,25,0.49
21300752,1610612750,1610612757,110.0,117.0,0.412,0.482,0,2014-02-08,51,24,27,0.471,51,36,15,0.706
21300753,1610612749,1610612745,95.0,101.0,0.444,0.494,0,2014-02-08,50,9,41,0.18,51,34,17,0.667
21300754,1610612756,1610612744,122.0,109.0,0.5379999999999999,0.488,1,2014-02-08,50,30,20,0.6,51,30,21,0.588
21300755,1610612762,1610612748,94.0,89.0,0.486,0.433,1,2014-02-08,50,17,33,0.34,49,35,14,0.7140000000000001
21300739,1610612754,1610612757,118.0,113.0,0.457,0.433,1,2014-02-07,49,39,10,0.7959999999999999,50,35,15,0.7
21300740,1610612753,1610612760,103.0,102.0,0.475,0.507,1,2014-02-07,52,15,37,0.288,52,40,12,0.769
21300741,1610612755,1610612747,98.0,112.0,0.425,0.506,0,2014-02-07,51,15,36,0.294,50,18,32,0.36
21300742,1610612764,1610612739,113.0,115.0,0.506,0.519,0,2014-02-07,49,24,25,0.49,50,17,33,0.34
21300743,1610612738,1610612758,99.0,89.0,0.455,0.356,1,2014-02-07,51,18,33,0.353,50,17,33,0.34
21300744,1610612765,1610612751,111.0,95.0,0.512,0.36,1,2014-02-07,49,20,29,0.408,48,22,26,0.4579999999999999
21300745,1610612752,1610612743,117.0,90.0,0.565,0.421,1,2014-02-07,50,20,30,0.4,48,24,24,0.5
21300746,1610612742,1610612762,103.0,81.0,0.469,0.408,1,2014-02-07,51,30,21,0.588,49,16,33,0.327
21300747,1610612740,1610612750,98.0,91.0,0.481,0.373,1,2014-02-07,49,22,27,0.449,50,24,26,0.48
21300748,1610612746,1610612761,118.0,105.0,0.507,0.4,1,2014-02-07,53,35,18,0.66,50,26,24,0.52
21300737,1610612751,1610612759,103.0,89.0,0.495,0.397,1,2014-02-06,47,22,25,0.4679999999999999,50,36,14,0.72
21300738,1610612744,1610612741,102.0,87.0,0.482,0.416,1,2014-02-06,50,30,20,0.6,49,24,25,0.49
21300725,1610612739,1610612747,108.0,119.0,0.376,0.532,0,2014-02-05,49,16,33,0.327,49,17,32,0.347
21300726,1610612755,1610612738,108.0,114.0,0.447,0.488,0,2014-02-05,50,15,35,0.3,50,17,33,0.34
21300727,1610612764,1610612759,118.0,125.0,0.436,0.49,0,2014-02-05,48,24,24,0.5,49,36,13,0.735
21300733,1610612753,1610612765,112.0,98.0,0.494,0.4589999999999999,1,2014-02-05,51,14,37,0.275,48,19,29,0.396
21300728,1610612752,1610612757,90.0,94.0,0.4,0.38,0,2014-02-05,49,19,30,0.3879999999999999,49,35,14,0.7140000000000001
21300729,1610612745,1610612756,122.0,108.0,0.5489999999999999,0.467,1,2014-02-05,50,33,17,0.66,49,29,20,0.5920000000000001
21300730,1610612763,1610612742,96.0,110.0,0.536,0.5379999999999999,0,2014-02-05,48,26,22,0.542,50,29,21,0.58
21300731,1610612740,1610612737,105.0,100.0,0.465,0.452,1,2014-02-05,48,21,27,0.4379999999999999,48,25,23,0.521
21300732,1610612760,1610612750,106.0,97.0,0.484,0.474,1,2014-02-05,51,40,11,0.784,49,24,25,0.49
21300734,1610612743,1610612749,110.0,100.0,0.4639999999999999,0.379,1,2014-02-05,47,24,23,0.511,49,9,40,0.184
21300735,1610612758,1610612761,109.0,101.0,0.395,0.429,1,2014-02-05,49,17,32,0.347,49,26,23,0.531
21300736,1610612746,1610612748,112.0,116.0,0.43,0.526,0,2014-02-05,52,34,18,0.654,48,35,13,0.7290000000000001
21300721,1610612737,1610612754,85.0,89.0,0.434,0.4589999999999999,0,2014-02-04,47,25,22,0.532,48,38,10,0.792
21300722,1610612750,1610612747,109.0,99.0,0.446,0.418,1,2014-02-04,48,24,24,0.5,48,16,32,0.3329999999999999
21300723,1610612756,1610612741,92.0,101.0,0.3879999999999999,0.449,0,2014-02-04,48,29,19,0.604,48,24,24,0.5
21300724,1610612744,1610612766,75.0,91.0,0.312,0.474,0,2014-02-04,49,29,20,0.5920000000000001,50,22,28,0.44
21300710,1610612754,1610612753,98.0,79.0,0.422,0.3979999999999999,1,2014-02-03,47,37,10,0.787,50,13,37,0.26
21300711,1610612764,1610612757,100.0,90.0,0.44,0.457,1,2014-02-03,47,24,23,0.511,48,34,14,0.708
21300712,1610612751,1610612755,108.0,102.0,0.444,0.521,1,2014-02-03,46,21,25,0.457,49,15,34,0.306
21300713,1610612748,1610612765,102.0,96.0,0.4589999999999999,0.41,1,2014-02-03,47,34,13,0.723,47,19,28,0.4039999999999999
21300714,1610612749,1610612752,101.0,98.0,0.444,0.436,1,2014-02-03,48,9,39,0.188,48,19,29,0.396
21300715,1610612740,1610612759,95.0,102.0,0.456,0.469,0,2014-02-03,47,20,27,0.426,48,35,13,0.7290000000000001
21300716,1610612760,1610612763,86.0,77.0,0.447,0.395,1,2014-02-03,50,39,11,0.78,47,26,21,0.5529999999999999
21300717,1610612742,1610612739,124.0,107.0,0.55,0.4629999999999999,1,2014-02-03,49,28,21,0.5710000000000001,48,16,32,0.3329999999999999
21300718,1610612743,1610612746,116.0,115.0,0.482,0.5,1,2014-02-03,46,23,23,0.5,51,34,17,0.667
21300719,1610612762,1610612761,79.0,94.0,0.41,0.44,0,2014-02-03,48,16,32,0.3329999999999999,48,26,22,0.542
21300720,1610612758,1610612741,99.0,70.0,0.522,0.282,1,2014-02-03,48,16,32,0.3329999999999999,47,23,24,0.489
21300709,1610612738,1610612753,96.0,89.0,0.5,0.413,1,2014-02-02,49,16,33,0.327,49,13,36,0.265
21300697,1610612754,1610612751,97.0,96.0,0.425,0.442,1,2014-02-01,46,36,10,0.7829999999999999,45,20,25,0.444
21300698,1610612764,1610612760,96.0,81.0,0.461,0.397,1,2014-02-01,46,23,23,0.5,49,38,11,0.7759999999999999
21300699,1610612737,1610612750,120.0,113.0,0.467,0.44,1,2014-02-01,46,25,21,0.5429999999999999,47,23,24,0.489
21300700,1610612765,1610612755,113.0,96.0,0.446,0.4270000000000001,1,2014-02-01,46,19,27,0.413,48,15,33,0.313
21300701,1610612745,1610612739,106.0,92.0,0.513,0.4370000000000001,1,2014-02-01,49,32,17,0.653,47,16,31,0.34
21300702,1610612763,1610612749,99.0,90.0,0.481,0.395,1,2014-02-01,46,26,20,0.565,47,8,39,0.17
21300703,1610612740,1610612741,88.0,79.0,0.475,0.386,1,2014-02-01,46,20,26,0.435,46,23,23,0.5
21300704,1610612759,1610612758,95.0,93.0,0.48,0.41,1,2014-02-01,47,34,13,0.723,47,15,32,0.319
21300705,1610612752,1610612748,91.0,106.0,0.493,0.539,0,2014-02-01,47,19,28,0.4039999999999999,46,33,13,0.7170000000000001
21300706,1610612756,1610612766,105.0,95.0,0.488,0.418,1,2014-02-01,47,29,18,0.617,49,21,28,0.429
21300707,1610612757,1610612761,106.0,103.0,0.461,0.46,1,2014-02-01,47,34,13,0.723,47,25,22,0.532
21300708,1610612746,1610612762,102.0,87.0,0.514,0.358,1,2014-02-01,50,34,16,0.68,47,16,31,0.34
21300689,1610612753,1610612749,113.0,102.0,0.518,0.4479999999999999,1,2014-01-31,48,13,35,0.271,46,8,38,0.174
21300690,1610612755,1610612737,99.0,125.0,0.368,0.506,0,2014-01-31,47,15,32,0.319,45,24,21,0.5329999999999999
21300691,1610612750,1610612763,90.0,94.0,0.4639999999999999,0.475,0,2014-01-31,46,23,23,0.5,45,25,20,0.556
21300692,1610612751,1610612760,95.0,120.0,0.473,0.636,0,2014-01-31,44,20,24,0.455,48,38,10,0.792
21300693,1610612742,1610612758,107.0,103.0,0.475,0.507,1,2014-01-31,48,27,21,0.563,46,15,31,0.326
21300694,1610612743,1610612761,90.0,100.0,0.45,0.435,0,2014-01-31,45,22,23,0.489,46,25,21,0.5429999999999999
21300695,1610612747,1610612766,100.0,110.0,0.387,0.523,0,2014-01-31,47,16,31,0.34,48,21,27,0.4379999999999999
21300696,1610612762,1610612744,90.0,95.0,0.479,0.375,0,2014-01-31,46,16,30,0.348,48,29,19,0.604
21300686,1610612754,1610612756,94.0,102.0,0.4370000000000001,0.429,0,2014-01-30,45,35,10,0.778,46,28,18,0.609
21300687,1610612752,1610612739,117.0,86.0,0.5660000000000001,0.356,1,2014-01-30,46,19,27,0.413,46,16,30,0.348
21300688,1610612744,1610612746,111.0,92.0,0.495,0.408,1,2014-01-30,47,28,19,0.596,49,33,16,0.6729999999999999
21300675,1610612748,1610612760,95.0,112.0,0.514,0.513,0,2014-01-29,45,32,13,0.711,47,37,10,0.787
21300676,1610612761,1610612753,98.0,83.0,0.425,0.3329999999999999,1,2014-01-29,45,24,21,0.5329999999999999,47,12,35,0.255
21300678,1610612738,1610612755,94.0,95.0,0.368,0.43,0,2014-01-29,48,15,33,0.313,46,15,31,0.326
21300679,1610612749,1610612756,117.0,126.0,0.4270000000000001,0.5379999999999999,0,2014-01-29,45,8,37,0.178,45,27,18,0.6
21300680,1610612750,1610612740,88.0,77.0,0.402,0.354,1,2014-01-29,45,23,22,0.511,45,19,26,0.422
21300681,1610612742,1610612745,115.0,117.0,0.465,0.5539999999999999,0,2014-01-29,47,26,21,0.5529999999999999,48,31,17,0.6459999999999999
21300682,1610612743,1610612766,98.0,101.0,0.39,0.423,0,2014-01-29,44,22,22,0.5,47,20,27,0.426
21300683,1610612759,1610612741,86.0,96.0,0.465,0.446,0,2014-01-29,46,33,13,0.7170000000000001,45,23,22,0.511
21300684,1610612758,1610612763,89.0,99.0,0.481,0.547,0,2014-01-29,45,15,30,0.3329999999999999,44,24,20,0.545
21300685,1610612746,1610612764,110.0,103.0,0.493,0.511,1,2014-01-29,48,33,15,0.688,45,22,23,0.489
21300668,1610612739,1610612740,89.0,100.0,0.413,0.527,0,2014-01-28,45,16,29,0.356,44,19,25,0.4320000000000001
21300669,1610612765,1610612753,103.0,87.0,0.4529999999999999,0.416,1,2014-01-28,45,18,27,0.4,46,12,34,0.261
21300670,1610612752,1610612738,114.0,88.0,0.537,0.39,1,2014-01-28,45,18,27,0.4,47,15,32,0.319
21300671,1610612745,1610612759,97.0,90.0,0.44,0.4270000000000001,1,2014-01-28,47,30,17,0.638,45,33,12,0.733
21300672,1610612757,1610612763,81.0,98.0,0.345,0.518,0,2014-01-28,46,33,13,0.7170000000000001,43,23,20,0.535
21300673,1610612744,1610612764,85.0,88.0,0.375,0.3779999999999999,0,2014-01-28,46,27,19,0.5870000000000001,44,22,22,0.5
21300674,1610612747,1610612754,92.0,104.0,0.3939999999999999,0.424,0,2014-01-28,46,16,30,0.348,44,35,9,0.795
21300662,1610612755,1610612756,113.0,124.0,0.46,0.5379999999999999,0,2014-01-27,45,14,31,0.311,44,26,18,0.591
21300663,1610612751,1610612761,103.0,104.0,0.481,0.4679999999999999,0,2014-01-27,43,20,23,0.465,44,23,21,0.523
21300664,1610612741,1610612750,86.0,95.0,0.376,0.466,0,2014-01-27,44,22,22,0.5,44,22,22,0.5
21300665,1610612749,1610612746,86.0,114.0,0.382,0.544,0,2014-01-27,44,8,36,0.182,47,32,15,0.6809999999999999
21300666,1610612760,1610612737,111.0,109.0,0.524,0.489,1,2014-01-27,46,36,10,0.7829999999999999,44,23,21,0.523
21300667,1610612762,1610612758,106.0,99.0,0.4,0.411,1,2014-01-27,45,16,29,0.356,44,15,29,0.341
21300654,1610612748,1610612759,113.0,101.0,0.581,0.5,1,2014-01-26,44,32,12,0.727,44,33,11,0.75
21300655,1610612752,1610612747,110.0,103.0,0.478,0.52,1,2014-01-26,44,17,27,0.386,45,16,29,0.356
21300656,1610612740,1610612753,100.0,92.0,0.457,0.4679999999999999,1,2014-01-26,43,18,25,0.419,45,12,33,0.267
21300657,1610612739,1610612756,90.0,99.0,0.395,0.415,0,2014-01-26,44,16,28,0.364,43,25,18,0.581
21300658,1610612738,1610612751,79.0,85.0,0.373,0.3929999999999999,0,2014-01-26,46,15,31,0.326,42,20,22,0.476
21300659,1610612742,1610612765,116.0,106.0,0.581,0.473,1,2014-01-26,46,26,20,0.565,44,17,27,0.386
21300660,1610612744,1610612757,103.0,88.0,0.418,0.337,1,2014-01-26,45,27,18,0.6,45,33,12,0.733
21300661,1610612758,1610612743,117.0,125.0,0.519,0.519,0,2014-01-26,43,15,28,0.349,43,22,21,0.512
21300646,1610612766,1610612741,87.0,89.0,0.42,0.4029999999999999,0,2014-01-25,46,19,27,0.413,43,22,21,0.512
21300647,1610612761,1610612746,118.0,126.0,0.486,0.5479999999999999,0,2014-01-25,43,22,21,0.512,46,31,15,0.674
21300648,1610612755,1610612760,91.0,103.0,0.3779999999999999,0.526,0,2014-01-25,44,14,30,0.318,45,35,10,0.778
21300649,1610612763,1610612745,99.0,81.0,0.466,0.37,1,2014-01-25,42,22,20,0.524,46,29,17,0.63
21300650,1610612749,1610612737,87.0,112.0,0.4629999999999999,0.526,0,2014-01-25,43,8,35,0.186,43,23,20,0.535
21300651,1610612743,1610612754,109.0,96.0,0.482,0.42,1,2014-01-25,42,21,21,0.5,43,34,9,0.7909999999999999
21300652,1610612762,1610612764,104.0,101.0,0.469,0.429,1,2014-01-25,44,15,29,0.341,43,21,22,0.488
21300653,1610612757,1610612750,115.0,104.0,0.484,0.4270000000000001,1,2014-01-25,44,33,11,0.75,43,21,22,0.488
21300633,1610612753,1610612747,114.0,105.0,0.481,0.456,1,2014-01-24,44,12,32,0.273,44,16,28,0.364
21300634,1610612755,1610612761,95.0,104.0,0.4270000000000001,0.476,0,2014-01-24,43,14,29,0.326,42,22,20,0.524
21300635,1610612737,1610612759,79.0,105.0,0.382,0.488,0,2014-01-24,42,22,20,0.524,43,33,10,0.767
21300636,1610612738,1610612760,83.0,101.0,0.4270000000000001,0.5379999999999999,0,2014-01-24,45,15,30,0.3329999999999999,44,34,10,0.773
21300637,1610612751,1610612742,107.0,106.0,0.507,0.436,1,2014-01-24,41,19,22,0.4629999999999999,45,25,20,0.556
21300638,1610612739,1610612749,93.0,78.0,0.42,0.405,1,2014-01-24,43,16,27,0.3720000000000001,42,8,34,0.19
21300639,1610612765,1610612740,101.0,103.0,0.435,0.507,0,2014-01-24,43,17,26,0.395,42,17,25,0.405
21300640,1610612752,1610612766,125.0,96.0,0.556,0.487,1,2014-01-24,43,16,27,0.3720000000000001,45,19,26,0.422
21300641,1610612741,1610612746,95.0,112.0,0.43,0.539,0,2014-01-24,42,21,21,0.5,45,30,15,0.667
21300642,1610612745,1610612763,87.0,88.0,0.405,0.462,0,2014-01-24,45,29,16,0.644,41,21,20,0.512
21300643,1610612756,1610612764,95.0,101.0,0.479,0.4529999999999999,0,2014-01-24,42,24,18,0.5710000000000001,42,21,21,0.5
21300644,1610612758,1610612754,111.0,116.0,0.386,0.4320000000000001,0,2014-01-24,42,15,27,0.357,42,34,8,0.81
21300645,1610612744,1610612750,120.0,121.0,0.551,0.5,0,2014-01-24,44,26,18,0.591,42,21,21,0.5
21300631,1610612748,1610612747,109.0,102.0,0.5770000000000001,0.455,1,2014-01-23,43,31,12,0.721,43,16,27,0.3720000000000001
21300632,1610612757,1610612743,110.0,105.0,0.4320000000000001,0.494,1,2014-01-23,43,32,11,0.7440000000000001,41,20,21,0.488
21300621,1610612766,1610612746,95.0,91.0,0.4639999999999999,0.433,1,2014-01-22,44,19,25,0.4320000000000001,44,29,15,0.659
21300622,1610612739,1610612741,87.0,98.0,0.375,0.529,0,2014-01-22,42,15,27,0.357,41,21,20,0.512
21300623,1610612753,1610612737,109.0,112.0,0.494,0.494,0,2014-01-22,43,11,32,0.256,41,22,19,0.537
21300624,1610612761,1610612742,93.0,85.0,0.421,0.466,1,2014-01-22,41,21,20,0.512,44,25,19,0.568
21300625,1610612764,1610612738,111.0,113.0,0.447,0.461,0,2014-01-22,41,20,21,0.488,44,15,29,0.341
21300626,1610612752,1610612755,106.0,110.0,0.451,0.477,0,2014-01-22,42,15,27,0.357,42,14,28,0.3329999999999999
21300627,1610612745,1610612758,119.0,98.0,0.478,0.395,1,2014-01-22,44,29,15,0.659,41,15,26,0.366
21300628,1610612749,1610612765,104.0,101.0,0.488,0.429,1,2014-01-22,41,8,33,0.195,42,17,25,0.405
21300630,1610612759,1610612760,105.0,111.0,0.5329999999999999,0.542,0,2014-01-22,42,32,10,0.762,43,33,10,0.767
21300629,1610612756,1610612754,124.0,100.0,0.542,0.507,1,2014-01-22,41,24,17,0.585,41,33,8,0.805
21300616,1610612751,1610612753,101.0,90.0,0.494,0.4579999999999999,1,2014-01-21,40,18,22,0.45,42,11,31,0.262
21300617,1610612748,1610612738,93.0,86.0,0.514,0.3929999999999999,1,2014-01-21,42,30,12,0.7140000000000001,43,14,29,0.326
21300618,1610612740,1610612758,97.0,114.0,0.478,0.512,0,2014-01-21,41,16,25,0.39,40,15,25,0.375
21300619,1610612760,1610612757,105.0,97.0,0.483,0.465,1,2014-01-21,42,32,10,0.762,42,31,11,0.738
21300620,1610612762,1610612750,97.0,112.0,0.471,0.456,0,2014-01-21,43,14,29,0.326,41,20,21,0.488
21300606,1610612739,1610612742,97.0,102.0,0.407,0.4579999999999999,0,2014-01-20,41,15,26,0.366,43,25,18,0.581
21300607,1610612765,1610612746,103.0,112.0,0.506,0.556,0,2014-01-20,41,17,24,0.415,43,29,14,0.674
21300608,1610612766,1610612761,100.0,95.0,0.4920000000000001,0.411,1,2014-01-20,43,18,25,0.419,40,20,20,0.5
21300609,1610612764,1610612755,107.0,99.0,0.44,0.42,1,2014-01-20,40,20,20,0.5,41,13,28,0.317
21300610,1610612752,1610612751,80.0,103.0,0.3379999999999999,0.493,0,2014-01-20,41,15,26,0.366,39,17,22,0.436
21300611,1610612763,1610612740,92.0,95.0,0.419,0.455,0,2014-01-20,40,20,20,0.5,40,16,24,0.4
21300612,1610612737,1610612748,121.0,114.0,0.519,0.487,1,2014-01-20,40,21,19,0.525,41,29,12,0.7070000000000001
21300613,1610612741,1610612747,102.0,100.0,0.382,0.422,1,2014-01-20,40,20,20,0.5,42,16,26,0.381
21300614,1610612745,1610612757,126.0,113.0,0.523,0.4539999999999999,1,2014-01-20,43,28,15,0.6509999999999999,41,31,10,0.7559999999999999
21300615,1610612744,1610612754,94.0,102.0,0.407,0.451,0,2014-01-20,43,26,17,0.605,40,33,7,0.825
21300601,1610612761,1610612747,106.0,112.0,0.489,0.4629999999999999,0,2014-01-19,39,20,19,0.513,41,16,25,0.39
21300602,1610612753,1610612738,93.0,91.0,0.423,0.3670000000000001,1,2014-01-19,41,11,30,0.268,42,14,28,0.3329999999999999
21300603,1610612760,1610612758,108.0,93.0,0.4529999999999999,0.429,1,2014-01-19,41,31,10,0.7559999999999999,39,14,25,0.359
21300604,1610612759,1610612749,110.0,82.0,0.5660000000000001,0.375,1,2014-01-19,41,32,9,0.78,40,7,33,0.175
21300605,1610612756,1610612743,117.0,103.0,0.505,0.439,1,2014-01-19,40,23,17,0.575,40,20,20,0.5
21300594,1610612754,1610612746,106.0,92.0,0.4579999999999999,0.3979999999999999,1,2014-01-18,39,32,7,0.821,42,28,14,0.667
21300595,1610612764,1610612765,98.0,104.0,0.487,0.494,0,2014-01-18,39,19,20,0.487,40,17,23,0.425
21300593,1610612766,1610612748,96.0,104.0,0.48,0.494,0,2014-01-18,42,17,25,0.405,40,29,11,0.725
21300596,1610612741,1610612755,103.0,78.0,0.488,0.351,1,2014-01-18,39,19,20,0.487,40,13,27,0.325
21300597,1610612745,1610612749,114.0,104.0,0.482,0.5,1,2014-01-18,42,27,15,0.643,39,7,32,0.179
21300598,1610612750,1610612762,98.0,72.0,0.434,0.288,1,2014-01-18,40,19,21,0.475,42,14,28,0.3329999999999999
21300599,1610612740,1610612744,87.0,97.0,0.386,0.44,0,2014-01-18,39,15,24,0.385,42,26,16,0.619
21300600,1610612742,1610612757,111.0,127.0,0.467,0.511,0,2014-01-18,42,24,18,0.5710000000000001,40,31,9,0.775
21300581,1610612752,1610612746,95.0,109.0,0.349,0.423,0,2014-01-17,40,15,25,0.375,41,28,13,0.6829999999999999
21300582,1610612753,1610612766,101.0,111.0,0.4629999999999999,0.527,0,2014-01-17,40,10,30,0.25,41,17,24,0.415
21300583,1610612755,1610612748,86.0,101.0,0.369,0.475,0,2014-01-17,39,13,26,0.3329999999999999,39,28,11,0.718
21300584,1610612761,1610612750,94.0,89.0,0.436,0.439,1,2014-01-17,38,20,18,0.526,39,18,21,0.462
21300585,1610612764,1610612741,96.0,93.0,0.506,0.461,1,2014-01-17,38,19,19,0.5,38,18,20,0.474
21300586,1610612738,1610612747,104.0,107.0,0.444,0.5,0,2014-01-17,41,14,27,0.341,40,15,25,0.375
21300587,1610612765,1610612762,89.0,110.0,0.4320000000000001,0.544,0,2014-01-17,39,16,23,0.41,41,14,27,0.341
21300588,1610612763,1610612758,91.0,90.0,0.462,0.407,1,2014-01-17,39,20,19,0.513,38,14,24,0.368
21300589,1610612759,1610612757,100.0,109.0,0.452,0.477,0,2014-01-17,40,31,9,0.775,39,30,9,0.769
21300590,1610612743,1610612739,109.0,117.0,0.435,0.477,0,2014-01-17,39,20,19,0.513,40,15,25,0.375
21300591,1610612756,1610612742,107.0,110.0,0.452,0.53,0,2014-01-17,39,22,17,0.564,41,24,17,0.585
21300592,1610612760,1610612744,127.0,121.0,0.58,0.524,1,2014-01-17,40,30,10,0.75,41,25,16,0.61
21300579,1610612737,1610612751,110.0,127.0,0.494,0.5820000000000001,0,2014-01-16,39,20,19,0.513,38,16,22,0.421
21300578,1610612754,1610612752,117.0,89.0,0.5,0.4,1,2014-01-16,38,31,7,0.816,39,15,24,0.385
21300580,1610612745,1610612760,92.0,104.0,0.402,0.4629999999999999,0,2014-01-16,41,26,15,0.634,39,29,10,0.7440000000000001
21300566,1610612753,1610612741,125.0,128.0,0.51,0.425,0,2014-01-15,39,10,29,0.256,37,18,19,0.486
21300567,1610612755,1610612766,95.0,92.0,0.506,0.3979999999999999,1,2014-01-15,38,13,25,0.342,40,16,24,0.4
21300568,1610612764,1610612748,114.0,97.0,0.547,0.44,1,2014-01-15,37,18,19,0.486,38,27,11,0.711
21300569,1610612738,1610612761,88.0,83.0,0.345,0.385,1,2014-01-15,40,14,26,0.35,37,19,18,0.514
21300570,1610612749,1610612763,77.0,82.0,0.3779999999999999,0.402,0,2014-01-15,38,7,31,0.184,38,19,19,0.5
21300571,1610612750,1610612758,108.0,111.0,0.4429999999999999,0.5489999999999999,0,2014-01-15,38,18,20,0.474,37,14,23,0.3779999999999999
21300572,1610612740,1610612745,100.0,103.0,0.455,0.514,0,2014-01-15,38,15,23,0.395,40,26,14,0.65
21300573,1610612759,1610612762,109.0,105.0,0.5379999999999999,0.494,1,2014-01-15,39,31,8,0.795,40,13,27,0.325
21300574,1610612756,1610612747,121.0,114.0,0.49,0.473,1,2014-01-15,38,22,16,0.579,39,14,25,0.359
21300575,1610612757,1610612739,108.0,96.0,0.477,0.4379999999999999,1,2014-01-15,38,29,9,0.763,39,14,25,0.359
21300576,1610612744,1610612743,116.0,123.0,0.433,0.542,0,2014-01-15,40,25,15,0.625,38,20,18,0.526
21300577,1610612746,1610612742,129.0,127.0,0.506,0.526,1,2014-01-15,40,27,13,0.675,40,23,17,0.575
21300562,1610612766,1610612752,108.0,98.0,0.507,0.481,1,2014-01-14,39,16,23,0.41,38,15,23,0.395
21300563,1610612754,1610612758,116.0,92.0,0.5489999999999999,0.424,1,2014-01-14,37,30,7,0.8109999999999999,36,13,23,0.361
21300564,1610612763,1610612760,90.0,87.0,0.4,0.407,1,2014-01-14,37,18,19,0.486,38,28,10,0.737
21300565,1610612747,1610612739,118.0,120.0,0.524,0.466,0,2014-01-14,38,14,24,0.368,38,14,24,0.368
21300555,1610612761,1610612749,116.0,94.0,0.506,0.422,1,2014-01-13,36,19,17,0.528,37,7,30,0.1889999999999999
21300556,1610612738,1610612745,92.0,104.0,0.376,0.4679999999999999,0,2014-01-13,39,13,26,0.3329999999999999,39,25,14,0.6409999999999999
21300557,1610612752,1610612756,98.0,96.0,0.4320000000000001,0.355,1,2014-01-13,37,15,22,0.405,37,21,16,0.568
21300558,1610612741,1610612764,88.0,102.0,0.43,0.52,0,2014-01-13,36,17,19,0.472,36,17,19,0.472
21300559,1610612740,1610612759,95.0,101.0,0.4370000000000001,0.522,0,2014-01-13,37,15,22,0.405,38,30,8,0.789
21300560,1610612742,1610612753,107.0,88.0,0.506,0.447,1,2014-01-13,39,23,16,0.59,38,10,28,0.263
21300561,1610612762,1610612743,118.0,103.0,0.557,0.44,1,2014-01-13,39,13,26,0.3329999999999999,37,19,18,0.514
21300552,1610612758,1610612739,124.0,80.0,0.519,0.3879999999999999,1,2014-01-12,35,13,22,0.371,37,13,24,0.351
21300553,1610612763,1610612737,108.0,101.0,0.518,0.475,1,2014-01-12,36,17,19,0.472,38,20,18,0.526
21300554,1610612759,1610612750,104.0,86.0,0.568,0.355,1,2014-01-12,37,29,8,0.784,37,18,19,0.486
21300543,1610612761,1610612751,96.0,80.0,0.405,0.4,1,2014-01-11,35,18,17,0.514,37,15,22,0.405
21300544,1610612764,1610612745,107.0,114.0,0.421,0.521,0,2014-01-11,35,16,19,0.457,38,24,14,0.632
21300545,1610612765,1610612756,110.0,108.0,0.4679999999999999,0.3939999999999999,1,2014-01-11,38,16,22,0.421,36,21,15,0.583
21300546,1610612755,1610612752,92.0,102.0,0.462,0.476,0,2014-01-11,37,12,25,0.324,36,14,22,0.389
21300547,1610612741,1610612766,103.0,97.0,0.469,0.4679999999999999,1,2014-01-11,35,17,18,0.486,38,15,23,0.395
21300548,1610612760,1610612749,101.0,85.0,0.407,0.395,1,2014-01-11,37,28,9,0.757,36,7,29,0.1939999999999999
21300549,1610612742,1610612740,110.0,107.0,0.4479999999999999,0.481,1,2014-01-11,38,22,16,0.579,36,15,21,0.417
21300550,1610612743,1610612753,120.0,94.0,0.506,0.44,1,2014-01-11,36,19,17,0.528,37,10,27,0.27
21300551,1610612757,1610612738,112.0,104.0,0.43,0.4629999999999999,1,2014-01-11,37,28,9,0.757,38,13,25,0.342
21300531,1610612754,1610612764,93.0,66.0,0.446,0.321,1,2014-01-10,36,29,7,0.8059999999999999,34,16,18,0.471
21300532,1610612755,1610612765,104.0,114.0,0.4320000000000001,0.426,0,2014-01-10,36,12,24,0.3329999999999999,37,15,22,0.405
21300533,1610612737,1610612745,83.0,80.0,0.3720000000000001,0.414,1,2014-01-10,37,20,17,0.541,37,23,14,0.622
21300534,1610612763,1610612756,104.0,99.0,0.488,0.413,1,2014-01-10,35,16,19,0.457,35,21,14,0.6
21300535,1610612750,1610612766,119.0,92.0,0.545,0.44,1,2014-01-10,36,18,18,0.5,37,15,22,0.405
21300536,1610612740,1610612742,90.0,107.0,0.45,0.526,0,2014-01-10,35,15,20,0.429,37,21,16,0.568
21300537,1610612751,1610612748,104.0,95.0,0.465,0.425,1,2014-01-10,36,15,21,0.417,37,27,10,0.73
21300538,1610612749,1610612741,72.0,81.0,0.318,0.387,0,2014-01-10,35,7,28,0.2,34,16,18,0.471
21300539,1610612762,1610612739,102.0,113.0,0.481,0.542,0,2014-01-10,38,12,26,0.316,36,13,23,0.361
21300540,1610612758,1610612753,103.0,83.0,0.513,0.3329999999999999,1,2014-01-10,34,12,22,0.353,36,10,26,0.278
21300541,1610612744,1610612738,99.0,97.0,0.413,0.447,1,2014-01-10,39,25,14,0.6409999999999999,37,13,24,0.351
21300542,1610612746,1610612747,123.0,87.0,0.489,0.345,1,2014-01-10,39,26,13,0.667,37,14,23,0.3779999999999999
21300529,1610612752,1610612748,102.0,92.0,0.537,0.544,1,2014-01-09,35,13,22,0.371,36,27,9,0.75
21300530,1610612743,1610612760,101.0,88.0,0.411,0.353,1,2014-01-09,35,18,17,0.514,36,27,9,0.75
21300520,1610612759,1610612742,112.0,90.0,0.526,0.419,1,2014-01-08,36,28,8,0.778,36,20,16,0.556
21300521,1610612761,1610612765,112.0,91.0,0.407,0.395,1,2014-01-08,34,17,17,0.5,36,14,22,0.389
21300522,1610612737,1610612754,97.0,87.0,0.4529999999999999,0.402,1,2014-01-08,36,19,17,0.528,35,28,7,0.8
21300523,1610612751,1610612744,102.0,98.0,0.442,0.462,1,2014-01-08,35,14,21,0.4,38,24,14,0.632
21300525,1610612740,1610612764,96.0,102.0,0.449,0.475,0,2014-01-08,34,15,19,0.441,33,16,17,0.485
21300526,1610612745,1610612747,113.0,99.0,0.4529999999999999,0.409,1,2014-01-08,36,23,13,0.639,36,14,22,0.389
21300524,1610612750,1610612756,103.0,104.0,0.395,0.413,0,2014-01-08,35,17,18,0.486,34,21,13,0.618
21300527,1610612757,1610612753,110.0,94.0,0.474,0.3979999999999999,1,2014-01-08,36,27,9,0.75,35,10,25,0.286
21300528,1610612746,1610612738,111.0,105.0,0.456,0.47,1,2014-01-08,38,25,13,0.6579999999999999,36,13,23,0.361
21300508,1610612766,1610612764,83.0,97.0,0.431,0.471,0,2014-01-07,36,15,21,0.417,32,15,17,0.469
21300509,1610612739,1610612755,111.0,93.0,0.494,0.395,1,2014-01-07,35,12,23,0.3429999999999999,35,12,23,0.3429999999999999
21300510,1610612754,1610612761,86.0,79.0,0.4270000000000001,0.37,1,2014-01-07,34,28,6,0.8240000000000001,33,16,17,0.485
21300511,1610612748,1610612740,107.0,88.0,0.513,0.4679999999999999,1,2014-01-07,35,27,8,0.7709999999999999,33,15,18,0.455
21300512,1610612752,1610612765,89.0,85.0,0.407,0.3720000000000001,1,2014-01-07,34,12,22,0.353,35,14,21,0.4
21300513,1610612741,1610612756,92.0,87.0,0.439,0.402,1,2014-01-07,33,15,18,0.455,33,20,13,0.606
21300514,1610612763,1610612759,108.0,110.0,0.465,0.518,0,2014-01-07,34,15,19,0.441,35,27,8,0.7709999999999999
21300515,1610612749,1610612744,80.0,101.0,0.3879999999999999,0.4589999999999999,0,2014-01-07,34,7,27,0.206,37,24,13,0.649
21300516,1610612742,1610612747,110.0,97.0,0.5329999999999999,0.42,1,2014-01-07,35,20,15,0.5710000000000001,35,14,21,0.4
21300517,1610612743,1610612738,129.0,98.0,0.518,0.385,1,2014-01-07,34,17,17,0.5,35,13,22,0.371
21300518,1610612762,1610612760,112.0,101.0,0.588,0.3929999999999999,1,2014-01-07,37,12,25,0.324,35,27,8,0.7709999999999999
21300519,1610612758,1610612757,123.0,119.0,0.471,0.433,1,2014-01-07,33,11,22,0.3329999999999999,35,26,9,0.743
21300505,1610612755,1610612750,95.0,126.0,0.475,0.46,0,2014-01-06,34,12,22,0.353,34,17,17,0.5
21300506,1610612751,1610612737,91.0,86.0,0.413,0.386,1,2014-01-06,34,13,21,0.382,35,18,17,0.514
21300507,1610612746,1610612753,101.0,81.0,0.422,0.357,1,2014-01-06,37,24,13,0.649,34,10,24,0.294
21300498,1610612765,1610612763,84.0,112.0,0.407,0.467,0,2014-01-05,34,14,20,0.412,33,15,18,0.455
21300499,1610612739,1610612754,78.0,82.0,0.342,0.364,0,2014-01-05,34,11,23,0.324,33,27,6,0.818
21300500,1610612748,1610612761,102.0,97.0,0.469,0.506,1,2014-01-05,34,26,8,0.765,32,16,16,0.5
21300501,1610612764,1610612744,96.0,112.0,0.43,0.506,0,2014-01-05,31,14,17,0.452,36,23,13,0.639
21300502,1610612760,1610612738,119.0,96.0,0.518,0.4379999999999999,1,2014-01-05,34,27,7,0.794,34,13,21,0.382
21300503,1610612742,1610612752,80.0,92.0,0.41,0.487,0,2014-01-05,34,19,15,0.5589999999999999,33,11,22,0.3329999999999999
21300504,1610612747,1610612743,115.0,137.0,0.472,0.535,0,2014-01-05,34,14,20,0.412,33,16,17,0.485
21300489,1610612754,1610612740,99.0,82.0,0.47,0.456,1,2014-01-04,32,26,6,0.813,32,15,17,0.469
21300490,1610612753,1610612748,94.0,110.0,0.413,0.541,0,2014-01-04,33,10,23,0.303,33,25,8,0.758
21300491,1610612751,1610612739,89.0,82.0,0.4370000000000001,0.3670000000000001,1,2014-01-04,33,12,21,0.364,33,11,22,0.3329999999999999
21300492,1610612741,1610612737,91.0,84.0,0.407,0.3720000000000001,1,2014-01-04,32,14,18,0.4379999999999999,34,18,16,0.529
21300493,1610612750,1610612760,111.0,115.0,0.457,0.482,0,2014-01-04,33,16,17,0.485,33,26,7,0.7879999999999999
21300494,1610612759,1610612746,116.0,92.0,0.556,0.4679999999999999,1,2014-01-04,34,26,8,0.765,36,23,13,0.639
21300495,1610612756,1610612749,116.0,100.0,0.482,0.544,1,2014-01-04,32,20,12,0.625,33,7,26,0.212
21300496,1610612757,1610612755,99.0,101.0,0.364,0.455,0,2014-01-04,34,26,8,0.765,33,12,21,0.364
21300497,1610612758,1610612766,103.0,113.0,0.457,0.542,0,2014-01-04,32,10,22,0.313,35,15,20,0.429
21300482,1610612764,1610612761,88.0,101.0,0.415,0.506,0,2014-01-03,30,14,16,0.467,31,16,15,0.516
21300483,1610612737,1610612744,100.0,101.0,0.4629999999999999,0.4479999999999999,0,2014-01-03,33,18,15,0.545,35,22,13,0.629
21300484,1610612738,1610612740,92.0,95.0,0.348,0.494,0,2014-01-03,33,13,20,0.3939999999999999,31,15,16,0.484
21300485,1610612745,1610612752,102.0,100.0,0.4589999999999999,0.416,1,2014-01-03,35,22,13,0.629,32,10,22,0.313
21300486,1610612742,1610612746,112.0,119.0,0.511,0.488,0,2014-01-03,33,19,14,0.5760000000000001,35,23,12,0.657
21300487,1610612743,1610612763,111.0,108.0,0.5379999999999999,0.487,1,2014-01-03,32,15,17,0.469,32,14,18,0.4379999999999999
21300488,1610612747,1610612762,110.0,99.0,0.519,0.442,1,2014-01-03,33,14,19,0.424,36,11,25,0.306
21300473,1610612739,1610612753,87.0,81.0,0.344,0.381,1,2014-01-02,32,11,21,0.344,32,10,22,0.313
21300474,1610612748,1610612744,114.0,123.0,0.513,0.561,0,2014-01-02,32,24,8,0.75,34,21,13,0.618
21300475,1610612741,1610612738,94.0,82.0,0.417,0.395,1,2014-01-02,31,13,18,0.419,32,13,19,0.406
21300476,1610612760,1610612751,93.0,95.0,0.5,0.4429999999999999,0,2014-01-02,32,25,7,0.7809999999999999,32,11,21,0.344
21300477,1610612759,1610612752,101.0,105.0,0.481,0.513,0,2014-01-02,33,25,8,0.758,31,10,21,0.3229999999999999
21300478,1610612756,1610612763,91.0,99.0,0.411,0.478,0,2014-01-02,31,19,12,0.613,31,14,17,0.452
21300479,1610612762,1610612749,96.0,87.0,0.444,0.474,1,2014-01-02,35,11,24,0.314,32,7,25,0.2189999999999999
21300480,1610612757,1610612766,134.0,104.0,0.581,0.43,1,2014-01-02,33,26,7,0.7879999999999999,34,14,20,0.412
21300481,1610612758,1610612755,104.0,113.0,0.422,0.467,0,2014-01-02,31,10,21,0.3229999999999999,32,11,21,0.344
21300468,1610612764,1610612742,78.0,87.0,0.375,0.385,0,2014-01-01,29,14,15,0.483,32,19,13,0.594
21300469,1610612761,1610612754,95.0,82.0,0.436,0.4320000000000001,1,2014-01-01,30,15,15,0.5,31,25,6,0.8059999999999999
21300470,1610612750,1610612740,124.0,112.0,0.557,0.517,1,2014-01-01,32,16,16,0.5,30,14,16,0.467
21300471,1610612743,1610612755,102.0,114.0,0.396,0.467,0,2014-01-01,31,14,17,0.452,31,10,21,0.3229999999999999
21300472,1610612746,1610612766,112.0,85.0,0.5529999999999999,0.382,1,2014-01-01,34,22,12,0.647,33,14,19,0.424
21300460,1610612738,1610612737,91.0,92.0,0.417,0.363,0,2013-12-31,31,13,18,0.419,32,18,14,0.563
21300461,1610612754,1610612739,91.0,76.0,0.442,0.363,1,2013-12-31,30,25,5,0.833,31,10,21,0.3229999999999999
21300462,1610612753,1610612744,81.0,94.0,0.382,0.482,0,2013-12-31,31,10,21,0.3229999999999999,33,20,13,0.606
21300464,1610612745,1610612758,106.0,110.0,0.481,0.494,0,2013-12-31,34,21,13,0.618,30,10,20,0.3329999999999999
21300465,1610612759,1610612751,113.0,92.0,0.513,0.44,1,2013-12-31,32,25,7,0.7809999999999999,31,10,21,0.3229999999999999
21300463,1610612741,1610612761,79.0,85.0,0.366,0.42,0,2013-12-31,30,12,18,0.4,29,14,15,0.483
21300466,1610612760,1610612757,94.0,98.0,0.439,0.396,0,2013-12-31,31,25,6,0.8059999999999999,32,25,7,0.7809999999999999
21300467,1610612747,1610612749,79.0,94.0,0.358,0.44,0,2013-12-31,32,13,19,0.406,31,7,24,0.226
21300453,1610612765,1610612764,99.0,106.0,0.439,0.5,0,2013-12-30,33,14,19,0.424,28,14,14,0.5
21300454,1610612763,1610612741,91.0,95.0,0.449,0.431,0,2013-12-30,30,13,17,0.433,29,12,17,0.414
21300455,1610612750,1610612742,98.0,100.0,0.456,0.477,0,2013-12-30,31,15,16,0.484,31,18,13,0.581
21300456,1610612740,1610612757,110.0,108.0,0.539,0.4429999999999999,1,2013-12-30,29,14,15,0.483,31,24,7,0.774
21300457,1610612743,1610612748,94.0,97.0,0.469,0.507,0,2013-12-30,30,14,16,0.467,31,24,7,0.774
21300458,1610612762,1610612766,83.0,80.0,0.425,0.369,1,2013-12-30,34,10,24,0.294,32,14,18,0.4379999999999999
21300459,1610612746,1610612756,88.0,107.0,0.365,0.482,0,2013-12-30,33,21,12,0.636,30,19,11,0.633
21300448,1610612739,1610612744,104.0,108.0,0.413,0.442,0,2013-12-29,30,10,20,0.3329999999999999,32,19,13,0.594
21300449,1610612753,1610612737,109.0,102.0,0.5539999999999999,0.444,1,2013-12-29,30,10,20,0.3329999999999999,31,17,14,0.5479999999999999
21300450,1610612760,1610612745,117.0,86.0,0.573,0.365,1,2013-12-29,30,25,5,0.833,33,21,12,0.636
21300451,1610612759,1610612758,112.0,104.0,0.4679999999999999,0.451,1,2013-12-29,31,24,7,0.774,29,9,20,0.31
21300452,1610612747,1610612755,104.0,111.0,0.369,0.411,0,2013-12-29,31,13,18,0.419,30,9,21,0.3
21300436,1610612738,1610612739,103.0,100.0,0.4579999999999999,0.4679999999999999,1,2013-12-28,30,13,17,0.433,29,10,19,0.345
21300437,1610612754,1610612751,105.0,91.0,0.535,0.4679999999999999,1,2013-12-28,29,24,5,0.828,30,10,20,0.3329999999999999
21300438,1610612761,1610612752,115.0,100.0,0.45,0.488,1,2013-12-28,28,13,15,0.4639999999999999,30,9,21,0.3
21300439,1610612764,1610612765,106.0,82.0,0.5,0.4029999999999999,1,2013-12-28,27,13,14,0.481,32,14,18,0.4379999999999999
21300440,1610612737,1610612766,118.0,116.0,0.407,0.433,1,2013-12-28,30,17,13,0.5670000000000001,31,14,17,0.452
21300441,1610612741,1610612742,83.0,105.0,0.4320000000000001,0.526,0,2013-12-28,28,11,17,0.3929999999999999,30,17,13,0.5670000000000001
21300442,1610612745,1610612740,107.0,98.0,0.494,0.441,1,2013-12-28,32,21,11,0.6559999999999999,28,13,15,0.4639999999999999
21300443,1610612763,1610612743,120.0,99.0,0.516,0.471,1,2013-12-28,29,13,16,0.4479999999999999,29,14,15,0.483
21300444,1610612749,1610612750,95.0,117.0,0.449,0.478,0,2013-12-28,30,6,24,0.2,30,15,15,0.5
21300445,1610612756,1610612755,115.0,101.0,0.4629999999999999,0.389,1,2013-12-28,29,18,11,0.621,29,8,21,0.276
21300446,1610612757,1610612748,107.0,108.0,0.506,0.511,0,2013-12-28,30,24,6,0.8,30,23,7,0.767
21300447,1610612746,1610612762,98.0,90.0,0.455,0.421,1,2013-12-28,32,21,11,0.6559999999999999,33,9,24,0.273
21300427,1610612766,1610612760,85.0,89.0,0.375,0.413,0,2013-12-27,30,14,16,0.467,29,24,5,0.828
21300428,1610612753,1610612765,109.0,92.0,0.529,0.411,1,2013-12-27,29,9,20,0.31,31,14,17,0.452
21300429,1610612751,1610612749,104.0,93.0,0.43,0.375,1,2013-12-27,29,10,19,0.345,29,6,23,0.207
21300430,1610612752,1610612761,83.0,95.0,0.38,0.425,0,2013-12-27,29,9,20,0.31,27,12,15,0.444
21300431,1610612750,1610612764,120.0,98.0,0.494,0.4579999999999999,1,2013-12-27,29,14,15,0.483,26,12,14,0.462
21300432,1610612740,1610612743,105.0,89.0,0.472,0.402,1,2013-12-27,27,13,14,0.481,28,14,14,0.5
21300433,1610612762,1610612747,105.0,103.0,0.455,0.5,1,2013-12-27,32,9,23,0.281,30,13,17,0.433
21300434,1610612758,1610612748,108.0,103.0,0.494,0.442,1,2013-12-27,28,9,19,0.321,29,22,7,0.759
21300435,1610612744,1610612756,115.0,86.0,0.529,0.36,1,2013-12-27,31,18,13,0.581,28,17,11,0.607
21300423,1610612739,1610612737,125.0,127.0,0.521,0.495,0,2013-12-26,28,10,18,0.357,29,16,13,0.552
21300424,1610612745,1610612763,100.0,92.0,0.4370000000000001,0.409,1,2013-12-26,31,20,11,0.645,28,12,16,0.429
21300425,1610612742,1610612759,107.0,116.0,0.4589999999999999,0.493,0,2013-12-26,29,16,13,0.552,30,23,7,0.767
21300426,1610612757,1610612746,116.0,112.0,0.4379999999999999,0.445,1,2013-12-26,29,24,5,0.828,31,20,11,0.645
21300418,1610612751,1610612741,78.0,95.0,0.352,0.486,0,2013-12-25,28,9,19,0.321,27,11,16,0.407
21300419,1610612752,1610612760,94.0,123.0,0.422,0.536,0,2013-12-25,28,9,19,0.321,28,23,5,0.821
21300420,1610612747,1610612748,95.0,101.0,0.418,0.513,0,2013-12-25,29,13,16,0.4479999999999999,28,22,6,0.7859999999999999
21300421,1610612759,1610612745,98.0,111.0,0.407,0.523,0,2013-12-25,29,22,7,0.759,30,19,11,0.633
21300422,1610612744,1610612746,105.0,103.0,0.421,0.494,1,2013-12-25,30,17,13,0.5670000000000001,30,20,10,0.667
21300407,1610612766,1610612749,111.0,110.0,0.434,0.433,1,2013-12-23,29,14,15,0.483,28,6,22,0.214
21300408,1610612739,1610612765,92.0,115.0,0.386,0.479,0,2013-12-23,27,10,17,0.37,30,14,16,0.467
21300409,1610612753,1610612752,98.0,103.0,0.416,0.4529999999999999,0,2013-12-23,28,8,20,0.286,27,9,18,0.3329999999999999
21300410,1610612751,1610612754,86.0,103.0,0.382,0.4579999999999999,0,2013-12-23,27,9,18,0.3329999999999999,28,23,5,0.821
21300411,1610612748,1610612737,121.0,119.0,0.505,0.484,1,2013-12-23,27,21,6,0.778,28,15,13,0.536
21300412,1610612745,1610612742,104.0,111.0,0.5429999999999999,0.506,0,2013-12-23,29,18,11,0.621,28,16,12,0.5710000000000001
21300413,1610612763,1610612762,104.0,94.0,0.47,0.467,1,2013-12-23,27,12,15,0.444,31,8,23,0.258
21300414,1610612759,1610612761,112.0,99.0,0.451,0.457,1,2013-12-23,28,22,6,0.7859999999999999,26,11,15,0.423
21300415,1610612743,1610612744,81.0,89.0,0.3829999999999999,0.429,0,2013-12-23,27,14,13,0.519,29,16,13,0.552
21300416,1610612756,1610612747,117.0,90.0,0.467,0.37,1,2013-12-23,27,17,10,0.63,28,13,15,0.4639999999999999
21300417,1610612758,1610612740,100.0,113.0,0.419,0.494,0,2013-12-23,27,8,19,0.296,26,12,14,0.462
21300404,1610612754,1610612738,106.0,79.0,0.494,0.381,1,2013-12-22,27,22,5,0.815,29,12,17,0.414
21300405,1610612760,1610612761,98.0,104.0,0.368,0.396,0,2013-12-22,27,22,5,0.815,25,11,14,0.44
21300406,1610612746,1610612750,120.0,116.0,0.474,0.469,1,2013-12-22,29,20,9,0.69,28,13,15,0.4639999999999999
21300392,1610612752,1610612763,87.0,95.0,0.418,0.476,0,2013-12-21,26,8,18,0.308,26,11,15,0.423
21300393,1610612738,1610612764,99.0,106.0,0.483,0.471,0,2013-12-21,28,12,16,0.429,25,12,13,0.48
21300395,1610612753,1610612758,100.0,105.0,0.476,0.494,0,2013-12-21,27,8,19,0.296,26,8,18,0.308
21300394,1610612766,1610612762,85.0,88.0,0.434,0.386,0,2013-12-21,28,13,15,0.4639999999999999,30,8,22,0.267
21300396,1610612765,1610612745,97.0,114.0,0.449,0.557,0,2013-12-21,29,13,16,0.4479999999999999,28,18,10,0.643
21300397,1610612741,1610612739,100.0,84.0,0.536,0.4,1,2013-12-21,26,10,16,0.385,26,10,16,0.385
21300398,1610612749,1610612755,116.0,106.0,0.524,0.409,1,2013-12-21,27,6,21,0.222,28,8,20,0.286
21300399,1610612759,1610612760,100.0,113.0,0.4270000000000001,0.489,0,2013-12-21,27,21,6,0.778,26,22,4,0.846
21300400,1610612756,1610612742,123.0,108.0,0.512,0.484,1,2013-12-21,26,16,10,0.615,27,15,12,0.556
21300401,1610612757,1610612740,110.0,107.0,0.439,0.4679999999999999,1,2013-12-21,28,23,5,0.821,25,11,14,0.44
21300402,1610612744,1610612747,102.0,83.0,0.3879999999999999,0.325,1,2013-12-21,28,15,13,0.536,27,13,14,0.481
21300403,1610612746,1610612743,112.0,91.0,0.4529999999999999,0.352,1,2013-12-21,28,19,9,0.679,26,14,12,0.5379999999999999
21300383,1610612755,1610612751,121.0,120.0,0.51,0.494,1,2013-12-20,27,8,19,0.296,26,9,17,0.346
21300384,1610612737,1610612762,118.0,85.0,0.523,0.3720000000000001,1,2013-12-20,27,15,12,0.556,29,7,22,0.241
21300385,1610612739,1610612749,114.0,111.0,0.39,0.4,1,2013-12-20,25,10,15,0.4,26,5,21,0.192
21300386,1610612765,1610612766,106.0,116.0,0.467,0.524,0,2013-12-20,28,13,15,0.4639999999999999,27,13,14,0.481
21300387,1610612748,1610612758,122.0,103.0,0.614,0.581,1,2013-12-20,26,20,6,0.769,25,7,18,0.28
21300388,1610612754,1610612745,114.0,81.0,0.531,0.381,1,2013-12-20,26,21,5,0.8079999999999999,27,17,10,0.63
21300389,1610612742,1610612761,108.0,109.0,0.505,0.462,0,2013-12-20,26,15,11,0.5770000000000001,24,10,14,0.417
21300390,1610612743,1610612756,99.0,103.0,0.412,0.3979999999999999,0,2013-12-20,25,14,11,0.56,25,15,10,0.6
21300391,1610612747,1610612750,104.0,91.0,0.5379999999999999,0.347,1,2013-12-20,26,13,13,0.5,27,13,14,0.481
21300381,1610612760,1610612741,107.0,95.0,0.512,0.377,1,2013-12-19,25,21,4,0.84,25,9,16,0.36
21300382,1610612744,1610612759,102.0,104.0,0.467,0.449,0,2013-12-19,27,14,13,0.519,26,21,5,0.8079999999999999
21300369,1610612748,1610612754,97.0,94.0,0.481,0.4379999999999999,1,2013-12-18,25,19,6,0.76,25,20,5,0.8
21300370,1610612753,1610612762,82.0,86.0,0.326,0.402,0,2013-12-18,26,8,18,0.308,28,7,21,0.25
21300371,1610612761,1610612766,102.0,104.0,0.4270000000000001,0.457,0,2013-12-18,23,9,14,0.391,26,12,14,0.462
21300372,1610612737,1610612758,124.0,107.0,0.58,0.476,1,2013-12-18,26,14,12,0.5379999999999999,24,7,17,0.292
21300373,1610612738,1610612765,106.0,107.0,0.494,0.466,0,2013-12-18,27,12,15,0.444,27,13,14,0.481
21300374,1610612751,1610612764,107.0,113.0,0.527,0.4320000000000001,0,2013-12-18,25,9,16,0.36,24,11,13,0.4579999999999999
21300375,1610612749,1610612752,101.0,107.0,0.415,0.376,0,2013-12-18,25,5,20,0.2,25,8,17,0.32
21300376,1610612750,1610612757,120.0,109.0,0.495,0.426,1,2013-12-18,26,13,13,0.5,27,22,5,0.815
21300377,1610612742,1610612763,105.0,91.0,0.5479999999999999,0.3979999999999999,1,2013-12-18,25,15,10,0.6,25,10,15,0.4
21300378,1610612756,1610612759,101.0,108.0,0.4629999999999999,0.471,0,2013-12-18,24,14,10,0.583,25,20,5,0.8
21300379,1610612745,1610612741,109.0,94.0,0.537,0.481,1,2013-12-18,26,17,9,0.654,24,9,15,0.375
21300380,1610612746,1610612740,108.0,95.0,0.423,0.3979999999999999,1,2013-12-18,27,18,9,0.667,24,11,13,0.4579999999999999
21300364,1610612766,1610612758,95.0,87.0,0.449,0.375,1,2013-12-17,25,11,14,0.44,23,7,16,0.304
21300365,1610612739,1610612757,116.0,119.0,0.471,0.446,0,2013-12-17,24,9,15,0.375,26,22,4,0.846
21300366,1610612763,1610612747,92.0,96.0,0.407,0.493,0,2013-12-17,24,10,14,0.417,25,12,13,0.48
21300367,1610612743,1610612760,93.0,105.0,0.414,0.489,0,2013-12-17,24,14,10,0.583,24,20,4,0.833
21300368,1610612744,1610612740,104.0,93.0,0.451,0.375,1,2013-12-17,26,14,12,0.5379999999999999,23,11,12,0.478
21300356,1610612754,1610612765,96.0,101.0,0.4320000000000001,0.4320000000000001,0,2013-12-16,24,20,4,0.833,26,12,14,0.462
21300357,1610612737,1610612747,114.0,100.0,0.489,0.476,1,2013-12-16,25,13,12,0.52,24,11,13,0.4579999999999999
21300358,1610612738,1610612750,101.0,97.0,0.442,0.3779999999999999,1,2013-12-16,26,12,14,0.462,25,12,13,0.48
21300359,1610612751,1610612755,130.0,94.0,0.603,0.411,1,2013-12-16,24,9,15,0.375,26,7,19,0.2689999999999999
21300360,1610612748,1610612762,117.0,94.0,0.634,0.4639999999999999,1,2013-12-16,24,18,6,0.75,27,6,21,0.222
21300361,1610612752,1610612764,101.0,102.0,0.418,0.542,0,2013-12-16,24,7,17,0.292,23,10,13,0.435
21300362,1610612741,1610612753,82.0,83.0,0.346,0.3979999999999999,0,2013-12-16,23,9,14,0.391,25,8,17,0.32
21300363,1610612746,1610612759,115.0,92.0,0.513,0.487,1,2013-12-16,26,17,9,0.654,24,19,5,0.792
21300350,1610612758,1610612745,106.0,91.0,0.481,0.413,1,2013-12-15,22,7,15,0.318,25,16,9,0.64
21300351,1610612763,1610612750,93.0,101.0,0.446,0.4429999999999999,0,2013-12-15,23,10,13,0.435,24,12,12,0.5
21300352,1610612765,1610612757,109.0,111.0,0.4679999999999999,0.414,0,2013-12-15,25,11,14,0.44,25,21,4,0.84
21300353,1610612760,1610612753,101.0,98.0,0.4479999999999999,0.451,1,2013-12-15,23,19,4,0.826,24,7,17,0.292
21300354,1610612743,1610612740,102.0,93.0,0.435,0.435,1,2013-12-15,23,14,9,0.609,22,11,11,0.5
21300355,1610612756,1610612744,106.0,102.0,0.4429999999999999,0.425,1,2013-12-15,23,14,9,0.609,25,13,12,0.52
21300342,1610612766,1610612747,85.0,88.0,0.4379999999999999,0.39,0,2013-12-14,24,10,14,0.417,23,11,12,0.478
21300343,1610612764,1610612746,97.0,113.0,0.494,0.565,0,2013-12-14,22,9,13,0.409,25,16,9,0.64
21300344,1610612748,1610612739,114.0,107.0,0.5529999999999999,0.4639999999999999,1,2013-12-14,23,17,6,0.7390000000000001,23,9,14,0.391
21300345,1610612752,1610612737,111.0,106.0,0.506,0.606,1,2013-12-14,23,7,16,0.304,24,12,12,0.5
21300346,1610612741,1610612761,77.0,99.0,0.36,0.482,0,2013-12-14,22,9,13,0.409,22,9,13,0.409
21300347,1610612755,1610612757,105.0,139.0,0.4479999999999999,0.5589999999999999,0,2013-12-14,25,7,18,0.28,24,20,4,0.833
21300348,1610612742,1610612749,106.0,93.0,0.477,0.444,1,2013-12-14,24,14,10,0.583,24,5,19,0.208
21300349,1610612762,1610612759,84.0,100.0,0.3929999999999999,0.466,0,2013-12-14,26,6,20,0.231,23,19,4,0.826
21300329,1610612754,1610612766,99.0,94.0,0.474,0.47,1,2013-12-13,23,20,3,0.87,23,10,13,0.435
21300330,1610612753,1610612739,100.0,109.0,0.435,0.483,0,2013-12-13,23,7,16,0.304,22,9,13,0.409
21300331,1610612761,1610612755,108.0,100.0,0.476,0.44,1,2013-12-13,21,8,13,0.381,24,7,17,0.292
21300332,1610612737,1610612764,101.0,99.0,0.4270000000000001,0.42,1,2013-12-13,23,12,11,0.522,21,9,12,0.429
21300333,1610612738,1610612752,90.0,86.0,0.485,0.4,1,2013-12-13,25,11,14,0.44,22,6,16,0.273
21300334,1610612765,1610612751,103.0,99.0,0.47,0.456,1,2013-12-13,24,11,13,0.4579999999999999,23,8,15,0.348
21300335,1610612740,1610612763,104.0,98.0,0.513,0.5,1,2013-12-13,21,11,10,0.524,22,10,12,0.455
21300336,1610612760,1610612747,122.0,97.0,0.475,0.414,1,2013-12-13,22,18,4,0.818,22,10,12,0.455
21300337,1610612749,1610612741,90.0,91.0,0.446,0.42,0,2013-12-13,23,5,18,0.217,21,9,12,0.429
21300338,1610612759,1610612750,117.0,110.0,0.552,0.4320000000000001,1,2013-12-13,22,18,4,0.818,23,11,12,0.478
21300339,1610612743,1610612762,93.0,103.0,0.424,0.452,0,2013-12-13,22,13,9,0.591,25,6,19,0.24
21300340,1610612756,1610612758,116.0,107.0,0.494,0.4370000000000001,1,2013-12-13,22,13,9,0.591,21,6,15,0.286
21300341,1610612744,1610612745,112.0,116.0,0.478,0.494,0,2013-12-13,24,13,11,0.542,24,16,8,0.667
21300327,1610612751,1610612746,102.0,93.0,0.446,0.371,1,2013-12-12,22,8,14,0.364,24,15,9,0.625
21300328,1610612757,1610612745,111.0,104.0,0.4379999999999999,0.426,1,2013-12-12,23,19,4,0.826,23,15,8,0.652
21300318,1610612766,1610612753,83.0,92.0,0.369,0.422,0,2013-12-11,22,10,12,0.455,22,7,15,0.318
21300319,1610612738,1610612746,88.0,96.0,0.413,0.447,0,2013-12-11,24,10,14,0.417,23,15,8,0.652
21300320,1610612763,1610612760,100.0,116.0,0.42,0.563,0,2013-12-11,21,10,11,0.476,21,17,4,0.81
21300321,1610612749,1610612759,77.0,109.0,0.345,0.523,0,2013-12-11,22,5,17,0.2269999999999999,21,17,4,0.81
21300322,1610612750,1610612755,106.0,99.0,0.385,0.527,1,2013-12-11,22,11,11,0.5,23,7,16,0.304
21300323,1610612740,1610612765,111.0,106.0,0.452,0.4379999999999999,1,2013-12-11,20,10,10,0.5,23,10,13,0.435
21300324,1610612752,1610612741,83.0,78.0,0.408,0.3329999999999999,1,2013-12-11,21,6,15,0.286,20,8,12,0.4
21300325,1610612758,1610612762,101.0,122.0,0.449,0.539,0,2013-12-11,20,6,14,0.3,24,5,19,0.208
21300326,1610612744,1610612742,95.0,93.0,0.43,0.42,1,2013-12-11,23,13,10,0.565,23,13,10,0.565
21300310,1610612739,1610612752,109.0,94.0,0.568,0.46,1,2013-12-10,21,8,13,0.381,20,5,15,0.25
21300311,1610612754,1610612748,90.0,84.0,0.507,0.429,1,2013-12-10,22,19,3,0.8640000000000001,22,16,6,0.727
21300312,1610612761,1610612759,103.0,116.0,0.4579999999999999,0.5489999999999999,0,2013-12-10,20,7,13,0.35,20,16,4,0.8
21300313,1610612737,1610612760,92.0,101.0,0.356,0.442,0,2013-12-10,22,11,11,0.5,20,16,4,0.8
21300314,1610612751,1610612738,104.0,96.0,0.557,0.4379999999999999,1,2013-12-10,21,7,14,0.3329999999999999,23,10,13,0.435
21300315,1610612765,1610612750,94.0,121.0,0.47,0.482,0,2013-12-10,22,10,12,0.455,21,10,11,0.476
21300316,1610612741,1610612749,74.0,78.0,0.373,0.4,0,2013-12-10,19,8,11,0.421,21,5,16,0.238
21300317,1610612747,1610612756,108.0,114.0,0.488,0.518,0,2013-12-10,21,10,11,0.476,21,12,9,0.5710000000000001
21300304,1610612766,1610612744,115.0,111.0,0.457,0.456,1,2013-12-09,21,10,11,0.476,22,12,10,0.545
21300305,1610612755,1610612746,83.0,94.0,0.359,0.4270000000000001,0,2013-12-09,22,7,15,0.318,22,14,8,0.636
21300306,1610612764,1610612743,74.0,75.0,0.36,0.411,0,2013-12-09,20,9,11,0.45,21,13,8,0.619
21300307,1610612763,1610612753,94.0,85.0,0.419,0.4,1,2013-12-09,20,10,10,0.5,21,6,15,0.286
21300308,1610612762,1610612757,94.0,105.0,0.439,0.471,0,2013-12-09,23,4,19,0.174,22,18,4,0.818
21300309,1610612758,1610612742,112.0,97.0,0.469,0.389,1,2013-12-09,19,6,13,0.316,22,13,9,0.591
21300299,1610612752,1610612738,73.0,114.0,0.342,0.542,0,2013-12-08,19,5,14,0.263,22,10,12,0.455
21300300,1610612765,1610612748,95.0,110.0,0.424,0.556,0,2013-12-08,21,10,11,0.476,21,16,5,0.762
21300301,1610612745,1610612753,98.0,88.0,0.421,0.344,1,2013-12-08,22,15,7,0.682,20,6,14,0.3
21300302,1610612760,1610612754,118.0,94.0,0.61,0.4,1,2013-12-08,19,15,4,0.789,21,18,3,0.857
21300303,1610612747,1610612761,94.0,106.0,0.43,0.488,0,2013-12-08,20,10,10,0.5,19,7,12,0.368
21300290,1610612755,1610612743,92.0,103.0,0.455,0.422,0,2013-12-07,21,7,14,0.3329999999999999,20,12,8,0.6
21300291,1610612739,1610612746,88.0,82.0,0.373,0.322,1,2013-12-07,20,7,13,0.35,21,13,8,0.619
21300292,1610612741,1610612765,75.0,92.0,0.3329999999999999,0.425,0,2013-12-07,18,8,10,0.444,20,10,10,0.5
21300293,1610612763,1610612744,82.0,108.0,0.365,0.5,0,2013-12-07,19,9,10,0.474,21,12,9,0.5710000000000001
21300294,1610612750,1610612748,82.0,103.0,0.293,0.551,0,2013-12-07,20,9,11,0.45,20,15,5,0.75
21300295,1610612749,1610612751,82.0,90.0,0.411,0.4589999999999999,0,2013-12-07,20,4,16,0.2,20,6,14,0.3
21300296,1610612759,1610612754,100.0,111.0,0.451,0.535,0,2013-12-07,19,15,4,0.789,20,18,2,0.9
21300297,1610612762,1610612758,102.0,112.0,0.4039999999999999,0.415,0,2013-12-07,22,4,18,0.182,18,5,13,0.278
21300298,1610612757,1610612742,106.0,108.0,0.4479999999999999,0.529,0,2013-12-07,21,17,4,0.81,21,13,8,0.619
21300280,1610612766,1610612755,105.0,88.0,0.462,0.402,1,2013-12-06,20,9,11,0.45,20,7,13,0.35
21300281,1610612764,1610612749,105.0,109.0,0.3979999999999999,0.457,0,2013-12-06,19,9,10,0.474,19,4,15,0.211
21300282,1610612737,1610612739,108.0,89.0,0.516,0.4039999999999999,1,2013-12-06,21,11,10,0.524,19,6,13,0.316
21300283,1610612738,1610612743,106.0,98.0,0.518,0.442,1,2013-12-06,21,9,12,0.429,19,11,8,0.579
21300284,1610612752,1610612753,121.0,83.0,0.53,0.429,1,2013-12-06,18,5,13,0.278,19,6,13,0.316
21300285,1610612745,1610612744,105.0,83.0,0.446,0.355,1,2013-12-06,21,14,7,0.667,20,11,9,0.55
21300286,1610612740,1610612760,95.0,109.0,0.375,0.506,0,2013-12-06,19,9,10,0.474,18,14,4,0.778
21300287,1610612756,1610612761,106.0,97.0,0.451,0.402,1,2013-12-06,20,11,9,0.55,18,6,12,0.3329999999999999
21300288,1610612757,1610612762,130.0,98.0,0.5539999999999999,0.419,1,2013-12-06,20,17,3,0.85,21,4,17,0.19
21300289,1610612758,1610612747,100.0,106.0,0.43,0.477,0,2013-12-06,17,4,13,0.235,19,10,9,0.526
21300277,1610612751,1610612752,83.0,113.0,0.397,0.5710000000000001,0,2013-12-05,19,5,14,0.263,17,4,13,0.235
21300278,1610612763,1610612746,81.0,101.0,0.377,0.475,0,2013-12-05,18,9,9,0.5,20,13,7,0.65
21300279,1610612741,1610612748,107.0,87.0,0.5,0.416,1,2013-12-05,17,8,9,0.471,19,14,5,0.737
21300269,1610612739,1610612743,98.0,88.0,0.407,0.391,1,2013-12-04,18,6,12,0.3329999999999999,18,11,7,0.611
21300270,1610612737,1610612746,107.0,97.0,0.512,0.47,1,2013-12-04,20,10,10,0.5,19,12,7,0.632
21300271,1610612745,1610612756,88.0,97.0,0.352,0.456,0,2013-12-04,20,13,7,0.65,19,10,9,0.526
21300272,1610612749,1610612765,98.0,105.0,0.396,0.384,0,2013-12-04,18,3,15,0.1669999999999999,19,9,10,0.474
21300273,1610612740,1610612742,97.0,100.0,0.4039999999999999,0.43,0,2013-12-04,18,9,9,0.5,20,12,8,0.6
21300274,1610612762,1610612754,86.0,95.0,0.413,0.476,0,2013-12-04,20,4,16,0.2,19,17,2,0.895
21300276,1610612757,1610612760,111.0,104.0,0.449,0.4379999999999999,1,2013-12-04,19,16,3,0.8420000000000001,17,13,4,0.765
21300261,1610612755,1610612753,126.0,125.0,0.479,0.5,1,2013-12-03,19,7,12,0.368,18,6,12,0.3329999999999999
21300262,1610612738,1610612749,108.0,100.0,0.494,0.474,1,2013-12-03,20,8,12,0.4,17,3,14,0.176
21300263,1610612751,1610612743,87.0,111.0,0.4,0.506,0,2013-12-03,18,5,13,0.278,17,11,6,0.647
21300264,1610612748,1610612765,97.0,107.0,0.439,0.513,0,2013-12-03,18,14,4,0.778,18,8,10,0.444
21300265,1610612763,1610612756,110.0,91.0,0.5479999999999999,0.425,1,2013-12-03,17,9,8,0.529,18,9,9,0.5
21300266,1610612742,1610612766,89.0,82.0,0.402,0.385,1,2013-12-03,19,11,8,0.579,19,8,11,0.421
21300267,1610612758,1610612760,95.0,97.0,0.3929999999999999,0.434,0,2013-12-03,16,4,12,0.25,16,13,3,0.813
21300268,1610612744,1610612761,112.0,103.0,0.506,0.519,1,2013-12-03,19,11,8,0.579,17,6,11,0.353
21300256,1610612764,1610612753,98.0,80.0,0.452,0.39,1,2013-12-02,18,9,9,0.5,17,6,11,0.353
21300257,1610612741,1610612740,128.0,131.0,0.475,0.442,0,2013-12-02,16,7,9,0.4379999999999999,17,9,8,0.529
21300258,1610612759,1610612737,102.0,100.0,0.5379999999999999,0.4379999999999999,1,2013-12-02,18,15,3,0.833,19,9,10,0.474
21300259,1610612762,1610612745,109.0,103.0,0.544,0.482,1,2013-12-02,19,4,15,0.211,19,13,6,0.684
21300260,1610612757,1610612754,106.0,102.0,0.474,0.4429999999999999,1,2013-12-02,18,15,3,0.833,18,16,2,0.889
21300248,1610612761,1610612743,98.0,112.0,0.402,0.506,0,2013-12-01,16,6,10,0.375,16,10,6,0.625
21300249,1610612746,1610612754,100.0,105.0,0.439,0.4379999999999999,0,2013-12-01,18,12,6,0.667,17,16,1,0.941
21300250,1610612765,1610612755,115.0,100.0,0.461,0.4320000000000001,1,2013-12-01,17,7,10,0.412,18,6,12,0.3329999999999999
21300251,1610612758,1610612744,113.0,115.0,0.526,0.512,0,2013-12-01,15,4,11,0.267,18,10,8,0.556
21300252,1610612748,1610612766,99.0,98.0,0.522,0.461,1,2013-12-01,17,14,3,0.8240000000000001,18,8,10,0.444
21300253,1610612760,1610612750,113.0,103.0,0.563,0.416,1,2013-12-01,15,12,3,0.8,19,9,10,0.474
21300254,1610612752,1610612740,99.0,103.0,0.447,0.494,0,2013-12-01,16,3,13,0.188,16,8,8,0.5
21300255,1610612747,1610612757,108.0,114.0,0.46,0.4370000000000001,0,2013-12-01,18,9,9,0.5,17,14,3,0.8240000000000001
21300241,1610612764,1610612737,108.0,101.0,0.487,0.444,1,2013-11-30,17,8,9,0.471,18,9,9,0.5
21300242,1610612739,1610612741,97.0,93.0,0.474,0.476,1,2013-11-30,17,5,12,0.294,15,7,8,0.467
21300243,1610612763,1610612751,88.0,97.0,0.4679999999999999,0.466,0,2013-11-30,16,8,8,0.5,17,5,12,0.294
21300244,1610612742,1610612750,106.0,112.0,0.489,0.506,0,2013-11-30,18,10,8,0.556,18,9,9,0.5
21300245,1610612759,1610612745,106.0,112.0,0.484,0.444,0,2013-11-30,17,14,3,0.8240000000000001,18,13,5,0.722
21300246,1610612756,1610612762,104.0,112.0,0.474,0.513,0,2013-11-30,17,9,8,0.529,18,3,15,0.1669999999999999
21300247,1610612749,1610612738,92.0,85.0,0.462,0.417,1,2013-11-30,16,3,13,0.188,19,7,12,0.368
21300228,1610612766,1610612749,92.0,76.0,0.4429999999999999,0.3329999999999999,1,2013-11-29,17,8,9,0.471,15,2,13,0.133
21300229,1610612753,1610612759,91.0,109.0,0.436,0.5529999999999999,0,2013-11-29,16,6,10,0.375,16,14,2,0.875
21300230,1610612761,1610612748,83.0,90.0,0.384,0.474,0,2013-11-29,15,6,9,0.4,16,13,3,0.813
21300231,1610612737,1610612742,88.0,87.0,0.425,0.377,1,2013-11-29,17,9,8,0.529,17,10,7,0.588
21300232,1610612738,1610612739,103.0,86.0,0.5,0.3720000000000001,1,2013-11-29,18,7,11,0.389,16,4,12,0.25
21300233,1610612765,1610612747,102.0,106.0,0.44,0.45,0,2013-11-29,16,6,10,0.375,17,9,8,0.529
21300234,1610612745,1610612751,114.0,95.0,0.527,0.416,1,2013-11-29,17,12,5,0.706,16,4,12,0.25
21300235,1610612760,1610612744,113.0,112.0,0.391,0.442,1,2013-11-29,14,11,3,0.7859999999999999,17,9,8,0.529
21300236,1610612754,1610612764,93.0,73.0,0.447,0.397,1,2013-11-29,16,15,1,0.938,16,7,9,0.4379999999999999
21300237,1610612755,1610612740,105.0,121.0,0.457,0.5479999999999999,0,2013-11-29,17,6,11,0.353,15,7,8,0.467
21300238,1610612743,1610612752,97.0,95.0,0.4370000000000001,0.41,1,2013-11-29,15,9,6,0.6,15,3,12,0.2
21300239,1610612762,1610612756,101.0,112.0,0.482,0.547,0,2013-11-29,17,2,15,0.118,16,9,7,0.563
21300240,1610612758,1610612746,98.0,104.0,0.462,0.446,0,2013-11-29,14,4,10,0.286,17,12,5,0.706
21300215,1610612766,1610612754,74.0,99.0,0.313,0.381,0,2013-11-27,16,7,9,0.4379999999999999,15,14,1,0.933
21300216,1610612753,1610612755,105.0,94.0,0.524,0.447,1,2013-11-27,15,6,9,0.4,16,6,10,0.375
21300217,1610612738,1610612763,93.0,100.0,0.4270000000000001,0.45,0,2013-11-27,17,6,11,0.353,15,8,7,0.5329999999999999
21300218,1610612751,1610612747,94.0,99.0,0.373,0.4,0,2013-11-27,15,4,11,0.267,16,8,8,0.5
21300219,1610612739,1610612748,84.0,95.0,0.349,0.486,0,2013-11-27,15,4,11,0.267,15,12,3,0.8
21300220,1610612765,1610612741,79.0,99.0,0.442,0.532,0,2013-11-27,15,6,9,0.4,14,7,7,0.5
21300221,1610612745,1610612737,113.0,84.0,0.551,0.4270000000000001,1,2013-11-27,16,11,5,0.688,16,8,8,0.5
21300222,1610612749,1610612764,92.0,100.0,0.435,0.5,0,2013-11-27,14,2,12,0.143,15,7,8,0.467
21300223,1610612750,1610612743,110.0,117.0,0.455,0.511,0,2013-11-27,17,8,9,0.471,14,8,6,0.5710000000000001
21300224,1610612760,1610612759,94.0,88.0,0.4639999999999999,0.391,1,2013-11-27,13,10,3,0.769,15,13,2,0.867
21300225,1610612742,1610612744,103.0,99.0,0.444,0.421,1,2013-11-27,16,10,6,0.625,16,9,7,0.563
21300226,1610612756,1610612757,120.0,106.0,0.519,0.4529999999999999,1,2013-11-27,15,8,7,0.5329999999999999,16,13,3,0.813
21300227,1610612746,1610612752,93.0,80.0,0.4320000000000001,0.386,1,2013-11-27,16,11,5,0.688,14,3,11,0.214
21300211,1610612761,1610612751,100.0,102.0,0.436,0.506,0,2013-11-26,14,6,8,0.429,14,4,10,0.286
21300212,1610612764,1610612747,116.0,111.0,0.529,0.53,1,2013-11-26,14,6,8,0.429,15,7,8,0.467
21300213,1610612737,1610612753,92.0,109.0,0.411,0.506,0,2013-11-26,15,8,7,0.5329999999999999,14,5,9,0.357
21300214,1610612740,1610612744,101.0,102.0,0.471,0.455,0,2013-11-26,14,6,8,0.429,15,9,6,0.6
21300202,1610612766,1610612738,86.0,96.0,0.446,0.4379999999999999,0,2013-11-25,15,7,8,0.467,16,6,10,0.375
21300203,1610612754,1610612750,98.0,84.0,0.5,0.33,1,2013-11-25,14,13,1,0.929,16,8,8,0.5
21300204,1610612765,1610612749,113.0,94.0,0.5379999999999999,0.452,1,2013-11-25,14,6,8,0.429,13,2,11,0.154
21300205,1610612748,1610612756,107.0,92.0,0.494,0.3979999999999999,1,2013-11-25,14,11,3,0.7859999999999999,14,7,7,0.5
21300206,1610612763,1610612745,86.0,93.0,0.415,0.493,0,2013-11-25,14,7,7,0.5,15,10,5,0.667
21300207,1610612742,1610612743,96.0,110.0,0.4629999999999999,0.547,0,2013-11-25,15,9,6,0.6,13,7,6,0.5379999999999999
21300208,1610612759,1610612740,112.0,93.0,0.5429999999999999,0.381,1,2013-11-25,14,13,1,0.929,13,6,7,0.462
21300209,1610612762,1610612741,89.0,83.0,0.3879999999999999,0.392,1,2013-11-25,16,2,14,0.125,13,6,7,0.462
21300210,1610612757,1610612752,102.0,91.0,0.44,0.447,1,2013-11-25,15,13,2,0.867,13,3,10,0.231
21300197,1610612751,1610612765,97.0,109.0,0.455,0.475,0,2013-11-24,13,3,10,0.231,13,5,8,0.385
21300198,1610612746,1610612741,121.0,82.0,0.585,0.395,1,2013-11-24,15,10,5,0.667,12,6,6,0.5
21300199,1610612753,1610612756,96.0,104.0,0.4639999999999999,0.484,0,2013-11-24,13,4,9,0.308,13,7,6,0.5379999999999999
21300200,1610612760,1610612762,95.0,73.0,0.507,0.3939999999999999,1,2013-11-24,12,9,3,0.75,15,1,14,0.067
21300201,1610612747,1610612758,100.0,86.0,0.46,0.417,1,2013-11-24,14,7,7,0.5,13,4,9,0.308
21300187,1610612746,1610612758,103.0,102.0,0.485,0.42,1,2013-11-23,14,9,5,0.643,12,4,8,0.3329999999999999
21300188,1610612754,1610612755,106.0,98.0,0.461,0.3429999999999999,1,2013-11-23,13,12,1,0.923,15,6,9,0.4
21300189,1610612764,1610612752,98.0,89.0,0.487,0.439,1,2013-11-23,13,5,8,0.385,12,3,9,0.25
21300190,1610612737,1610612738,87.0,94.0,0.387,0.4579999999999999,0,2013-11-23,14,8,6,0.5710000000000001,15,5,10,0.3329999999999999
21300191,1610612748,1610612753,101.0,99.0,0.474,0.466,1,2013-11-23,13,10,3,0.769,12,4,8,0.3329999999999999
21300192,1610612745,1610612750,112.0,101.0,0.519,0.4,1,2013-11-23,14,9,5,0.643,15,8,7,0.5329999999999999
21300193,1610612749,1610612766,72.0,96.0,0.353,0.494,0,2013-11-23,12,2,10,0.1669999999999999,14,7,7,0.5
21300194,1610612759,1610612739,126.0,96.0,0.575,0.47,1,2013-11-23,13,12,1,0.923,14,4,10,0.286
21300195,1610612743,1610612742,102.0,100.0,0.4429999999999999,0.402,1,2013-11-23,12,6,6,0.5,14,9,5,0.643
21300196,1610612744,1610612757,101.0,113.0,0.4679999999999999,0.43,0,2013-11-23,14,8,6,0.5710000000000001,14,12,2,0.857
21300176,1610612766,1610612756,91.0,98.0,0.416,0.471,0,2013-11-22,13,6,7,0.462,12,6,6,0.5
21300177,1610612755,1610612749,115.0,107.0,0.57,0.441,1,2013-11-22,14,6,8,0.429,11,2,9,0.182
21300178,1610612761,1610612764,96.0,88.0,0.474,0.419,1,2013-11-22,13,6,7,0.462,12,4,8,0.3329999999999999
21300179,1610612738,1610612754,82.0,97.0,0.507,0.469,0,2013-11-22,14,4,10,0.286,12,11,1,0.917
21300180,1610612765,1610612737,89.0,96.0,0.429,0.435,0,2013-11-22,12,4,8,0.3329999999999999,13,8,5,0.615
21300181,1610612763,1610612759,86.0,102.0,0.4379999999999999,0.532,0,2013-11-22,13,7,6,0.5379999999999999,12,11,1,0.917
21300182,1610612750,1610612751,111.0,81.0,0.412,0.397,1,2013-11-22,14,8,6,0.5710000000000001,12,3,9,0.25
21300183,1610612740,1610612739,104.0,100.0,0.409,0.532,1,2013-11-22,12,6,6,0.5,13,4,9,0.308
21300184,1610612742,1610612762,103.0,93.0,0.507,0.5,1,2013-11-22,13,9,4,0.6920000000000001,14,1,13,0.071
21300185,1610612757,1610612741,98.0,95.0,0.409,0.386,1,2013-11-22,13,11,2,0.846,11,6,5,0.545
21300186,1610612747,1610612744,102.0,95.0,0.476,0.415,1,2013-11-22,13,6,7,0.462,13,8,5,0.615
21300174,1610612760,1610612746,105.0,91.0,0.519,0.413,1,2013-11-21,11,8,3,0.727,13,8,5,0.615
21300175,1610612743,1610612741,97.0,87.0,0.452,0.3879999999999999,1,2013-11-21,11,5,6,0.455,10,6,4,0.6
21300161,1610612766,1610612751,95.0,91.0,0.444,0.478,1,2013-11-20,12,6,6,0.5,11,3,8,0.273
21300162,1610612739,1610612764,91.0,98.0,0.416,0.452,0,2013-11-20,12,4,8,0.3329999999999999,11,4,7,0.364
21300163,1610612752,1610612754,96.0,103.0,0.37,0.379,0,2013-11-20,11,3,8,0.273,11,10,1,0.909
21300164,1610612753,1610612748,92.0,120.0,0.408,0.514,0,2013-11-20,11,4,7,0.364,12,9,3,0.75
21300165,1610612755,1610612761,98.0,108.0,0.447,0.419,0,2013-11-20,13,5,8,0.385,12,5,7,0.417
21300166,1610612737,1610612765,93.0,85.0,0.507,0.402,1,2013-11-20,12,7,5,0.583,11,4,7,0.364
21300167,1610612749,1610612757,82.0,91.0,0.4379999999999999,0.407,0,2013-11-20,10,2,8,0.2,12,10,2,0.833
21300168,1610612750,1610612746,98.0,102.0,0.3779999999999999,0.494,0,2013-11-20,13,7,6,0.5379999999999999,12,8,4,0.667
21300169,1610612740,1610612762,105.0,98.0,0.506,0.446,1,2013-11-20,11,5,6,0.455,13,1,12,0.077
21300170,1610612759,1610612738,104.0,93.0,0.481,0.4529999999999999,1,2013-11-20,11,10,1,0.909,13,4,9,0.308
21300171,1610612756,1610612758,106.0,113.0,0.447,0.4629999999999999,0,2013-11-20,11,5,6,0.455,11,4,7,0.364
21300172,1610612742,1610612745,123.0,120.0,0.583,0.5529999999999999,1,2013-11-20,12,8,4,0.667,13,8,5,0.615
21300173,1610612744,1610612763,81.0,88.0,0.439,0.386,0,2013-11-20,12,8,4,0.667,12,7,5,0.583
21300156,1610612764,1610612750,104.0,100.0,0.482,0.435,1,2013-11-19,10,3,7,0.3,12,7,5,0.583
21300157,1610612765,1610612752,92.0,86.0,0.5,0.434,1,2013-11-19,10,4,6,0.4,10,3,7,0.3
21300158,1610612748,1610612737,104.0,88.0,0.506,0.446,1,2013-11-19,11,8,3,0.727,11,6,5,0.545
21300159,1610612745,1610612738,109.0,85.0,0.569,0.3229999999999999,1,2013-11-19,12,8,4,0.667,12,4,8,0.3329999999999999
21300160,1610612758,1610612756,107.0,104.0,0.47,0.4679999999999999,1,2013-11-19,10,3,7,0.3,10,5,5,0.5
21300150,1610612751,1610612757,98.0,108.0,0.365,0.539,0,2013-11-18,10,3,7,0.3,11,9,2,0.818
21300151,1610612741,1610612766,86.0,81.0,0.36,0.363,1,2013-11-18,9,6,3,0.667,11,5,6,0.455
21300152,1610612760,1610612743,115.0,113.0,0.409,0.482,1,2013-11-18,10,7,3,0.7,10,4,6,0.4
21300153,1610612742,1610612755,97.0,94.0,0.436,0.384,1,2013-11-18,11,7,4,0.636,12,5,7,0.417
21300154,1610612762,1610612744,87.0,98.0,0.395,0.405,0,2013-11-18,12,1,11,0.083,11,8,3,0.727
21300155,1610612746,1610612763,102.0,106.0,0.395,0.481,0,2013-11-18,11,7,4,0.636,11,6,5,0.545
21300147,1610612761,1610612757,110.0,118.0,0.447,0.444,0,2013-11-17,11,4,7,0.364,10,8,2,0.8
21300148,1610612758,1610612763,86.0,97.0,0.379,0.556,0,2013-11-17,9,2,7,0.222,10,5,5,0.5
21300149,1610612747,1610612765,114.0,99.0,0.522,0.483,1,2013-11-17,12,5,7,0.417,9,3,6,0.3329999999999999
21300136,1610612766,1610612748,81.0,97.0,0.349,0.507,0,2013-11-16,10,5,5,0.5,10,7,3,0.7
21300137,1610612753,1610612742,100.0,108.0,0.529,0.512,0,2013-11-16,10,4,6,0.4,10,6,4,0.6
21300138,1610612764,1610612739,96.0,103.0,0.3979999999999999,0.444,0,2013-11-16,9,2,7,0.222,11,4,7,0.364
21300139,1610612752,1610612737,90.0,110.0,0.3779999999999999,0.564,0,2013-11-16,9,3,6,0.3329999999999999,10,6,4,0.6
21300140,1610612741,1610612754,110.0,94.0,0.506,0.4,1,2013-11-16,8,5,3,0.625,10,9,1,0.9
21300141,1610612745,1610612743,122.0,111.0,0.506,0.455,1,2013-11-16,11,7,4,0.636,9,4,5,0.444
21300142,1610612750,1610612738,106.0,88.0,0.426,0.395,1,2013-11-16,11,7,4,0.636,11,4,7,0.364
21300143,1610612740,1610612755,135.0,98.0,0.605,0.422,1,2013-11-16,10,4,6,0.4,11,5,6,0.455
21300144,1610612749,1610612760,79.0,92.0,0.349,0.415,0,2013-11-16,9,2,7,0.222,9,6,3,0.667
21300145,1610612744,1610612762,102.0,88.0,0.513,0.455,1,2013-11-16,10,7,3,0.7,11,1,10,0.091
21300146,1610612746,1610612751,110.0,103.0,0.519,0.424,1,2013-11-16,10,7,3,0.7,9,3,6,0.3329999999999999
21300125,1610612754,1610612749,104.0,77.0,0.506,0.341,1,2013-11-15,9,9,0,1.0,8,2,6,0.25
21300126,1610612761,1610612741,80.0,96.0,0.354,0.45,0,2013-11-15,10,4,6,0.4,7,4,3,0.5710000000000001
21300127,1610612737,1610612755,113.0,103.0,0.481,0.465,1,2013-11-15,9,5,4,0.556,10,5,5,0.5
21300128,1610612738,1610612757,96.0,109.0,0.457,0.488,0,2013-11-15,10,4,6,0.4,9,7,2,0.778
21300129,1610612739,1610612766,80.0,86.0,0.405,0.4,0,2013-11-15,10,3,7,0.3,9,5,4,0.556
21300130,1610612748,1610612742,110.0,104.0,0.541,0.5,1,2013-11-15,9,6,3,0.667,9,5,4,0.556
21300131,1610612743,1610612750,117.0,113.0,0.485,0.489,1,2013-11-15,8,4,4,0.5,10,6,4,0.6
21300132,1610612756,1610612751,98.0,100.0,0.43,0.4370000000000001,0,2013-11-15,9,5,4,0.556,8,3,5,0.375
21300133,1610612762,1610612759,82.0,91.0,0.385,0.461,0,2013-11-15,10,1,9,0.1,10,9,1,0.9
21300134,1610612747,1610612763,86.0,89.0,0.4379999999999999,0.435,0,2013-11-15,11,4,7,0.364,9,4,5,0.444
21300135,1610612758,1610612765,90.0,97.0,0.425,0.447,0,2013-11-15,8,2,6,0.25,8,3,5,0.375
21300123,1610612752,1610612745,106.0,109.0,0.4370000000000001,0.456,0,2013-11-14,8,3,5,0.375,10,6,4,0.6
21300124,1610612744,1610612760,116.0,115.0,0.479,0.513,1,2013-11-14,9,6,3,0.667,8,5,3,0.625
21300111,1610612753,1610612749,94.0,91.0,0.4270000000000001,0.446,1,2013-11-13,9,4,5,0.444,7,2,5,0.286
21300112,1610612755,1610612745,123.0,117.0,0.417,0.4479999999999999,1,2013-11-13,9,5,4,0.556,9,5,4,0.556
21300113,1610612738,1610612766,83.0,89.0,0.377,0.366,0,2013-11-13,9,4,5,0.444,8,4,4,0.5
21300114,1610612763,1610612761,87.0,103.0,0.4270000000000001,0.4629999999999999,0,2013-11-13,8,3,5,0.375,9,4,5,0.444
21300115,1610612750,1610612739,124.0,95.0,0.5489999999999999,0.414,1,2013-11-13,9,6,3,0.667,9,3,6,0.3329999999999999
21300116,1610612737,1610612752,91.0,95.0,0.455,0.42,0,2013-11-13,8,4,4,0.5,7,3,4,0.429
21300117,1610612759,1610612764,92.0,79.0,0.506,0.363,1,2013-11-13,9,8,1,0.889,8,2,6,0.25
21300118,1610612743,1610612747,111.0,99.0,0.4,0.3939999999999999,1,2013-11-13,7,3,4,0.429,10,4,6,0.4
21300119,1610612762,1610612740,111.0,105.0,0.514,0.494,1,2013-11-13,9,1,8,0.111,9,3,6,0.3329999999999999
21300120,1610612757,1610612756,90.0,89.0,0.417,0.43,1,2013-11-13,8,6,2,0.75,8,5,3,0.625
21300121,1610612758,1610612751,107.0,86.0,0.436,0.3779999999999999,1,2013-11-13,7,2,5,0.286,7,2,5,0.286
21300122,1610612746,1610612760,111.0,103.0,0.4529999999999999,0.467,1,2013-11-13,9,6,3,0.667,7,5,2,0.7140000000000001
21300107,1610612748,1610612749,118.0,95.0,0.5820000000000001,0.418,1,2013-11-12,8,5,3,0.625,6,2,4,0.3329999999999999
21300108,1610612742,1610612764,105.0,95.0,0.488,0.44,1,2013-11-12,8,5,3,0.625,7,2,5,0.286
21300109,1610612744,1610612765,113.0,95.0,0.6,0.425,1,2013-11-12,8,5,3,0.625,7,2,5,0.286
21300110,1610612747,1610612740,116.0,95.0,0.557,0.405,1,2013-11-12,9,4,5,0.444,8,3,5,0.375
21300098,1610612766,1610612737,94.0,103.0,0.407,0.461,0,2013-11-11,7,3,4,0.429,7,4,3,0.5710000000000001
21300099,1610612754,1610612763,95.0,79.0,0.487,0.413,1,2013-11-11,8,8,0,1.0,7,3,4,0.429
21300100,1610612755,1610612759,85.0,109.0,0.415,0.494,0,2013-11-11,8,4,4,0.5,8,7,1,0.875
21300101,1610612738,1610612753,120.0,105.0,0.6,0.4589999999999999,1,2013-11-11,8,4,4,0.5,8,3,5,0.375
21300102,1610612741,1610612739,96.0,81.0,0.41,0.413,1,2013-11-11,6,3,3,0.5,8,3,5,0.375
21300103,1610612745,1610612761,110.0,104.0,0.44,0.3329999999999999,1,2013-11-11,8,5,3,0.625,8,3,5,0.375
21300104,1610612762,1610612743,81.0,100.0,0.4029999999999999,0.45,0,2013-11-11,8,0,8,0.0,6,2,4,0.3329999999999999
21300105,1610612757,1610612765,109.0,103.0,0.512,0.462,1,2013-11-11,7,5,2,0.7140000000000001,6,2,4,0.3329999999999999
21300106,1610612746,1610612750,109.0,107.0,0.55,0.417,1,2013-11-11,8,5,3,0.625,8,5,3,0.625
21300094,1610612752,1610612759,89.0,120.0,0.3779999999999999,0.539,0,2013-11-10,6,2,4,0.3329999999999999,7,6,1,0.857
21300095,1610612760,1610612764,106.0,105.0,0.446,0.455,1,2013-11-10,6,5,1,0.833,6,2,4,0.3329999999999999
21300096,1610612756,1610612740,101.0,94.0,0.487,0.4429999999999999,1,2013-11-10,7,5,2,0.7140000000000001,7,3,4,0.429
21300097,1610612747,1610612750,90.0,113.0,0.38,0.489,0,2013-11-10,8,3,5,0.375,7,5,2,0.7140000000000001
21300085,1610612761,1610612762,115.0,91.0,0.482,0.442,1,2013-11-09,7,3,4,0.429,7,0,7,0.0
21300086,1610612737,1610612753,104.0,94.0,0.478,0.4629999999999999,1,2013-11-09,6,3,3,0.5,7,3,4,0.429
21300087,1610612751,1610612754,91.0,96.0,0.461,0.4629999999999999,0,2013-11-09,6,2,4,0.3329999999999999,7,7,0,1.0
21300088,1610612739,1610612755,127.0,125.0,0.451,0.475,1,2013-11-09,7,3,4,0.429,7,4,3,0.5710000000000001
21300089,1610612748,1610612738,110.0,111.0,0.5770000000000001,0.517,0,2013-11-09,7,4,3,0.5710000000000001,7,3,4,0.429
21300090,1610612745,1610612746,94.0,107.0,0.449,0.477,0,2013-11-09,7,4,3,0.5710000000000001,7,4,3,0.5710000000000001
21300091,1610612763,1610612744,108.0,90.0,0.532,0.423,1,2013-11-09,6,3,3,0.5,7,4,3,0.5710000000000001
21300092,1610612749,1610612742,83.0,91.0,0.3829999999999999,0.423,0,2013-11-09,5,2,3,0.4,7,4,3,0.5710000000000001
21300093,1610612758,1610612757,85.0,96.0,0.462,0.439,0,2013-11-09,6,1,5,0.1669999999999999,6,4,2,0.667
21300073,1610612766,1610612752,91.0,101.0,0.408,0.467,0,2013-11-08,6,3,3,0.5,5,2,3,0.4
21300074,1610612754,1610612761,91.0,84.0,0.462,0.395,1,2013-11-08,6,6,0,1.0,6,2,4,0.3329999999999999
21300075,1610612753,1610612738,89.0,91.0,0.3979999999999999,0.358,0,2013-11-08,6,3,3,0.5,6,2,4,0.3329999999999999
21300076,1610612755,1610612739,94.0,79.0,0.476,0.3329999999999999,1,2013-11-08,6,4,2,0.667,6,2,4,0.3329999999999999
21300077,1610612764,1610612751,112.0,108.0,0.466,0.466,1,2013-11-08,5,2,3,0.4,5,2,3,0.4
21300078,1610612765,1610612760,110.0,119.0,0.429,0.451,0,2013-11-08,5,2,3,0.4,5,4,1,0.8
21300079,1610612741,1610612762,97.0,73.0,0.528,0.294,1,2013-11-08,5,2,3,0.4,6,0,6,0.0
21300080,1610612750,1610612742,116.0,108.0,0.461,0.489,1,2013-11-08,6,4,2,0.667,6,3,3,0.5
21300081,1610612740,1610612747,96.0,85.0,0.4370000000000001,0.3879999999999999,1,2013-11-08,6,3,3,0.5,7,3,4,0.429
21300082,1610612759,1610612744,76.0,74.0,0.392,0.408,1,2013-11-08,6,5,1,0.833,6,4,2,0.667
21300083,1610612756,1610612743,114.0,103.0,0.482,0.45,1,2013-11-08,6,4,2,0.667,5,1,4,0.2
21300084,1610612757,1610612758,104.0,91.0,0.488,0.419,1,2013-11-08,5,3,2,0.6,5,1,4,0.2
21300070,1610612748,1610612746,102.0,97.0,0.535,0.493,1,2013-11-07,6,4,2,0.667,6,3,3,0.5
21300071,1610612743,1610612737,109.0,107.0,0.488,0.457,1,2013-11-07,4,1,3,0.25,5,2,3,0.4
21300072,1610612745,1610612747,98.0,99.0,0.377,0.391,0,2013-11-07,6,4,2,0.667,6,3,3,0.5
21300060,1610612766,1610612761,92.0,90.0,0.493,0.4429999999999999,1,2013-11-06,5,3,2,0.6,5,2,3,0.4
21300061,1610612754,1610612741,97.0,80.0,0.419,0.356,1,2013-11-06,5,5,0,1.0,4,1,3,0.25
21300062,1610612753,1610612746,98.0,90.0,0.488,0.379,1,2013-11-06,5,3,2,0.6,5,3,2,0.6
21300063,1610612755,1610612764,102.0,116.0,0.47,0.439,0,2013-11-06,5,3,2,0.6,4,1,3,0.25
21300064,1610612738,1610612762,97.0,87.0,0.449,0.4629999999999999,1,2013-11-06,5,1,4,0.2,5,0,5,0.0
21300065,1610612763,1610612740,84.0,99.0,0.479,0.487,0,2013-11-06,5,2,3,0.4,5,2,3,0.4
21300066,1610612749,1610612739,109.0,104.0,0.5,0.447,1,2013-11-06,4,2,2,0.5,5,2,3,0.4
21300067,1610612750,1610612744,93.0,106.0,0.3779999999999999,0.5,0,2013-11-06,5,3,2,0.6,5,4,1,0.8
21300068,1610612759,1610612756,99.0,96.0,0.482,0.494,1,2013-11-06,5,4,1,0.8,5,3,2,0.6
21300069,1610612760,1610612742,107.0,93.0,0.544,0.424,1,2013-11-06,4,3,1,0.75,5,3,2,0.6
21300051,1610612761,1610612748,95.0,104.0,0.431,0.494,0,2013-11-05,4,2,2,0.5,5,3,2,0.6
21300052,1610612751,1610612762,104.0,88.0,0.513,0.3779999999999999,1,2013-11-05,4,2,2,0.5,4,0,4,0.0
21300053,1610612765,1610612754,91.0,99.0,0.379,0.521,0,2013-11-05,4,2,2,0.5,4,4,0,1.0
21300054,1610612752,1610612766,97.0,102.0,0.4270000000000001,0.423,0,2013-11-05,4,1,3,0.25,4,2,2,0.5
21300055,1610612740,1610612756,98.0,104.0,0.435,0.5,0,2013-11-05,4,1,3,0.25,4,3,1,0.75
21300056,1610612742,1610612747,123.0,104.0,0.521,0.4429999999999999,1,2013-11-05,4,3,1,0.75,5,2,3,0.4
21300057,1610612743,1610612759,94.0,102.0,0.422,0.465,0,2013-11-05,3,0,3,0.0,4,3,1,0.75
21300058,1610612757,1610612745,101.0,116.0,0.414,0.547,0,2013-11-05,4,2,2,0.5,5,4,1,0.8
21300059,1610612758,1610612737,100.0,105.0,0.4379999999999999,0.481,0,2013-11-05,4,1,3,0.25,4,2,2,0.5
21300047,1610612739,1610612750,93.0,92.0,0.4589999999999999,0.362,1,2013-11-04,4,2,2,0.5,4,3,1,0.75
21300048,1610612755,1610612744,90.0,110.0,0.352,0.446,0,2013-11-04,4,3,1,0.75,4,3,1,0.75
21300049,1610612763,1610612738,95.0,88.0,0.486,0.471,1,2013-11-04,4,2,2,0.5,4,0,4,0.0
21300050,1610612746,1610612745,137.0,118.0,0.521,0.5,1,2013-11-04,4,3,1,0.75,4,3,1,0.75
21300041,1610612765,1610612738,87.0,77.0,0.447,0.419,1,2013-11-03,3,2,1,0.667,3,0,3,0.0
21300042,1610612748,1610612764,103.0,93.0,0.529,0.4270000000000001,1,2013-11-03,4,2,2,0.5,3,0,3,0.0
21300043,1610612753,1610612751,107.0,86.0,0.472,0.382,1,2013-11-03,4,2,2,0.5,3,1,2,0.3329999999999999
21300044,1610612760,1610612756,103.0,96.0,0.4270000000000001,0.4,1,2013-11-03,3,2,1,0.667,3,2,1,0.667
21300045,1610612752,1610612750,100.0,109.0,0.449,0.4429999999999999,0,2013-11-03,3,1,2,0.3329999999999999,3,3,0,1.0
21300046,1610612747,1610612737,105.0,103.0,0.4270000000000001,0.444,1,2013-11-03,4,2,2,0.5,3,1,2,0.3329999999999999
21300033,1610612754,1610612739,89.0,74.0,0.416,0.349,1,2013-11-02,3,3,0,1.0,3,1,2,0.3329999999999999
21300034,1610612755,1610612741,107.0,104.0,0.488,0.452,1,2013-11-02,3,3,0,1.0,3,1,2,0.3329999999999999
21300035,1610612740,1610612766,105.0,84.0,0.493,0.375,1,2013-11-02,3,1,2,0.3329999999999999,3,1,2,0.3329999999999999
21300036,1610612742,1610612763,111.0,99.0,0.4,0.425,1,2013-11-02,3,2,1,0.667,3,1,2,0.3329999999999999
21300037,1610612749,1610612761,90.0,97.0,0.44,0.397,0,2013-11-02,3,1,2,0.3329999999999999,3,2,1,0.667
21300038,1610612762,1610612745,93.0,104.0,0.42,0.507,0,2013-11-02,3,0,3,0.0,3,3,0,1.0
21300039,1610612757,1610612759,115.0,105.0,0.556,0.5,1,2013-11-02,3,2,1,0.667,3,2,1,0.667
21300040,1610612744,1610612758,98.0,87.0,0.513,0.345,1,2013-11-02,3,2,1,0.667,3,1,2,0.3329999999999999
21300020,1610612766,1610612739,90.0,84.0,0.452,0.381,1,2013-11-01,2,1,1,0.5,2,1,1,0.5
21300021,1610612753,1610612740,110.0,90.0,0.557,0.348,1,2013-11-01,3,1,2,0.3329999999999999,2,0,2,0.0
21300022,1610612764,1610612755,102.0,109.0,0.436,0.511,0,2013-11-01,2,0,2,0.0,2,2,0,1.0
21300023,1610612737,1610612761,102.0,95.0,0.4679999999999999,0.455,1,2013-11-01,2,1,1,0.5,2,1,1,0.5
21300024,1610612738,1610612749,98.0,105.0,0.447,0.417,0,2013-11-01,2,0,2,0.0,2,1,1,0.5
21300025,1610612745,1610612742,113.0,105.0,0.466,0.38,1,2013-11-01,2,2,0,1.0,2,1,1,0.5
21300026,1610612763,1610612765,111.0,108.0,0.519,0.472,1,2013-11-01,2,1,1,0.5,2,1,1,0.5
21300027,1610612750,1610612760,100.0,81.0,0.429,0.349,1,2013-11-01,2,2,0,1.0,2,1,1,0.5
21300028,1610612751,1610612748,101.0,100.0,0.485,0.478,1,2013-11-01,2,1,1,0.5,3,1,2,0.3329999999999999
21300029,1610612743,1610612757,98.0,113.0,0.364,0.4270000000000001,0,2013-11-01,2,0,2,0.0,2,1,1,0.5
21300030,1610612756,1610612762,87.0,84.0,0.373,0.365,1,2013-11-01,2,2,0,1.0,2,0,2,0.0
21300031,1610612758,1610612746,101.0,110.0,0.456,0.5,0,2013-11-01,2,1,1,0.5,3,2,1,0.667
21300032,1610612747,1610612759,85.0,91.0,0.366,0.4039999999999999,0,2013-11-01,3,1,2,0.3329999999999999,2,2,0,1.0
21300018,1610612741,1610612752,82.0,81.0,0.408,0.36,1,2013-10-31,2,1,1,0.5,2,1,1,0.5
21300019,1610612746,1610612744,126.0,115.0,0.494,0.526,1,2013-10-31,2,1,1,0.5,2,1,1,0.5
21300004,1610612739,1610612751,98.0,94.0,0.417,0.402,1,2013-10-30,1,1,0,1.0,1,0,1,0.0
21300005,1610612755,1610612748,114.0,110.0,0.5379999999999999,0.494,1,2013-10-30,1,1,0,1.0,2,1,1,0.5
21300006,1610612761,1610612738,93.0,87.0,0.442,0.485,1,2013-10-30,1,1,0,1.0,1,0,1,0.0
21300007,1610612765,1610612764,113.0,102.0,0.5,0.436,1,2013-10-30,1,1,0,1.0,1,0,1,0.0
21300008,1610612752,1610612749,90.0,83.0,0.507,0.4589999999999999,1,2013-10-30,1,1,0,1.0,1,0,1,0.0
21300009,1610612745,1610612766,96.0,83.0,0.474,0.3670000000000001,1,2013-10-30,1,1,0,1.0,1,0,1,0.0
21300010,1610612750,1610612753,120.0,115.0,0.42,0.47,1,2013-10-30,1,1,0,1.0,2,0,2,0.0
21300011,1610612740,1610612754,90.0,95.0,0.4,0.429,0,2013-10-30,1,0,1,0.0,2,2,0,1.0
21300012,1610612742,1610612737,118.0,109.0,0.5710000000000001,0.487,1,2013-10-30,1,1,0,1.0,1,0,1,0.0
21300013,1610612759,1610612763,101.0,94.0,0.526,0.419,1,2013-10-30,1,1,0,1.0,1,0,1,0.0
21300014,1610612762,1610612760,98.0,101.0,0.456,0.407,0,2013-10-30,1,0,1,0.0,1,1,0,1.0
21300015,1610612756,1610612757,104.0,91.0,0.518,0.407,1,2013-10-30,1,1,0,1.0,1,0,1,0.0
21300016,1610612758,1610612743,90.0,88.0,0.407,0.43,1,2013-10-30,1,1,0,1.0,1,0,1,0.0
21300017,1610612744,1610612747,125.0,94.0,0.535,0.3929999999999999,1,2013-10-30,1,1,0,1.0,2,1,1,0.5
21300001,1610612754,1610612753,97.0,87.0,0.479,0.387,1,2013-10-29,1,1,0,1.0,1,0,1,0.0
21300002,1610612748,1610612741,107.0,95.0,0.514,0.422,1,2013-10-29,1,1,0,1.0,1,0,1,0.0
21300003,1610612747,1610612746,116.0,103.0,0.452,0.494,1,2013-10-29,1,1,0,1.0,1,0,1,0.0
11300108,1610612753,1610612740,82.0,101.0,0.349,0.522,0,2013-10-25,8,2,6,0.25,8,7,1,0.875
11300112,1610612752,1610612766,83.0,85.0,0.373,0.411,0,2013-10-25,7,2,5,0.286,8,5,3,0.625
11300113,1610612748,1610612751,87.0,108.0,0.493,0.5479999999999999,0,2013-10-25,8,5,3,0.625,7,5,2,0.7140000000000001
11300109,1610612741,1610612743,94.0,89.0,0.379,0.4639999999999999,1,2013-10-25,8,8,0,1.0,7,2,5,0.286
11300110,1610612763,1610612745,73.0,92.0,0.319,0.424,0,2013-10-25,8,4,4,0.5,7,6,1,0.857
11300115,1610612742,1610612754,77.0,98.0,0.37,0.4039999999999999,0,2013-10-25,8,4,4,0.5,8,3,5,0.375
11300111,1610612747,1610612762,111.0,106.0,0.5,0.451,1,2013-10-25,8,4,4,0.5,8,1,7,0.125
11300116,1610612746,1610612758,100.0,110.0,0.392,0.44,0,2013-10-25,8,5,3,0.625,7,5,2,0.7140000000000001
11300104,1610612766,1610612739,105.0,92.0,0.451,0.42,1,2013-10-24,7,4,3,0.5710000000000001,8,4,4,0.5
11300106,1610612765,1610612750,99.0,98.0,0.48,0.422,1,2013-10-24,8,4,4,0.5,7,4,3,0.5710000000000001
11300105,1610612759,1610612745,92.0,109.0,0.3979999999999999,0.449,0,2013-10-24,7,3,4,0.429,6,5,1,0.833
11300107,1610612744,1610612757,74.0,90.0,0.33,0.361,0,2013-10-24,7,3,4,0.429,7,5,2,0.7140000000000001
11300093,1610612761,1610612763,108.0,72.0,0.457,0.354,1,2013-10-23,7,6,1,0.857,7,4,3,0.5710000000000001
11300094,1610612738,1610612751,101.0,97.0,0.4529999999999999,0.416,1,2013-10-23,8,2,6,0.25,6,4,2,0.667
11300095,1610612755,1610612750,102.0,125.0,0.35,0.436,0,2013-10-23,7,2,5,0.286,6,4,2,0.667
11300096,1610612739,1610612764,82.0,101.0,0.395,0.46,0,2013-10-23,7,4,3,0.5710000000000001,7,2,5,0.286
11300097,1610612749,1610612752,105.0,95.0,0.522,0.3979999999999999,1,2013-10-23,6,1,5,0.1669999999999999,6,2,4,0.3329999999999999
11300098,1610612740,1610612748,95.0,108.0,0.455,0.52,0,2013-10-23,7,6,1,0.857,7,5,2,0.7140000000000001
11300101,1610612742,1610612737,98.0,88.0,0.477,0.4379999999999999,1,2013-10-23,7,4,3,0.5710000000000001,7,1,6,0.143
11300099,1610612743,1610612756,79.0,98.0,0.341,0.465,0,2013-10-23,6,2,4,0.3329999999999999,7,5,2,0.7140000000000001
11300103,1610612760,1610612741,95.0,104.0,0.4589999999999999,0.486,0,2013-10-23,7,4,3,0.5710000000000001,7,7,0,1.0
11300100,1610612758,1610612744,91.0,90.0,0.426,0.415,1,2013-10-23,6,4,2,0.667,6,3,3,0.5
11300102,1610612746,1610612762,103.0,99.0,0.386,0.425,1,2013-10-23,7,5,2,0.7140000000000001,7,1,6,0.143
11300089,1610612737,1610612754,89.0,107.0,0.4679999999999999,0.526,0,2013-10-22,6,1,5,0.1669999999999999,7,2,5,0.286
11300090,1610612765,1610612764,99.0,96.0,0.487,0.456,1,2013-10-22,7,3,4,0.429,6,1,5,0.1669999999999999
11300091,1610612759,1610612753,123.0,101.0,0.534,0.447,1,2013-10-22,6,3,3,0.5,7,2,5,0.286
11300088,1610612756,1610612760,88.0,76.0,0.3829999999999999,0.385,1,2013-10-22,6,4,2,0.667,6,4,2,0.667
11300092,1610612747,1610612762,108.0,94.0,0.474,0.3979999999999999,1,2013-10-22,7,3,4,0.429,6,1,5,0.1669999999999999
11300084,1610612761,1610612752,123.0,120.0,0.421,0.417,1,2013-10-21,6,5,1,0.833,5,2,3,0.4
11300085,1610612739,1610612755,104.0,93.0,0.442,0.352,1,2013-10-21,6,4,2,0.667,6,2,4,0.3329999999999999
11300086,1610612741,1610612749,105.0,84.0,0.422,0.381,1,2013-10-21,6,6,0,1.0,5,0,5,0.0
11300087,1610612745,1610612742,100.0,95.0,0.417,0.4039999999999999,1,2013-10-21,5,4,1,0.8,6,3,3,0.5
11300079,1610612737,1610612763,82.0,90.0,0.346,0.416,0,2013-10-20,5,1,4,0.2,6,4,2,0.667
11300080,1610612753,1610612765,87.0,86.0,0.462,0.417,1,2013-10-20,6,2,4,0.3329999999999999,6,2,4,0.3329999999999999
11300081,1610612750,1610612738,104.0,89.0,0.43,0.384,1,2013-10-20,5,3,2,0.6,7,1,6,0.143
11300082,1610612760,1610612762,88.0,82.0,0.3779999999999999,0.382,1,2013-10-20,5,4,1,0.8,5,1,4,0.2
11300083,1610612757,1610612758,109.0,105.0,0.488,0.412,1,2013-10-20,6,4,2,0.667,5,3,2,0.6
11300074,1610612740,1610612764,93.0,89.0,0.415,0.408,1,2013-10-19,6,6,0,1.0,5,1,4,0.2
11300075,1610612766,1610612742,83.0,89.0,0.426,0.412,0,2013-10-19,6,3,3,0.5,5,3,2,0.6
11300076,1610612748,1610612759,121.0,96.0,0.568,0.411,1,2013-10-19,6,4,2,0.667,5,2,3,0.4
11300077,1610612739,1610612754,79.0,102.0,0.295,0.447,0,2013-10-19,5,3,2,0.6,6,1,5,0.1669999999999999
11300078,1610612746,1610612743,118.0,111.0,0.519,0.494,1,2013-10-19,6,4,2,0.667,5,2,3,0.4
11300072,1610612744,1610612747,115.0,89.0,0.511,0.413,1,2013-10-18,5,3,2,0.6,6,2,4,0.3329999999999999
11300070,1610612753,1610612763,91.0,97.0,0.434,0.442,0,2013-10-18,5,1,4,0.2,5,3,2,0.6
11300071,1610612741,1610612754,103.0,98.0,0.456,0.447,1,2013-10-18,5,5,0,1.0,5,0,5,0.0
11300073,1610612746,1610612757,84.0,94.0,0.354,0.384,0,2013-10-18,5,3,2,0.6,5,3,2,0.6
11300063,1610612766,1610612755,110.0,84.0,0.469,0.373,1,2013-10-17,5,3,2,0.6,5,2,3,0.4
11300064,1610612764,1610612752,89.0,98.0,0.395,0.4629999999999999,0,2013-10-17,4,1,3,0.25,4,2,2,0.5
11300065,1610612739,1610612765,96.0,84.0,0.4579999999999999,0.387,1,2013-10-17,4,3,1,0.75,5,2,3,0.4
11300068,1610612737,1610612759,104.0,106.0,0.4529999999999999,0.477,0,2013-10-17,4,1,3,0.25,4,2,2,0.5
11300066,1610612760,1610612740,102.0,105.0,0.493,0.493,0,2013-10-17,4,3,1,0.75,5,5,0,1.0
11300069,1610612751,1610612748,86.0,62.0,0.4320000000000001,0.318,1,2013-10-17,5,4,1,0.8,5,3,2,0.6
11300067,1610612758,1610612756,107.0,90.0,0.434,0.476,1,2013-10-17,4,3,1,0.75,5,3,2,0.6
11300058,1610612761,1610612738,99.0,97.0,0.478,0.417,1,2013-10-16,5,4,1,0.8,6,1,5,0.1669999999999999
11300059,1610612754,1610612742,85.0,92.0,0.3329999999999999,0.429,0,2013-10-16,4,0,4,0.0,4,2,2,0.5
11300060,1610612741,1610612765,96.0,81.0,0.4579999999999999,0.325,1,2013-10-16,4,4,0,1.0,4,2,2,0.5
11300061,1610612745,1610612753,108.0,104.0,0.417,0.457,1,2013-10-16,4,3,1,0.75,4,1,3,0.25
11300062,1610612762,1610612757,92.0,99.0,0.3879999999999999,0.422,0,2013-10-16,4,1,3,0.25,4,2,2,0.5
11300057,1610612747,1610612744,95.0,100.0,0.43,0.444,0,2013-10-15,5,2,3,0.4,4,2,2,0.5
11300051,1610612764,1610612748,100.0,82.0,0.462,0.387,1,2013-10-15,3,1,2,0.3329999999999999,4,3,1,0.75
11300052,1610612739,1610612766,74.0,92.0,0.355,0.441,0,2013-10-15,3,2,1,0.667,4,2,2,0.5
11300056,1610612751,1610612738,82.0,80.0,0.355,0.356,1,2013-10-15,4,3,1,0.75,5,1,4,0.2
11300053,1610612763,1610612749,102.0,99.0,0.423,0.462,1,2013-10-15,4,2,2,0.5,4,0,4,0.0
11300054,1610612760,1610612743,109.0,81.0,0.452,0.377,1,2013-10-15,3,3,0,1.0,4,2,2,0.5
11300055,1610612756,1610612746,96.0,102.0,0.4629999999999999,0.527,0,2013-10-15,4,3,1,0.75,4,3,1,0.75
11300047,1610612755,1610612751,97.0,127.0,0.3929999999999999,0.539,0,2013-10-14,4,2,2,0.5,3,2,1,0.667
11300050,1610612742,1610612753,94.0,102.0,0.379,0.521,0,2013-10-14,3,1,2,0.3329999999999999,3,1,2,0.3329999999999999
11300048,1610612743,1610612759,98.0,94.0,0.409,0.466,1,2013-10-14,3,2,1,0.667,3,1,2,0.3329999999999999
11300049,1610612758,1610612746,99.0,88.0,0.456,0.415,1,2013-10-14,3,2,1,0.667,3,2,1,0.667
11300044,1610612745,1610612754,107.0,98.0,0.4589999999999999,0.4370000000000001,1,2013-10-13,3,2,1,0.667,3,0,3,0.0
11300043,1610612740,1610612737,105.0,73.0,0.56,0.3879999999999999,1,2013-10-13,4,4,0,1.0,3,1,2,0.3329999999999999
11300045,1610612759,1610612756,99.0,106.0,0.451,0.461,0,2013-10-13,2,1,1,0.5,3,3,0,1.0
11300037,1610612764,1610612741,81.0,83.0,0.3289999999999999,0.431,0,2013-10-12,2,0,2,0.0,3,3,0,1.0
11300040,1610612738,1610612752,111.0,81.0,0.542,0.3329999999999999,1,2013-10-12,4,1,3,0.25,3,1,2,0.3329999999999999
11300041,1610612751,1610612765,88.0,99.0,0.409,0.514,0,2013-10-12,2,1,1,0.5,3,2,1,0.667
11300038,1610612750,1610612761,97.0,104.0,0.364,0.5,0,2013-10-12,4,2,2,0.5,4,3,1,0.75
11300042,1610612749,1610612766,76.0,83.0,0.3670000000000001,0.35,0,2013-10-12,3,0,3,0.0,3,1,2,0.3329999999999999
11300039,1610612762,1610612746,74.0,106.0,0.361,0.551,0,2013-10-12,3,1,2,0.3329999999999999,2,2,0,1.0
11300032,1610612761,1610612752,100.0,91.0,0.451,0.396,1,2013-10-11,3,2,1,0.667,2,1,1,0.5
11300033,1610612755,1610612738,97.0,85.0,0.494,0.36,1,2013-10-11,3,2,1,0.667,3,0,3,0.0
11300034,1610612753,1610612739,105.0,110.0,0.513,0.3929999999999999,0,2013-10-11,2,0,2,0.0,2,2,0,1.0
11300036,1610612748,1610612766,86.0,75.0,0.447,0.38,1,2013-10-11,3,3,0,1.0,2,0,2,0.0
11300035,1610612757,1610612762,96.0,86.0,0.486,0.377,1,2013-10-11,3,1,2,0.3329999999999999,2,1,1,0.5
11300031,1610612754,1610612745,96.0,116.0,0.395,0.532,0,2013-10-10,2,0,2,0.0,2,1,1,0.5
11300030,1610612765,1610612748,107.0,112.0,0.4579999999999999,0.476,0,2013-10-10,2,1,1,0.5,2,2,0,1.0
11300028,1610612750,1610612749,98.0,89.0,0.395,0.474,1,2013-10-10,3,2,1,0.667,2,0,2,0.0
11300029,1610612747,1610612758,86.0,104.0,0.345,0.537,0,2013-10-10,4,2,2,0.5,2,1,1,0.5
11300022,1610612761,1610612750,89.0,101.0,0.4270000000000001,0.4679999999999999,0,2013-10-09,2,1,1,0.5,2,1,1,0.5
11300023,1610612753,1610612740,95.0,99.0,0.386,0.3979999999999999,0,2013-10-09,1,0,1,0.0,3,3,0,1.0
11300026,1610612738,1610612752,102.0,103.0,0.494,0.52,0,2013-10-09,2,0,2,0.0,1,1,0,1.0
11300024,1610612763,1610612742,90.0,95.0,0.434,0.456,0,2013-10-09,2,0,2,0.0,2,1,1,0.5
11300025,1610612757,1610612756,98.0,104.0,0.467,0.4629999999999999,0,2013-10-09,2,0,2,0.0,2,2,0,1.0
11300021,1610612755,1610612760,99.0,103.0,0.41,0.435,0,2013-10-08,2,1,1,0.5,2,2,0,1.0
11300015,1610612764,1610612751,106.0,111.0,0.3979999999999999,0.488,0,2013-10-08,1,0,1,0.0,1,1,0,1.0
11300016,1610612739,1610612749,99.0,87.0,0.415,0.377,1,2013-10-08,1,1,0,1.0,1,0,1,0.0
11300019,1610612766,1610612737,85.0,87.0,0.368,0.419,0,2013-10-08,1,0,1,0.0,2,1,1,0.5
11300017,1610612762,1610612744,101.0,78.0,0.462,0.326,1,2013-10-08,1,1,0,1.0,3,1,2,0.3329999999999999
11300018,1610612747,1610612743,90.0,88.0,0.395,0.33,1,2013-10-08,3,2,1,0.667,2,1,1,0.5
11300011,1610612738,1610612761,89.0,97.0,0.3979999999999999,0.521,0,2013-10-07,1,0,1,0.0,1,1,0,1.0
11300012,1610612748,1610612737,92.0,87.0,0.431,0.4270000000000001,1,2013-10-07,1,1,0,1.0,1,0,1,0.0
11300007,1610612741,1610612763,106.0,87.0,0.473,0.431,1,2013-10-07,2,2,0,1.0,1,0,1,0.0
11300013,1610612742,1610612740,92.0,94.0,0.5,0.43,0,2013-10-07,1,0,1,0.0,2,2,0,1.0
11300010,1610612757,1610612746,81.0,89.0,0.359,0.37,0,2013-10-07,1,0,1,0.0,1,1,0,1.0
11300014,1610612744,1610612758,94.0,81.0,0.434,0.411,1,2013-10-07,2,1,1,0.5,1,0,1,0.0
11300006,1610612747,1610612743,88.0,97.0,0.3229999999999999,0.424,0,2013-10-06,2,1,1,0.5,1,1,0,1.0
11300002,1610612754,1610612741,76.0,82.0,0.3289999999999999,0.3779999999999999,0,2013-10-05,1,0,1,0.0,1,1,0,1.0
11300003,1610612745,1610612740,115.0,116.0,0.574,0.488,0,2013-10-05,1,0,1,0.0,1,1,0,1.0
11300004,1610612747,1610612744,104.0,95.0,0.412,0.3979999999999999,1,2013-10-05,1,1,0,1.0,1,0,1,0.0
41200407,1610612748,1610612759,95.0,88.0,0.439,0.3779999999999999,1,2013-06-20,82,66,16,0.805,82,58,24,0.7070000000000001
41200406,1610612748,1610612759,103.0,100.0,0.469,0.435,1,2013-06-18,82,66,16,0.805,82,58,24,0.7070000000000001
41200405,1610612759,1610612748,114.0,104.0,0.6,0.43,1,2013-06-16,82,58,24,0.7070000000000001,82,66,16,0.805
41200404,1610612759,1610612748,93.0,109.0,0.4429999999999999,0.529,0,2013-06-13,82,58,24,0.7070000000000001,82,66,16,0.805
41200403,1610612759,1610612748,113.0,77.0,0.489,0.408,1,2013-06-11,82,58,24,0.7070000000000001,82,66,16,0.805
41200402,1610612748,1610612759,103.0,84.0,0.494,0.41,1,2013-06-09,82,66,16,0.805,82,58,24,0.7070000000000001
41200401,1610612748,1610612759,88.0,92.0,0.436,0.417,0,2013-06-06,82,66,16,0.805,82,58,24,0.7070000000000001
41200307,1610612748,1610612754,99.0,76.0,0.39,0.406,1,2013-06-03,82,66,16,0.805,81,49,32,0.605
41200306,1610612754,1610612748,91.0,77.0,0.5,0.361,1,2013-06-01,81,49,32,0.605,82,66,16,0.805
41200305,1610612748,1610612754,90.0,79.0,0.507,0.449,1,2013-05-30,82,66,16,0.805,81,49,32,0.605
41200304,1610612754,1610612748,99.0,92.0,0.5,0.39,1,2013-05-28,81,49,32,0.605,82,66,16,0.805
41200314,1610612763,1610612759,86.0,93.0,0.3720000000000001,0.513,0,2013-05-27,82,56,26,0.6829999999999999,82,58,24,0.7070000000000001
41200303,1610612754,1610612748,96.0,114.0,0.397,0.545,0,2013-05-26,81,49,32,0.605,82,66,16,0.805
41200313,1610612763,1610612759,93.0,104.0,0.392,0.5,0,2013-05-25,82,56,26,0.6829999999999999,82,58,24,0.7070000000000001
41200302,1610612748,1610612754,93.0,97.0,0.466,0.5,0,2013-05-24,82,66,16,0.805,81,49,32,0.605
41200301,1610612748,1610612754,103.0,102.0,0.477,0.446,1,2013-05-22,82,66,16,0.805,81,49,32,0.605
41200312,1610612759,1610612763,93.0,89.0,0.434,0.34,1,2013-05-21,82,58,24,0.7070000000000001,82,56,26,0.6829999999999999
41200311,1610612759,1610612763,105.0,83.0,0.526,0.4320000000000001,1,2013-05-19,82,58,24,0.7070000000000001,82,56,26,0.6829999999999999
41200216,1610612754,1610612752,106.0,99.0,0.507,0.4,1,2013-05-18,81,49,32,0.605,82,54,28,0.659
41200215,1610612752,1610612754,85.0,75.0,0.41,0.362,1,2013-05-16,82,54,28,0.659,81,49,32,0.605
41200236,1610612744,1610612759,82.0,94.0,0.3879999999999999,0.452,0,2013-05-16,82,47,35,0.573,82,58,24,0.7070000000000001
41200205,1610612748,1610612741,94.0,91.0,0.457,0.44,1,2013-05-15,82,66,16,0.805,82,45,37,0.5489999999999999
41200225,1610612760,1610612763,84.0,88.0,0.365,0.37,0,2013-05-15,82,60,22,0.732,82,56,26,0.6829999999999999
41200214,1610612754,1610612752,93.0,82.0,0.408,0.356,1,2013-05-14,81,49,32,0.605,82,54,28,0.659
41200235,1610612759,1610612744,109.0,91.0,0.519,0.467,1,2013-05-14,82,58,24,0.7070000000000001,82,47,35,0.573
41200204,1610612741,1610612748,65.0,88.0,0.257,0.485,0,2013-05-13,82,45,37,0.5489999999999999,82,66,16,0.805
41200224,1610612763,1610612760,103.0,97.0,0.4039999999999999,0.43,1,2013-05-13,82,56,26,0.6829999999999999,82,60,22,0.732
41200234,1610612744,1610612759,97.0,87.0,0.38,0.355,1,2013-05-12,82,47,35,0.573,82,58,24,0.7070000000000001
41200223,1610612763,1610612760,87.0,81.0,0.405,0.364,1,2013-05-11,82,56,26,0.6829999999999999,82,60,22,0.732
41200213,1610612754,1610612752,82.0,71.0,0.35,0.352,1,2013-05-11,81,49,32,0.605,82,54,28,0.659
41200203,1610612741,1610612748,94.0,104.0,0.455,0.5,0,2013-05-10,82,45,37,0.5489999999999999,82,66,16,0.805
41200233,1610612744,1610612759,92.0,102.0,0.3929999999999999,0.506,0,2013-05-10,82,47,35,0.573,82,58,24,0.7070000000000001
41200202,1610612748,1610612741,115.0,78.0,0.6,0.355,1,2013-05-08,82,66,16,0.805,82,45,37,0.5489999999999999
41200232,1610612759,1610612744,91.0,100.0,0.3929999999999999,0.452,0,2013-05-08,82,58,24,0.7070000000000001,82,47,35,0.573
41200212,1610612752,1610612754,105.0,79.0,0.494,0.455,1,2013-05-07,82,54,28,0.659,81,49,32,0.605
41200222,1610612760,1610612763,93.0,99.0,0.429,0.419,0,2013-05-07,82,60,22,0.732,82,56,26,0.6829999999999999
41200201,1610612748,1610612741,86.0,93.0,0.397,0.4370000000000001,0,2013-05-06,82,66,16,0.805,82,45,37,0.5489999999999999
41200231,1610612759,1610612744,129.0,127.0,0.4379999999999999,0.51,1,2013-05-06,82,58,24,0.7070000000000001,82,47,35,0.573
41200221,1610612760,1610612763,93.0,91.0,0.413,0.4270000000000001,1,2013-05-05,82,60,22,0.732,82,56,26,0.6829999999999999
41200211,1610612752,1610612754,95.0,102.0,0.4320000000000001,0.487,0,2013-05-05,82,54,28,0.659,81,49,32,0.605
41200137,1610612751,1610612741,93.0,99.0,0.407,0.488,0,2013-05-04,82,49,33,0.598,82,45,37,0.5489999999999999
41200116,1610612738,1610612752,80.0,88.0,0.381,0.418,0,2013-05-03,81,41,40,0.506,82,54,28,0.659
41200126,1610612737,1610612754,73.0,81.0,0.3329999999999999,0.421,0,2013-05-03,82,44,38,0.537,81,49,32,0.605
41200146,1610612745,1610612760,94.0,103.0,0.411,0.4579999999999999,0,2013-05-03,82,45,37,0.5489999999999999,82,60,22,0.732
41200176,1610612763,1610612746,118.0,105.0,0.507,0.526,1,2013-05-03,82,56,26,0.6829999999999999,82,56,26,0.6829999999999999
41200136,1610612741,1610612751,92.0,95.0,0.4039999999999999,0.43,0,2013-05-02,82,45,37,0.5489999999999999,82,49,33,0.598
41200166,1610612744,1610612743,92.0,88.0,0.4029999999999999,0.347,1,2013-05-02,82,47,35,0.573,82,57,25,0.695
41200115,1610612752,1610612738,86.0,92.0,0.395,0.457,0,2013-05-01,82,54,28,0.659,81,41,40,0.506
41200125,1610612754,1610612737,106.0,83.0,0.507,0.3329999999999999,1,2013-05-01,81,49,32,0.605,82,44,38,0.537
41200145,1610612760,1610612745,100.0,107.0,0.419,0.472,0,2013-05-01,82,60,22,0.732,82,45,37,0.5489999999999999
41200165,1610612743,1610612744,107.0,100.0,0.4270000000000001,0.4320000000000001,1,2013-04-30,82,57,25,0.695,82,47,35,0.573
41200175,1610612746,1610612763,93.0,103.0,0.442,0.435,0,2013-04-30,82,56,26,0.6829999999999999,82,56,26,0.6829999999999999
41200135,1610612751,1610612741,110.0,91.0,0.5,0.493,1,2013-04-29,82,49,33,0.598,82,45,37,0.5489999999999999
41200124,1610612737,1610612754,102.0,91.0,0.446,0.381,1,2013-04-29,82,44,38,0.537,81,49,32,0.605
41200144,1610612745,1610612760,105.0,103.0,0.487,0.486,1,2013-04-29,82,45,37,0.5489999999999999,82,60,22,0.732
41200114,1610612738,1610612752,97.0,90.0,0.447,0.344,1,2013-04-28,81,41,40,0.506,82,54,28,0.659
41200104,1610612749,1610612748,77.0,88.0,0.37,0.466,0,2013-04-28,82,38,44,0.4629999999999999,82,66,16,0.805
41200154,1610612747,1610612759,82.0,103.0,0.474,0.4639999999999999,0,2013-04-28,82,45,37,0.5489999999999999,82,58,24,0.7070000000000001
41200164,1610612744,1610612743,115.0,101.0,0.557,0.465,1,2013-04-28,82,47,35,0.573,82,57,25,0.695
41200134,1610612741,1610612751,142.0,134.0,0.532,0.495,1,2013-04-27,82,45,37,0.5489999999999999,82,49,33,0.598
41200174,1610612763,1610612746,104.0,83.0,0.506,0.41,1,2013-04-27,82,56,26,0.6829999999999999,82,56,26,0.6829999999999999
41200123,1610612737,1610612754,90.0,69.0,0.4270000000000001,0.272,1,2013-04-27,82,44,38,0.537,81,49,32,0.605
41200143,1610612745,1610612760,101.0,104.0,0.434,0.379,0,2013-04-27,82,45,37,0.5489999999999999,82,60,22,0.732
41200113,1610612738,1610612752,76.0,90.0,0.4,0.5,0,2013-04-26,81,41,40,0.506,82,54,28,0.659
41200153,1610612747,1610612759,89.0,120.0,0.4320000000000001,0.612,0,2013-04-26,82,45,37,0.5489999999999999,82,58,24,0.7070000000000001
41200163,1610612744,1610612743,110.0,108.0,0.525,0.465,1,2013-04-26,82,47,35,0.573,82,57,25,0.695
41200103,1610612749,1610612748,91.0,104.0,0.4579999999999999,0.519,0,2013-04-25,82,38,44,0.4629999999999999,82,66,16,0.805
41200133,1610612741,1610612751,79.0,76.0,0.397,0.346,1,2013-04-25,82,45,37,0.5489999999999999,82,49,33,0.598
41200173,1610612763,1610612746,94.0,82.0,0.3879999999999999,0.3879999999999999,1,2013-04-25,82,56,26,0.6829999999999999,82,56,26,0.6829999999999999
41200142,1610612760,1610612745,105.0,102.0,0.435,0.396,1,2013-04-24,82,60,22,0.732,82,45,37,0.5489999999999999
41200122,1610612754,1610612737,113.0,98.0,0.471,0.494,1,2013-04-24,81,49,32,0.605,82,44,38,0.537
41200152,1610612759,1610612747,102.0,91.0,0.512,0.451,1,2013-04-24,82,58,24,0.7070000000000001,82,45,37,0.5489999999999999
41200102,1610612748,1610612749,98.0,86.0,0.449,0.5,1,2013-04-23,82,66,16,0.805,82,38,44,0.4629999999999999
41200112,1610612752,1610612738,87.0,71.0,0.421,0.371,1,2013-04-23,82,54,28,0.659,81,41,40,0.506
41200162,1610612743,1610612744,117.0,131.0,0.5,0.6459999999999999,0,2013-04-23,82,57,25,0.695,82,47,35,0.573
41200132,1610612751,1610612741,82.0,90.0,0.354,0.481,0,2013-04-22,82,49,33,0.598,82,45,37,0.5489999999999999
41200172,1610612746,1610612763,93.0,91.0,0.474,0.452,1,2013-04-22,82,56,26,0.6829999999999999,82,56,26,0.6829999999999999
41200121,1610612754,1610612737,107.0,90.0,0.449,0.5,1,2013-04-21,81,49,32,0.605,82,44,38,0.537
41200151,1610612759,1610612747,91.0,79.0,0.376,0.411,1,2013-04-21,82,58,24,0.7070000000000001,82,45,37,0.5489999999999999
41200101,1610612748,1610612749,110.0,87.0,0.5589999999999999,0.415,1,2013-04-21,82,66,16,0.805,82,38,44,0.4629999999999999
41200141,1610612760,1610612745,120.0,91.0,0.53,0.363,1,2013-04-21,82,60,22,0.732,82,45,37,0.5489999999999999
41200111,1610612752,1610612738,85.0,78.0,0.405,0.415,1,2013-04-20,82,54,28,0.659,81,41,40,0.506
41200161,1610612743,1610612744,97.0,95.0,0.447,0.413,1,2013-04-20,82,57,25,0.695,82,47,35,0.573
41200131,1610612751,1610612741,106.0,89.0,0.5579999999999999,0.474,1,2013-04-20,82,49,33,0.598,82,45,37,0.5489999999999999
41200171,1610612746,1610612763,112.0,91.0,0.5539999999999999,0.465,1,2013-04-20,82,56,26,0.6829999999999999,82,56,26,0.6829999999999999
21201216,1610612761,1610612738,114.0,90.0,0.5,0.44,1,2013-04-17,82,34,48,0.415,81,41,40,0.506
21201217,1610612751,1610612765,103.0,99.0,0.481,0.474,1,2013-04-17,82,49,33,0.598,82,29,53,0.354
21201218,1610612752,1610612737,98.0,92.0,0.429,0.411,1,2013-04-17,82,54,28,0.659,82,44,38,0.537
21201219,1610612766,1610612739,105.0,98.0,0.507,0.488,1,2013-04-17,82,21,61,0.256,82,24,58,0.293
21201220,1610612748,1610612753,105.0,93.0,0.5379999999999999,0.519,1,2013-04-17,82,66,16,0.805,82,20,62,0.244
21201221,1610612754,1610612755,95.0,105.0,0.45,0.506,0,2013-04-17,81,49,32,0.605,82,34,48,0.415
21201222,1610612741,1610612764,95.0,92.0,0.474,0.424,1,2013-04-17,82,45,37,0.5489999999999999,82,29,53,0.354
21201223,1610612763,1610612762,86.0,70.0,0.405,0.321,1,2013-04-17,82,56,26,0.6829999999999999,82,43,39,0.524
21201224,1610612742,1610612740,99.0,87.0,0.512,0.369,1,2013-04-17,82,41,41,0.5,82,27,55,0.3289999999999999
21201225,1610612759,1610612750,95.0,108.0,0.418,0.462,0,2013-04-17,82,58,24,0.7070000000000001,82,31,51,0.3779999999999999
21201226,1610612760,1610612749,89.0,95.0,0.416,0.424,0,2013-04-17,82,60,22,0.732,82,38,44,0.4629999999999999
21201227,1610612743,1610612756,118.0,98.0,0.527,0.385,1,2013-04-17,82,57,25,0.695,82,25,57,0.305
21201228,1610612747,1610612745,99.0,95.0,0.3670000000000001,0.417,1,2013-04-17,82,45,37,0.5489999999999999,82,45,37,0.5489999999999999
21201229,1610612758,1610612746,108.0,112.0,0.449,0.5,0,2013-04-17,82,28,54,0.341,82,56,26,0.6829999999999999
21201230,1610612757,1610612744,88.0,99.0,0.4270000000000001,0.43,0,2013-04-17,82,33,49,0.402,82,47,35,0.573
21201213,1610612737,1610612761,96.0,113.0,0.3979999999999999,0.513,0,2013-04-16,81,44,37,0.5429999999999999,81,33,48,0.407
21201215,1610612746,1610612757,93.0,77.0,0.4679999999999999,0.411,1,2013-04-16,81,55,26,0.679,81,33,48,0.407
21201202,1610612766,1610612752,106.0,95.0,0.581,0.43,1,2013-04-15,81,20,61,0.247,81,53,28,0.654
21201203,1610612753,1610612741,84.0,102.0,0.419,0.56,0,2013-04-15,81,20,61,0.247,81,44,37,0.5429999999999999
21201204,1610612739,1610612748,95.0,96.0,0.4529999999999999,0.5,0,2013-04-15,81,24,57,0.296,81,65,16,0.802
21201205,1610612751,1610612764,106.0,101.0,0.467,0.532,1,2013-04-15,81,48,33,0.593,81,29,52,0.358
21201206,1610612765,1610612755,109.0,101.0,0.494,0.4479999999999999,1,2013-04-15,81,29,52,0.358,81,33,48,0.407
21201207,1610612749,1610612743,111.0,112.0,0.42,0.435,0,2013-04-15,81,37,44,0.457,81,56,25,0.691
21201208,1610612742,1610612763,97.0,103.0,0.447,0.475,0,2013-04-15,81,40,41,0.494,81,55,26,0.679
21201209,1610612760,1610612758,104.0,95.0,0.457,0.4370000000000001,1,2013-04-15,81,60,21,0.741,81,28,53,0.346
21201210,1610612750,1610612762,80.0,96.0,0.4270000000000001,0.4679999999999999,0,2013-04-15,81,30,51,0.37,81,43,38,0.531
21201211,1610612756,1610612745,119.0,112.0,0.495,0.467,1,2013-04-15,81,25,56,0.309,81,45,36,0.556
21201212,1610612744,1610612759,116.0,106.0,0.541,0.4589999999999999,1,2013-04-15,81,46,35,0.568,81,58,23,0.716
21201194,1610612748,1610612741,105.0,93.0,0.514,0.354,1,2013-04-14,80,64,16,0.8,80,43,37,0.5379999999999999
21201195,1610612761,1610612751,93.0,87.0,0.439,0.405,1,2013-04-14,80,32,48,0.4,80,47,33,0.588
21201196,1610612752,1610612754,90.0,80.0,0.4270000000000001,0.431,1,2013-04-14,80,53,27,0.6629999999999999,80,49,31,0.613
21201197,1610612755,1610612739,91.0,77.0,0.442,0.365,1,2013-04-14,80,33,47,0.413,80,24,56,0.3
21201198,1610612743,1610612757,118.0,109.0,0.531,0.4629999999999999,1,2013-04-14,80,55,25,0.688,80,33,47,0.413
21201199,1610612740,1610612742,89.0,107.0,0.379,0.523,0,2013-04-14,81,27,54,0.3329999999999999,80,40,40,0.5
21201200,1610612745,1610612758,121.0,100.0,0.542,0.39,1,2013-04-14,80,45,35,0.563,80,28,52,0.35
21201201,1610612747,1610612759,91.0,86.0,0.365,0.371,1,2013-04-14,81,44,37,0.5429999999999999,80,58,22,0.725
21201190,1610612766,1610612749,95.0,85.0,0.4629999999999999,0.391,1,2013-04-13,80,19,61,0.238,80,37,43,0.4629999999999999
21201191,1610612753,1610612738,88.0,120.0,0.422,0.593,0,2013-04-13,80,20,60,0.25,80,41,39,0.513
21201192,1610612763,1610612746,87.0,91.0,0.41,0.4629999999999999,0,2013-04-13,80,54,26,0.675,80,54,26,0.675
21201193,1610612750,1610612756,105.0,93.0,0.494,0.507,1,2013-04-13,80,30,50,0.375,80,24,56,0.3
21201176,1610612761,1610612741,97.0,88.0,0.472,0.442,1,2013-04-12,79,31,48,0.392,79,43,36,0.544
21201177,1610612764,1610612755,86.0,97.0,0.414,0.43,0,2013-04-12,80,29,51,0.363,79,32,47,0.405
21201178,1610612754,1610612751,109.0,117.0,0.5,0.512,0,2013-04-12,79,49,30,0.62,79,47,32,0.595
21201179,1610612737,1610612749,109.0,104.0,0.506,0.413,1,2013-04-12,80,44,36,0.55,79,37,42,0.4679999999999999
21201180,1610612748,1610612738,109.0,101.0,0.5489999999999999,0.482,1,2013-04-12,79,63,16,0.797,79,40,39,0.506
21201181,1610612765,1610612766,113.0,93.0,0.518,0.449,1,2013-04-12,80,28,52,0.35,79,18,61,0.228
21201182,1610612739,1610612752,91.0,101.0,0.43,0.506,0,2013-04-12,79,24,55,0.304,79,52,27,0.6579999999999999
21201183,1610612740,1610612746,93.0,96.0,0.422,0.449,0,2013-04-12,80,27,53,0.3379999999999999,79,53,26,0.6709999999999999
21201184,1610612745,1610612763,78.0,82.0,0.311,0.349,0,2013-04-12,79,44,35,0.557,79,54,25,0.684
21201185,1610612742,1610612743,108.0,105.0,0.4529999999999999,0.441,1,2013-04-12,79,39,40,0.494,79,54,25,0.684
21201186,1610612759,1610612758,108.0,101.0,0.545,0.4379999999999999,1,2013-04-12,79,58,21,0.7340000000000001,79,28,51,0.354
21201187,1610612762,1610612750,107.0,100.0,0.583,0.462,1,2013-04-12,80,42,38,0.525,79,29,50,0.3670000000000001
21201188,1610612757,1610612760,90.0,106.0,0.409,0.519,0,2013-04-12,79,33,46,0.418,80,59,21,0.738
21201189,1610612747,1610612744,118.0,116.0,0.515,0.474,1,2013-04-12,80,43,37,0.5379999999999999,80,45,35,0.563
21201174,1610612741,1610612752,118.0,111.0,0.4479999999999999,0.4039999999999999,1,2013-04-11,78,43,35,0.551,78,51,27,0.654
21201175,1610612744,1610612760,97.0,116.0,0.44,0.506,0,2013-04-11,79,45,34,0.57,79,58,21,0.7340000000000001
21201164,1610612755,1610612737,101.0,124.0,0.42,0.5379999999999999,0,2013-04-10,78,31,47,0.397,79,43,36,0.544
21201165,1610612764,1610612748,98.0,103.0,0.45,0.44,0,2013-04-10,79,29,50,0.3670000000000001,78,62,16,0.795
21201166,1610612753,1610612749,113.0,103.0,0.4679999999999999,0.386,1,2013-04-10,79,20,59,0.253,78,37,41,0.474
21201167,1610612739,1610612765,104.0,111.0,0.488,0.5,0,2013-04-10,78,24,54,0.308,79,27,52,0.342
21201168,1610612738,1610612751,93.0,101.0,0.457,0.4589999999999999,0,2013-04-10,78,40,38,0.513,78,46,32,0.59
21201169,1610612742,1610612756,91.0,102.0,0.4,0.416,0,2013-04-10,78,38,40,0.487,79,24,55,0.304
21201170,1610612758,1610612740,121.0,110.0,0.5529999999999999,0.487,1,2013-04-10,78,28,50,0.359,79,27,52,0.342
21201171,1610612757,1610612747,106.0,113.0,0.447,0.589,0,2013-04-10,78,33,45,0.423,79,42,37,0.532
21201172,1610612743,1610612759,96.0,86.0,0.4529999999999999,0.402,1,2013-04-10,78,54,24,0.6920000000000001,78,57,21,0.731
21201173,1610612746,1610612750,111.0,95.0,0.5710000000000001,0.389,1,2013-04-10,78,52,26,0.667,78,29,49,0.3720000000000001
21201154,1610612754,1610612739,99.0,94.0,0.405,0.4589999999999999,1,2013-04-09,78,49,29,0.628,77,24,53,0.312
21201155,1610612751,1610612755,104.0,83.0,0.452,0.375,1,2013-04-09,77,45,32,0.584,77,31,46,0.4029999999999999
21201156,1610612752,1610612764,120.0,99.0,0.563,0.455,1,2013-04-09,77,51,26,0.662,78,29,49,0.3720000000000001
21201157,1610612748,1610612749,94.0,83.0,0.4320000000000001,0.44,1,2013-04-09,77,61,16,0.792,77,37,40,0.481
21201158,1610612741,1610612761,98.0,101.0,0.43,0.514,0,2013-04-09,77,42,35,0.545,78,30,48,0.385
21201159,1610612763,1610612766,94.0,75.0,0.476,0.375,1,2013-04-09,78,53,25,0.679,78,18,60,0.231
21201160,1610612745,1610612756,101.0,98.0,0.43,0.442,1,2013-04-09,78,44,34,0.564,78,23,55,0.295
21201161,1610612762,1610612760,80.0,90.0,0.392,0.395,0,2013-04-09,79,41,38,0.519,78,57,21,0.731
21201162,1610612747,1610612740,104.0,96.0,0.506,0.44,1,2013-04-09,78,41,37,0.526,78,27,51,0.346
21201163,1610612744,1610612750,105.0,89.0,0.429,0.3670000000000001,1,2013-04-09,78,45,33,0.5770000000000001,77,29,48,0.377
21201145,1610612760,1610612752,120.0,125.0,0.5770000000000001,0.495,0,2013-04-07,77,56,21,0.727,76,50,26,0.6579999999999999
21201146,1610612746,1610612747,109.0,95.0,0.5,0.434,1,2013-04-07,77,51,26,0.662,77,40,37,0.519
21201147,1610612738,1610612764,107.0,96.0,0.5579999999999999,0.4429999999999999,1,2013-04-07,77,40,37,0.519,77,29,48,0.377
21201148,1610612739,1610612753,91.0,85.0,0.36,0.3779999999999999,1,2013-04-07,76,24,52,0.316,78,19,59,0.244
21201149,1610612758,1610612763,87.0,89.0,0.358,0.4379999999999999,0,2013-04-07,77,27,50,0.351,77,52,25,0.675
21201150,1610612765,1610612741,99.0,85.0,0.534,0.452,1,2013-04-07,78,26,52,0.3329999999999999,76,42,34,0.5529999999999999
21201151,1610612744,1610612762,90.0,97.0,0.473,0.455,0,2013-04-07,77,44,33,0.5710000000000001,78,41,37,0.526
21201152,1610612756,1610612740,92.0,95.0,0.425,0.4,0,2013-04-07,77,23,54,0.299,77,27,50,0.351
21201153,1610612757,1610612742,91.0,96.0,0.4629999999999999,0.467,0,2013-04-07,77,33,44,0.429,77,38,39,0.494
21201138,1610612764,1610612754,104.0,85.0,0.494,0.407,1,2013-04-06,76,29,47,0.382,77,48,29,0.623
21201139,1610612751,1610612766,105.0,96.0,0.488,0.45,1,2013-04-06,76,44,32,0.579,77,18,59,0.2339999999999999
21201140,1610612748,1610612755,106.0,87.0,0.482,0.402,1,2013-04-06,76,60,16,0.789,76,31,45,0.408
21201141,1610612750,1610612765,107.0,101.0,0.434,0.5329999999999999,1,2013-04-06,76,29,47,0.382,77,25,52,0.325
21201142,1610612749,1610612761,100.0,83.0,0.474,0.361,1,2013-04-06,76,37,39,0.487,77,29,48,0.377
21201143,1610612759,1610612737,99.0,97.0,0.45,0.422,1,2013-04-06,77,57,20,0.74,78,42,36,0.5379999999999999
21201144,1610612743,1610612745,132.0,114.0,0.545,0.47,1,2013-04-06,77,53,24,0.688,77,43,34,0.5579999999999999
21201127,1610612738,1610612739,91.0,97.0,0.4039999999999999,0.4039999999999999,0,2013-04-05,76,39,37,0.513,75,23,52,0.307
21201128,1610612752,1610612749,101.0,83.0,0.461,0.382,1,2013-04-05,75,49,26,0.653,75,36,39,0.48
21201129,1610612737,1610612755,90.0,101.0,0.466,0.4629999999999999,0,2013-04-05,77,42,35,0.545,75,31,44,0.413
21201126,1610612766,1610612748,79.0,89.0,0.318,0.449,0,2013-04-05,76,18,58,0.237,75,59,16,0.787
21201130,1610612754,1610612760,75.0,97.0,0.375,0.474,0,2013-04-05,76,48,28,0.632,76,56,20,0.737
21201131,1610612741,1610612753,87.0,86.0,0.402,0.425,1,2013-04-05,75,42,33,0.56,77,19,58,0.247
21201132,1610612750,1610612761,93.0,95.0,0.4479999999999999,0.471,0,2013-04-05,75,28,47,0.373,76,29,47,0.382
21201133,1610612762,1610612740,95.0,83.0,0.506,0.416,1,2013-04-05,77,40,37,0.519,76,26,50,0.342
21201134,1610612756,1610612744,107.0,111.0,0.611,0.512,0,2013-04-05,76,23,53,0.303,76,44,32,0.579
21201135,1610612758,1610612742,108.0,117.0,0.4479999999999999,0.511,0,2013-04-05,76,27,49,0.355,76,37,39,0.487
21201136,1610612757,1610612745,98.0,116.0,0.418,0.513,0,2013-04-05,76,33,43,0.434,76,43,33,0.5660000000000001
21201137,1610612747,1610612763,86.0,84.0,0.4589999999999999,0.442,1,2013-04-05,76,40,36,0.526,76,51,25,0.6709999999999999
21201123,1610612751,1610612741,90.0,92.0,0.4429999999999999,0.4629999999999999,0,2013-04-04,75,43,32,0.573,74,41,33,0.5539999999999999
21201124,1610612743,1610612742,95.0,94.0,0.3929999999999999,0.466,1,2013-04-04,76,52,24,0.684,75,36,39,0.48
21201125,1610612760,1610612759,100.0,88.0,0.4629999999999999,0.3979999999999999,1,2013-04-04,75,55,20,0.733,76,56,20,0.737
21201111,1610612761,1610612764,88.0,78.0,0.455,0.325,1,2013-04-03,75,28,47,0.373,75,28,47,0.373
21201112,1610612766,1610612755,88.0,83.0,0.4320000000000001,0.351,1,2013-04-03,75,18,57,0.24,74,30,44,0.405
21201113,1610612737,1610612752,82.0,95.0,0.485,0.519,0,2013-04-03,76,42,34,0.5529999999999999,74,48,26,0.649
21201114,1610612739,1610612751,95.0,113.0,0.382,0.5660000000000001,0,2013-04-03,74,22,52,0.297,74,43,31,0.581
21201115,1610612738,1610612765,98.0,93.0,0.507,0.366,1,2013-04-03,75,39,36,0.52,76,25,51,0.3289999999999999
21201116,1610612749,1610612750,98.0,107.0,0.4379999999999999,0.524,0,2013-04-03,74,36,38,0.486,74,28,46,0.3779999999999999
21201117,1610612759,1610612753,98.0,84.0,0.444,0.389,1,2013-04-03,75,56,19,0.747,76,19,57,0.25
21201118,1610612762,1610612743,96.0,113.0,0.4639999999999999,0.562,0,2013-04-03,76,39,37,0.513,75,51,24,0.68
21201119,1610612758,1610612745,102.0,112.0,0.391,0.488,0,2013-04-03,75,27,48,0.36,75,42,33,0.56
21201120,1610612757,1610612763,76.0,94.0,0.413,0.507,0,2013-04-03,75,33,42,0.44,75,51,24,0.68
21201121,1610612746,1610612756,126.0,101.0,0.5589999999999999,0.455,1,2013-04-03,76,50,26,0.6579999999999999,75,23,52,0.307
21201122,1610612744,1610612740,98.0,88.0,0.462,0.3979999999999999,1,2013-04-03,75,43,32,0.573,75,26,49,0.347
21201108,1610612764,1610612741,90.0,86.0,0.423,0.3929999999999999,1,2013-04-02,74,28,46,0.3779999999999999,73,40,33,0.5479999999999999
21201109,1610612748,1610612752,90.0,102.0,0.5,0.521,0,2013-04-02,74,58,16,0.784,73,47,26,0.644
21201110,1610612747,1610612742,101.0,81.0,0.444,0.42,1,2013-04-02,75,39,36,0.52,74,36,38,0.486
21201100,1610612761,1610612765,98.0,108.0,0.506,0.5579999999999999,0,2013-04-01,74,27,47,0.365,75,25,50,0.3329999999999999
21201101,1610612737,1610612739,102.0,94.0,0.457,0.506,1,2013-04-01,75,42,33,0.56,73,22,51,0.301
21201102,1610612749,1610612766,131.0,102.0,0.51,0.507,1,2013-04-01,73,36,37,0.493,74,17,57,0.23
21201103,1610612763,1610612759,92.0,90.0,0.456,0.48,1,2013-04-01,74,50,24,0.6759999999999999,74,55,19,0.743
21201104,1610612745,1610612753,111.0,103.0,0.449,0.419,1,2013-04-01,74,41,33,0.5539999999999999,75,19,56,0.253
21201105,1610612750,1610612738,110.0,100.0,0.482,0.519,1,2013-04-01,73,27,46,0.37,74,38,36,0.514
21201106,1610612762,1610612757,112.0,102.0,0.542,0.5820000000000001,1,2013-04-01,75,39,36,0.52,74,33,41,0.446
21201107,1610612746,1610612754,106.0,109.0,0.488,0.5489999999999999,0,2013-04-01,75,49,26,0.653,75,48,27,0.64
21201095,1610612764,1610612761,109.0,92.0,0.482,0.395,1,2013-03-31,73,27,46,0.37,73,27,46,0.37
21201096,1610612740,1610612739,112.0,92.0,0.541,0.4629999999999999,1,2013-03-31,74,26,48,0.351,72,22,50,0.306
21201097,1610612741,1610612765,95.0,94.0,0.395,0.5,1,2013-03-31,72,40,32,0.556,74,24,50,0.324
21201098,1610612759,1610612748,86.0,88.0,0.4429999999999999,0.465,0,2013-03-31,73,55,18,0.753,73,58,15,0.795
21201099,1610612752,1610612738,108.0,89.0,0.486,0.4320000000000001,1,2013-03-31,72,46,26,0.639,73,38,35,0.521
21201085,1610612742,1610612741,100.0,98.0,0.506,0.475,1,2013-03-30,73,36,37,0.493,71,39,32,0.5489999999999999
21201086,1610612737,1610612753,97.0,88.0,0.436,0.391,1,2013-03-30,74,41,33,0.5539999999999999,74,19,55,0.257
21201087,1610612755,1610612766,100.0,92.0,0.521,0.5,1,2013-03-30,73,30,43,0.411,73,17,56,0.233
21201088,1610612745,1610612746,98.0,81.0,0.4379999999999999,0.397,1,2013-03-30,73,40,33,0.5479999999999999,74,49,25,0.662
21201089,1610612750,1610612763,86.0,99.0,0.433,0.507,0,2013-03-30,72,26,46,0.361,73,49,24,0.6709999999999999
21201090,1610612749,1610612760,99.0,109.0,0.3779999999999999,0.5329999999999999,0,2013-03-30,72,35,37,0.486,74,54,20,0.73
21201091,1610612762,1610612751,116.0,107.0,0.556,0.519,1,2013-03-30,74,38,36,0.514,73,42,31,0.575
21201092,1610612756,1610612754,104.0,112.0,0.488,0.4629999999999999,0,2013-03-30,74,23,51,0.311,74,47,27,0.635
21201093,1610612758,1610612747,98.0,103.0,0.4529999999999999,0.4629999999999999,0,2013-03-30,74,27,47,0.365,74,38,36,0.514
21201094,1610612744,1610612757,125.0,98.0,0.54,0.384,1,2013-03-30,74,42,32,0.568,73,33,40,0.452
21201074,1610612753,1610612764,97.0,92.0,0.43,0.37,1,2013-03-29,73,19,54,0.26,72,26,46,0.361
21201075,1610612738,1610612737,118.0,107.0,0.542,0.455,1,2013-03-29,72,38,34,0.528,73,40,33,0.5479999999999999
21201076,1610612752,1610612766,111.0,102.0,0.494,0.466,1,2013-03-29,71,45,26,0.634,72,17,55,0.236
21201077,1610612765,1610612761,82.0,99.0,0.408,0.537,0,2013-03-29,73,24,49,0.3289999999999999,72,27,45,0.375
21201078,1610612739,1610612755,87.0,97.0,0.43,0.488,0,2013-03-29,71,22,49,0.31,72,29,43,0.4029999999999999
21201079,1610612763,1610612745,103.0,94.0,0.506,0.42,1,2013-03-29,72,48,24,0.667,72,39,33,0.542
21201080,1610612740,1610612748,89.0,108.0,0.4589999999999999,0.609,0,2013-03-29,73,25,48,0.342,72,57,15,0.792
21201081,1610612750,1610612760,101.0,93.0,0.446,0.456,1,2013-03-29,71,26,45,0.366,73,53,20,0.726
21201082,1610612759,1610612746,104.0,102.0,0.527,0.506,1,2013-03-29,72,55,17,0.764,73,49,24,0.6709999999999999
21201083,1610612743,1610612751,109.0,87.0,0.568,0.405,1,2013-03-29,74,50,24,0.6759999999999999,72,42,30,0.583
21201084,1610612757,1610612762,95.0,105.0,0.493,0.5,0,2013-03-29,72,33,39,0.4579999999999999,73,37,36,0.507
21201071,1610612749,1610612747,113.0,103.0,0.484,0.442,1,2013-03-28,71,35,36,0.493,73,37,36,0.507
21201072,1610612742,1610612754,78.0,103.0,0.386,0.476,0,2013-03-28,72,35,37,0.486,73,46,27,0.63
21201073,1610612756,1610612758,103.0,117.0,0.447,0.53,0,2013-03-28,73,23,50,0.315,73,27,46,0.37
21201057,1610612761,1610612737,88.0,107.0,0.449,0.494,0,2013-03-27,71,26,45,0.366,72,40,32,0.556
21201058,1610612755,1610612749,100.0,92.0,0.472,0.416,1,2013-03-27,71,28,43,0.3939999999999999,70,34,36,0.486
21201059,1610612766,1610612753,114.0,108.0,0.518,0.524,1,2013-03-27,71,17,54,0.239,72,18,54,0.25
21201060,1610612739,1610612738,92.0,93.0,0.442,0.447,0,2013-03-27,70,22,48,0.314,71,37,34,0.521
21201061,1610612752,1610612763,108.0,101.0,0.514,0.471,1,2013-03-27,70,44,26,0.629,71,47,24,0.662
21201062,1610612741,1610612748,101.0,97.0,0.471,0.481,1,2013-03-27,70,39,31,0.557,71,56,15,0.789
21201063,1610612740,1610612746,91.0,105.0,0.493,0.466,0,2013-03-27,72,25,47,0.347,72,49,23,0.6809999999999999
21201064,1610612745,1610612754,91.0,100.0,0.386,0.449,0,2013-03-27,71,39,32,0.5489999999999999,72,45,27,0.625
21201065,1610612760,1610612764,103.0,80.0,0.46,0.321,1,2013-03-27,72,53,19,0.736,71,26,45,0.366
21201066,1610612750,1610612747,117.0,120.0,0.4639999999999999,0.537,0,2013-03-27,70,25,45,0.357,72,37,35,0.514
21201067,1610612759,1610612743,100.0,99.0,0.461,0.477,1,2013-03-27,71,54,17,0.7609999999999999,73,49,24,0.6709999999999999
21201068,1610612762,1610612756,103.0,88.0,0.518,0.447,1,2013-03-27,72,36,36,0.5,72,23,49,0.319
21201069,1610612744,1610612758,98.0,105.0,0.456,0.456,0,2013-03-27,73,41,32,0.562,72,26,46,0.361
21201070,1610612757,1610612751,93.0,111.0,0.439,0.484,0,2013-03-27,71,33,38,0.465,71,42,29,0.5920000000000001
21201054,1610612738,1610612752,85.0,100.0,0.449,0.433,0,2013-03-26,70,36,34,0.514,69,43,26,0.623
21201055,1610612765,1610612750,82.0,105.0,0.405,0.532,0,2013-03-26,72,24,48,0.3329999999999999,69,25,44,0.362
21201056,1610612742,1610612746,109.0,102.0,0.488,0.447,1,2013-03-26,71,35,36,0.493,71,48,23,0.6759999999999999
21201048,1610612764,1610612763,107.0,94.0,0.5,0.442,1,2013-03-25,70,26,44,0.371,70,47,23,0.6709999999999999
21201049,1610612753,1610612748,94.0,108.0,0.43,0.474,0,2013-03-25,71,18,53,0.254,70,56,14,0.8
21201050,1610612754,1610612737,100.0,94.0,0.476,0.45,1,2013-03-25,71,44,27,0.62,71,39,32,0.5489999999999999
21201051,1610612740,1610612743,110.0,86.0,0.482,0.379,1,2013-03-25,71,25,46,0.352,72,49,23,0.6809999999999999
21201052,1610612762,1610612755,107.0,91.0,0.488,0.386,1,2013-03-25,71,35,36,0.493,70,27,43,0.386
21201053,1610612744,1610612747,109.0,103.0,0.478,0.396,1,2013-03-25,72,41,31,0.569,71,36,35,0.507
21201040,1610612749,1610612737,99.0,104.0,0.457,0.5,0,2013-03-24,69,34,35,0.493,70,39,31,0.557
21201041,1610612748,1610612766,109.0,77.0,0.5,0.337,1,2013-03-24,69,55,14,0.797,70,16,54,0.2289999999999999
21201042,1610612745,1610612759,96.0,95.0,0.4,0.423,1,2013-03-24,70,39,31,0.557,70,53,17,0.757
21201043,1610612760,1610612757,103.0,83.0,0.524,0.405,1,2013-03-24,71,52,19,0.732,70,33,37,0.471
21201044,1610612750,1610612741,97.0,104.0,0.5,0.461,0,2013-03-24,68,24,44,0.353,69,38,31,0.551
21201045,1610612742,1610612762,113.0,108.0,0.5429999999999999,0.512,1,2013-03-24,70,34,36,0.486,70,34,36,0.486
21201046,1610612756,1610612751,100.0,102.0,0.414,0.461,0,2013-03-24,71,23,48,0.324,70,41,29,0.586
21201047,1610612758,1610612755,103.0,117.0,0.494,0.49,0,2013-03-24,71,25,46,0.352,69,27,42,0.391
21201033,1610612766,1610612765,91.0,92.0,0.4270000000000001,0.456,0,2013-03-23,69,16,53,0.2319999999999999,71,24,47,0.3379999999999999
21201034,1610612752,1610612761,110.0,84.0,0.519,0.447,1,2013-03-23,68,42,26,0.618,70,26,44,0.371
21201035,1610612741,1610612754,87.0,84.0,0.4320000000000001,0.385,1,2013-03-23,68,37,31,0.544,70,43,27,0.614
21201036,1610612763,1610612738,110.0,106.0,0.457,0.514,1,2013-03-23,69,47,22,0.6809999999999999,69,36,33,0.522
21201037,1610612743,1610612758,101.0,95.0,0.435,0.4529999999999999,1,2013-03-23,71,49,22,0.69,70,25,45,0.357
21201038,1610612746,1610612751,101.0,95.0,0.4679999999999999,0.4589999999999999,1,2013-03-23,70,48,22,0.6859999999999999,69,40,29,0.58
21201039,1610612744,1610612764,101.0,92.0,0.493,0.409,1,2013-03-23,71,40,31,0.563,69,25,44,0.362
21201022,1610612761,1610612752,94.0,99.0,0.456,0.535,0,2013-03-22,69,26,43,0.377,67,41,26,0.612
21201023,1610612753,1610612760,89.0,97.0,0.413,0.425,0,2013-03-22,70,18,52,0.257,70,51,19,0.7290000000000001
21201024,1610612754,1610612749,102.0,78.0,0.481,0.307,1,2013-03-22,69,43,26,0.623,68,34,34,0.5
21201025,1610612737,1610612757,93.0,104.0,0.446,0.471,0,2013-03-22,69,38,31,0.551,69,33,36,0.478
21201026,1610612748,1610612765,103.0,89.0,0.5589999999999999,0.41,1,2013-03-22,68,54,14,0.794,70,23,47,0.3289999999999999
21201027,1610612740,1610612763,90.0,83.0,0.474,0.411,1,2013-03-22,70,24,46,0.3429999999999999,68,46,22,0.6759999999999999
21201028,1610612745,1610612739,116.0,78.0,0.5710000000000001,0.36,1,2013-03-22,69,38,31,0.551,69,22,47,0.319
21201029,1610612742,1610612738,104.0,94.0,0.4629999999999999,0.416,1,2013-03-22,69,33,36,0.478,68,36,32,0.529
21201030,1610612759,1610612762,104.0,97.0,0.4639999999999999,0.4270000000000001,1,2013-03-22,69,53,16,0.768,69,34,35,0.493
21201031,1610612756,1610612750,86.0,117.0,0.379,0.532,0,2013-03-22,70,23,47,0.3289999999999999,67,24,43,0.358
21201032,1610612747,1610612764,100.0,103.0,0.481,0.46,0,2013-03-22,70,36,34,0.514,68,25,43,0.368
21201019,1610612741,1610612757,89.0,99.0,0.4379999999999999,0.488,0,2013-03-21,67,36,31,0.537,68,32,36,0.471
21201020,1610612743,1610612755,101.0,100.0,0.487,0.551,1,2013-03-21,70,48,22,0.6859999999999999,68,26,42,0.382
21201021,1610612758,1610612750,101.0,98.0,0.5329999999999999,0.418,1,2013-03-21,69,25,44,0.362,66,23,43,0.348
21201008,1610612766,1610612761,107.0,101.0,0.467,0.422,1,2013-03-20,68,16,52,0.235,68,26,42,0.382
21201009,1610612739,1610612748,95.0,98.0,0.457,0.444,0,2013-03-20,68,22,46,0.324,67,53,14,0.7909999999999999
21201010,1610612752,1610612753,106.0,94.0,0.526,0.481,1,2013-03-20,66,40,26,0.606,69,18,51,0.261
21201011,1610612737,1610612749,98.0,90.0,0.481,0.374,1,2013-03-20,68,38,30,0.5589999999999999,67,34,33,0.507
21201012,1610612763,1610612760,90.0,89.0,0.36,0.357,1,2013-03-20,67,46,21,0.687,69,50,19,0.725
21201013,1610612740,1610612738,87.0,86.0,0.4370000000000001,0.4579999999999999,1,2013-03-20,69,23,46,0.3329999999999999,67,36,31,0.537
21201014,1610612745,1610612762,100.0,93.0,0.447,0.456,1,2013-03-20,68,37,31,0.544,68,34,34,0.5
21201015,1610612742,1610612751,96.0,113.0,0.5,0.506,0,2013-03-20,68,32,36,0.471,68,40,28,0.588
21201016,1610612759,1610612744,104.0,93.0,0.482,0.44,1,2013-03-20,68,52,16,0.765,70,39,31,0.557
21201017,1610612756,1610612764,79.0,88.0,0.337,0.485,0,2013-03-20,69,23,46,0.3329999999999999,67,24,43,0.358
21201018,1610612746,1610612755,101.0,72.0,0.526,0.3670000000000001,1,2013-03-20,69,47,22,0.6809999999999999,67,26,41,0.3879999999999999
21201004,1610612754,1610612753,95.0,73.0,0.391,0.318,1,2013-03-19,68,42,26,0.618,68,18,50,0.265
21201005,1610612749,1610612757,102.0,95.0,0.483,0.434,1,2013-03-19,66,34,32,0.515,67,31,36,0.4629999999999999
21201006,1610612760,1610612743,104.0,114.0,0.435,0.4479999999999999,0,2013-03-19,68,50,18,0.735,69,47,22,0.6809999999999999
21201007,1610612758,1610612746,116.0,101.0,0.507,0.45,1,2013-03-19,68,24,44,0.353,68,46,22,0.6759999999999999
21200993,1610612755,1610612757,101.0,100.0,0.5,0.422,1,2013-03-18,66,26,40,0.3939999999999999,66,31,35,0.47
21200994,1610612766,1610612764,119.0,114.0,0.532,0.531,1,2013-03-18,67,15,52,0.2239999999999999,66,23,43,0.348
21200995,1610612739,1610612754,90.0,111.0,0.38,0.4429999999999999,0,2013-03-18,67,22,45,0.3279999999999999,67,41,26,0.612
21200996,1610612737,1610612742,113.0,127.0,0.56,0.573,0,2013-03-18,67,37,30,0.552,67,32,35,0.478
21200997,1610612765,1610612751,82.0,119.0,0.436,0.542,0,2013-03-18,69,23,46,0.3329999999999999,67,39,28,0.5820000000000001
21200998,1610612738,1610612748,103.0,105.0,0.542,0.494,0,2013-03-18,66,36,30,0.545,66,52,14,0.7879999999999999
21200999,1610612741,1610612743,118.0,119.0,0.49,0.46,0,2013-03-18,66,36,30,0.545,68,46,22,0.6759999999999999
21201000,1610612763,1610612750,92.0,77.0,0.488,0.337,1,2013-03-18,66,45,21,0.682,65,23,42,0.354
21201001,1610612740,1610612744,72.0,93.0,0.337,0.5,0,2013-03-18,68,22,46,0.324,69,39,30,0.565
21201002,1610612756,1610612747,99.0,76.0,0.483,0.3329999999999999,1,2013-03-18,68,23,45,0.3379999999999999,69,36,33,0.522
21201003,1610612762,1610612752,83.0,90.0,0.382,0.4639999999999999,0,2013-03-18,67,34,33,0.507,65,39,26,0.6
21200985,1610612761,1610612748,91.0,108.0,0.415,0.5820000000000001,0,2013-03-17,67,26,41,0.3879999999999999,65,51,14,0.785
21200986,1610612749,1610612753,115.0,109.0,0.444,0.505,1,2013-03-17,65,33,32,0.508,67,18,49,0.2689999999999999
21200987,1610612746,1610612752,93.0,80.0,0.4529999999999999,0.358,1,2013-03-17,67,46,21,0.687,64,38,26,0.594
21200988,1610612745,1610612744,78.0,108.0,0.326,0.4579999999999999,0,2013-03-17,67,36,31,0.537,68,38,30,0.5589999999999999
21200989,1610612750,1610612740,97.0,95.0,0.563,0.4589999999999999,1,2013-03-17,64,23,41,0.359,67,22,45,0.3279999999999999
21200990,1610612742,1610612760,101.0,107.0,0.4579999999999999,0.488,0,2013-03-17,66,31,35,0.47,67,50,17,0.746
21200991,1610612751,1610612737,93.0,105.0,0.419,0.524,0,2013-03-17,66,38,28,0.5760000000000001,66,37,29,0.561
21200992,1610612747,1610612758,113.0,102.0,0.569,0.4379999999999999,1,2013-03-17,68,36,32,0.529,67,23,44,0.3429999999999999
21200979,1610612764,1610612756,127.0,105.0,0.516,0.477,1,2013-03-16,65,23,42,0.354,67,22,45,0.3279999999999999
21200980,1610612738,1610612766,105.0,88.0,0.519,0.447,1,2013-03-16,65,36,29,0.5539999999999999,66,14,52,0.212
21200981,1610612755,1610612754,98.0,91.0,0.494,0.386,1,2013-03-16,65,25,40,0.385,66,40,26,0.606
21200982,1610612759,1610612739,119.0,113.0,0.5770000000000001,0.506,1,2013-03-16,67,51,16,0.7609999999999999,66,22,44,0.3329999999999999
21200983,1610612762,1610612763,90.0,84.0,0.4370000000000001,0.429,1,2013-03-16,66,34,32,0.515,65,44,21,0.677
21200984,1610612757,1610612765,112.0,101.0,0.477,0.526,1,2013-03-16,65,31,34,0.477,68,23,45,0.3379999999999999
21200969,1610612761,1610612766,92.0,78.0,0.485,0.325,1,2013-03-15,66,26,40,0.3939999999999999,65,14,51,0.215
21200970,1610612764,1610612740,96.0,87.0,0.5,0.4379999999999999,1,2013-03-15,64,22,42,0.344,66,22,44,0.3329999999999999
21200971,1610612754,1610612747,93.0,99.0,0.374,0.423,0,2013-03-15,65,40,25,0.615,67,35,32,0.522
21200972,1610612737,1610612756,107.0,94.0,0.488,0.4429999999999999,1,2013-03-15,65,36,29,0.5539999999999999,66,22,44,0.3329999999999999
21200973,1610612745,1610612750,108.0,100.0,0.486,0.481,1,2013-03-15,66,36,30,0.545,63,22,41,0.349
21200974,1610612760,1610612753,117.0,104.0,0.5529999999999999,0.435,1,2013-03-15,66,49,17,0.742,66,18,48,0.273
21200975,1610612749,1610612748,94.0,107.0,0.371,0.519,0,2013-03-15,64,32,32,0.5,64,50,14,0.7809999999999999
21200976,1610612742,1610612739,96.0,86.0,0.5,0.436,1,2013-03-15,65,31,34,0.477,65,22,43,0.3379999999999999
21200977,1610612743,1610612763,87.0,80.0,0.455,0.353,1,2013-03-15,67,45,22,0.672,64,44,20,0.688
21200978,1610612744,1610612741,95.0,113.0,0.447,0.518,0,2013-03-15,67,37,30,0.552,65,36,29,0.5539999999999999
21200967,1610612759,1610612742,92.0,91.0,0.44,0.446,1,2013-03-14,66,50,16,0.758,64,30,34,0.469
21200968,1610612757,1610612752,105.0,90.0,0.513,0.439,1,2013-03-14,64,30,34,0.469,63,38,25,0.603
21200956,1610612755,1610612748,94.0,98.0,0.471,0.467,0,2013-03-13,64,24,40,0.375,63,49,14,0.778
21200957,1610612764,1610612749,106.0,93.0,0.5,0.4589999999999999,1,2013-03-13,63,21,42,0.3329999999999999,63,32,31,0.508
21200958,1610612754,1610612750,107.0,91.0,0.5,0.4379999999999999,1,2013-03-13,64,40,24,0.625,62,22,40,0.355
21200959,1610612738,1610612761,112.0,88.0,0.513,0.43,1,2013-03-13,64,35,29,0.547,65,25,40,0.385
21200960,1610612737,1610612747,96.0,92.0,0.4679999999999999,0.391,1,2013-03-13,64,35,29,0.547,66,34,32,0.515
21200961,1610612745,1610612756,111.0,81.0,0.513,0.42,1,2013-03-13,65,35,30,0.5379999999999999,65,22,43,0.3379999999999999
21200962,1610612760,1610612762,110.0,87.0,0.536,0.35,1,2013-03-13,65,48,17,0.738,65,33,32,0.508
21200963,1610612758,1610612741,121.0,79.0,0.542,0.386,1,2013-03-13,66,23,43,0.348,64,35,29,0.547
21200964,1610612743,1610612752,117.0,94.0,0.488,0.43,1,2013-03-13,66,44,22,0.667,62,38,24,0.613
21200965,1610612746,1610612763,85.0,96.0,0.431,0.544,0,2013-03-13,66,45,21,0.682,63,44,19,0.698
21200966,1610612744,1610612765,105.0,97.0,0.569,0.449,1,2013-03-13,66,37,29,0.561,67,23,44,0.3429999999999999
21200948,1610612766,1610612738,100.0,74.0,0.455,0.409,1,2013-03-12,64,14,50,0.2189999999999999,63,34,29,0.54
21200949,1610612753,1610612747,97.0,106.0,0.3979999999999999,0.466,0,2013-03-12,65,18,47,0.2769999999999999,65,34,31,0.523
21200950,1610612739,1610612764,95.0,90.0,0.41,0.408,1,2013-03-12,64,22,42,0.344,62,20,42,0.3229999999999999
21200951,1610612751,1610612740,108.0,98.0,0.5,0.513,1,2013-03-12,65,38,27,0.585,65,22,43,0.3379999999999999
21200952,1610612748,1610612737,98.0,81.0,0.4270000000000001,0.423,1,2013-03-12,62,48,14,0.774,63,34,29,0.54
21200953,1610612749,1610612742,108.0,115.0,0.483,0.5,0,2013-03-12,62,32,30,0.516,63,30,33,0.476
21200954,1610612750,1610612759,107.0,83.0,0.537,0.354,1,2013-03-12,61,22,39,0.361,65,49,16,0.754
21200955,1610612757,1610612763,97.0,102.0,0.405,0.513,0,2013-03-12,63,29,34,0.46,62,43,19,0.6940000000000001
21200943,1610612755,1610612751,106.0,97.0,0.526,0.494,1,2013-03-11,63,24,39,0.381,64,37,27,0.578
21200944,1610612759,1610612760,105.0,93.0,0.524,0.429,1,2013-03-11,64,49,15,0.7659999999999999,64,47,17,0.7340000000000001
21200945,1610612762,1610612765,103.0,90.0,0.519,0.425,1,2013-03-11,64,33,31,0.516,66,23,43,0.348
21200946,1610612756,1610612743,93.0,108.0,0.417,0.512,0,2013-03-11,64,22,42,0.344,65,43,22,0.662
21200947,1610612744,1610612752,92.0,63.0,0.41,0.2739999999999999,1,2013-03-11,65,36,29,0.5539999999999999,61,38,23,0.623
21200934,1610612760,1610612738,91.0,79.0,0.441,0.377,1,2013-03-10,63,47,16,0.746,62,34,28,0.5479999999999999
21200935,1610612747,1610612741,90.0,81.0,0.4529999999999999,0.371,1,2013-03-10,64,33,31,0.516,63,35,28,0.556
21200936,1610612761,1610612739,100.0,96.0,0.3929999999999999,0.419,1,2013-03-10,64,25,39,0.391,63,21,42,0.3329999999999999
21200937,1610612753,1610612755,99.0,91.0,0.494,0.465,1,2013-03-10,64,18,46,0.281,62,23,39,0.371
21200938,1610612748,1610612754,105.0,91.0,0.5589999999999999,0.413,1,2013-03-10,61,47,14,0.77,63,39,24,0.619
21200939,1610612740,1610612757,98.0,96.0,0.465,0.487,1,2013-03-10,64,22,42,0.344,62,29,33,0.4679999999999999
21200940,1610612750,1610612742,77.0,100.0,0.364,0.457,0,2013-03-10,60,21,39,0.35,62,29,33,0.4679999999999999
21200941,1610612758,1610612749,113.0,115.0,0.4679999999999999,0.46,0,2013-03-10,65,22,43,0.3379999999999999,61,32,29,0.525
21200942,1610612746,1610612765,129.0,97.0,0.625,0.469,1,2013-03-10,65,45,20,0.6920000000000001,65,23,42,0.354
21200927,1610612737,1610612751,80.0,93.0,0.416,0.434,0,2013-03-09,62,34,28,0.5479999999999999,63,37,26,0.5870000000000001
21200928,1610612752,1610612762,113.0,84.0,0.507,0.385,1,2013-03-09,60,38,22,0.633,63,32,31,0.508
21200929,1610612764,1610612766,104.0,87.0,0.5,0.405,1,2013-03-09,61,20,41,0.3279999999999999,63,13,50,0.206
21200930,1610612763,1610612740,96.0,85.0,0.469,0.43,1,2013-03-09,61,42,19,0.6890000000000001,63,21,42,0.3329999999999999
21200931,1610612743,1610612750,111.0,88.0,0.5379999999999999,0.417,1,2013-03-09,64,42,22,0.6559999999999999,59,21,38,0.356
21200932,1610612756,1610612745,107.0,105.0,0.451,0.43,1,2013-03-09,63,22,41,0.349,64,34,30,0.531
21200933,1610612744,1610612749,93.0,103.0,0.451,0.487,0,2013-03-09,64,35,29,0.547,60,31,29,0.517
21200915,1610612766,1610612760,94.0,116.0,0.412,0.568,0,2013-03-08,62,13,49,0.21,62,46,16,0.742
21200916,1610612753,1610612754,86.0,115.0,0.39,0.518,0,2013-03-08,63,17,46,0.27,62,39,23,0.629
21200918,1610612751,1610612764,95.0,78.0,0.395,0.356,1,2013-03-08,62,36,26,0.581,60,19,41,0.317
21200919,1610612765,1610612742,99.0,102.0,0.406,0.526,0,2013-03-08,64,23,41,0.359,61,28,33,0.4589999999999999
21200920,1610612739,1610612763,92.0,103.0,0.4579999999999999,0.523,0,2013-03-08,62,21,41,0.3389999999999999,60,41,19,0.6829999999999999
21200917,1610612738,1610612737,107.0,102.0,0.513,0.455,1,2013-03-08,61,34,27,0.557,61,34,27,0.557
21200921,1610612748,1610612755,102.0,93.0,0.532,0.481,1,2013-03-08,60,46,14,0.767,61,23,38,0.377
21200922,1610612741,1610612762,89.0,88.0,0.37,0.457,1,2013-03-08,62,35,27,0.565,62,32,30,0.516
21200923,1610612759,1610612757,106.0,136.0,0.524,0.616,0,2013-03-08,63,48,15,0.762,61,29,32,0.475
21200924,1610612758,1610612756,121.0,112.0,0.5489999999999999,0.478,1,2013-03-08,64,22,42,0.344,62,21,41,0.3389999999999999
21200925,1610612747,1610612761,118.0,116.0,0.429,0.516,1,2013-03-08,63,32,31,0.508,63,24,39,0.381
21200926,1610612744,1610612745,88.0,94.0,0.379,0.365,0,2013-03-08,63,35,28,0.556,63,34,29,0.54
21200913,1610612752,1610612760,94.0,95.0,0.407,0.4429999999999999,0,2013-03-07,59,37,22,0.627,61,45,16,0.738
21200914,1610612743,1610612746,107.0,92.0,0.5579999999999999,0.424,1,2013-03-07,63,41,22,0.6509999999999999,64,44,20,0.688
21200899,1610612766,1610612751,78.0,99.0,0.381,0.507,0,2013-03-06,61,13,48,0.213,61,35,26,0.574
21200900,1610612739,1610612762,104.0,101.0,0.411,0.4370000000000001,1,2013-03-06,61,21,40,0.344,61,32,29,0.525
21200901,1610612754,1610612738,81.0,83.0,0.364,0.41,0,2013-03-06,61,38,23,0.623,60,33,27,0.55
21200902,1610612737,1610612755,107.0,96.0,0.5379999999999999,0.43,1,2013-03-06,60,34,26,0.5670000000000001,60,23,37,0.3829999999999999
21200903,1610612748,1610612753,97.0,96.0,0.4320000000000001,0.449,1,2013-03-06,59,45,14,0.763,62,17,45,0.2739999999999999
21200904,1610612765,1610612752,77.0,87.0,0.4320000000000001,0.413,0,2013-03-06,63,23,40,0.365,58,37,21,0.638
21200905,1610612763,1610612757,91.0,85.0,0.4370000000000001,0.408,1,2013-03-06,59,40,19,0.6779999999999999,60,28,32,0.467
21200906,1610612740,1610612747,102.0,108.0,0.4320000000000001,0.487,0,2013-03-06,62,21,41,0.3389999999999999,62,31,31,0.5
21200907,1610612750,1610612764,87.0,82.0,0.408,0.446,1,2013-03-06,58,21,37,0.362,59,19,40,0.322
21200908,1610612742,1610612745,112.0,108.0,0.542,0.449,1,2013-03-06,60,27,33,0.45,62,33,29,0.532
21200909,1610612759,1610612741,101.0,83.0,0.541,0.3670000000000001,1,2013-03-06,62,48,14,0.774,61,34,27,0.557
21200910,1610612756,1610612761,71.0,98.0,0.3779999999999999,0.481,0,2013-03-06,61,21,40,0.344,62,24,38,0.387
21200911,1610612746,1610612749,117.0,101.0,0.54,0.481,1,2013-03-06,63,44,19,0.698,59,30,29,0.508
21200912,1610612744,1610612758,87.0,83.0,0.36,0.3979999999999999,1,2013-03-06,62,35,27,0.565,63,21,42,0.3329999999999999
21200896,1610612755,1610612738,101.0,109.0,0.41,0.506,0,2013-03-05,59,23,36,0.39,59,32,27,0.542
21200897,1610612760,1610612747,122.0,105.0,0.479,0.4029999999999999,1,2013-03-05,60,44,16,0.733,61,30,31,0.4920000000000001
21200898,1610612758,1610612743,113.0,120.0,0.4589999999999999,0.541,0,2013-03-05,62,21,41,0.3389999999999999,62,40,22,0.645
21200889,1610612739,1610612752,97.0,102.0,0.507,0.462,0,2013-03-04,60,20,40,0.3329999999999999,57,36,21,0.632
21200890,1610612749,1610612762,109.0,108.0,0.474,0.4039999999999999,1,2013-03-04,58,30,28,0.517,60,32,28,0.5329999999999999
21200891,1610612740,1610612753,102.0,105.0,0.4629999999999999,0.494,0,2013-03-04,61,21,40,0.344,61,17,44,0.2789999999999999
21200892,1610612750,1610612748,81.0,97.0,0.375,0.514,0,2013-03-04,57,20,37,0.351,58,44,14,0.759
21200893,1610612743,1610612737,104.0,88.0,0.535,0.4039999999999999,1,2013-03-04,61,39,22,0.639,59,33,26,0.5589999999999999
21200894,1610612757,1610612766,122.0,105.0,0.598,0.4639999999999999,1,2013-03-04,59,28,31,0.475,60,13,47,0.217
21200895,1610612744,1610612761,125.0,118.0,0.573,0.436,1,2013-03-04,61,34,27,0.557,61,23,38,0.377
21200880,1610612752,1610612748,93.0,99.0,0.4320000000000001,0.4639999999999999,0,2013-03-03,56,35,21,0.625,57,43,14,0.754
21200881,1610612746,1610612760,104.0,108.0,0.4629999999999999,0.475,0,2013-03-03,62,43,19,0.6940000000000001,59,43,16,0.7290000000000001
21200882,1610612764,1610612755,90.0,87.0,0.425,0.3879999999999999,1,2013-03-03,58,19,39,0.3279999999999999,58,23,35,0.397
21200883,1610612753,1610612763,82.0,108.0,0.397,0.53,0,2013-03-03,60,16,44,0.267,58,39,19,0.672
21200884,1610612758,1610612766,119.0,83.0,0.467,0.364,1,2013-03-03,61,21,40,0.344,59,13,46,0.22
21200885,1610612745,1610612742,136.0,103.0,0.575,0.475,1,2013-03-03,61,33,28,0.541,59,26,33,0.441
21200886,1610612759,1610612765,114.0,75.0,0.506,0.326,1,2013-03-03,61,47,14,0.77,62,23,39,0.371
21200887,1610612754,1610612741,97.0,92.0,0.465,0.4320000000000001,1,2013-03-03,60,38,22,0.633,60,34,26,0.5670000000000001
21200888,1610612747,1610612737,99.0,98.0,0.487,0.5,1,2013-03-03,60,30,30,0.5,58,33,25,0.569
21200876,1610612755,1610612744,104.0,97.0,0.518,0.419,1,2013-03-02,57,23,34,0.4039999999999999,60,33,27,0.55
21200877,1610612741,1610612751,96.0,85.0,0.521,0.444,1,2013-03-02,59,34,25,0.5760000000000001,60,34,26,0.5670000000000001
21200878,1610612749,1610612761,122.0,114.0,0.5,0.46,1,2013-03-02,57,29,28,0.509,60,23,37,0.3829999999999999
21200879,1610612757,1610612750,109.0,94.0,0.489,0.391,1,2013-03-02,58,27,31,0.466,56,20,36,0.357
21200864,1610612761,1610612754,81.0,93.0,0.4029999999999999,0.486,0,2013-03-01,59,23,36,0.39,59,37,22,0.627
21200865,1610612764,1610612752,88.0,96.0,0.419,0.4320000000000001,0,2013-03-01,57,18,39,0.316,55,35,20,0.636
21200866,1610612753,1610612745,110.0,118.0,0.564,0.545,0,2013-03-01,59,16,43,0.271,60,32,28,0.5329999999999999
21200867,1610612738,1610612744,94.0,86.0,0.48,0.34,1,2013-03-01,58,31,27,0.534,59,33,26,0.5589999999999999
21200869,1610612739,1610612746,89.0,105.0,0.446,0.518,0,2013-03-01,59,20,39,0.3389999999999999,61,43,18,0.705
21200868,1610612748,1610612763,98.0,91.0,0.466,0.429,1,2013-03-01,56,42,14,0.75,57,38,19,0.667
21200870,1610612751,1610612742,90.0,98.0,0.462,0.5,0,2013-03-01,59,34,25,0.5760000000000001,58,26,32,0.4479999999999999
21200871,1610612740,1610612765,100.0,95.0,0.4320000000000001,0.5,1,2013-03-01,60,21,39,0.35,61,23,38,0.377
21200872,1610612759,1610612758,130.0,102.0,0.607,0.4589999999999999,1,2013-03-01,60,46,14,0.767,60,20,40,0.3329999999999999
21200873,1610612762,1610612766,98.0,68.0,0.487,0.346,1,2013-03-01,59,32,27,0.542,58,13,45,0.2239999999999999
21200874,1610612756,1610612737,92.0,87.0,0.444,0.425,1,2013-03-01,60,21,39,0.35,57,33,24,0.579
21200875,1610612743,1610612760,105.0,103.0,0.4529999999999999,0.434,1,2013-03-01,60,38,22,0.633,58,42,16,0.7240000000000001
21200861,1610612754,1610612746,91.0,99.0,0.4270000000000001,0.488,0,2013-02-28,58,36,22,0.621,60,42,18,0.7
21200862,1610612741,1610612755,93.0,82.0,0.386,0.3879999999999999,1,2013-02-28,58,33,25,0.569,56,22,34,0.3929999999999999
21200863,1610612747,1610612750,116.0,94.0,0.53,0.457,1,2013-02-28,59,29,30,0.4920000000000001,55,20,35,0.364
21200851,1610612753,1610612758,101.0,125.0,0.446,0.5479999999999999,0,2013-02-27,58,16,42,0.276,59,20,39,0.3389999999999999
21200852,1610612739,1610612761,103.0,92.0,0.415,0.449,1,2013-02-27,58,20,38,0.345,58,23,35,0.397
21200854,1610612764,1610612765,95.0,96.0,0.476,0.542,0,2013-02-27,56,18,38,0.321,60,23,37,0.3829999999999999
21200853,1610612752,1610612744,109.0,105.0,0.414,0.5,1,2013-02-27,54,34,20,0.63,58,33,25,0.569
21200855,1610612763,1610612742,90.0,84.0,0.3720000000000001,0.434,1,2013-02-27,56,38,18,0.679,57,25,32,0.439
21200856,1610612745,1610612749,107.0,110.0,0.472,0.483,0,2013-02-27,59,31,28,0.525,56,28,28,0.5
21200857,1610612760,1610612740,119.0,74.0,0.5529999999999999,0.351,1,2013-02-27,57,42,15,0.737,59,20,39,0.3389999999999999
21200858,1610612759,1610612756,101.0,105.0,0.4320000000000001,0.4629999999999999,0,2013-02-27,59,45,14,0.763,59,20,39,0.3389999999999999
21200859,1610612762,1610612737,91.0,102.0,0.446,0.487,0,2013-02-27,58,31,27,0.534,56,33,23,0.589
21200860,1610612757,1610612743,109.0,111.0,0.447,0.517,0,2013-02-27,57,26,31,0.456,59,37,22,0.627
21200843,1610612755,1610612753,84.0,98.0,0.395,0.539,0,2013-02-26,55,22,33,0.4,57,16,41,0.281
21200844,1610612754,1610612744,108.0,97.0,0.488,0.434,1,2013-02-26,57,36,21,0.632,57,33,24,0.579
21200845,1610612748,1610612758,141.0,129.0,0.5539999999999999,0.516,1,2013-02-26,55,41,14,0.745,58,19,39,0.3279999999999999
21200846,1610612741,1610612739,98.0,101.0,0.5,0.494,0,2013-02-26,57,32,25,0.561,57,19,38,0.3329999999999999
21200847,1610612740,1610612751,97.0,101.0,0.46,0.487,0,2013-02-26,58,20,38,0.345,58,34,24,0.586
21200848,1610612742,1610612749,90.0,95.0,0.424,0.415,0,2013-02-26,56,25,31,0.446,55,27,28,0.491
21200849,1610612756,1610612750,84.0,83.0,0.407,0.344,1,2013-02-26,58,19,39,0.3279999999999999,54,20,34,0.37
21200850,1610612746,1610612766,106.0,84.0,0.539,0.407,1,2013-02-26,59,41,18,0.695,57,13,44,0.228
21200839,1610612761,1610612764,84.0,90.0,0.3670000000000001,0.42,0,2013-02-25,57,23,34,0.4039999999999999,55,18,37,0.327
21200840,1610612765,1610612737,103.0,114.0,0.488,0.506,0,2013-02-25,59,22,37,0.373,55,32,23,0.5820000000000001
21200841,1610612743,1610612747,119.0,108.0,0.557,0.551,1,2013-02-25,58,36,22,0.621,58,28,30,0.483
21200842,1610612762,1610612738,107.0,110.0,0.4429999999999999,0.477,0,2013-02-25,57,31,26,0.544,57,30,27,0.526
21200830,1610612742,1610612747,99.0,103.0,0.4479999999999999,0.472,0,2013-02-24,55,25,30,0.455,57,28,29,0.491
21200832,1610612750,1610612744,99.0,100.0,0.435,0.457,0,2013-02-24,53,20,33,0.377,56,33,23,0.589
21200833,1610612748,1610612739,109.0,105.0,0.52,0.5,1,2013-02-24,54,40,14,0.741,56,18,38,0.321
21200834,1610612740,1610612758,110.0,95.0,0.506,0.422,1,2013-02-24,57,20,37,0.351,57,19,38,0.3329999999999999
21200831,1610612751,1610612763,72.0,76.0,0.377,0.451,0,2013-02-24,57,33,24,0.579,55,37,18,0.6729999999999999
21200835,1610612752,1610612755,99.0,93.0,0.4270000000000001,0.424,1,2013-02-24,53,33,20,0.623,54,22,32,0.407
21200836,1610612756,1610612759,87.0,97.0,0.37,0.444,0,2013-02-24,57,18,39,0.316,58,45,13,0.7759999999999999
21200837,1610612757,1610612738,92.0,86.0,0.4429999999999999,0.424,1,2013-02-24,56,26,30,0.4639999999999999,56,29,27,0.518
21200838,1610612760,1610612741,102.0,72.0,0.456,0.291,1,2013-02-24,56,41,15,0.732,56,32,24,0.5710000000000001
21200823,1610612764,1610612745,105.0,103.0,0.513,0.452,1,2013-02-23,54,17,37,0.315,58,31,27,0.534
21200824,1610612766,1610612743,99.0,113.0,0.451,0.53,0,2013-02-23,56,13,43,0.2319999999999999,57,35,22,0.614
21200825,1610612753,1610612739,94.0,118.0,0.481,0.494,0,2013-02-23,56,15,41,0.268,55,18,37,0.327
21200826,1610612755,1610612748,90.0,114.0,0.449,0.584,0,2013-02-23,53,22,31,0.415,53,39,14,0.736
21200827,1610612765,1610612754,72.0,90.0,0.3379999999999999,0.4529999999999999,0,2013-02-23,58,22,36,0.379,56,35,21,0.625
21200828,1610612749,1610612737,102.0,103.0,0.461,0.429,0,2013-02-23,54,26,28,0.481,54,31,23,0.574
21200829,1610612746,1610612762,107.0,94.0,0.513,0.417,1,2013-02-23,58,40,18,0.69,56,31,25,0.5539999999999999
21200811,1610612761,1610612752,100.0,98.0,0.4379999999999999,0.467,1,2013-02-22,56,23,33,0.411,52,32,20,0.615
21200812,1610612764,1610612743,119.0,113.0,0.477,0.481,1,2013-02-22,53,16,37,0.302,56,34,22,0.607
21200813,1610612766,1610612741,75.0,105.0,0.3329999999999999,0.506,0,2013-02-22,55,13,42,0.236,55,32,23,0.5820000000000001
21200814,1610612754,1610612765,114.0,82.0,0.562,0.354,1,2013-02-22,55,34,21,0.618,57,22,35,0.386
21200815,1610612751,1610612745,96.0,106.0,0.44,0.532,0,2013-02-22,56,33,23,0.589,57,31,26,0.544
21200816,1610612737,1610612758,122.0,108.0,0.5329999999999999,0.4320000000000001,1,2013-02-22,53,30,23,0.5660000000000001,56,19,37,0.3389999999999999
21200817,1610612763,1610612753,88.0,82.0,0.447,0.417,1,2013-02-22,54,36,18,0.667,55,15,40,0.273
21200818,1610612740,1610612742,100.0,104.0,0.407,0.476,0,2013-02-22,56,19,37,0.3389999999999999,54,25,29,0.4629999999999999
21200819,1610612760,1610612750,127.0,111.0,0.578,0.482,1,2013-02-22,55,40,15,0.727,52,20,32,0.385
21200820,1610612756,1610612738,88.0,113.0,0.417,0.557,0,2013-02-22,56,18,38,0.321,55,29,26,0.527
21200821,1610612747,1610612757,111.0,107.0,0.471,0.489,1,2013-02-22,56,27,29,0.482,55,25,30,0.455
21200822,1610612744,1610612759,107.0,101.0,0.415,0.389,1,2013-02-22,55,32,23,0.5820000000000001,57,44,13,0.772
21200809,1610612741,1610612748,67.0,86.0,0.373,0.507,0,2013-02-21,54,31,23,0.574,52,38,14,0.731
21200810,1610612746,1610612759,90.0,116.0,0.421,0.589,0,2013-02-21,57,39,18,0.684,56,44,12,0.7859999999999999
21200798,1610612761,1610612763,82.0,88.0,0.366,0.363,0,2013-02-20,55,22,33,0.4,53,35,18,0.66
21200799,1610612766,1610612765,99.0,105.0,0.4039999999999999,0.494,0,2013-02-20,54,13,41,0.241,56,22,34,0.3929999999999999
21200801,1610612754,1610612752,125.0,91.0,0.532,0.337,1,2013-02-20,54,33,21,0.611,51,32,19,0.627
21200800,1610612739,1610612740,105.0,100.0,0.494,0.487,1,2013-02-20,54,17,37,0.315,55,19,36,0.345
21200802,1610612737,1610612748,90.0,103.0,0.5,0.474,0,2013-02-20,52,29,23,0.5579999999999999,51,37,14,0.725
21200803,1610612749,1610612751,94.0,97.0,0.467,0.4,0,2013-02-20,53,26,27,0.491,55,33,22,0.6
21200804,1610612745,1610612760,122.0,119.0,0.478,0.483,1,2013-02-20,56,30,26,0.536,54,39,15,0.722
21200805,1610612750,1610612755,94.0,87.0,0.4,0.3829999999999999,1,2013-02-20,51,20,31,0.392,52,22,30,0.423
21200806,1610612742,1610612753,111.0,96.0,0.477,0.4589999999999999,1,2013-02-20,53,24,29,0.4529999999999999,54,15,39,0.278
21200807,1610612747,1610612738,113.0,99.0,0.506,0.476,1,2013-02-20,55,26,29,0.473,54,28,26,0.519
21200808,1610612744,1610612756,108.0,98.0,0.483,0.476,1,2013-02-20,54,31,23,0.574,55,18,37,0.327
21200789,1610612764,1610612761,88.0,96.0,0.385,0.449,0,2013-02-19,52,15,37,0.288,54,22,32,0.407
21200790,1610612753,1610612766,92.0,105.0,0.416,0.469,0,2013-02-19,53,15,38,0.283,53,13,40,0.245
21200791,1610612751,1610612749,113.0,111.0,0.473,0.479,1,2013-02-19,54,32,22,0.593,52,26,26,0.5
21200792,1610612765,1610612763,91.0,105.0,0.4629999999999999,0.563,0,2013-02-19,55,21,34,0.382,52,34,18,0.654
21200793,1610612740,1610612741,87.0,96.0,0.417,0.4639999999999999,0,2013-02-19,54,19,35,0.352,53,31,22,0.585
21200794,1610612743,1610612738,97.0,90.0,0.429,0.4429999999999999,1,2013-02-19,55,34,21,0.618,53,28,25,0.528
21200795,1610612762,1610612744,115.0,101.0,0.5,0.47,1,2013-02-19,55,31,24,0.564,53,30,23,0.5660000000000001
21200796,1610612758,1610612759,102.0,108.0,0.3779999999999999,0.467,0,2013-02-19,55,19,36,0.345,55,43,12,0.782
21200797,1610612757,1610612756,98.0,102.0,0.413,0.5,0,2013-02-19,54,25,29,0.4629999999999999,54,18,36,0.3329999999999999
21200787,1610612760,1610612748,100.0,110.0,0.4379999999999999,0.466,0,2013-02-14,53,39,14,0.736,50,36,14,0.72
21200788,1610612747,1610612746,101.0,125.0,0.507,0.517,0,2013-02-14,54,25,29,0.4629999999999999,56,39,17,0.696
21200775,1610612753,1610612737,76.0,108.0,0.415,0.446,0,2013-02-13,52,15,37,0.288,51,29,22,0.569
21200776,1610612739,1610612759,95.0,96.0,0.412,0.452,0,2013-02-13,53,16,37,0.302,54,42,12,0.778
21200777,1610612754,1610612766,101.0,77.0,0.4320000000000001,0.317,1,2013-02-13,53,32,21,0.604,52,12,40,0.231
21200778,1610612738,1610612741,71.0,69.0,0.368,0.365,1,2013-02-13,52,28,24,0.5379999999999999,52,30,22,0.5770000000000001
21200779,1610612751,1610612743,119.0,108.0,0.547,0.532,1,2013-02-13,53,31,22,0.585,54,33,21,0.611
21200780,1610612752,1610612761,88.0,92.0,0.354,0.425,0,2013-02-13,50,32,18,0.64,53,21,32,0.396
21200781,1610612765,1610612764,96.0,85.0,0.4429999999999999,0.486,1,2013-02-13,54,21,33,0.389,51,15,36,0.294
21200782,1610612749,1610612755,94.0,92.0,0.42,0.447,1,2013-02-13,51,26,25,0.51,51,22,29,0.431
21200783,1610612740,1610612757,99.0,63.0,0.471,0.324,1,2013-02-13,53,19,34,0.358,53,25,28,0.472
21200784,1610612750,1610612762,93.0,97.0,0.341,0.4370000000000001,0,2013-02-13,50,19,31,0.38,54,30,24,0.556
21200785,1610612742,1610612758,123.0,100.0,0.467,0.413,1,2013-02-13,52,23,29,0.442,54,19,35,0.352
21200786,1610612746,1610612745,106.0,96.0,0.493,0.439,1,2013-02-13,55,38,17,0.691,55,29,26,0.527
21200769,1610612761,1610612743,109.0,108.0,0.47,0.518,1,2013-02-12,52,20,32,0.385,53,33,20,0.623
21200770,1610612748,1610612757,117.0,104.0,0.581,0.534,1,2013-02-12,49,35,14,0.7140000000000001,52,25,27,0.481
21200771,1610612763,1610612758,108.0,101.0,0.547,0.465,1,2013-02-12,51,33,18,0.647,53,19,34,0.358
21200772,1610612762,1610612760,109.0,94.0,0.483,0.5589999999999999,1,2013-02-12,53,29,24,0.547,52,39,13,0.75
21200773,1610612747,1610612756,91.0,85.0,0.434,0.412,1,2013-02-12,53,25,28,0.472,53,17,36,0.321
21200774,1610612744,1610612745,107.0,116.0,0.452,0.473,0,2013-02-12,52,30,22,0.5770000000000001,54,29,25,0.537
21200761,1610612755,1610612746,90.0,107.0,0.417,0.5870000000000001,0,2013-02-11,50,22,28,0.44,54,37,17,0.685
21200762,1610612766,1610612738,94.0,91.0,0.429,0.416,1,2013-02-11,51,12,39,0.235,51,27,24,0.529
21200763,1610612739,1610612750,92.0,100.0,0.506,0.52,0,2013-02-11,52,16,36,0.308,49,19,30,0.3879999999999999
21200764,1610612754,1610612751,84.0,89.0,0.344,0.3879999999999999,0,2013-02-11,52,31,21,0.596,52,30,22,0.5770000000000001
21200765,1610612765,1610612740,86.0,105.0,0.358,0.494,0,2013-02-11,53,20,33,0.377,52,18,34,0.346
21200766,1610612741,1610612759,89.0,103.0,0.474,0.52,0,2013-02-11,51,30,21,0.588,53,41,12,0.774
21200767,1610612749,1610612764,90.0,102.0,0.379,0.568,0,2013-02-11,50,25,25,0.5,50,15,35,0.3
21200768,1610612742,1610612737,101.0,105.0,0.4270000000000001,0.519,0,2013-02-11,51,22,29,0.431,50,28,22,0.56
21200752,1610612752,1610612746,88.0,102.0,0.446,0.513,0,2013-02-10,49,32,17,0.653,53,36,17,0.679
21200753,1610612748,1610612747,107.0,97.0,0.55,0.5,1,2013-02-10,48,34,14,0.708,52,24,28,0.462
21200754,1610612738,1610612743,118.0,114.0,0.3979999999999999,0.425,1,2013-02-10,50,27,23,0.54,52,33,19,0.635
21200755,1610612761,1610612740,102.0,89.0,0.513,0.493,1,2013-02-10,51,19,32,0.373,51,17,34,0.3329999999999999
21200756,1610612753,1610612757,110.0,104.0,0.505,0.506,1,2013-02-10,51,15,36,0.294,51,25,26,0.49
21200757,1610612763,1610612750,105.0,88.0,0.519,0.493,1,2013-02-10,50,32,18,0.64,48,18,30,0.375
21200758,1610612751,1610612759,86.0,111.0,0.472,0.589,0,2013-02-10,51,29,22,0.569,52,40,12,0.769
21200759,1610612756,1610612760,69.0,97.0,0.33,0.447,0,2013-02-10,52,17,35,0.327,51,39,12,0.765
21200760,1610612758,1610612745,117.0,111.0,0.46,0.494,1,2013-02-10,52,19,33,0.365,53,28,25,0.528
21200747,1610612739,1610612743,103.0,111.0,0.44,0.5,0,2013-02-09,51,16,35,0.314,51,33,18,0.647
21200748,1610612755,1610612766,87.0,76.0,0.419,0.307,1,2013-02-09,49,22,27,0.449,50,11,39,0.22
21200749,1610612749,1610612765,100.0,105.0,0.395,0.494,0,2013-02-09,49,25,24,0.51,52,20,32,0.385
21200750,1610612742,1610612744,116.0,91.0,0.494,0.382,1,2013-02-09,50,22,28,0.44,51,30,21,0.588
21200751,1610612758,1610612762,120.0,109.0,0.518,0.488,1,2013-02-09,51,18,33,0.353,52,28,24,0.5379999999999999
21200735,1610612764,1610612751,89.0,74.0,0.45,0.3289999999999999,1,2013-02-08,49,14,35,0.286,50,29,21,0.58
21200736,1610612766,1610612747,93.0,100.0,0.4270000000000001,0.45,0,2013-02-08,49,11,38,0.2239999999999999,51,24,27,0.471
21200737,1610612754,1610612761,98.0,100.0,0.449,0.4379999999999999,0,2013-02-08,51,31,20,0.608,50,18,32,0.36
21200738,1610612737,1610612740,100.0,111.0,0.473,0.523,0,2013-02-08,49,27,22,0.551,50,17,33,0.34
21200739,1610612765,1610612759,119.0,109.0,0.517,0.457,1,2013-02-08,51,19,32,0.373,51,39,12,0.765
21200740,1610612739,1610612753,119.0,108.0,0.488,0.523,1,2013-02-08,50,16,34,0.32,50,14,36,0.28
21200741,1610612748,1610612746,111.0,89.0,0.529,0.442,1,2013-02-08,47,33,14,0.7020000000000001,52,35,17,0.6729999999999999
21200742,1610612763,1610612744,99.0,93.0,0.456,0.486,1,2013-02-08,49,31,18,0.633,50,30,20,0.6
21200743,1610612745,1610612757,118.0,103.0,0.595,0.455,1,2013-02-08,52,28,24,0.5379999999999999,50,25,25,0.5
21200744,1610612760,1610612756,127.0,96.0,0.575,0.47,1,2013-02-08,50,38,12,0.76,51,17,34,0.3329999999999999
21200745,1610612750,1610612752,94.0,100.0,0.4629999999999999,0.469,0,2013-02-08,47,18,29,0.3829999999999999,48,32,16,0.667
21200746,1610612762,1610612741,89.0,93.0,0.474,0.456,0,2013-02-08,51,28,23,0.5489999999999999,50,30,20,0.6
21200733,1610612738,1610612747,116.0,95.0,0.529,0.414,1,2013-02-07,49,26,23,0.531,50,23,27,0.46
21200734,1610612743,1610612741,128.0,96.0,0.581,0.418,1,2013-02-07,50,32,18,0.64,49,29,20,0.5920000000000001
21200720,1610612761,1610612738,95.0,99.0,0.415,0.479,0,2013-02-06,49,17,32,0.347,48,25,23,0.521
21200721,1610612755,1610612754,69.0,88.0,0.348,0.395,0,2013-02-06,48,21,27,0.4379999999999999,50,31,19,0.62
21200722,1610612764,1610612752,106.0,96.0,0.532,0.405,1,2013-02-06,48,13,35,0.271,47,31,16,0.66
21200723,1610612753,1610612746,76.0,86.0,0.345,0.402,0,2013-02-06,49,14,35,0.286,51,35,16,0.6859999999999999
21200724,1610612739,1610612766,122.0,95.0,0.565,0.4679999999999999,1,2013-02-06,49,15,34,0.306,48,11,37,0.2289999999999999
21200725,1610612737,1610612763,103.0,92.0,0.514,0.452,1,2013-02-06,48,27,21,0.563,48,30,18,0.625
21200726,1610612748,1610612745,114.0,108.0,0.488,0.488,1,2013-02-06,46,32,14,0.696,51,27,24,0.529
21200727,1610612765,1610612751,90.0,93.0,0.434,0.415,0,2013-02-06,50,18,32,0.36,49,29,20,0.5920000000000001
21200728,1610612740,1610612756,93.0,84.0,0.52,0.449,1,2013-02-06,49,16,33,0.327,50,17,33,0.34
21200729,1610612760,1610612744,119.0,98.0,0.505,0.409,1,2013-02-06,49,37,12,0.755,49,30,19,0.612
21200730,1610612742,1610612757,105.0,99.0,0.477,0.429,1,2013-02-06,49,21,28,0.429,49,25,24,0.51
21200731,1610612750,1610612759,94.0,104.0,0.407,0.457,0,2013-02-06,46,18,28,0.391,50,39,11,0.78
21200732,1610612762,1610612749,100.0,86.0,0.481,0.354,1,2013-02-06,50,28,22,0.56,48,25,23,0.521
21200715,1610612754,1610612737,114.0,103.0,0.48,0.444,1,2013-02-05,49,30,19,0.612,47,26,21,0.5529999999999999
21200716,1610612751,1610612747,83.0,92.0,0.348,0.451,0,2013-02-05,48,28,20,0.583,49,23,26,0.469
21200717,1610612763,1610612756,90.0,96.0,0.439,0.507,0,2013-02-05,47,30,17,0.638,49,17,32,0.347
21200718,1610612745,1610612744,140.0,109.0,0.505,0.477,1,2013-02-05,50,27,23,0.54,48,30,18,0.625
21200719,1610612743,1610612749,112.0,104.0,0.44,0.48,1,2013-02-05,49,31,18,0.633,47,25,22,0.532
21200413,1610612754,1610612741,111.0,101.0,0.527,0.4429999999999999,1,2013-02-04,48,29,19,0.604,48,29,19,0.604
21200708,1610612755,1610612753,78.0,61.0,0.456,0.3379999999999999,1,2013-02-04,47,21,26,0.447,48,14,34,0.292
21200709,1610612764,1610612746,98.0,90.0,0.44,0.4679999999999999,1,2013-02-04,47,12,35,0.255,50,34,16,0.68
21200710,1610612752,1610612765,99.0,85.0,0.456,0.422,1,2013-02-04,46,31,15,0.674,49,18,31,0.3670000000000001
21200711,1610612748,1610612766,99.0,94.0,0.506,0.425,1,2013-02-04,45,31,14,0.6890000000000001,47,11,36,0.2339999999999999
21200712,1610612760,1610612742,112.0,91.0,0.471,0.414,1,2013-02-04,48,36,12,0.75,48,20,28,0.417
21200713,1610612750,1610612757,98.0,100.0,0.471,0.586,0,2013-02-04,45,18,27,0.4,48,25,23,0.521
21200714,1610612762,1610612758,98.0,91.0,0.528,0.402,1,2013-02-04,49,27,22,0.551,50,17,33,0.34
21200705,1610612738,1610612746,106.0,104.0,0.5,0.506,1,2013-02-03,47,24,23,0.511,49,34,15,0.6940000000000001
21200706,1610612765,1610612747,97.0,98.0,0.446,0.47,0,2013-02-03,48,18,30,0.375,48,22,26,0.4579999999999999
21200707,1610612761,1610612748,85.0,100.0,0.373,0.5329999999999999,0,2013-02-03,48,17,31,0.354,44,30,14,0.682
21200696,1610612737,1610612741,76.0,93.0,0.392,0.409,0,2013-02-02,46,26,20,0.565,47,29,18,0.617
21200697,1610612752,1610612758,120.0,81.0,0.547,0.421,1,2013-02-02,45,30,15,0.667,49,17,32,0.347
21200698,1610612739,1610612760,115.0,110.0,0.478,0.494,1,2013-02-02,48,14,34,0.292,47,35,12,0.745
21200699,1610612745,1610612766,109.0,95.0,0.512,0.418,1,2013-02-02,49,26,23,0.531,46,11,35,0.239
21200700,1610612750,1610612740,115.0,86.0,0.584,0.4,1,2013-02-02,44,18,26,0.409,48,15,33,0.313
21200701,1610612749,1610612753,107.0,98.0,0.467,0.436,1,2013-02-02,46,25,21,0.5429999999999999,47,14,33,0.298
21200702,1610612759,1610612764,96.0,86.0,0.487,0.409,1,2013-02-02,49,38,11,0.7759999999999999,46,11,35,0.239
21200703,1610612757,1610612762,105.0,99.0,0.507,0.433,1,2013-02-02,47,24,23,0.511,48,26,22,0.542
21200704,1610612744,1610612756,113.0,93.0,0.506,0.407,1,2013-02-02,47,30,17,0.638,48,16,32,0.3329999999999999
21200684,1610612761,1610612746,98.0,73.0,0.469,0.347,1,2013-02-01,47,17,30,0.362,48,34,14,0.708
21200685,1610612754,1610612748,102.0,89.0,0.557,0.471,1,2013-02-01,47,28,19,0.596,43,29,14,0.674
21200686,1610612738,1610612753,97.0,84.0,0.5,0.379,1,2013-02-01,46,23,23,0.5,46,14,32,0.304
21200687,1610612751,1610612741,93.0,89.0,0.52,0.436,1,2013-02-01,47,28,19,0.596,46,28,18,0.609
21200688,1610612752,1610612749,96.0,86.0,0.421,0.3979999999999999,1,2013-02-01,44,29,15,0.659,45,24,21,0.5329999999999999
21200689,1610612755,1610612758,89.0,80.0,0.474,0.38,1,2013-02-01,46,20,26,0.435,48,17,31,0.354
21200690,1610612765,1610612739,117.0,99.0,0.542,0.3979999999999999,1,2013-02-01,47,18,29,0.3829999999999999,47,13,34,0.2769999999999999
21200691,1610612763,1610612764,85.0,76.0,0.449,0.41,1,2013-02-01,46,30,16,0.652,45,11,34,0.244
21200692,1610612743,1610612740,113.0,98.0,0.524,0.528,1,2013-02-01,48,30,18,0.625,47,15,32,0.319
21200693,1610612762,1610612757,86.0,77.0,0.4320000000000001,0.3670000000000001,1,2013-02-01,47,26,21,0.5529999999999999,46,23,23,0.5
21200694,1610612756,1610612742,99.0,109.0,0.4270000000000001,0.455,0,2013-02-01,47,16,31,0.34,47,20,27,0.426
21200695,1610612750,1610612747,100.0,111.0,0.461,0.424,0,2013-02-01,43,17,26,0.395,47,21,26,0.447
21200682,1610612760,1610612763,106.0,89.0,0.556,0.347,1,2013-01-31,46,35,11,0.7609999999999999,45,29,16,0.644
21200683,1610612744,1610612742,100.0,97.0,0.429,0.444,1,2013-01-31,46,29,17,0.63,46,19,27,0.413
21200670,1610612755,1610612764,92.0,84.0,0.421,0.4,1,2013-01-30,45,19,26,0.422,44,11,33,0.25
21200671,1610612754,1610612765,98.0,79.0,0.444,0.364,1,2013-01-30,46,27,19,0.5870000000000001,46,17,29,0.37
21200672,1610612738,1610612758,99.0,81.0,0.534,0.397,1,2013-01-30,45,22,23,0.489,47,17,30,0.362
21200673,1610612752,1610612753,113.0,97.0,0.573,0.494,1,2013-01-30,43,28,15,0.6509999999999999,45,14,31,0.311
21200674,1610612737,1610612761,93.0,92.0,0.48,0.3879999999999999,1,2013-01-30,45,26,19,0.578,46,16,30,0.348
21200675,1610612751,1610612748,85.0,105.0,0.449,0.518,0,2013-01-30,46,27,19,0.5870000000000001,42,29,13,0.69
21200676,1610612749,1610612741,88.0,104.0,0.415,0.495,0,2013-01-30,44,24,20,0.545,45,28,17,0.622
21200677,1610612750,1610612746,90.0,96.0,0.434,0.461,0,2013-01-30,42,17,25,0.405,47,34,13,0.723
21200678,1610612759,1610612766,102.0,78.0,0.551,0.411,1,2013-01-30,48,37,11,0.7709999999999999,45,11,34,0.244
21200679,1610612743,1610612745,118.0,110.0,0.512,0.481,1,2013-01-30,47,29,18,0.617,48,25,23,0.521
21200680,1610612762,1610612740,104.0,99.0,0.5,0.474,1,2013-01-30,46,25,21,0.5429999999999999,46,15,31,0.326
21200681,1610612756,1610612747,92.0,86.0,0.4579999999999999,0.423,1,2013-01-30,46,16,30,0.348,46,20,26,0.435
21200666,1610612739,1610612744,95.0,108.0,0.429,0.536,0,2013-01-29,46,13,33,0.283,45,28,17,0.622
21200667,1610612765,1610612749,90.0,117.0,0.405,0.469,0,2013-01-29,45,17,28,0.3779999999999999,43,24,19,0.5579999999999999
21200668,1610612757,1610612742,106.0,104.0,0.4529999999999999,0.5,1,2013-01-29,45,23,22,0.511,45,19,26,0.422
21200669,1610612747,1610612740,111.0,106.0,0.494,0.424,1,2013-01-29,45,20,25,0.444,45,15,30,0.3329999999999999
21200659,1610612761,1610612744,102.0,114.0,0.4370000000000001,0.535,0,2013-01-28,45,16,29,0.356,44,27,17,0.614
21200660,1610612755,1610612763,100.0,103.0,0.542,0.5479999999999999,0,2013-01-28,44,18,26,0.409,44,29,15,0.659
21200661,1610612764,1610612758,94.0,96.0,0.481,0.439,0,2013-01-28,43,11,32,0.256,46,17,29,0.37
21200662,1610612751,1610612753,97.0,77.0,0.5,0.405,1,2013-01-28,45,27,18,0.6,44,14,30,0.318
21200663,1610612741,1610612766,93.0,85.0,0.449,0.395,1,2013-01-28,44,27,17,0.614,44,11,33,0.25
21200664,1610612743,1610612754,102.0,101.0,0.474,0.4589999999999999,1,2013-01-28,46,28,18,0.609,45,26,19,0.578
21200665,1610612762,1610612745,80.0,125.0,0.395,0.528,0,2013-01-28,45,24,21,0.5329999999999999,47,25,22,0.532
21200652,1610612738,1610612748,100.0,98.0,0.409,0.406,1,2013-01-27,44,21,23,0.477,41,28,13,0.6829999999999999
21200653,1610612747,1610612760,105.0,96.0,0.5539999999999999,0.444,1,2013-01-27,44,19,25,0.4320000000000001,45,34,11,0.7559999999999999
21200654,1610612753,1610612765,102.0,104.0,0.444,0.506,0,2013-01-27,43,14,29,0.326,44,17,27,0.386
21200655,1610612763,1610612740,83.0,91.0,0.364,0.429,0,2013-01-27,43,28,15,0.6509999999999999,44,15,29,0.341
21200656,1610612752,1610612737,106.0,104.0,0.542,0.6,1,2013-01-27,42,27,15,0.643,44,25,19,0.568
21200657,1610612742,1610612756,110.0,95.0,0.511,0.442,1,2013-01-27,44,19,25,0.4320000000000001,45,15,30,0.3329999999999999
21200658,1610612746,1610612757,96.0,83.0,0.512,0.439,1,2013-01-27,46,33,13,0.7170000000000001,44,22,22,0.5
21200642,1610612761,1610612739,98.0,99.0,0.488,0.474,0,2013-01-26,44,16,28,0.364,45,13,32,0.289
21200643,1610612755,1610612752,97.0,80.0,0.507,0.346,1,2013-01-26,43,18,25,0.419,41,26,15,0.634
21200644,1610612764,1610612741,86.0,73.0,0.43,0.408,1,2013-01-26,42,11,31,0.262,43,26,17,0.605
21200645,1610612766,1610612750,102.0,101.0,0.507,0.481,1,2013-01-26,43,11,32,0.256,41,17,24,0.415
21200646,1610612745,1610612751,119.0,106.0,0.494,0.45,1,2013-01-26,46,24,22,0.522,44,26,18,0.591
21200647,1610612749,1610612744,109.0,102.0,0.406,0.419,1,2013-01-26,42,23,19,0.5479999999999999,43,26,17,0.605
21200648,1610612759,1610612756,108.0,99.0,0.494,0.506,1,2013-01-26,47,36,11,0.7659999999999999,44,15,29,0.341
21200649,1610612743,1610612758,121.0,93.0,0.528,0.42,1,2013-01-26,45,27,18,0.6,45,16,29,0.356
21200650,1610612762,1610612754,114.0,110.0,0.53,0.537,1,2013-01-26,44,24,20,0.545,44,26,18,0.591
21200651,1610612757,1610612746,101.0,100.0,0.467,0.494,1,2013-01-26,43,22,21,0.512,45,32,13,0.711
21200632,1610612764,1610612750,114.0,101.0,0.578,0.4429999999999999,1,2013-01-25,41,10,31,0.244,40,17,23,0.425
21200633,1610612737,1610612738,123.0,111.0,0.447,0.452,1,2013-01-25,43,25,18,0.581,43,20,23,0.465
21200634,1610612748,1610612765,110.0,88.0,0.5579999999999999,0.472,1,2013-01-25,40,28,12,0.7,43,16,27,0.3720000000000001
21200635,1610612739,1610612749,113.0,108.0,0.523,0.467,1,2013-01-25,44,12,32,0.273,41,22,19,0.537
21200636,1610612741,1610612744,103.0,87.0,0.466,0.346,1,2013-01-25,42,26,16,0.619,42,26,16,0.619
21200637,1610612763,1610612751,101.0,77.0,0.522,0.408,1,2013-01-25,42,28,14,0.667,43,26,17,0.605
21200638,1610612740,1610612745,82.0,100.0,0.3879999999999999,0.479,0,2013-01-25,43,14,29,0.326,45,23,22,0.511
21200639,1610612742,1610612759,107.0,113.0,0.462,0.483,0,2013-01-25,43,18,25,0.419,46,35,11,0.7609999999999999
21200640,1610612758,1610612760,95.0,105.0,0.419,0.487,0,2013-01-25,44,16,28,0.364,44,34,10,0.773
21200641,1610612747,1610612762,102.0,84.0,0.5379999999999999,0.42,1,2013-01-25,43,18,25,0.419,43,23,20,0.535
21200629,1610612753,1610612761,95.0,97.0,0.4320000000000001,0.5,0,2013-01-24,42,14,28,0.3329999999999999,43,16,27,0.3720000000000001
21200630,1610612738,1610612752,86.0,89.0,0.408,0.386,0,2013-01-24,42,20,22,0.476,40,26,14,0.65
21200631,1610612756,1610612746,93.0,88.0,0.423,0.3979999999999999,1,2013-01-24,43,15,28,0.349,44,32,12,0.727
21200620,1610612741,1610612765,85.0,82.0,0.4370000000000001,0.415,1,2013-01-23,41,25,16,0.61,42,16,26,0.381
21200618,1610612766,1610612737,92.0,104.0,0.408,0.494,0,2013-01-23,42,10,32,0.238,42,24,18,0.5710000000000001
21200626,1610612758,1610612756,96.0,106.0,0.481,0.478,0,2013-01-23,43,16,27,0.3720000000000001,42,14,28,0.3329999999999999
21200619,1610612748,1610612761,123.0,116.0,0.5489999999999999,0.5,1,2013-01-23,39,27,12,0.6920000000000001,42,15,27,0.357
21200627,1610612757,1610612754,100.0,80.0,0.564,0.375,1,2013-01-23,42,21,21,0.5,43,26,17,0.605
21200621,1610612763,1610612747,106.0,93.0,0.49,0.425,1,2013-01-23,41,27,14,0.659,42,17,25,0.405
21200622,1610612745,1610612743,95.0,105.0,0.446,0.465,0,2013-01-23,44,22,22,0.5,44,26,18,0.591
21200628,1610612744,1610612760,104.0,99.0,0.44,0.462,1,2013-01-23,41,26,15,0.634,43,33,10,0.767
21200623,1610612750,1610612751,83.0,91.0,0.4579999999999999,0.44,0,2013-01-23,39,17,22,0.436,42,26,16,0.619
21200624,1610612759,1610612740,106.0,102.0,0.5379999999999999,0.469,1,2013-01-23,45,34,11,0.7559999999999999,42,14,28,0.3329999999999999
21200625,1610612762,1610612764,92.0,88.0,0.447,0.36,1,2013-01-23,42,23,19,0.5479999999999999,40,9,31,0.225
21200617,1610612746,1610612760,97.0,109.0,0.4639999999999999,0.526,0,2013-01-22,43,32,11,0.7440000000000001,42,33,9,0.7859999999999999
21200614,1610612739,1610612738,95.0,90.0,0.451,0.381,1,2013-01-22,43,11,32,0.256,41,20,21,0.488
21200616,1610612749,1610612755,110.0,102.0,0.519,0.442,1,2013-01-22,40,22,18,0.55,42,17,25,0.405
21200615,1610612765,1610612753,105.0,90.0,0.462,0.452,1,2013-01-22,41,16,25,0.39,41,14,27,0.341
21200605,1610612763,1610612754,81.0,82.0,0.422,0.493,0,2013-01-21,40,26,14,0.65,42,26,16,0.619
21200606,1610612740,1610612758,114.0,105.0,0.483,0.469,1,2013-01-21,41,14,27,0.341,42,16,26,0.381
21200607,1610612766,1610612745,94.0,100.0,0.42,0.392,0,2013-01-21,41,10,31,0.244,43,22,21,0.512
21200608,1610612737,1610612750,104.0,96.0,0.5770000000000001,0.486,1,2013-01-21,41,23,18,0.561,38,17,21,0.447
21200609,1610612752,1610612751,85.0,88.0,0.405,0.419,0,2013-01-21,39,25,14,0.6409999999999999,41,25,16,0.61
21200610,1610612744,1610612746,106.0,99.0,0.52,0.4579999999999999,1,2013-01-21,40,25,15,0.625,42,32,10,0.762
21200611,1610612755,1610612759,85.0,90.0,0.44,0.42,0,2013-01-21,41,17,24,0.415,44,33,11,0.75
21200612,1610612741,1610612747,95.0,83.0,0.419,0.395,1,2013-01-21,40,24,16,0.6,41,17,24,0.415
21200613,1610612757,1610612764,95.0,98.0,0.457,0.4639999999999999,0,2013-01-21,41,20,21,0.488,39,9,30,0.231
21200601,1610612761,1610612747,108.0,103.0,0.5479999999999999,0.4320000000000001,1,2013-01-20,41,15,26,0.366,40,17,23,0.425
21200602,1610612753,1610612742,105.0,111.0,0.506,0.5,0,2013-01-20,40,14,26,0.35,42,18,24,0.429
21200603,1610612765,1610612738,103.0,88.0,0.462,0.3979999999999999,1,2013-01-20,40,15,25,0.375,40,20,20,0.5
21200604,1610612743,1610612760,121.0,118.0,0.484,0.461,1,2013-01-20,43,25,18,0.581,41,32,9,0.78
21200593,1610612766,1610612758,93.0,97.0,0.431,0.457,0,2013-01-19,40,10,30,0.25,41,16,25,0.39
21200594,1610612737,1610612759,93.0,98.0,0.412,0.477,0,2013-01-19,40,22,18,0.55,43,32,11,0.7440000000000001
21200595,1610612741,1610612763,82.0,85.0,0.365,0.405,0,2013-01-19,39,23,16,0.59,39,26,13,0.667
21200596,1610612740,1610612744,112.0,116.0,0.57,0.494,0,2013-01-19,40,13,27,0.325,39,24,15,0.615
21200597,1610612750,1610612745,92.0,79.0,0.469,0.321,1,2013-01-19,37,17,20,0.4589999999999999,42,21,21,0.5
21200598,1610612762,1610612739,109.0,98.0,0.5,0.41,1,2013-01-19,41,22,19,0.537,42,10,32,0.238
21200599,1610612757,1610612749,104.0,110.0,0.42,0.4429999999999999,0,2013-01-19,40,20,20,0.5,39,21,18,0.5379999999999999
21200600,1610612746,1610612764,94.0,87.0,0.366,0.416,1,2013-01-19,41,32,9,0.78,38,8,30,0.211
21200584,1610612738,1610612741,99.0,100.0,0.418,0.48,0,2013-01-18,39,20,19,0.513,38,23,15,0.605
21200585,1610612755,1610612761,108.0,101.0,0.516,0.455,1,2013-01-18,40,17,23,0.425,40,14,26,0.35
21200586,1610612753,1610612766,100.0,106.0,0.4679999999999999,0.4679999999999999,0,2013-01-18,39,14,25,0.359,39,10,29,0.256
21200587,1610612754,1610612745,105.0,95.0,0.46,0.41,1,2013-01-18,41,25,16,0.61,41,21,20,0.512
21200588,1610612751,1610612737,94.0,89.0,0.405,0.4379999999999999,1,2013-01-18,40,24,16,0.6,39,22,17,0.564
21200589,1610612763,1610612758,85.0,69.0,0.436,0.341,1,2013-01-18,38,25,13,0.6579999999999999,40,15,25,0.375
21200590,1610612759,1610612744,95.0,88.0,0.45,0.429,1,2013-01-18,42,31,11,0.738,38,23,15,0.605
21200591,1610612743,1610612764,108.0,112.0,0.488,0.513,0,2013-01-18,42,24,18,0.5710000000000001,37,8,29,0.216
21200592,1610612742,1610612760,114.0,117.0,0.451,0.411,0,2013-01-18,41,17,24,0.415,40,32,8,0.8
21200580,1610612765,1610612752,87.0,102.0,0.4429999999999999,0.4579999999999999,0,2013-01-17,39,14,25,0.359,38,25,13,0.6579999999999999
21200581,1610612750,1610612746,77.0,90.0,0.357,0.455,0,2013-01-17,36,16,20,0.444,40,31,9,0.775
21200582,1610612756,1610612749,94.0,98.0,0.382,0.424,0,2013-01-17,41,13,28,0.317,38,20,18,0.526
21200583,1610612747,1610612748,90.0,99.0,0.431,0.482,0,2013-01-17,39,17,22,0.436,38,26,12,0.684
21200570,1610612761,1610612741,105.0,107.0,0.447,0.4529999999999999,0,2013-01-16,39,14,25,0.359,37,22,15,0.595
21200571,1610612753,1610612754,97.0,86.0,0.465,0.435,1,2013-01-16,38,14,24,0.368,40,24,16,0.6
21200572,1610612737,1610612751,109.0,95.0,0.5770000000000001,0.425,1,2013-01-16,38,22,16,0.579,39,23,16,0.59
21200573,1610612738,1610612740,78.0,90.0,0.4589999999999999,0.4370000000000001,0,2013-01-16,38,20,18,0.526,39,13,26,0.3329999999999999
21200574,1610612760,1610612743,117.0,97.0,0.518,0.452,1,2013-01-16,39,31,8,0.795,41,24,17,0.585
21200575,1610612742,1610612745,105.0,100.0,0.384,0.3929999999999999,1,2013-01-16,40,17,23,0.425,40,21,19,0.525
21200576,1610612759,1610612763,103.0,82.0,0.579,0.42,1,2013-01-16,41,30,11,0.732,37,24,13,0.649
21200577,1610612758,1610612764,95.0,94.0,0.482,0.4529999999999999,1,2013-01-16,39,15,24,0.385,36,7,29,0.1939999999999999
21200578,1610612757,1610612739,88.0,93.0,0.392,0.386,0,2013-01-16,39,20,19,0.513,41,10,31,0.244
21200579,1610612744,1610612748,75.0,92.0,0.363,0.4,0,2013-01-16,37,23,14,0.622,37,25,12,0.6759999999999999
21200564,1610612755,1610612740,99.0,111.0,0.476,0.53,0,2013-01-15,39,16,23,0.41,38,12,26,0.316
21200565,1610612766,1610612754,76.0,103.0,0.347,0.414,0,2013-01-15,38,9,29,0.237,39,24,15,0.615
21200566,1610612751,1610612761,113.0,106.0,0.494,0.488,1,2013-01-15,38,23,15,0.605,38,14,24,0.368
21200567,1610612745,1610612746,109.0,117.0,0.5,0.5379999999999999,0,2013-01-15,39,21,18,0.5379999999999999,39,30,9,0.769
21200568,1610612743,1610612757,115.0,111.0,0.475,0.477,1,2013-01-15,40,24,16,0.6,38,20,18,0.526
21200569,1610612747,1610612749,104.0,88.0,0.5,0.358,1,2013-01-15,38,17,21,0.447,37,19,18,0.514
21200556,1610612764,1610612753,120.0,91.0,0.561,0.425,1,2013-01-14,35,7,28,0.2,37,13,24,0.351
21200557,1610612738,1610612766,100.0,89.0,0.488,0.418,1,2013-01-14,37,20,17,0.541,37,9,28,0.243
21200558,1610612741,1610612737,97.0,58.0,0.418,0.293,1,2013-01-14,36,21,15,0.583,37,21,16,0.568
21200559,1610612763,1610612746,73.0,99.0,0.303,0.461,0,2013-01-14,36,24,12,0.667,38,29,9,0.763
21200560,1610612742,1610612750,113.0,98.0,0.597,0.412,1,2013-01-14,39,16,23,0.41,35,16,19,0.457
21200561,1610612762,1610612748,104.0,97.0,0.474,0.542,1,2013-01-14,40,21,19,0.525,36,24,12,0.667
21200562,1610612756,1610612760,90.0,102.0,0.417,0.476,0,2013-01-14,40,13,27,0.325,38,30,8,0.789
21200563,1610612758,1610612739,124.0,118.0,0.512,0.478,1,2013-01-14,38,14,24,0.368,40,9,31,0.225
21200549,1610612752,1610612740,100.0,87.0,0.4320000000000001,0.402,1,2013-01-13,37,24,13,0.649,37,11,26,0.297
21200550,1610612761,1610612749,96.0,107.0,0.424,0.519,0,2013-01-13,37,14,23,0.3779999999999999,36,19,17,0.528
21200551,1610612751,1610612754,97.0,86.0,0.407,0.422,1,2013-01-13,37,22,15,0.595,38,23,15,0.605
21200552,1610612759,1610612750,106.0,88.0,0.563,0.371,1,2013-01-13,40,29,11,0.725,34,16,18,0.471
21200553,1610612743,1610612744,116.0,105.0,0.478,0.518,1,2013-01-13,39,23,16,0.59,36,23,13,0.639
21200554,1610612757,1610612760,83.0,87.0,0.36,0.451,0,2013-01-13,37,20,17,0.541,37,29,8,0.784
21200555,1610612747,1610612739,113.0,93.0,0.58,0.411,1,2013-01-13,37,16,21,0.4320000000000001,39,9,30,0.231
21200541,1610612746,1610612753,101.0,104.0,0.489,0.481,0,2013-01-12,37,28,9,0.757,36,13,23,0.361
21200542,1610612764,1610612737,93.0,83.0,0.456,0.385,1,2013-01-12,34,6,28,0.176,36,21,15,0.583
21200543,1610612754,1610612766,96.0,88.0,0.4270000000000001,0.462,1,2013-01-12,37,23,14,0.622,36,9,27,0.25
21200544,1610612755,1610612745,107.0,100.0,0.494,0.44,1,2013-01-12,38,16,22,0.421,38,21,17,0.5529999999999999
21200545,1610612765,1610612762,87.0,90.0,0.523,0.507,0,2013-01-12,38,14,24,0.368,39,20,19,0.513
21200546,1610612741,1610612756,81.0,97.0,0.364,0.493,0,2013-01-12,35,20,15,0.5710000000000001,39,13,26,0.3329999999999999
21200547,1610612742,1610612763,104.0,83.0,0.488,0.381,1,2013-01-12,38,15,23,0.395,35,24,11,0.6859999999999999
21200548,1610612758,1610612748,99.0,128.0,0.4370000000000001,0.563,0,2013-01-12,37,13,24,0.351,35,24,11,0.6859999999999999
21200530,1610612761,1610612766,99.0,78.0,0.4529999999999999,0.373,1,2013-01-11,36,14,22,0.389,35,9,26,0.257
21200531,1610612738,1610612745,103.0,91.0,0.519,0.4379999999999999,1,2013-01-11,36,19,17,0.528,37,21,16,0.568
21200532,1610612751,1610612756,99.0,79.0,0.4529999999999999,0.392,1,2013-01-11,36,21,15,0.583,38,12,26,0.316
21200533,1610612737,1610612762,103.0,95.0,0.556,0.474,1,2013-01-11,35,21,14,0.6,38,19,19,0.5
21200534,1610612752,1610612741,101.0,108.0,0.411,0.574,0,2013-01-11,36,23,13,0.639,34,20,14,0.588
21200535,1610612763,1610612759,101.0,98.0,0.471,0.461,1,2013-01-11,34,24,10,0.706,39,28,11,0.718
21200536,1610612740,1610612750,104.0,92.0,0.524,0.449,1,2013-01-11,36,11,25,0.306,33,16,17,0.485
21200537,1610612749,1610612765,87.0,103.0,0.396,0.433,0,2013-01-11,35,18,17,0.514,37,14,23,0.3779999999999999
21200538,1610612743,1610612739,98.0,91.0,0.439,0.435,1,2013-01-11,38,22,16,0.579,38,9,29,0.237
21200539,1610612747,1610612760,101.0,116.0,0.3979999999999999,0.506,0,2013-01-11,36,15,21,0.417,36,28,8,0.778
21200540,1610612744,1610612757,103.0,97.0,0.477,0.38,1,2013-01-11,35,23,12,0.657,36,20,16,0.556
21200527,1610612754,1610612752,81.0,76.0,0.392,0.348,1,2013-01-10,36,22,14,0.611,35,23,12,0.657
21200528,1610612758,1610612742,112.0,117.0,0.494,0.4270000000000001,0,2013-01-10,36,13,23,0.361,37,14,23,0.3779999999999999
21200529,1610612757,1610612748,92.0,90.0,0.375,0.455,1,2013-01-10,35,20,15,0.5710000000000001,34,23,11,0.6759999999999999
21200516,1610612761,1610612755,90.0,72.0,0.488,0.392,1,2013-01-09,35,13,22,0.371,37,15,22,0.405
21200517,1610612766,1610612762,102.0,112.0,0.477,0.537,0,2013-01-09,34,9,25,0.265,37,19,18,0.514
21200518,1610612739,1610612737,99.0,83.0,0.457,0.44,1,2013-01-09,37,9,28,0.243,34,20,14,0.588
21200519,1610612738,1610612756,87.0,79.0,0.457,0.3929999999999999,1,2013-01-09,35,18,17,0.514,37,12,25,0.324
21200520,1610612741,1610612749,96.0,104.0,0.411,0.4639999999999999,0,2013-01-09,33,19,14,0.5760000000000001,34,18,16,0.529
21200521,1610612740,1610612745,88.0,79.0,0.417,0.4,1,2013-01-09,35,10,25,0.286,36,21,15,0.583
21200522,1610612759,1610612747,108.0,105.0,0.488,0.4629999999999999,1,2013-01-09,38,28,10,0.737,35,15,20,0.429
21200523,1610612760,1610612750,106.0,84.0,0.474,0.431,1,2013-01-09,35,27,8,0.7709999999999999,32,16,16,0.5
21200524,1610612743,1610612753,108.0,105.0,0.436,0.473,1,2013-01-09,37,21,16,0.568,35,12,23,0.3429999999999999
21200525,1610612746,1610612742,99.0,93.0,0.481,0.429,1,2013-01-09,36,28,8,0.778,36,13,23,0.361
21200526,1610612744,1610612763,87.0,94.0,0.465,0.455,0,2013-01-09,34,22,12,0.647,33,23,10,0.6970000000000001
21200511,1610612755,1610612751,89.0,109.0,0.481,0.482,0,2013-01-08,36,15,21,0.417,35,20,15,0.5710000000000001
21200512,1610612754,1610612748,87.0,77.0,0.363,0.412,1,2013-01-08,35,21,14,0.6,33,23,10,0.6970000000000001
21200513,1610612749,1610612756,108.0,99.0,0.462,0.411,1,2013-01-08,33,17,16,0.515,36,12,24,0.3329999999999999
21200514,1610612745,1610612747,125.0,112.0,0.552,0.473,1,2013-01-08,35,21,14,0.6,34,15,19,0.441
21200515,1610612750,1610612737,108.0,103.0,0.46,0.494,1,2013-01-08,31,16,15,0.516,33,20,13,0.606
21200504,1610612764,1610612760,101.0,99.0,0.4370000000000001,0.425,1,2013-01-07,33,5,28,0.152,34,26,8,0.765
21200505,1610612752,1610612738,96.0,102.0,0.408,0.527,0,2013-01-07,34,23,11,0.6759999999999999,34,17,17,0.5
21200506,1610612741,1610612739,118.0,92.0,0.537,0.423,1,2013-01-07,32,19,13,0.594,36,8,28,0.222
21200507,1610612740,1610612759,95.0,88.0,0.482,0.452,1,2013-01-07,34,9,25,0.265,37,27,10,0.73
21200508,1610612762,1610612742,100.0,94.0,0.397,0.4320000000000001,1,2013-01-07,36,18,18,0.5,35,13,22,0.371
21200509,1610612758,1610612763,81.0,113.0,0.368,0.488,0,2013-01-07,35,13,22,0.371,32,22,10,0.688
21200510,1610612757,1610612753,125.0,119.0,0.511,0.495,1,2013-01-07,34,19,15,0.5589999999999999,34,12,22,0.353
21200499,1610612761,1610612760,92.0,104.0,0.447,0.494,0,2013-01-06,34,12,22,0.353,33,26,7,0.7879999999999999
21200500,1610612748,1610612764,99.0,71.0,0.4629999999999999,0.358,1,2013-01-06,32,23,9,0.7190000000000001,32,4,28,0.125
21200501,1610612765,1610612766,101.0,108.0,0.5,0.435,0,2013-01-06,36,13,23,0.361,33,9,24,0.273
21200502,1610612756,1610612763,81.0,92.0,0.392,0.536,0,2013-01-06,35,12,23,0.3429999999999999,31,21,10,0.677
21200503,1610612747,1610612743,105.0,112.0,0.4629999999999999,0.436,0,2013-01-06,33,15,18,0.455,36,20,16,0.556
21200489,1610612737,1610612738,81.0,89.0,0.412,0.4589999999999999,0,2013-01-05,32,20,12,0.625,33,16,17,0.485
21200490,1610612753,1610612752,106.0,114.0,0.482,0.477,0,2013-01-05,33,12,21,0.364,33,23,10,0.6970000000000001
21200491,1610612754,1610612749,95.0,80.0,0.435,0.3779999999999999,1,2013-01-05,34,20,14,0.588,32,16,16,0.5
21200492,1610612751,1610612758,113.0,93.0,0.518,0.4,1,2013-01-05,34,19,15,0.5589999999999999,34,13,21,0.382
21200493,1610612739,1610612745,104.0,112.0,0.396,0.4679999999999999,0,2013-01-05,35,8,27,0.2289999999999999,34,20,14,0.588
21200494,1610612750,1610612757,97.0,102.0,0.418,0.43,0,2013-01-05,30,15,15,0.5,33,18,15,0.545
21200495,1610612742,1610612740,96.0,99.0,0.4589999999999999,0.4529999999999999,0,2013-01-05,34,13,21,0.382,33,8,25,0.242
21200496,1610612759,1610612755,109.0,86.0,0.482,0.417,1,2013-01-05,36,27,9,0.75,35,15,20,0.429
21200497,1610612743,1610612762,110.0,91.0,0.513,0.359,1,2013-01-05,35,19,16,0.5429999999999999,35,17,18,0.486
21200498,1610612746,1610612744,115.0,89.0,0.522,0.444,1,2013-01-05,35,27,8,0.7709999999999999,33,22,11,0.667
21200478,1610612761,1610612758,96.0,105.0,0.38,0.526,0,2013-01-04,33,12,21,0.364,33,13,20,0.3939999999999999
21200479,1610612764,1610612751,113.0,115.0,0.473,0.461,0,2013-01-04,31,4,27,0.129,33,18,15,0.545
21200480,1610612766,1610612739,104.0,106.0,0.451,0.5,0,2013-01-04,32,8,24,0.25,34,8,26,0.235
21200482,1610612765,1610612737,85.0,84.0,0.412,0.413,1,2013-01-04,35,13,22,0.371,31,20,11,0.645
21200481,1610612748,1610612741,89.0,96.0,0.462,0.45,0,2013-01-04,31,22,9,0.71,31,18,13,0.581
21200483,1610612738,1610612754,94.0,75.0,0.449,0.318,1,2013-01-04,32,15,17,0.469,33,19,14,0.5760000000000001
21200484,1610612763,1610612757,84.0,86.0,0.395,0.407,0,2013-01-04,30,20,10,0.667,32,17,15,0.531
21200485,1610612760,1610612755,109.0,85.0,0.52,0.405,1,2013-01-04,32,25,7,0.7809999999999999,34,15,19,0.441
21200486,1610612749,1610612745,101.0,115.0,0.4479999999999999,0.542,0,2013-01-04,31,16,15,0.516,33,19,14,0.5760000000000001
21200487,1610612756,1610612762,80.0,87.0,0.4529999999999999,0.449,0,2013-01-04,34,12,22,0.353,34,17,17,0.5
21200488,1610612746,1610612747,107.0,102.0,0.5,0.461,1,2013-01-04,34,26,8,0.765,32,15,17,0.469
21200476,1610612752,1610612759,100.0,83.0,0.476,0.364,1,2013-01-03,32,22,10,0.688,35,26,9,0.743
21200477,1610612743,1610612750,97.0,101.0,0.465,0.446,0,2013-01-03,34,18,16,0.529,29,15,14,0.517
21200464,1610612761,1610612757,102.0,79.0,0.532,0.4429999999999999,1,2013-01-02,32,12,20,0.375,31,16,15,0.516
21200465,1610612753,1610612741,94.0,96.0,0.474,0.4679999999999999,0,2013-01-02,32,12,20,0.375,30,17,13,0.5670000000000001
21200466,1610612739,1610612758,94.0,97.0,0.391,0.4320000000000001,0,2013-01-02,33,7,26,0.212,32,12,20,0.375
21200467,1610612754,1610612764,89.0,81.0,0.377,0.422,1,2013-01-02,32,19,13,0.594,30,4,26,0.133
21200468,1610612738,1610612763,83.0,93.0,0.451,0.479,0,2013-01-02,31,14,17,0.452,29,20,9,0.69
21200469,1610612748,1610612742,119.0,109.0,0.472,0.436,1,2013-01-02,30,22,8,0.733,33,13,20,0.3939999999999999
21200470,1610612749,1610612759,110.0,117.0,0.489,0.517,0,2013-01-02,30,16,14,0.5329999999999999,34,26,8,0.765
21200471,1610612745,1610612740,104.0,92.0,0.494,0.422,1,2013-01-02,32,18,14,0.563,32,7,25,0.2189999999999999
21200472,1610612760,1610612751,93.0,110.0,0.493,0.5,0,2013-01-02,31,24,7,0.774,32,17,15,0.531
21200473,1610612762,1610612750,106.0,84.0,0.494,0.345,1,2013-01-02,33,16,17,0.485,28,14,14,0.5
21200474,1610612756,1610612755,95.0,89.0,0.4589999999999999,0.44,1,2013-01-02,33,12,21,0.364,33,15,18,0.455
21200475,1610612744,1610612746,115.0,94.0,0.5,0.363,1,2013-01-02,32,22,10,0.688,33,25,8,0.758
21200458,1610612764,1610612742,94.0,103.0,0.405,0.5,0,2013-01-01,29,4,25,0.138,32,13,19,0.406
21200459,1610612752,1610612757,100.0,105.0,0.429,0.506,0,2013-01-01,31,21,10,0.677,30,16,14,0.5329999999999999
21200460,1610612765,1610612758,103.0,97.0,0.52,0.419,1,2013-01-01,34,12,22,0.353,31,11,20,0.355
21200461,1610612740,1610612737,86.0,95.0,0.439,0.494,0,2013-01-01,31,7,24,0.226,30,20,10,0.667
21200462,1610612743,1610612746,92.0,78.0,0.451,0.385,1,2013-01-01,33,18,15,0.545,32,25,7,0.7809999999999999
21200463,1610612747,1610612755,99.0,103.0,0.3939999999999999,0.477,0,2013-01-01,31,15,16,0.484,32,15,17,0.469
21200452,1610612754,1610612763,88.0,83.0,0.4,0.3779999999999999,1,2012-12-31,31,18,13,0.581,28,19,9,0.679
21200453,1610612741,1610612766,81.0,91.0,0.351,0.471,0,2012-12-31,29,16,13,0.552,31,8,23,0.258
21200454,1610612753,1610612748,110.0,112.0,0.477,0.471,0,2012-12-31,31,12,19,0.387,29,21,8,0.7240000000000001
21200455,1610612745,1610612737,123.0,104.0,0.536,0.478,1,2012-12-31,31,17,14,0.5479999999999999,29,19,10,0.655
21200457,1610612759,1610612751,104.0,73.0,0.589,0.3779999999999999,1,2012-12-31,33,25,8,0.758,31,16,15,0.516
21200456,1610612760,1610612756,114.0,96.0,0.506,0.474,1,2012-12-31,30,24,6,0.8,32,11,21,0.344
21200448,1610612765,1610612749,96.0,94.0,0.476,0.4679999999999999,1,2012-12-30,33,11,22,0.3329999999999999,29,16,13,0.552
21200449,1610612742,1610612759,86.0,111.0,0.4,0.506,0,2012-12-30,31,12,19,0.387,32,24,8,0.75
21200450,1610612758,1610612738,118.0,96.0,0.537,0.419,1,2012-12-30,30,11,19,0.3670000000000001,30,14,16,0.467
21200451,1610612746,1610612762,107.0,96.0,0.5,0.413,1,2012-12-30,31,25,6,0.8059999999999999,32,15,17,0.469
21200437,1610612766,1610612740,95.0,98.0,0.494,0.4270000000000001,0,2012-12-29,30,7,23,0.233,30,7,23,0.233
21200438,1610612737,1610612754,109.0,100.0,0.55,0.475,1,2012-12-29,28,19,9,0.679,30,17,13,0.5670000000000001
21200439,1610612753,1610612761,88.0,123.0,0.444,0.561,0,2012-12-29,30,12,18,0.4,31,11,20,0.355
21200440,1610612751,1610612739,103.0,100.0,0.467,0.4629999999999999,1,2012-12-29,30,16,14,0.5329999999999999,32,7,25,0.2189999999999999
21200441,1610612741,1610612764,87.0,77.0,0.391,0.365,1,2012-12-29,28,16,12,0.5710000000000001,28,4,24,0.143
21200442,1610612763,1610612743,81.0,72.0,0.4039999999999999,0.426,1,2012-12-29,27,19,8,0.7040000000000001,32,17,15,0.531
21200443,1610612745,1610612760,94.0,124.0,0.3979999999999999,0.479,0,2012-12-29,30,16,14,0.5329999999999999,29,23,6,0.7929999999999999
21200444,1610612750,1610612756,111.0,107.0,0.506,0.4639999999999999,1,2012-12-29,27,14,13,0.519,31,11,20,0.355
21200445,1610612749,1610612748,104.0,85.0,0.408,0.434,1,2012-12-29,28,16,12,0.5710000000000001,28,20,8,0.7140000000000001
21200446,1610612757,1610612755,89.0,85.0,0.447,0.424,1,2012-12-29,29,15,14,0.517,31,14,17,0.452
21200447,1610612744,1610612738,101.0,83.0,0.521,0.36,1,2012-12-29,31,21,10,0.677,29,14,15,0.483
21200425,1610612764,1610612753,105.0,97.0,0.477,0.4529999999999999,1,2012-12-28,27,4,23,0.148,29,12,17,0.414
21200426,1610612754,1610612756,97.0,91.0,0.442,0.4629999999999999,1,2012-12-28,29,17,12,0.586,30,11,19,0.3670000000000001
21200427,1610612751,1610612766,97.0,81.0,0.447,0.384,1,2012-12-28,29,15,14,0.517,29,7,22,0.241
21200428,1610612765,1610612748,109.0,99.0,0.581,0.506,1,2012-12-28,32,10,22,0.313,27,20,7,0.741
21200429,1610612739,1610612737,94.0,102.0,0.419,0.487,0,2012-12-28,31,7,24,0.226,27,18,9,0.667
21200430,1610612740,1610612761,97.0,104.0,0.451,0.435,0,2012-12-28,29,6,23,0.207,30,10,20,0.3329999999999999
21200431,1610612742,1610612743,85.0,106.0,0.375,0.457,0,2012-12-28,30,12,18,0.4,31,17,14,0.5479999999999999
21200432,1610612759,1610612745,122.0,116.0,0.5710000000000001,0.523,1,2012-12-28,31,23,8,0.742,29,16,13,0.552
21200433,1610612762,1610612746,114.0,116.0,0.479,0.494,0,2012-12-28,31,15,16,0.484,30,24,6,0.8
21200434,1610612758,1610612752,106.0,105.0,0.4529999999999999,0.494,1,2012-12-28,29,10,19,0.345,30,21,9,0.7
21200435,1610612747,1610612757,104.0,87.0,0.465,0.414,1,2012-12-28,30,15,15,0.5,28,14,14,0.5
21200436,1610612744,1610612755,96.0,89.0,0.425,0.402,1,2012-12-28,30,20,10,0.667,30,14,16,0.467
21200423,1610612760,1610612742,111.0,105.0,0.419,0.421,1,2012-12-27,28,22,6,0.7859999999999999,29,12,17,0.414
21200424,1610612746,1610612738,106.0,77.0,0.482,0.4029999999999999,1,2012-12-27,29,23,6,0.7929999999999999,28,14,14,0.5
21200410,1610612764,1610612739,84.0,87.0,0.461,0.3779999999999999,0,2012-12-26,26,3,23,0.115,30,7,23,0.233
21200411,1610612766,1610612748,92.0,105.0,0.436,0.457,0,2012-12-26,28,7,21,0.25,26,20,6,0.769
21200412,1610612753,1610612740,94.0,97.0,0.456,0.5,0,2012-12-26,28,12,16,0.429,28,6,22,0.214
21200414,1610612737,1610612765,126.0,119.0,0.469,0.44,1,2012-12-26,26,17,9,0.654,31,9,22,0.29
21200415,1610612749,1610612751,108.0,93.0,0.476,0.386,1,2012-12-26,27,15,12,0.556,28,14,14,0.5
21200416,1610612763,1610612755,89.0,99.0,0.389,0.521,0,2012-12-26,26,18,8,0.6920000000000001,29,14,15,0.483
21200417,1610612750,1610612745,84.0,87.0,0.381,0.407,0,2012-12-26,26,13,13,0.5,28,16,12,0.5710000000000001
21200418,1610612759,1610612761,100.0,80.0,0.479,0.423,1,2012-12-26,30,22,8,0.733,29,9,20,0.31
21200419,1610612743,1610612747,126.0,114.0,0.479,0.494,1,2012-12-26,30,16,14,0.5329999999999999,29,14,15,0.483
21200420,1610612762,1610612744,83.0,94.0,0.386,0.402,0,2012-12-26,30,15,15,0.5,29,19,10,0.655
21200421,1610612756,1610612752,97.0,99.0,0.4579999999999999,0.455,0,2012-12-26,29,11,18,0.379,29,21,8,0.7240000000000001
21200422,1610612757,1610612758,109.0,91.0,0.506,0.407,1,2012-12-26,27,14,13,0.519,28,9,19,0.321
21200405,1610612751,1610612738,76.0,93.0,0.406,0.494,0,2012-12-25,27,14,13,0.519,27,14,13,0.519
21200406,1610612747,1610612752,100.0,94.0,0.481,0.4270000000000001,1,2012-12-25,28,14,14,0.5,28,20,8,0.7140000000000001
21200407,1610612748,1610612760,103.0,97.0,0.475,0.423,1,2012-12-25,25,19,6,0.76,27,21,6,0.778
21200408,1610612741,1610612745,97.0,120.0,0.446,0.561,0,2012-12-25,27,15,12,0.556,27,15,12,0.556
21200409,1610612746,1610612743,112.0,100.0,0.484,0.5,1,2012-12-25,28,22,6,0.7859999999999999,29,15,14,0.517
21200399,1610612751,1610612755,95.0,92.0,0.446,0.4320000000000001,1,2012-12-23,26,14,12,0.5379999999999999,28,13,15,0.4639999999999999
21200400,1610612752,1610612750,94.0,91.0,0.444,0.405,1,2012-12-23,27,20,7,0.741,25,13,12,0.52
21200401,1610612753,1610612762,93.0,97.0,0.5,0.434,0,2012-12-23,27,12,15,0.444,29,15,14,0.517
21200402,1610612759,1610612742,129.0,91.0,0.56,0.4589999999999999,1,2012-12-23,29,21,8,0.7240000000000001,28,12,16,0.429
21200403,1610612756,1610612746,77.0,103.0,0.363,0.535,0,2012-12-23,28,11,17,0.3929999999999999,27,21,6,0.778
21200404,1610612758,1610612757,108.0,96.0,0.556,0.435,1,2012-12-23,27,9,18,0.3329999999999999,26,13,13,0.5
21200390,1610612764,1610612765,87.0,96.0,0.377,0.409,0,2012-12-22,25,3,22,0.12,30,9,21,0.3
21200391,1610612737,1610612741,92.0,75.0,0.494,0.421,1,2012-12-22,25,16,9,0.64,26,15,11,0.5770000000000001
21200392,1610612748,1610612762,105.0,89.0,0.521,0.411,1,2012-12-22,24,18,6,0.75,28,14,14,0.5
21200393,1610612740,1610612754,75.0,81.0,0.402,0.429,0,2012-12-22,27,5,22,0.185,28,16,12,0.5710000000000001
21200394,1610612745,1610612763,121.0,96.0,0.537,0.532,1,2012-12-22,26,14,12,0.5379999999999999,25,18,7,0.72
21200395,1610612749,1610612739,82.0,94.0,0.392,0.4320000000000001,0,2012-12-22,26,14,12,0.5379999999999999,29,6,23,0.207
21200396,1610612743,1610612766,110.0,88.0,0.511,0.379,1,2012-12-22,28,15,13,0.536,27,7,20,0.259
21200397,1610612757,1610612756,96.0,93.0,0.478,0.449,1,2012-12-22,25,13,12,0.52,27,11,16,0.407
21200398,1610612744,1610612747,115.0,118.0,0.447,0.4579999999999999,0,2012-12-22,28,18,10,0.643,27,13,14,0.481
21200380,1610612761,1610612753,93.0,90.0,0.407,0.5,1,2012-12-21,28,9,19,0.321,26,12,14,0.462
21200381,1610612755,1610612737,99.0,80.0,0.512,0.392,1,2012-12-21,27,13,14,0.481,24,15,9,0.625
21200382,1610612738,1610612749,94.0,99.0,0.3829999999999999,0.434,0,2012-12-21,26,13,13,0.5,25,14,11,0.56
21200383,1610612752,1610612741,106.0,110.0,0.418,0.446,0,2012-12-21,26,19,7,0.731,25,15,10,0.6
21200384,1610612765,1610612764,100.0,68.0,0.422,0.3289999999999999,1,2012-12-21,29,8,21,0.276,24,3,21,0.125
21200385,1610612739,1610612754,89.0,99.0,0.4,0.488,0,2012-12-21,28,5,23,0.179,27,15,12,0.556
21200386,1610612763,1610612742,92.0,82.0,0.4039999999999999,0.408,1,2012-12-21,24,18,6,0.75,27,12,15,0.444
21200387,1610612759,1610612740,99.0,94.0,0.513,0.4529999999999999,1,2012-12-21,28,20,8,0.7140000000000001,26,5,21,0.192
21200388,1610612746,1610612758,97.0,85.0,0.425,0.418,1,2012-12-21,26,20,6,0.769,26,8,18,0.308
21200389,1610612744,1610612766,115.0,100.0,0.518,0.3670000000000001,1,2012-12-21,27,18,9,0.667,26,7,19,0.2689999999999999
21200377,1610612750,1610612760,99.0,93.0,0.44,0.402,1,2012-12-20,24,13,11,0.542,26,21,5,0.8079999999999999
21200378,1610612742,1610612748,95.0,110.0,0.385,0.5379999999999999,0,2012-12-20,26,12,14,0.462,23,17,6,0.7390000000000001
21200379,1610612757,1610612743,101.0,93.0,0.359,0.3879999999999999,1,2012-12-20,24,12,12,0.5,27,14,13,0.519
21200366,1610612761,1610612765,97.0,91.0,0.486,0.417,1,2012-12-19,27,8,19,0.296,28,7,21,0.25
21200367,1610612752,1610612751,100.0,86.0,0.4579999999999999,0.449,1,2012-12-19,25,19,6,0.76,25,13,12,0.52
21200368,1610612753,1610612764,90.0,83.0,0.42,0.442,1,2012-12-19,25,12,13,0.48,23,3,20,0.13
21200369,1610612754,1610612762,104.0,84.0,0.513,0.3720000000000001,1,2012-12-19,26,14,12,0.5379999999999999,27,14,13,0.519
21200370,1610612738,1610612739,103.0,91.0,0.597,0.409,1,2012-12-19,25,13,12,0.52,27,5,22,0.185
21200371,1610612737,1610612760,92.0,100.0,0.3829999999999999,0.429,0,2012-12-19,23,15,8,0.652,25,21,4,0.84
21200372,1610612745,1610612755,125.0,103.0,0.56,0.449,1,2012-12-19,25,13,12,0.52,26,12,14,0.462
21200373,1610612756,1610612766,121.0,104.0,0.5529999999999999,0.465,1,2012-12-19,26,11,15,0.423,25,7,18,0.28
21200374,1610612763,1610612749,90.0,80.0,0.409,0.353,1,2012-12-19,23,17,6,0.7390000000000001,24,13,11,0.542
21200375,1610612758,1610612744,131.0,127.0,0.5,0.5,1,2012-12-19,25,8,17,0.32,26,17,9,0.654
21200376,1610612746,1610612740,93.0,77.0,0.5,0.387,1,2012-12-19,25,19,6,0.76,25,5,20,0.2
21200356,1610612764,1610612737,95.0,100.0,0.379,0.436,0,2012-12-18,22,3,19,0.136,22,15,7,0.682
21200357,1610612739,1610612761,99.0,113.0,0.514,0.52,0,2012-12-18,26,5,21,0.192,26,7,19,0.2689999999999999
21200358,1610612751,1610612762,90.0,92.0,0.429,0.446,0,2012-12-18,24,13,11,0.542,26,14,12,0.5379999999999999
21200359,1610612748,1610612750,103.0,92.0,0.4679999999999999,0.43,1,2012-12-18,22,16,6,0.727,23,12,11,0.522
21200360,1610612741,1610612738,100.0,89.0,0.5,0.4320000000000001,1,2012-12-18,24,14,10,0.583,24,12,12,0.5
21200361,1610612749,1610612754,98.0,93.0,0.43,0.4,1,2012-12-18,23,13,10,0.565,25,13,12,0.52
21200362,1610612742,1610612755,107.0,100.0,0.542,0.43,1,2012-12-18,25,12,13,0.48,25,12,13,0.48
21200363,1610612743,1610612759,112.0,106.0,0.4370000000000001,0.4,1,2012-12-18,26,14,12,0.5379999999999999,27,19,8,0.7040000000000001
21200364,1610612747,1610612766,101.0,100.0,0.3979999999999999,0.4,1,2012-12-18,26,12,14,0.462,24,7,17,0.292
21200365,1610612744,1610612740,103.0,96.0,0.436,0.467,1,2012-12-18,25,17,8,0.68,24,5,19,0.208
21200350,1610612753,1610612750,102.0,93.0,0.537,0.406,1,2012-12-17,24,11,13,0.4579999999999999,22,12,10,0.545
21200351,1610612752,1610612745,96.0,109.0,0.433,0.513,0,2012-12-17,24,18,6,0.75,24,12,12,0.5
21200352,1610612765,1610612746,76.0,88.0,0.408,0.449,0,2012-12-17,27,7,20,0.259,24,18,6,0.75
21200353,1610612763,1610612741,80.0,71.0,0.375,0.373,1,2012-12-17,22,16,6,0.727,23,13,10,0.565
21200354,1610612760,1610612759,107.0,93.0,0.447,0.456,1,2012-12-17,24,20,4,0.833,26,19,7,0.731
21200355,1610612756,1610612758,101.0,90.0,0.482,0.41,1,2012-12-17,25,10,15,0.4,24,7,17,0.292
21200346,1610612761,1610612745,103.0,96.0,0.4589999999999999,0.41,1,2012-12-16,25,6,19,0.24,23,11,12,0.478
21200347,1610612755,1610612747,98.0,111.0,0.494,0.488,0,2012-12-16,24,12,12,0.5,25,11,14,0.44
21200348,1610612758,1610612743,97.0,122.0,0.341,0.541,0,2012-12-16,23,7,16,0.304,25,13,12,0.52
21200349,1610612757,1610612740,95.0,94.0,0.4629999999999999,0.45,1,2012-12-16,23,11,12,0.478,23,5,18,0.217
21200337,1610612737,1610612744,93.0,115.0,0.369,0.495,0,2012-12-15,21,14,7,0.667,24,16,8,0.667
21200336,1610612766,1610612753,98.0,107.0,0.462,0.544,0,2012-12-15,23,7,16,0.304,23,10,13,0.435
21200338,1610612752,1610612739,103.0,102.0,0.435,0.488,1,2012-12-15,23,18,5,0.7829999999999999,25,5,20,0.2
21200339,1610612748,1610612764,102.0,72.0,0.506,0.375,1,2012-12-15,21,15,6,0.7140000000000001,21,3,18,0.143
21200340,1610612765,1610612754,77.0,88.0,0.386,0.486,0,2012-12-15,26,7,19,0.2689999999999999,24,13,11,0.542
21200341,1610612741,1610612751,83.0,82.0,0.44,0.387,1,2012-12-15,22,13,9,0.591,23,13,10,0.565
21200342,1610612750,1610612742,114.0,106.0,0.436,0.4639999999999999,1,2012-12-15,21,12,9,0.5710000000000001,24,11,13,0.4579999999999999
21200343,1610612749,1610612746,85.0,111.0,0.361,0.537,0,2012-12-15,22,12,10,0.545,23,17,6,0.7390000000000001
21200344,1610612759,1610612738,103.0,88.0,0.469,0.469,1,2012-12-15,25,19,6,0.76,23,12,11,0.522
21200345,1610612762,1610612763,86.0,99.0,0.419,0.447,0,2012-12-15,25,13,12,0.52,21,15,6,0.7140000000000001
21200325,1610612761,1610612742,95.0,74.0,0.405,0.391,1,2012-12-14,24,5,19,0.208,23,11,12,0.478
21200326,1610612764,1610612747,96.0,102.0,0.434,0.451,0,2012-12-14,20,3,17,0.15,24,10,14,0.417
21200327,1610612754,1610612755,95.0,85.0,0.455,0.4320000000000001,1,2012-12-14,23,12,11,0.522,23,12,11,0.522
21200330,1610612753,1610612744,99.0,85.0,0.477,0.37,1,2012-12-14,22,9,13,0.409,23,15,8,0.652
21200328,1610612751,1610612765,107.0,105.0,0.452,0.4039999999999999,1,2012-12-14,22,13,9,0.591,25,7,18,0.28
21200329,1610612739,1610612749,86.0,90.0,0.395,0.3979999999999999,0,2012-12-14,24,5,19,0.208,21,12,9,0.5710000000000001
21200331,1610612740,1610612750,102.0,113.0,0.5379999999999999,0.534,0,2012-12-14,22,5,17,0.2269999999999999,20,11,9,0.55
21200332,1610612745,1610612738,101.0,89.0,0.487,0.4,1,2012-12-14,22,11,11,0.5,22,12,10,0.545
21200333,1610612760,1610612758,113.0,103.0,0.494,0.4529999999999999,1,2012-12-14,23,19,4,0.826,22,7,15,0.318
21200334,1610612756,1610612762,99.0,84.0,0.4579999999999999,0.402,1,2012-12-14,24,9,15,0.375,24,13,11,0.542
21200335,1610612743,1610612763,99.0,94.0,0.522,0.415,1,2012-12-14,24,12,12,0.5,20,14,6,0.7
21200322,1610612737,1610612766,113.0,90.0,0.573,0.43,1,2012-12-13,20,14,6,0.7,22,7,15,0.318
21200323,1610612752,1610612747,116.0,107.0,0.532,0.417,1,2012-12-13,22,17,5,0.773,23,9,14,0.391
21200324,1610612757,1610612759,98.0,90.0,0.455,0.4579999999999999,1,2012-12-13,22,10,12,0.455,24,18,6,0.75
21200309,1610612761,1610612751,88.0,94.0,0.493,0.4529999999999999,0,2012-12-12,23,4,19,0.174,21,12,9,0.5710000000000001
21200310,1610612753,1610612737,80.0,86.0,0.3829999999999999,0.4379999999999999,0,2012-12-12,21,8,13,0.381,19,13,6,0.684
21200311,1610612754,1610612739,96.0,81.0,0.41,0.3329999999999999,1,2012-12-12,22,11,11,0.5,23,5,18,0.217
21200312,1610612755,1610612741,89.0,96.0,0.451,0.436,0,2012-12-12,22,12,10,0.545,21,12,9,0.5710000000000001
21200313,1610612766,1610612746,94.0,100.0,0.4270000000000001,0.435,0,2012-12-12,21,7,14,0.3329999999999999,22,16,6,0.727
21200314,1610612748,1610612744,95.0,97.0,0.475,0.4629999999999999,0,2012-12-12,20,14,6,0.7,22,15,7,0.682
21200315,1610612738,1610612742,117.0,115.0,0.43,0.511,1,2012-12-12,21,12,9,0.5710000000000001,22,11,11,0.5
21200316,1610612749,1610612758,98.0,85.0,0.406,0.3720000000000001,1,2012-12-12,20,11,9,0.55,21,7,14,0.3329999999999999
21200317,1610612745,1610612764,99.0,93.0,0.447,0.3929999999999999,1,2012-12-12,21,10,11,0.476,19,3,16,0.158
21200318,1610612760,1610612740,92.0,88.0,0.4370000000000001,0.3979999999999999,1,2012-12-12,22,18,4,0.818,21,5,16,0.238
21200319,1610612750,1610612743,108.0,105.0,0.4370000000000001,0.506,1,2012-12-12,19,10,9,0.526,23,11,12,0.478
21200320,1610612756,1610612763,82.0,80.0,0.382,0.452,1,2012-12-12,23,8,15,0.348,19,14,5,0.737
21200321,1610612762,1610612759,99.0,96.0,0.488,0.425,1,2012-12-12,23,13,10,0.565,23,18,5,0.7829999999999999
21200304,1610612751,1610612752,97.0,100.0,0.529,0.462,0,2012-12-11,20,11,9,0.55,21,16,5,0.762
21200305,1610612739,1610612747,100.0,94.0,0.44,0.413,1,2012-12-11,22,5,17,0.2269999999999999,22,9,13,0.409
21200306,1610612765,1610612743,94.0,101.0,0.42,0.4629999999999999,0,2012-12-11,24,7,17,0.292,22,11,11,0.5
21200307,1610612740,1610612764,70.0,77.0,0.325,0.3289999999999999,0,2012-12-11,20,5,15,0.25,18,3,15,0.1669999999999999
21200308,1610612741,1610612746,89.0,94.0,0.402,0.4629999999999999,0,2012-12-11,20,11,9,0.55,21,15,6,0.7140000000000001
21200298,1610612755,1610612765,104.0,97.0,0.537,0.395,1,2012-12-10,21,12,9,0.5710000000000001,23,7,16,0.304
21200299,1610612766,1610612744,96.0,104.0,0.373,0.452,0,2012-12-10,20,7,13,0.35,21,14,7,0.667
21200300,1610612748,1610612737,101.0,92.0,0.5820000000000001,0.4270000000000001,1,2012-12-10,19,14,5,0.737,18,12,6,0.667
21200301,1610612745,1610612759,126.0,134.0,0.423,0.522,0,2012-12-10,20,9,11,0.45,22,18,4,0.818
21200302,1610612742,1610612758,119.0,96.0,0.552,0.44,1,2012-12-10,21,11,10,0.524,20,7,13,0.35
21200303,1610612757,1610612761,92.0,74.0,0.4039999999999999,0.351,1,2012-12-10,21,9,12,0.429,22,4,18,0.182
21200292,1610612746,1610612761,102.0,83.0,0.456,0.39,1,2012-12-09,20,14,6,0.7,21,4,17,0.19
21200293,1610612751,1610612749,88.0,97.0,0.405,0.465,0,2012-12-09,19,11,8,0.579,19,10,9,0.526
21200294,1610612760,1610612754,104.0,93.0,0.487,0.4629999999999999,1,2012-12-09,21,17,4,0.81,21,10,11,0.476
21200295,1610612752,1610612743,112.0,106.0,0.43,0.556,1,2012-12-09,20,15,5,0.75,21,10,11,0.476
21200296,1610612756,1610612753,90.0,98.0,0.462,0.519,0,2012-12-09,22,7,15,0.318,20,8,12,0.4
21200297,1610612747,1610612762,110.0,117.0,0.471,0.542,0,2012-12-09,21,9,12,0.429,22,12,10,0.545
21200282,1610612746,1610612756,117.0,99.0,0.516,0.462,1,2012-12-08,19,13,6,0.684,21,7,14,0.3329999999999999
21200283,1610612764,1610612744,97.0,101.0,0.425,0.4320000000000001,0,2012-12-08,17,2,15,0.118,20,13,7,0.65
21200284,1610612766,1610612759,102.0,132.0,0.4679999999999999,0.556,0,2012-12-08,19,7,12,0.368,21,17,4,0.81
21200285,1610612738,1610612755,92.0,79.0,0.5329999999999999,0.392,1,2012-12-08,20,11,9,0.55,20,11,9,0.55
21200286,1610612748,1610612740,106.0,90.0,0.58,0.449,1,2012-12-08,18,13,5,0.722,19,5,14,0.263
21200287,1610612739,1610612765,97.0,104.0,0.429,0.467,0,2012-12-08,21,4,17,0.19,22,7,15,0.318
21200288,1610612741,1610612752,93.0,85.0,0.436,0.321,1,2012-12-08,19,11,8,0.579,19,14,5,0.737
21200289,1610612763,1610612737,83.0,93.0,0.429,0.442,0,2012-12-08,18,14,4,0.778,17,12,5,0.706
21200290,1610612745,1610612742,109.0,116.0,0.486,0.473,0,2012-12-08,19,9,10,0.474,20,10,10,0.5
21200291,1610612757,1610612758,80.0,99.0,0.387,0.419,0,2012-12-08,20,8,12,0.4,19,7,12,0.368
21200270,1610612755,1610612738,95.0,94.0,0.374,0.4320000000000001,1,2012-12-07,19,11,8,0.579,19,10,9,0.526
21200271,1610612754,1610612743,89.0,92.0,0.447,0.442,0,2012-12-07,20,10,10,0.5,20,10,10,0.5
21200272,1610612751,1610612744,102.0,109.0,0.425,0.511,0,2012-12-07,18,11,7,0.611,19,12,7,0.632
21200273,1610612737,1610612764,104.0,95.0,0.482,0.456,1,2012-12-07,16,11,5,0.688,16,2,14,0.125
21200274,1610612765,1610612741,104.0,108.0,0.514,0.524,0,2012-12-07,21,6,15,0.286,18,10,8,0.556
21200275,1610612740,1610612763,89.0,96.0,0.48,0.5,0,2012-12-07,18,5,13,0.278,17,14,3,0.8240000000000001
21200276,1610612750,1610612739,91.0,73.0,0.429,0.345,1,2012-12-07,18,9,9,0.5,20,4,16,0.2
21200277,1610612749,1610612766,108.0,93.0,0.4039999999999999,0.444,1,2012-12-07,18,9,9,0.5,18,7,11,0.389
21200278,1610612759,1610612745,114.0,92.0,0.552,0.389,1,2012-12-07,20,16,4,0.8,18,9,9,0.5
21200279,1610612762,1610612761,131.0,99.0,0.495,0.402,1,2012-12-07,21,11,10,0.524,20,4,16,0.2
21200280,1610612760,1610612747,114.0,108.0,0.488,0.429,1,2012-12-07,20,16,4,0.8,20,9,11,0.45
21200281,1610612758,1610612753,91.0,82.0,0.405,0.375,1,2012-12-07,18,6,12,0.3329999999999999,19,7,12,0.368
21200268,1610612748,1610612752,92.0,112.0,0.421,0.451,0,2012-12-06,17,12,5,0.706,18,14,4,0.778
21200269,1610612756,1610612742,94.0,97.0,0.4,0.474,0,2012-12-06,20,7,13,0.35,19,9,10,0.474
21200257,1610612766,1610612752,98.0,100.0,0.47,0.424,0,2012-12-05,17,7,10,0.412,17,13,4,0.765
21200258,1610612754,1610612757,99.0,92.0,0.45,0.43,1,2012-12-05,19,10,9,0.526,19,8,11,0.421
21200259,1610612738,1610612750,104.0,94.0,0.526,0.44,1,2012-12-05,18,10,8,0.556,17,8,9,0.471
21200261,1610612765,1610612744,97.0,104.0,0.4429999999999999,0.4529999999999999,0,2012-12-05,20,6,14,0.3,18,11,7,0.611
21200260,1610612737,1610612743,108.0,104.0,0.442,0.481,1,2012-12-05,15,10,5,0.667,19,9,10,0.474
21200262,1610612739,1610612741,85.0,95.0,0.365,0.472,0,2012-12-05,19,4,15,0.211,17,9,8,0.529
21200263,1610612740,1610612747,87.0,103.0,0.412,0.4629999999999999,0,2012-12-05,17,5,12,0.294,19,9,10,0.474
21200264,1610612759,1610612749,110.0,99.0,0.471,0.417,1,2012-12-05,19,15,4,0.789,17,8,9,0.471
21200265,1610612762,1610612753,87.0,81.0,0.416,0.442,1,2012-12-05,20,10,10,0.5,18,7,11,0.389
21200266,1610612758,1610612761,107.0,100.0,0.4629999999999999,0.407,1,2012-12-05,17,5,12,0.294,19,4,15,0.211
21200267,1610612746,1610612742,112.0,90.0,0.5,0.405,1,2012-12-05,18,12,6,0.667,18,8,10,0.444
21200251,1610612755,1610612750,88.0,105.0,0.422,0.532,0,2012-12-04,18,10,8,0.556,16,8,8,0.5
21200252,1610612764,1610612748,105.0,101.0,0.481,0.461,1,2012-12-04,15,2,13,0.133,16,12,4,0.75
21200253,1610612751,1610612760,111.0,117.0,0.429,0.606,0,2012-12-04,17,11,6,0.647,19,15,4,0.789
21200254,1610612741,1610612754,76.0,80.0,0.384,0.363,0,2012-12-04,16,8,8,0.5,18,9,9,0.5
21200255,1610612763,1610612756,108.0,98.0,0.471,0.4629999999999999,1,2012-12-04,16,13,3,0.813,19,7,12,0.368
21200256,1610612745,1610612747,107.0,105.0,0.376,0.4579999999999999,1,2012-12-04,17,9,8,0.529,18,8,10,0.444
21200245,1610612766,1610612757,112.0,118.0,0.466,0.467,0,2012-12-03,16,7,9,0.4379999999999999,18,8,10,0.444
21200246,1610612765,1610612739,89.0,79.0,0.429,0.337,1,2012-12-03,19,6,13,0.316,18,4,14,0.222
21200247,1610612740,1610612749,102.0,81.0,0.524,0.382,1,2012-12-03,16,5,11,0.313,16,8,8,0.5
21200248,1610612743,1610612761,113.0,110.0,0.471,0.488,1,2012-12-03,18,9,9,0.5,18,4,14,0.222
21200249,1610612762,1610612746,104.0,105.0,0.568,0.472,0,2012-12-03,19,9,10,0.474,17,11,6,0.647
21200250,1610612744,1610612753,94.0,102.0,0.457,0.435,0,2012-12-03,17,10,7,0.588,17,7,10,0.412
21200243,1610612752,1610612756,106.0,99.0,0.444,0.488,1,2012-12-02,16,12,4,0.75,18,7,11,0.389
21200244,1610612747,1610612753,103.0,113.0,0.419,0.5,0,2012-12-02,17,8,9,0.471,16,6,10,0.375
21200233,1610612748,1610612751,102.0,89.0,0.513,0.44,1,2012-12-01,15,12,3,0.8,16,11,5,0.688
21200234,1610612739,1610612757,117.0,118.0,0.434,0.489,0,2012-12-01,17,4,13,0.235,17,7,10,0.412
21200235,1610612741,1610612755,93.0,88.0,0.469,0.439,1,2012-12-01,15,8,7,0.5329999999999999,17,10,7,0.588
21200236,1610612740,1610612760,79.0,100.0,0.37,0.506,0,2012-12-01,15,4,11,0.267,18,14,4,0.778
21200237,1610612745,1610612762,124.0,116.0,0.5539999999999999,0.511,1,2012-12-01,16,8,8,0.5,18,9,9,0.5
21200238,1610612749,1610612738,91.0,88.0,0.456,0.415,1,2012-12-01,15,8,7,0.5329999999999999,17,9,8,0.529
21200239,1610612759,1610612763,99.0,95.0,0.416,0.364,1,2012-12-01,18,14,4,0.778,15,12,3,0.8
21200240,1610612742,1610612765,92.0,77.0,0.409,0.341,1,2012-12-01,17,8,9,0.471,18,5,13,0.278
21200241,1610612746,1610612758,116.0,81.0,0.547,0.382,1,2012-12-01,16,10,6,0.625,16,4,12,0.25
21200242,1610612744,1610612754,103.0,92.0,0.475,0.4589999999999999,1,2012-12-01,16,10,6,0.625,17,8,9,0.471
21200222,1610612761,1610612756,101.0,97.0,0.481,0.481,1,2012-11-30,17,4,13,0.235,17,7,10,0.412
21200223,1610612766,1610612755,98.0,104.0,0.47,0.512,0,2012-11-30,15,7,8,0.467,16,10,6,0.625
21200224,1610612753,1610612751,86.0,98.0,0.449,0.4579999999999999,0,2012-11-30,15,5,10,0.3329999999999999,15,11,4,0.733
21200225,1610612738,1610612757,96.0,78.0,0.493,0.348,1,2012-11-30,16,9,7,0.563,16,6,10,0.375
21200226,1610612752,1610612764,108.0,87.0,0.531,0.449,1,2012-11-30,15,11,4,0.733,14,1,13,0.071
21200227,1610612737,1610612739,111.0,113.0,0.487,0.482,0,2012-11-30,14,9,5,0.643,16,4,12,0.25
21200228,1610612763,1610612765,90.0,78.0,0.4,0.4029999999999999,1,2012-11-30,14,12,2,0.857,17,5,12,0.294
21200229,1610612760,1610612762,106.0,94.0,0.52,0.413,1,2012-11-30,17,13,4,0.765,17,9,8,0.529
21200230,1610612750,1610612749,95.0,85.0,0.391,0.366,1,2012-11-30,15,7,8,0.467,14,7,7,0.5
21200231,1610612758,1610612754,92.0,97.0,0.4270000000000001,0.435,0,2012-11-30,15,4,11,0.267,16,8,8,0.5
21200232,1610612747,1610612743,122.0,103.0,0.54,0.465,1,2012-11-30,16,8,8,0.5,17,8,9,0.471
21200220,1610612748,1610612759,105.0,100.0,0.488,0.45,1,2012-11-29,14,11,3,0.7859999999999999,17,13,4,0.765
21200221,1610612744,1610612743,106.0,105.0,0.512,0.452,1,2012-11-29,15,9,6,0.6,16,8,8,0.5
21200209,1610612764,1610612757,84.0,82.0,0.4370000000000001,0.349,1,2012-11-28,13,1,12,0.077,15,6,9,0.4
21200210,1610612753,1610612759,89.0,110.0,0.4320000000000001,0.524,0,2012-11-28,14,5,9,0.357,16,13,3,0.813
21200211,1610612738,1610612751,83.0,95.0,0.4270000000000001,0.402,0,2012-11-28,15,8,7,0.5329999999999999,14,10,4,0.7140000000000001
21200212,1610612737,1610612766,94.0,91.0,0.4,0.395,1,2012-11-28,13,9,4,0.6920000000000001,14,7,7,0.5
21200213,1610612765,1610612756,117.0,77.0,0.526,0.341,1,2012-11-28,16,5,11,0.313,16,7,9,0.4379999999999999
21200214,1610612741,1610612742,101.0,78.0,0.493,0.346,1,2012-11-28,14,7,7,0.5,16,7,9,0.4379999999999999
21200215,1610612749,1610612752,88.0,102.0,0.4579999999999999,0.479,0,2012-11-28,13,7,6,0.5379999999999999,14,10,4,0.7140000000000001
21200216,1610612763,1610612761,103.0,82.0,0.475,0.392,1,2012-11-28,13,11,2,0.846,16,3,13,0.188
21200217,1610612740,1610612762,84.0,96.0,0.425,0.4920000000000001,0,2012-11-28,14,4,10,0.286,16,9,7,0.563
21200218,1610612760,1610612745,120.0,98.0,0.54,0.414,1,2012-11-28,16,12,4,0.75,15,7,8,0.467
21200219,1610612746,1610612750,101.0,95.0,0.457,0.3779999999999999,1,2012-11-28,15,9,6,0.6,14,6,8,0.429
21200204,1610612755,1610612742,100.0,98.0,0.467,0.457,1,2012-11-27,15,9,6,0.6,15,7,8,0.467
21200205,1610612739,1610612756,78.0,91.0,0.357,0.4679999999999999,0,2012-11-27,15,3,12,0.2,15,7,8,0.467
21200206,1610612745,1610612761,117.0,101.0,0.53,0.488,1,2012-11-27,14,7,7,0.5,15,3,12,0.2
21200207,1610612758,1610612750,89.0,97.0,0.44,0.4579999999999999,0,2012-11-27,14,4,10,0.286,13,6,7,0.462
21200208,1610612747,1610612754,77.0,79.0,0.316,0.3670000000000001,0,2012-11-27,15,7,8,0.467,15,7,8,0.467
21200013,1610612751,1610612752,96.0,89.0,0.407,0.3879999999999999,1,2012-11-26,13,9,4,0.6920000000000001,13,9,4,0.6920000000000001
21200197,1610612764,1610612759,92.0,118.0,0.411,0.563,0,2012-11-26,12,0,12,0.0,15,12,3,0.8
21200198,1610612765,1610612757,108.0,101.0,0.525,0.424,1,2012-11-26,15,4,11,0.267,14,6,8,0.429
21200199,1610612741,1610612749,92.0,93.0,0.4379999999999999,0.4589999999999999,0,2012-11-26,13,6,7,0.462,12,7,5,0.583
21200200,1610612763,1610612739,84.0,78.0,0.465,0.408,1,2012-11-26,12,10,2,0.833,14,3,11,0.214
21200201,1610612760,1610612766,114.0,69.0,0.513,0.291,1,2012-11-26,15,11,4,0.733,13,7,6,0.5379999999999999
21200202,1610612762,1610612743,105.0,103.0,0.462,0.5479999999999999,1,2012-11-26,15,8,7,0.5329999999999999,15,8,7,0.5329999999999999
21200203,1610612746,1610612740,98.0,105.0,0.4679999999999999,0.507,0,2012-11-26,14,8,6,0.5710000000000001,13,4,9,0.308
21200191,1610612761,1610612759,106.0,111.0,0.364,0.4270000000000001,0,2012-11-25,14,3,11,0.214,14,11,3,0.7859999999999999
21200192,1610612752,1610612765,121.0,100.0,0.481,0.474,1,2012-11-25,12,9,3,0.75,14,3,11,0.214
21200193,1610612751,1610612757,98.0,85.0,0.424,0.436,1,2012-11-25,12,8,4,0.667,13,6,7,0.462
21200194,1610612755,1610612756,104.0,101.0,0.481,0.47,1,2012-11-25,14,8,6,0.5710000000000001,14,6,8,0.429
21200195,1610612753,1610612738,110.0,116.0,0.456,0.4479999999999999,0,2012-11-25,13,5,8,0.385,14,8,6,0.5710000000000001
21200196,1610612743,1610612740,102.0,84.0,0.5329999999999999,0.3879999999999999,1,2012-11-25,14,8,6,0.5710000000000001,12,3,9,0.25
21200183,1610612755,1610612760,109.0,116.0,0.495,0.4429999999999999,0,2012-11-24,13,7,6,0.5379999999999999,14,10,4,0.7140000000000001
21200184,1610612764,1610612766,106.0,108.0,0.366,0.41,0,2012-11-24,11,0,11,0.0,12,7,5,0.583
21200185,1610612737,1610612746,104.0,93.0,0.507,0.4270000000000001,1,2012-11-24,12,8,4,0.667,13,8,5,0.615
21200186,1610612748,1610612739,110.0,108.0,0.522,0.4429999999999999,1,2012-11-24,13,10,3,0.769,13,3,10,0.231
21200187,1610612742,1610612747,89.0,115.0,0.37,0.488,0,2012-11-24,14,7,7,0.5,14,7,7,0.5
21200188,1610612749,1610612741,86.0,93.0,0.4320000000000001,0.39,0,2012-11-24,11,6,5,0.545,12,6,6,0.5
21200189,1610612758,1610612762,108.0,97.0,0.541,0.405,1,2012-11-24,13,4,9,0.308,14,7,7,0.5
21200190,1610612744,1610612750,96.0,85.0,0.423,0.384,1,2012-11-24,14,8,6,0.5710000000000001,12,5,7,0.417
21200171,1610612766,1610612737,91.0,101.0,0.373,0.5379999999999999,0,2012-11-23,11,6,5,0.545,11,7,4,0.636
21200172,1610612753,1610612739,108.0,104.0,0.5,0.425,1,2012-11-23,12,5,7,0.417,12,3,9,0.25
21200173,1610612738,1610612760,108.0,100.0,0.488,0.4679999999999999,1,2012-11-23,13,7,6,0.5379999999999999,13,9,4,0.6920000000000001
21200174,1610612751,1610612746,86.0,76.0,0.466,0.4029999999999999,1,2012-11-23,11,7,4,0.636,12,8,4,0.667
21200175,1610612765,1610612761,91.0,90.0,0.462,0.41,1,2012-11-23,13,3,10,0.231,13,3,10,0.231
21200176,1610612754,1610612759,97.0,104.0,0.413,0.494,0,2012-11-23,14,6,8,0.429,13,10,3,0.769
21200177,1610612763,1610612747,106.0,98.0,0.507,0.446,1,2012-11-23,11,9,2,0.818,13,6,7,0.462
21200178,1610612745,1610612752,131.0,103.0,0.517,0.43,1,2012-11-23,13,6,7,0.462,11,8,3,0.727
21200179,1610612743,1610612744,102.0,91.0,0.476,0.4379999999999999,1,2012-11-23,13,7,6,0.5379999999999999,13,7,6,0.5379999999999999
21200180,1610612762,1610612758,104.0,102.0,0.434,0.5,1,2012-11-23,13,7,6,0.5379999999999999,12,3,9,0.25
21200181,1610612756,1610612740,111.0,108.0,0.489,0.513,1,2012-11-23,13,6,7,0.462,11,3,8,0.273
21200182,1610612757,1610612750,103.0,95.0,0.5379999999999999,0.41,1,2012-11-23,12,6,6,0.5,11,5,6,0.455
21200157,1610612766,1610612761,98.0,97.0,0.419,0.4629999999999999,1,2012-11-21,10,6,4,0.6,12,3,9,0.25
21200158,1610612753,1610612765,90.0,74.0,0.434,0.3289999999999999,1,2012-11-21,11,4,7,0.364,12,2,10,0.1669999999999999
21200159,1610612739,1610612755,92.0,83.0,0.407,0.36,1,2012-11-21,11,3,8,0.273,12,7,5,0.583
21200160,1610612754,1610612740,115.0,107.0,0.435,0.424,1,2012-11-21,13,6,7,0.462,10,3,7,0.3
21200161,1610612738,1610612759,100.0,112.0,0.532,0.584,0,2012-11-21,12,6,6,0.5,12,9,3,0.75
21200162,1610612737,1610612764,101.0,100.0,0.435,0.4270000000000001,1,2012-11-21,10,6,4,0.6,10,0,10,0.0
21200163,1610612748,1610612749,113.0,106.0,0.477,0.422,1,2012-11-21,12,9,3,0.75,10,6,4,0.6
21200164,1610612760,1610612746,117.0,111.0,0.456,0.43,1,2012-11-21,12,9,3,0.75,11,8,3,0.727
21200165,1610612745,1610612741,93.0,89.0,0.4320000000000001,0.4,1,2012-11-21,12,5,7,0.417,11,5,6,0.455
21200166,1610612750,1610612743,94.0,101.0,0.382,0.4429999999999999,0,2012-11-21,10,5,5,0.5,12,6,6,0.5
21200167,1610612742,1610612752,114.0,111.0,0.494,0.506,1,2012-11-21,13,7,6,0.5379999999999999,10,8,2,0.8
21200168,1610612756,1610612757,114.0,87.0,0.597,0.4029999999999999,1,2012-11-21,12,5,7,0.417,11,5,6,0.455
21200169,1610612758,1610612747,113.0,97.0,0.5429999999999999,0.446,1,2012-11-21,11,3,8,0.273,12,6,6,0.5
21200170,1610612744,1610612751,102.0,93.0,0.5329999999999999,0.4579999999999999,1,2012-11-21,12,7,5,0.583,10,6,4,0.6
21200154,1610612755,1610612761,106.0,98.0,0.471,0.451,1,2012-11-20,11,7,4,0.636,11,3,8,0.273
21200155,1610612740,1610612752,80.0,102.0,0.42,0.446,0,2012-11-20,9,3,6,0.3329999999999999,9,8,1,0.889
21200156,1610612747,1610612751,95.0,90.0,0.479,0.415,1,2012-11-20,11,6,5,0.545,9,6,3,0.667
21200147,1610612764,1610612754,89.0,96.0,0.356,0.486,0,2012-11-19,9,0,9,0.0,12,5,7,0.417
21200148,1610612766,1610612749,102.0,98.0,0.439,0.473,1,2012-11-19,9,5,4,0.556,9,6,3,0.667
21200149,1610612737,1610612753,81.0,72.0,0.382,0.3779999999999999,1,2012-11-19,9,5,4,0.556,10,3,7,0.3
21200150,1610612763,1610612743,92.0,97.0,0.462,0.444,0,2012-11-19,10,8,2,0.8,11,5,6,0.455
21200151,1610612742,1610612744,101.0,105.0,0.43,0.407,0,2012-11-19,12,6,6,0.5,11,6,5,0.545
21200152,1610612759,1610612746,87.0,92.0,0.354,0.471,0,2012-11-19,11,8,3,0.727,10,8,2,0.8
21200153,1610612762,1610612745,102.0,91.0,0.402,0.349,1,2012-11-19,12,6,6,0.5,11,4,7,0.364
21200139,1610612752,1610612754,88.0,76.0,0.3670000000000001,0.3939999999999999,1,2012-11-18,8,7,1,0.875,11,4,7,0.364
21200140,1610612761,1610612753,97.0,86.0,0.475,0.4,1,2012-11-18,10,3,7,0.3,9,3,6,0.3329999999999999
21200141,1610612755,1610612739,86.0,79.0,0.425,0.357,1,2012-11-18,10,6,4,0.6,10,2,8,0.2
21200142,1610612758,1610612751,90.0,99.0,0.4629999999999999,0.48,0,2012-11-18,10,2,8,0.2,8,6,2,0.75
21200143,1610612760,1610612744,119.0,109.0,0.506,0.524,1,2012-11-18,11,8,3,0.727,10,5,5,0.5
21200144,1610612765,1610612738,103.0,83.0,0.542,0.451,1,2012-11-18,11,2,9,0.182,11,6,5,0.545
21200145,1610612757,1610612741,102.0,94.0,0.494,0.493,1,2012-11-18,10,5,5,0.5,10,5,5,0.5
21200146,1610612747,1610612745,119.0,108.0,0.541,0.489,1,2012-11-18,10,5,5,0.5,10,4,6,0.4
21200131,1610612738,1610612761,107.0,89.0,0.5660000000000001,0.429,1,2012-11-17,10,6,4,0.6,9,2,7,0.222
21200133,1610612764,1610612762,76.0,83.0,0.365,0.3779999999999999,0,2012-11-17,8,0,8,0.0,11,5,6,0.455
21200134,1610612766,1610612763,87.0,94.0,0.376,0.3879999999999999,0,2012-11-17,8,4,4,0.5,9,8,1,0.889
21200135,1610612739,1610612742,95.0,103.0,0.375,0.514,0,2012-11-17,9,2,7,0.222,11,6,5,0.545
21200136,1610612749,1610612740,117.0,113.0,0.462,0.532,1,2012-11-17,8,6,2,0.75,8,3,5,0.375
21200137,1610612759,1610612743,126.0,100.0,0.534,0.5,1,2012-11-17,10,8,2,0.8,10,4,6,0.4
21200132,1610612746,1610612741,101.0,80.0,0.493,0.337,1,2012-11-17,9,7,2,0.778,9,5,4,0.556
21200138,1610612756,1610612748,88.0,97.0,0.43,0.535,0,2012-11-17,11,4,7,0.364,11,8,3,0.727
21200122,1610612755,1610612762,99.0,93.0,0.46,0.444,1,2012-11-16,9,5,4,0.556,10,4,6,0.4
21200124,1610612754,1610612742,103.0,83.0,0.47,0.37,1,2012-11-16,10,4,6,0.4,10,5,5,0.5
21200123,1610612765,1610612753,106.0,110.0,0.537,0.494,0,2012-11-16,10,1,9,0.1,8,3,5,0.375
21200125,1610612740,1610612760,95.0,110.0,0.423,0.541,0,2012-11-16,7,3,4,0.429,10,7,3,0.7
21200126,1610612750,1610612744,98.0,106.0,0.43,0.506,0,2012-11-16,9,5,4,0.556,9,5,4,0.556
21200127,1610612763,1610612752,105.0,95.0,0.487,0.514,1,2012-11-16,8,7,1,0.875,7,6,1,0.857
21200128,1610612758,1610612737,96.0,112.0,0.4589999999999999,0.5529999999999999,0,2012-11-16,9,2,7,0.222,8,4,4,0.5
21200129,1610612757,1610612745,119.0,117.0,0.512,0.466,1,2012-11-16,9,4,5,0.444,9,4,5,0.444
21200130,1610612747,1610612756,114.0,102.0,0.472,0.489,1,2012-11-16,9,4,5,0.444,10,4,6,0.4
21200119,1610612751,1610612738,102.0,97.0,0.424,0.467,1,2012-11-15,7,5,2,0.7140000000000001,9,5,4,0.556
21200120,1610612759,1610612752,100.0,104.0,0.4370000000000001,0.4529999999999999,0,2012-11-15,9,7,2,0.778,6,6,0,1.0
21200121,1610612743,1610612748,93.0,98.0,0.42,0.4679999999999999,0,2012-11-15,9,4,5,0.444,10,7,3,0.7
21200109,1610612755,1610612765,76.0,94.0,0.298,0.479,0,2012-11-14,8,4,4,0.5,9,1,8,0.111
21200110,1610612738,1610612762,98.0,93.0,0.5,0.402,1,2012-11-14,8,5,3,0.625,9,4,5,0.444
21200111,1610612749,1610612754,99.0,85.0,0.418,0.375,1,2012-11-14,7,5,2,0.7140000000000001,9,3,6,0.3329999999999999
21200112,1610612745,1610612740,100.0,96.0,0.45,0.405,1,2012-11-14,8,4,4,0.5,6,3,3,0.5
21200113,1610612760,1610612763,97.0,107.0,0.486,0.473,0,2012-11-14,9,6,3,0.667,7,6,1,0.857
21200114,1610612750,1610612766,87.0,89.0,0.3829999999999999,0.452,0,2012-11-14,8,5,3,0.625,7,4,3,0.5710000000000001
21200115,1610612742,1610612764,107.0,101.0,0.5,0.481,1,2012-11-14,9,5,4,0.556,7,0,7,0.0
21200116,1610612756,1610612741,106.0,112.0,0.4,0.5,0,2012-11-14,9,4,5,0.444,8,5,3,0.625
21200117,1610612746,1610612748,107.0,100.0,0.486,0.455,1,2012-11-14,8,6,2,0.75,9,6,3,0.667
21200118,1610612744,1610612737,92.0,88.0,0.465,0.436,1,2012-11-14,8,4,4,0.5,7,3,4,0.429
21200103,1610612766,1610612764,92.0,76.0,0.397,0.298,1,2012-11-13,6,3,3,0.5,6,0,6,0.0
21200104,1610612753,1610612752,89.0,99.0,0.493,0.488,0,2012-11-13,7,2,5,0.286,5,5,0,1.0
21200105,1610612754,1610612761,72.0,74.0,0.32,0.361,0,2012-11-13,8,3,5,0.375,8,2,6,0.25
21200106,1610612751,1610612739,114.0,101.0,0.545,0.4370000000000001,1,2012-11-13,6,4,2,0.667,8,2,6,0.25
21200107,1610612758,1610612757,86.0,103.0,0.4679999999999999,0.486,0,2012-11-13,8,2,6,0.25,8,3,5,0.375
21200108,1610612747,1610612759,82.0,84.0,0.419,0.389,0,2012-11-13,8,3,5,0.375,8,7,1,0.875
21200095,1610612761,1610612762,133.0,140.0,0.472,0.495,0,2012-11-12,7,1,6,0.143,8,4,4,0.5
21200096,1610612755,1610612749,96.0,105.0,0.435,0.513,0,2012-11-12,7,4,3,0.5710000000000001,6,4,2,0.667
21200097,1610612765,1610612760,90.0,92.0,0.3979999999999999,0.37,0,2012-11-12,8,0,8,0.0,8,6,2,0.75
21200098,1610612741,1610612738,95.0,101.0,0.4589999999999999,0.506,0,2012-11-12,7,4,3,0.5710000000000001,7,4,3,0.5710000000000001
21200099,1610612745,1610612748,110.0,113.0,0.45,0.506,0,2012-11-12,7,3,4,0.429,8,6,2,0.75
21200100,1610612742,1610612750,82.0,90.0,0.363,0.462,0,2012-11-12,8,4,4,0.5,7,5,2,0.7140000000000001
21200101,1610612756,1610612743,110.0,100.0,0.457,0.539,1,2012-11-12,8,4,4,0.5,8,4,4,0.5
21200102,1610612757,1610612737,87.0,95.0,0.361,0.4429999999999999,0,2012-11-12,7,2,5,0.286,6,3,3,0.5
21200090,1610612751,1610612753,82.0,74.0,0.3720000000000001,0.357,1,2012-11-11,5,3,2,0.6,6,2,4,0.3329999999999999
21200091,1610612746,1610612737,89.0,76.0,0.4629999999999999,0.417,1,2012-11-11,7,5,2,0.7140000000000001,5,2,3,0.4
21200092,1610612763,1610612748,104.0,86.0,0.442,0.38,1,2012-11-11,6,5,1,0.833,7,5,2,0.7140000000000001
21200093,1610612760,1610612739,106.0,91.0,0.5479999999999999,0.41,1,2012-11-11,7,5,2,0.7140000000000001,7,2,5,0.286
21200094,1610612747,1610612758,103.0,90.0,0.444,0.4,1,2012-11-11,7,3,4,0.429,7,2,5,0.286
21200081,1610612761,1610612755,83.0,93.0,0.38,0.466,0,2012-11-10,6,1,5,0.1669999999999999,6,4,2,0.667
21200082,1610612754,1610612764,89.0,85.0,0.425,0.4429999999999999,1,2012-11-10,7,3,4,0.429,5,0,5,0.0
21200083,1610612766,1610612742,101.0,97.0,0.421,0.405,1,2012-11-10,5,2,3,0.4,7,4,3,0.5710000000000001
21200084,1610612741,1610612750,87.0,80.0,0.425,0.3879999999999999,1,2012-11-10,6,4,2,0.667,6,4,2,0.667
21200085,1610612745,1610612765,96.0,82.0,0.402,0.4,1,2012-11-10,6,3,3,0.5,7,0,7,0.0
21200086,1610612749,1610612738,92.0,96.0,0.3979999999999999,0.444,0,2012-11-10,5,3,2,0.6,6,3,3,0.5
21200087,1610612762,1610612756,94.0,81.0,0.487,0.368,1,2012-11-10,7,3,4,0.429,7,3,4,0.429
21200088,1610612757,1610612759,109.0,112.0,0.472,0.5710000000000001,0,2012-11-10,6,2,4,0.3329999999999999,7,6,1,0.857
21200089,1610612744,1610612743,101.0,107.0,0.382,0.381,0,2012-11-10,7,3,4,0.429,7,4,3,0.5710000000000001
21200068,1610612764,1610612749,91.0,101.0,0.436,0.513,0,2012-11-09,4,0,4,0.0,4,3,1,0.75
21200069,1610612753,1610612751,68.0,107.0,0.429,0.5,0,2012-11-09,5,2,3,0.4,4,2,2,0.5
21200070,1610612738,1610612755,100.0,106.0,0.487,0.488,0,2012-11-09,5,2,3,0.4,5,3,2,0.6
21200071,1610612752,1610612742,104.0,94.0,0.417,0.407,1,2012-11-09,4,4,0,1.0,6,4,2,0.667
21200072,1610612737,1610612748,89.0,95.0,0.42,0.487,0,2012-11-09,4,2,2,0.5,6,5,1,0.833
21200073,1610612763,1610612745,93.0,85.0,0.3720000000000001,0.408,1,2012-11-09,5,4,1,0.8,5,2,3,0.4
21200074,1610612740,1610612766,107.0,99.0,0.518,0.482,1,2012-11-09,5,3,2,0.6,4,1,3,0.25
21200075,1610612760,1610612765,105.0,94.0,0.535,0.414,1,2012-11-09,6,4,2,0.667,6,0,6,0.0
21200076,1610612750,1610612754,96.0,94.0,0.5,0.44,1,2012-11-09,5,4,1,0.8,6,2,4,0.3329999999999999
21200077,1610612756,1610612739,107.0,105.0,0.469,0.481,1,2012-11-09,6,3,3,0.5,6,2,4,0.3329999999999999
21200078,1610612758,1610612759,86.0,97.0,0.352,0.486,0,2012-11-09,6,2,4,0.3329999999999999,6,5,1,0.833
21200079,1610612743,1610612762,104.0,84.0,0.435,0.368,1,2012-11-09,6,3,3,0.5,6,2,4,0.3329999999999999
21200080,1610612747,1610612744,101.0,77.0,0.4,0.337,1,2012-11-09,6,2,4,0.3329999999999999,6,3,3,0.5
21200066,1610612741,1610612760,91.0,97.0,0.417,0.493,0,2012-11-08,5,3,2,0.6,5,3,2,0.6
21200067,1610612757,1610612746,90.0,103.0,0.4270000000000001,0.532,0,2012-11-08,5,2,3,0.4,6,4,2,0.667
21200053,1610612766,1610612756,110.0,117.0,0.4370000000000001,0.462,0,2012-11-07,3,1,2,0.3329999999999999,5,2,3,0.4
21200054,1610612738,1610612764,100.0,94.0,0.42,0.411,1,2012-11-07,4,2,2,0.5,3,0,3,0.0
21200055,1610612737,1610612754,89.0,86.0,0.4370000000000001,0.412,1,2012-11-07,3,2,1,0.667,5,2,3,0.4
21200056,1610612748,1610612751,103.0,73.0,0.519,0.375,1,2012-11-07,5,4,1,0.8,3,1,2,0.3329999999999999
21200057,1610612749,1610612763,90.0,108.0,0.385,0.53,0,2012-11-07,3,2,1,0.667,4,3,1,0.75
21200058,1610612740,1610612755,62.0,77.0,0.3329999999999999,0.417,0,2012-11-07,4,2,2,0.5,4,2,2,0.5
21200059,1610612745,1610612743,87.0,93.0,0.369,0.451,0,2012-11-07,4,2,2,0.5,5,2,3,0.4
21200060,1610612750,1610612753,90.0,75.0,0.447,0.35,1,2012-11-07,4,3,1,0.75,4,2,2,0.5
21200061,1610612742,1610612761,109.0,104.0,0.4639999999999999,0.444,1,2012-11-07,5,4,1,0.8,5,1,4,0.2
21200062,1610612762,1610612747,95.0,86.0,0.446,0.3379999999999999,1,2012-11-07,5,2,3,0.4,5,1,4,0.2
21200063,1610612758,1610612765,105.0,103.0,0.488,0.493,1,2012-11-07,5,2,3,0.4,5,0,5,0.0
21200064,1610612746,1610612759,106.0,84.0,0.5539999999999999,0.411,1,2012-11-07,5,3,2,0.6,5,4,1,0.8
21200065,1610612744,1610612739,106.0,96.0,0.5379999999999999,0.419,1,2012-11-07,5,3,2,0.6,5,2,3,0.4
21200050,1610612741,1610612753,99.0,93.0,0.476,0.419,1,2012-11-06,4,3,1,0.75,3,2,1,0.667
21200051,1610612760,1610612761,108.0,88.0,0.473,0.357,1,2012-11-06,4,2,2,0.5,4,1,3,0.25
21200052,1610612743,1610612765,109.0,97.0,0.446,0.449,1,2012-11-06,4,1,3,0.25,4,0,4,0.0
21200042,1610612755,1610612752,88.0,110.0,0.337,0.4639999999999999,0,2012-11-05,3,1,2,0.3329999999999999,3,3,0,1.0
21200043,1610612751,1610612750,96.0,107.0,0.479,0.5,0,2012-11-05,2,1,1,0.5,3,2,1,0.667
21200044,1610612748,1610612756,124.0,99.0,0.547,0.3979999999999999,1,2012-11-05,4,3,1,0.75,4,1,3,0.25
21200045,1610612763,1610612762,103.0,94.0,0.418,0.444,1,2012-11-05,3,2,1,0.667,4,1,3,0.25
21200046,1610612742,1610612757,114.0,91.0,0.615,0.387,1,2012-11-05,4,3,1,0.75,4,2,2,0.5
21200047,1610612759,1610612754,101.0,79.0,0.471,0.342,1,2012-11-05,4,4,0,1.0,4,2,2,0.5
21200048,1610612758,1610612744,94.0,92.0,0.457,0.397,1,2012-11-05,4,1,3,0.25,4,2,2,0.5
21200049,1610612746,1610612739,101.0,108.0,0.527,0.435,0,2012-11-05,4,2,2,0.5,4,2,2,0.5
21200037,1610612752,1610612755,100.0,84.0,0.506,0.43,1,2012-11-04,2,2,0,1.0,2,1,1,0.5
21200038,1610612761,1610612750,105.0,86.0,0.444,0.4529999999999999,1,2012-11-04,3,1,2,0.3329999999999999,2,1,1,0.5
21200039,1610612753,1610612756,115.0,94.0,0.489,0.429,1,2012-11-04,2,2,0,1.0,3,1,2,0.3329999999999999
21200040,1610612760,1610612737,95.0,104.0,0.465,0.494,0,2012-11-04,3,1,2,0.3329999999999999,2,1,1,0.5
21200041,1610612747,1610612765,108.0,79.0,0.519,0.354,1,2012-11-04,4,1,3,0.25,3,0,3,0.0
21200027,1610612764,1610612738,86.0,89.0,0.436,0.429,0,2012-11-03,2,0,2,0.0,3,1,2,0.3329999999999999
21200028,1610612754,1610612758,106.0,98.0,0.3939999999999999,0.363,1,2012-11-03,3,2,1,0.667,3,0,3,0.0
21200029,1610612751,1610612761,107.0,100.0,0.457,0.451,1,2012-11-03,1,1,0,1.0,2,0,2,0.0
21200030,1610612748,1610612743,119.0,116.0,0.518,0.516,1,2012-11-03,3,2,1,0.667,3,0,3,0.0
21200031,1610612741,1610612740,82.0,89.0,0.33,0.4270000000000001,0,2012-11-03,3,2,1,0.667,3,2,1,0.667
21200032,1610612745,1610612757,85.0,95.0,0.354,0.419,0,2012-11-03,3,2,1,0.667,3,2,1,0.667
21200033,1610612749,1610612739,105.0,102.0,0.519,0.47,1,2012-11-03,2,2,0,1.0,3,1,2,0.3329999999999999
21200034,1610612742,1610612766,126.0,99.0,0.613,0.429,1,2012-11-03,3,2,1,0.667,2,1,1,0.5
21200035,1610612759,1610612762,110.0,100.0,0.568,0.494,1,2012-11-03,3,3,0,1.0,3,1,2,0.3329999999999999
21200036,1610612746,1610612744,110.0,114.0,0.429,0.488,0,2012-11-03,3,2,1,0.667,3,2,1,0.667
21200015,1610612766,1610612754,90.0,89.0,0.365,0.3979999999999999,1,2012-11-02,1,1,0,1.0,2,1,1,0.5
21200016,1610612753,1610612743,102.0,89.0,0.488,0.381,1,2012-11-02,1,1,0,1.0,2,0,2,0.0
21200017,1610612738,1610612749,88.0,99.0,0.446,0.465,0,2012-11-02,2,0,2,0.0,1,1,0,1.0
21200018,1610612737,1610612745,102.0,109.0,0.471,0.422,0,2012-11-02,1,0,1,0.0,2,2,0,1.0
21200019,1610612739,1610612741,86.0,115.0,0.405,0.638,0,2012-11-02,2,1,1,0.5,2,2,0,1.0
21200020,1610612752,1610612748,104.0,84.0,0.429,0.465,1,2012-11-02,1,1,0,1.0,2,1,1,0.5
21200021,1610612740,1610612762,88.0,86.0,0.457,0.412,1,2012-11-02,2,1,1,0.5,2,1,1,0.5
21200022,1610612760,1610612757,106.0,92.0,0.513,0.36,1,2012-11-02,2,1,1,0.5,2,1,1,0.5
21200023,1610612750,1610612758,92.0,80.0,0.368,0.36,1,2012-11-02,1,1,0,1.0,2,0,2,0.0
21200024,1610612756,1610612765,92.0,89.0,0.435,0.411,1,2012-11-02,2,1,1,0.5,2,0,2,0.0
21200025,1610612747,1610612746,95.0,105.0,0.5,0.452,0,2012-11-02,3,0,3,0.0,2,2,0,1.0
21200026,1610612744,1610612763,94.0,104.0,0.45,0.455,0,2012-11-02,2,1,1,0.5,2,1,1,0.5
21200014,1610612759,1610612760,86.0,84.0,0.4429999999999999,0.377,1,2012-11-01,2,2,0,1.0,1,0,1,0.0
21200004,1610612761,1610612754,88.0,90.0,0.363,0.474,0,2012-10-31,1,0,1,0.0,1,1,0,1.0
21200005,1610612755,1610612743,84.0,75.0,0.353,0.375,1,2012-10-31,1,1,0,1.0,1,0,1,0.0
21200006,1610612765,1610612745,96.0,105.0,0.4429999999999999,0.494,0,2012-10-31,1,0,1,0.0,1,1,0,1.0
21200007,1610612741,1610612758,93.0,87.0,0.418,0.405,1,2012-10-31,1,1,0,1.0,1,0,1,0.0
21200008,1610612740,1610612759,95.0,99.0,0.4379999999999999,0.475,0,2012-10-31,1,0,1,0.0,1,1,0,1.0
21200009,1610612762,1610612742,113.0,94.0,0.4270000000000001,0.376,1,2012-10-31,1,1,0,1.0,2,1,1,0.5
21200010,1610612756,1610612744,85.0,87.0,0.4,0.384,0,2012-10-31,1,0,1,0.0,1,1,0,1.0
21200011,1610612746,1610612763,101.0,92.0,0.514,0.384,1,2012-10-31,1,1,0,1.0,1,0,1,0.0
21200012,1610612757,1610612747,116.0,106.0,0.506,0.5,1,2012-10-31,1,1,0,1.0,2,0,2,0.0
21200001,1610612739,1610612764,94.0,84.0,0.456,0.356,1,2012-10-30,1,1,0,1.0,1,0,1,0.0
21200002,1610612748,1610612738,120.0,107.0,0.544,0.52,1,2012-10-30,1,1,0,1.0,1,0,1,0.0
21200003,1610612747,1610612742,91.0,99.0,0.494,0.471,0,2012-10-30,1,0,1,0.0,1,1,0,1.0
11200110,1610612753,1610612745,92.0,108.0,0.396,0.513,0,2012-10-26,8,2,6,0.25,7,5,2,0.7140000000000001
11200111,1610612741,1610612754,97.0,90.0,0.456,0.444,1,2012-10-26,7,5,2,0.7140000000000001,7,4,3,0.5710000000000001
11200114,1610612765,1610612737,104.0,88.0,0.513,0.4,1,2012-10-26,8,4,4,0.5,7,3,4,0.429
11200048,1610612763,1610612761,106.0,120.0,0.447,0.457,0,2012-10-26,8,4,4,0.5,7,6,1,0.857
11200112,1610612749,1610612750,76.0,100.0,0.361,0.514,0,2012-10-26,8,3,5,0.375,7,5,2,0.7140000000000001
11200118,1610612748,1610612740,89.0,96.0,0.384,0.478,0,2012-10-26,8,4,4,0.5,8,4,4,0.5
11200115,1610612742,1610612766,99.0,82.0,0.43,0.303,1,2012-10-26,8,4,4,0.5,8,1,7,0.125
11200116,1610612759,1610612764,100.0,85.0,0.467,0.369,1,2012-10-26,7,4,3,0.5710000000000001,8,3,5,0.375
11200117,1610612756,1610612743,88.0,72.0,0.414,0.365,1,2012-10-26,7,4,3,0.5710000000000001,7,3,4,0.429
11200106,1610612766,1610612749,90.0,100.0,0.356,0.419,0,2012-10-25,7,1,6,0.143,7,3,4,0.429
11200107,1610612762,1610612757,97.0,91.0,0.481,0.446,1,2012-10-25,8,5,3,0.625,7,3,4,0.429
11200108,1610612747,1610612758,82.0,94.0,0.424,0.4529999999999999,0,2012-10-25,8,0,8,0.0,7,5,2,0.7140000000000001
11200109,1610612743,1610612746,94.0,106.0,0.4,0.488,0,2012-10-25,6,3,3,0.5,8,5,3,0.625
11200017,1610612751,1610612752,95.0,97.0,0.402,0.42,0,2012-10-24,6,3,3,0.5,6,3,3,0.5
11200099,1610612763,1610612753,115.0,100.0,0.511,0.487,1,2012-10-24,7,4,3,0.5710000000000001,7,2,5,0.286
11200100,1610612740,1610612745,90.0,97.0,0.465,0.44,0,2012-10-24,7,3,4,0.429,6,4,2,0.667
11200101,1610612760,1610612742,88.0,76.0,0.43,0.373,1,2012-10-24,7,4,3,0.5710000000000001,7,3,4,0.429
11200102,1610612750,1610612765,95.0,76.0,0.457,0.3289999999999999,1,2012-10-24,6,4,2,0.667,7,3,4,0.429
11200104,1610612748,1610612764,94.0,101.0,0.423,0.425,0,2012-10-24,7,4,3,0.5710000000000001,7,3,4,0.429
11200105,1610612746,1610612747,97.0,91.0,0.4679999999999999,0.471,1,2012-10-24,7,4,3,0.5710000000000001,7,0,7,0.0
11200095,1610612766,1610612748,92.0,98.0,0.368,0.515,0,2012-10-23,6,1,5,0.1669999999999999,6,4,2,0.667
11200096,1610612739,1610612754,82.0,100.0,0.37,0.475,0,2012-10-23,7,3,4,0.429,6,4,2,0.667
11200097,1610612741,1610612760,94.0,89.0,0.421,0.39,1,2012-10-23,6,4,2,0.667,6,3,3,0.5
11200098,1610612744,1610612756,107.0,92.0,0.569,0.4589999999999999,1,2012-10-23,8,6,2,0.75,6,3,3,0.5
11200089,1610612761,1610612749,104.0,95.0,0.455,0.402,1,2012-10-22,6,5,1,0.833,6,2,4,0.3329999999999999
11200092,1610612755,1610612752,98.0,90.0,0.542,0.38,1,2012-10-22,7,6,1,0.857,5,2,3,0.4
11200093,1610612742,1610612740,87.0,74.0,0.36,0.3329999999999999,1,2012-10-22,6,3,3,0.5,6,3,3,0.5
11200090,1610612756,1610612758,103.0,88.0,0.435,0.374,1,2012-10-22,5,3,2,0.6,6,4,2,0.667
11200091,1610612757,1610612762,120.0,114.0,0.575,0.519,1,2012-10-22,6,3,3,0.5,7,4,3,0.5710000000000001
11200094,1610612746,1610612744,88.0,71.0,0.4039999999999999,0.3289999999999999,1,2012-10-22,6,3,3,0.5,7,5,2,0.7140000000000001
11200085,1610612753,1610612759,104.0,100.0,0.494,0.407,1,2012-10-21,6,2,4,0.3329999999999999,6,3,3,0.5
11200088,1610612738,1610612755,79.0,88.0,0.424,0.413,0,2012-10-21,8,3,5,0.375,6,5,1,0.833
11200087,1610612760,1610612743,108.0,101.0,0.461,0.452,1,2012-10-21,5,3,2,0.6,5,3,2,0.6
11200086,1610612747,1610612758,92.0,99.0,0.493,0.407,0,2012-10-21,6,0,6,0.0,5,4,1,0.8
11200082,1610612748,1610612759,104.0,101.0,0.527,0.47,1,2012-10-20,5,3,2,0.6,5,3,2,0.6
11200078,1610612737,1610612742,110.0,94.0,0.457,0.37,1,2012-10-20,6,3,3,0.5,5,2,3,0.4
11200079,1610612754,1610612763,83.0,80.0,0.361,0.37,1,2012-10-20,5,3,2,0.6,6,3,3,0.5
11200081,1610612738,1610612752,109.0,98.0,0.5479999999999999,0.429,1,2012-10-20,7,3,4,0.429,4,2,2,0.5
11200083,1610612765,1610612766,85.0,80.0,0.373,0.363,1,2012-10-20,6,3,3,0.5,5,1,4,0.2
11200084,1610612749,1610612764,94.0,102.0,0.395,0.478,0,2012-10-20,5,2,3,0.4,6,2,4,0.3329999999999999
11200080,1610612762,1610612746,99.0,91.0,0.424,0.515,1,2012-10-20,6,4,2,0.667,5,2,3,0.4
11200071,1610612761,1610612752,107.0,88.0,0.456,0.465,1,2012-10-19,5,4,1,0.8,3,2,1,0.667
11200072,1610612753,1610612754,112.0,96.0,0.5489999999999999,0.4039999999999999,1,2012-10-19,5,1,4,0.2,4,2,2,0.5
11200077,1610612751,1610612755,96.0,106.0,0.442,0.494,0,2012-10-19,5,3,2,0.6,5,4,1,0.8
11200073,1610612741,1610612750,92.0,81.0,0.418,0.4270000000000001,1,2012-10-19,5,3,2,0.6,5,3,2,0.6
11200074,1610612760,1610612756,107.0,97.0,0.494,0.494,1,2012-10-19,4,2,2,0.5,4,2,2,0.5
11200075,1610612747,1610612758,98.0,103.0,0.4679999999999999,0.444,0,2012-10-19,5,0,5,0.0,4,3,1,0.75
11200076,1610612757,1610612744,97.0,101.0,0.4370000000000001,0.5,0,2012-10-19,5,2,3,0.4,6,5,1,0.833
11200068,1610612737,1610612740,97.0,68.0,0.419,0.3289999999999999,1,2012-10-18,5,2,3,0.4,5,3,2,0.6
11200069,1610612748,1610612765,105.0,78.0,0.476,0.352,1,2012-10-18,4,2,2,0.5,5,2,3,0.4
11200067,1610612749,1610612763,94.0,97.0,0.4320000000000001,0.4429999999999999,0,2012-10-18,4,2,2,0.5,5,3,2,0.6
11200070,1610612751,1610612738,85.0,115.0,0.3720000000000001,0.565,0,2012-10-18,4,3,1,0.75,6,2,4,0.3329999999999999
11200060,1610612761,1610612764,104.0,101.0,0.5,0.43,1,2012-10-17,4,3,1,0.75,5,1,4,0.2
11200061,1610612755,1610612739,113.0,99.0,0.5,0.4270000000000001,1,2012-10-17,4,3,1,0.75,6,3,3,0.5
11200062,1610612745,1610612763,109.0,102.0,0.506,0.375,1,2012-10-17,5,3,2,0.6,4,2,2,0.5
11200065,1610612742,1610612756,94.0,100.0,0.4629999999999999,0.442,0,2012-10-17,4,2,2,0.5,3,2,1,0.667
11200063,1610612758,1610612744,88.0,98.0,0.3329999999999999,0.456,0,2012-10-17,3,2,1,0.667,5,4,1,0.8
11200064,1610612757,1610612743,97.0,80.0,0.44,0.38,1,2012-10-17,4,2,2,0.5,4,3,1,0.75
11200066,1610612746,1610612762,96.0,94.0,0.4270000000000001,0.407,1,2012-10-17,4,2,2,0.5,5,3,2,0.6
11200053,1610612754,1610612737,102.0,98.0,0.446,0.387,1,2012-10-16,3,2,1,0.667,4,1,3,0.25
11200058,1610612738,1610612751,96.0,97.0,0.465,0.487,0,2012-10-16,5,1,4,0.2,3,3,0,1.0
11200059,1610612765,1610612753,112.0,86.0,0.5429999999999999,0.486,1,2012-10-16,4,2,2,0.5,4,0,4,0.0
11200054,1610612741,1610612749,100.0,94.0,0.4679999999999999,0.419,1,2012-10-16,4,2,2,0.5,3,2,1,0.667
11200055,1610612760,1610612766,120.0,98.0,0.64,0.444,1,2012-10-16,3,1,2,0.3329999999999999,4,1,3,0.25
11200057,1610612747,1610612762,80.0,114.0,0.375,0.534,0,2012-10-16,4,0,4,0.0,4,3,1,0.75
11200046,1610612755,1610612738,107.0,75.0,0.489,0.38,1,2012-10-15,3,2,1,0.667,4,1,3,0.25
11200047,1610612739,1610612753,114.0,111.0,0.471,0.474,1,2012-10-15,5,3,2,0.6,3,0,3,0.0
11200051,1610612751,1610612764,98.0,88.0,0.5,0.39,1,2012-10-15,2,2,0,1.0,4,1,3,0.25
11200052,1610612742,1610612745,123.0,104.0,0.516,0.412,1,2012-10-15,3,2,1,0.667,4,2,2,0.5
11200049,1610612743,1610612744,104.0,98.0,0.3979999999999999,0.481,1,2012-10-15,3,3,0,1.0,4,3,1,0.75
11200050,1610612758,1610612757,117.0,100.0,0.55,0.4,1,2012-10-15,2,2,0,1.0,3,1,2,0.3329999999999999
11200043,1610612748,1610612746,89.0,99.0,0.4,0.5,0,2012-10-14,3,1,2,0.3329999999999999,3,1,2,0.3329999999999999
11200044,1610612745,1610612759,107.0,116.0,0.4320000000000001,0.529,0,2012-10-14,3,2,1,0.667,4,3,1,0.75
11200045,1610612763,1610612737,110.0,102.0,0.477,0.4379999999999999,1,2012-10-14,3,2,1,0.667,3,1,2,0.3329999999999999
11200037,1610612755,1610612751,105.0,108.0,0.4039999999999999,0.407,0,2012-10-13,2,1,1,0.5,1,1,0,1.0
11200039,1610612738,1610612752,95.0,98.0,0.408,0.3670000000000001,0,2012-10-13,3,1,2,0.3329999999999999,2,2,0,1.0
11200040,1610612739,1610612764,95.0,99.0,0.4,0.4529999999999999,0,2012-10-13,4,2,2,0.5,3,1,2,0.3329999999999999
11200038,1610612750,1610612741,82.0,75.0,0.3279999999999999,0.368,1,2012-10-13,3,2,1,0.667,3,1,2,0.3329999999999999
11200041,1610612749,1610612765,108.0,91.0,0.4629999999999999,0.391,1,2012-10-13,2,2,0,1.0,3,1,2,0.3329999999999999
11200042,1610612747,1610612762,86.0,99.0,0.351,0.439,0,2012-10-13,3,0,3,0.0,3,2,1,0.667
11200030,1610612761,1610612765,82.0,75.0,0.3939999999999999,0.347,1,2012-10-12,3,2,1,0.667,2,1,1,0.5
11200031,1610612754,1610612750,96.0,91.0,0.436,0.479,1,2012-10-12,2,1,1,0.5,2,1,1,0.5
11200032,1610612741,1610612739,83.0,86.0,0.349,0.411,0,2012-10-12,2,1,1,0.5,3,2,1,0.667
11200033,1610612745,1610612740,95.0,75.0,0.493,0.337,1,2012-10-12,2,2,0,1.0,4,3,1,0.75
11200036,1610612759,1610612743,91.0,97.0,0.423,0.439,0,2012-10-12,3,2,1,0.667,2,2,0,1.0
11200034,1610612762,1610612760,97.0,81.0,0.42,0.3720000000000001,1,2012-10-12,2,1,1,0.5,2,0,2,0.0
11200035,1610612756,1610612757,104.0,93.0,0.512,0.386,1,2012-10-12,2,1,1,0.5,2,1,1,0.5
11200028,1610612746,1610612748,80.0,94.0,0.431,0.4029999999999999,0,2012-10-11,2,0,2,0.0,2,1,1,0.5
11200025,1610612764,1610612752,101.0,108.0,0.423,0.472,0,2012-10-11,2,0,2,0.0,1,1,0,1.0
11200026,1610612753,1610612755,95.0,102.0,0.452,0.447,0,2012-10-11,2,0,2,0.0,1,1,0,1.0
11200027,1610612766,1610612740,87.0,90.0,0.395,0.452,0,2012-10-11,3,1,2,0.3329999999999999,3,3,0,1.0
11200023,1610612765,1610612761,101.0,99.0,0.506,0.473,1,2012-10-10,1,1,0,1.0,2,1,1,0.5
11200019,1610612745,1610612760,107.0,105.0,0.43,0.478,1,2012-10-10,1,1,0,1.0,1,0,1,0.0
11200020,1610612750,1610612754,84.0,70.0,0.405,0.348,1,2012-10-10,1,1,0,1.0,1,0,1,0.0
11200024,1610612759,1610612737,101.0,99.0,0.519,0.3829999999999999,1,2012-10-10,2,2,0,1.0,2,1,1,0.5
11200021,1610612758,1610612756,102.0,96.0,0.407,0.414,1,2012-10-10,1,1,0,1.0,1,0,1,0.0
11200022,1610612747,1610612757,75.0,93.0,0.38,0.435,0,2012-10-10,2,0,2,0.0,1,1,0,1.0
11200014,1610612739,1610612749,80.0,97.0,0.385,0.44,0,2012-10-09,2,1,1,0.5,1,1,0,1.0
11200015,1610612741,1610612763,92.0,88.0,0.357,0.422,1,2012-10-09,1,1,0,1.0,2,1,1,0.5
11200016,1610612740,1610612766,97.0,82.0,0.4370000000000001,0.44,1,2012-10-09,2,2,0,1.0,2,1,1,0.5
11200013,1610612744,1610612762,83.0,80.0,0.4679999999999999,0.375,1,2012-10-08,2,2,0,1.0,1,0,1,0.0
11200006,1610612766,1610612764,100.0,88.0,0.451,0.3329999999999999,1,2012-10-07,1,1,0,1.0,1,0,1,0.0
11200008,1610612737,1610612748,92.0,79.0,0.413,0.451,1,2012-10-07,1,1,0,1.0,1,0,1,0.0
11200007,1610612740,1610612753,85.0,80.0,0.3720000000000001,0.375,1,2012-10-07,1,1,0,1.0,1,0,1,0.0
11200009,1610612747,1610612744,83.0,110.0,0.3939999999999999,0.562,0,2012-10-07,1,0,1,0.0,1,1,0,1.0
11200005,1610612746,1610612743,104.0,106.0,0.512,0.532,0,2012-10-06,1,0,1,0.0,1,1,0,1.0
41100405,1610612748,1610612760,121.0,106.0,0.519,0.414,1,2012-06-21,66,46,20,0.6970000000000001,66,47,19,0.7120000000000001
41100404,1610612748,1610612760,104.0,98.0,0.481,0.488,1,2012-06-19,66,46,20,0.6970000000000001,66,47,19,0.7120000000000001
41100403,1610612748,1610612760,91.0,85.0,0.3779999999999999,0.429,1,2012-06-17,66,46,20,0.6970000000000001,66,47,19,0.7120000000000001
41100402,1610612760,1610612748,96.0,100.0,0.43,0.474,0,2012-06-14,66,47,19,0.7120000000000001,66,46,20,0.6970000000000001
41100401,1610612760,1610612748,105.0,94.0,0.519,0.462,1,2012-06-12,66,47,19,0.7120000000000001,66,46,20,0.6970000000000001
41100307,1610612748,1610612738,101.0,88.0,0.514,0.467,1,2012-06-09,66,46,20,0.6970000000000001,66,39,27,0.591
41100306,1610612738,1610612748,79.0,98.0,0.4270000000000001,0.487,0,2012-06-07,66,39,27,0.591,66,46,20,0.6970000000000001
41100316,1610612760,1610612759,107.0,99.0,0.5,0.44,1,2012-06-06,66,47,19,0.7120000000000001,66,50,16,0.758
41100305,1610612748,1610612738,90.0,94.0,0.39,0.407,0,2012-06-05,66,46,20,0.6970000000000001,66,39,27,0.591
41100315,1610612759,1610612760,103.0,108.0,0.4589999999999999,0.5,0,2012-06-04,66,50,16,0.758,66,47,19,0.7120000000000001
41100304,1610612738,1610612748,93.0,91.0,0.412,0.425,1,2012-06-03,66,39,27,0.591,66,46,20,0.6970000000000001
41100314,1610612760,1610612759,109.0,103.0,0.564,0.5,1,2012-06-02,66,47,19,0.7120000000000001,66,50,16,0.758
41100303,1610612738,1610612748,101.0,91.0,0.5,0.494,1,2012-06-01,66,39,27,0.591,66,46,20,0.6970000000000001
41100313,1610612760,1610612759,102.0,82.0,0.455,0.395,1,2012-05-31,66,47,19,0.7120000000000001,66,50,16,0.758
41100302,1610612748,1610612738,115.0,111.0,0.446,0.494,1,2012-05-30,66,46,20,0.6970000000000001,66,39,27,0.591
41100312,1610612759,1610612760,120.0,111.0,0.551,0.42,1,2012-05-29,66,50,16,0.758,66,47,19,0.7120000000000001
41100301,1610612748,1610612738,93.0,79.0,0.5,0.395,1,2012-05-28,66,46,20,0.6970000000000001,66,39,27,0.591
41100311,1610612759,1610612760,101.0,98.0,0.4579999999999999,0.422,1,2012-05-27,66,50,16,0.758,66,47,19,0.7120000000000001
41100217,1610612738,1610612755,85.0,75.0,0.425,0.35,1,2012-05-26,66,39,27,0.591,66,35,31,0.53
41100206,1610612754,1610612748,93.0,105.0,0.486,0.539,0,2012-05-24,66,42,24,0.636,66,46,20,0.6970000000000001
41100216,1610612755,1610612738,82.0,75.0,0.457,0.3329999999999999,1,2012-05-23,66,35,31,0.53,66,39,27,0.591
41100205,1610612748,1610612754,115.0,83.0,0.614,0.337,1,2012-05-22,66,46,20,0.6970000000000001,66,42,24,0.636
41100215,1610612738,1610612755,101.0,85.0,0.522,0.4679999999999999,1,2012-05-21,66,39,27,0.591,66,35,31,0.53
41100235,1610612760,1610612747,106.0,90.0,0.467,0.4529999999999999,1,2012-05-21,66,47,19,0.7120000000000001,66,41,25,0.621
41100204,1610612754,1610612748,93.0,101.0,0.418,0.475,0,2012-05-20,66,42,24,0.636,66,46,20,0.6970000000000001
41100224,1610612746,1610612759,99.0,102.0,0.477,0.528,0,2012-05-20,66,40,26,0.606,66,50,16,0.758
41100223,1610612746,1610612759,86.0,96.0,0.4629999999999999,0.461,0,2012-05-19,66,40,26,0.606,66,50,16,0.758
41100234,1610612747,1610612760,100.0,103.0,0.43,0.494,0,2012-05-19,66,41,25,0.621,66,47,19,0.7120000000000001
41100214,1610612755,1610612738,92.0,83.0,0.3779999999999999,0.423,1,2012-05-18,66,35,31,0.53,66,39,27,0.591
41100233,1610612747,1610612760,99.0,96.0,0.386,0.3979999999999999,1,2012-05-18,66,41,25,0.621,66,47,19,0.7120000000000001
41100203,1610612754,1610612748,94.0,75.0,0.434,0.3720000000000001,1,2012-05-17,66,42,24,0.636,66,46,20,0.6970000000000001
41100222,1610612759,1610612746,105.0,88.0,0.532,0.4920000000000001,1,2012-05-17,66,50,16,0.758,66,40,26,0.606
41100213,1610612755,1610612738,91.0,107.0,0.407,0.519,0,2012-05-16,66,35,31,0.53,66,39,27,0.591
41100232,1610612760,1610612747,77.0,75.0,0.42,0.385,1,2012-05-16,66,47,19,0.7120000000000001,66,41,25,0.621
41100202,1610612748,1610612754,75.0,78.0,0.346,0.3779999999999999,0,2012-05-15,66,46,20,0.6970000000000001,66,42,24,0.636
41100221,1610612759,1610612746,108.0,92.0,0.488,0.446,1,2012-05-15,66,50,16,0.758,66,40,26,0.606
41100212,1610612738,1610612755,81.0,82.0,0.418,0.408,0,2012-05-14,66,39,27,0.591,66,35,31,0.53
41100231,1610612760,1610612747,119.0,90.0,0.53,0.4320000000000001,1,2012-05-14,66,47,19,0.7120000000000001,66,41,25,0.621
41100177,1610612763,1610612746,72.0,82.0,0.325,0.385,0,2012-05-13,66,41,25,0.621,66,40,26,0.606
41100201,1610612748,1610612754,95.0,86.0,0.407,0.4029999999999999,1,2012-05-13,66,46,20,0.6970000000000001,66,42,24,0.636
41100211,1610612738,1610612755,92.0,91.0,0.439,0.439,1,2012-05-12,66,39,27,0.591,66,35,31,0.53
41100167,1610612747,1610612743,96.0,87.0,0.3929999999999999,0.3929999999999999,1,2012-05-12,66,41,25,0.621,66,38,28,0.5760000000000001
41100176,1610612746,1610612763,88.0,90.0,0.43,0.455,0,2012-05-11,66,40,26,0.606,66,41,25,0.621
41100106,1610612755,1610612741,79.0,78.0,0.397,0.375,1,2012-05-10,66,35,31,0.53,66,50,16,0.758
41100136,1610612738,1610612737,83.0,80.0,0.419,0.41,1,2012-05-10,66,39,27,0.591,66,40,26,0.606
41100166,1610612743,1610612747,113.0,96.0,0.516,0.422,1,2012-05-10,66,38,28,0.5760000000000001,66,41,25,0.621
41100115,1610612748,1610612752,106.0,94.0,0.436,0.474,1,2012-05-09,66,46,20,0.6970000000000001,66,36,30,0.545
41100175,1610612763,1610612746,92.0,80.0,0.444,0.371,1,2012-05-09,66,41,25,0.621,66,40,26,0.606
41100125,1610612754,1610612753,105.0,87.0,0.524,0.421,1,2012-05-08,66,42,24,0.636,66,37,29,0.561
41100135,1610612737,1610612738,87.0,86.0,0.466,0.442,1,2012-05-08,66,40,26,0.606,66,39,27,0.591
41100105,1610612741,1610612755,77.0,69.0,0.415,0.321,1,2012-05-08,66,50,16,0.758,66,35,31,0.53
41100165,1610612747,1610612743,99.0,102.0,0.389,0.4589999999999999,0,2012-05-08,66,41,25,0.621,66,38,28,0.5760000000000001
41100144,1610612762,1610612759,81.0,87.0,0.364,0.3779999999999999,0,2012-05-07,66,36,30,0.545,66,50,16,0.758
41100174,1610612746,1610612763,101.0,97.0,0.447,0.434,1,2012-05-07,66,40,26,0.606,66,41,25,0.621
41100104,1610612755,1610612741,89.0,82.0,0.392,0.4,1,2012-05-06,66,35,31,0.53,66,50,16,0.758
41100114,1610612752,1610612748,89.0,87.0,0.4270000000000001,0.411,1,2012-05-06,66,36,30,0.545,66,46,20,0.6970000000000001
41100134,1610612738,1610612737,101.0,79.0,0.513,0.408,1,2012-05-06,66,39,27,0.591,66,40,26,0.606
41100164,1610612743,1610612747,88.0,92.0,0.4529999999999999,0.4529999999999999,0,2012-05-06,66,38,28,0.5760000000000001,66,41,25,0.621
41100124,1610612753,1610612754,99.0,101.0,0.4,0.4639999999999999,0,2012-05-05,66,37,29,0.561,66,42,24,0.636
41100173,1610612746,1610612763,87.0,86.0,0.471,0.4,1,2012-05-05,66,40,26,0.606,66,41,25,0.621
41100154,1610612742,1610612760,97.0,103.0,0.418,0.52,0,2012-05-05,66,36,30,0.545,66,47,19,0.7120000000000001
41100143,1610612762,1610612759,90.0,102.0,0.4039999999999999,0.488,0,2012-05-05,66,36,30,0.545,66,50,16,0.758
41100133,1610612738,1610612737,90.0,84.0,0.405,0.3779999999999999,1,2012-05-04,66,39,27,0.591,66,40,26,0.606
41100103,1610612755,1610612741,79.0,74.0,0.342,0.373,1,2012-05-04,66,35,31,0.53,66,50,16,0.758
41100163,1610612743,1610612747,99.0,84.0,0.3979999999999999,0.3720000000000001,1,2012-05-04,66,38,28,0.5760000000000001,66,41,25,0.621
41100113,1610612752,1610612748,70.0,87.0,0.319,0.426,0,2012-05-03,66,36,30,0.545,66,46,20,0.6970000000000001
41100153,1610612742,1610612760,79.0,95.0,0.342,0.424,0,2012-05-03,66,36,30,0.545,66,47,19,0.7120000000000001
41100142,1610612759,1610612762,114.0,83.0,0.573,0.344,1,2012-05-02,66,50,16,0.758,66,36,30,0.545
41100123,1610612753,1610612754,74.0,97.0,0.423,0.4679999999999999,0,2012-05-02,66,37,29,0.561,66,42,24,0.636
41100172,1610612763,1610612746,105.0,98.0,0.48,0.5670000000000001,1,2012-05-02,66,41,25,0.621,66,40,26,0.606
41100132,1610612737,1610612738,80.0,87.0,0.349,0.426,0,2012-05-01,66,40,26,0.606,66,39,27,0.591
41100102,1610612741,1610612755,92.0,109.0,0.452,0.59,0,2012-05-01,66,50,16,0.758,66,35,31,0.53
41100162,1610612747,1610612743,104.0,100.0,0.4479999999999999,0.44,1,2012-05-01,66,41,25,0.621,66,38,28,0.5760000000000001
41100112,1610612748,1610612752,104.0,94.0,0.521,0.494,1,2012-04-30,66,46,20,0.6970000000000001,66,36,30,0.545
41100122,1610612754,1610612753,93.0,78.0,0.429,0.355,1,2012-04-30,66,42,24,0.636,66,37,29,0.561
41100152,1610612760,1610612742,102.0,99.0,0.4479999999999999,0.418,1,2012-04-30,66,47,19,0.7120000000000001,66,36,30,0.545
41100141,1610612759,1610612762,106.0,91.0,0.476,0.421,1,2012-04-29,66,50,16,0.758,66,36,30,0.545
41100161,1610612747,1610612743,103.0,88.0,0.5,0.356,1,2012-04-29,66,41,25,0.621,66,38,28,0.5760000000000001
41100131,1610612737,1610612738,83.0,74.0,0.408,0.39,1,2012-04-29,66,40,26,0.606,66,39,27,0.591
41100171,1610612763,1610612746,98.0,99.0,0.447,0.5,0,2012-04-29,66,41,25,0.621,66,40,26,0.606
41100101,1610612741,1610612755,103.0,91.0,0.513,0.3979999999999999,1,2012-04-28,66,50,16,0.758,66,35,31,0.53
41100111,1610612748,1610612752,100.0,67.0,0.486,0.357,1,2012-04-28,66,46,20,0.6970000000000001,66,36,30,0.545
41100121,1610612754,1610612753,77.0,81.0,0.345,0.395,0,2012-04-28,66,42,24,0.636,66,37,29,0.561
41100151,1610612760,1610612742,99.0,98.0,0.481,0.436,1,2012-04-28,66,47,19,0.7120000000000001,66,36,30,0.545
21100980,1610612761,1610612751,98.0,67.0,0.42,0.301,1,2012-04-26,66,23,43,0.348,66,22,44,0.3329999999999999
21100978,1610612765,1610612755,108.0,86.0,0.506,0.391,1,2012-04-26,66,25,41,0.379,66,35,31,0.53
21100979,1610612738,1610612749,87.0,74.0,0.402,0.3720000000000001,1,2012-04-26,66,39,27,0.591,66,31,35,0.47
21100981,1610612764,1610612748,104.0,70.0,0.5529999999999999,0.358,1,2012-04-26,66,20,46,0.303,66,46,20,0.6970000000000001
21100982,1610612766,1610612752,84.0,104.0,0.4320000000000001,0.518,0,2012-04-26,66,7,59,0.106,66,36,30,0.545
21100983,1610612737,1610612742,106.0,89.0,0.529,0.423,1,2012-04-26,66,40,26,0.606,66,36,30,0.545
21100984,1610612741,1610612739,107.0,75.0,0.529,0.322,1,2012-04-26,66,50,16,0.758,66,21,45,0.318
21100985,1610612763,1610612753,88.0,76.0,0.472,0.411,1,2012-04-26,66,41,25,0.621,66,37,29,0.561
21100986,1610612745,1610612740,84.0,77.0,0.352,0.397,1,2012-04-26,66,34,32,0.515,66,21,45,0.318
21100987,1610612750,1610612743,102.0,131.0,0.449,0.629,0,2012-04-26,66,26,40,0.3939999999999999,66,38,28,0.5760000000000001
21100988,1610612762,1610612757,96.0,94.0,0.422,0.45,1,2012-04-26,66,36,30,0.545,66,28,38,0.424
21100989,1610612758,1610612747,113.0,96.0,0.511,0.451,1,2012-04-26,66,22,44,0.3329999999999999,66,41,25,0.621
21100990,1610612744,1610612759,101.0,107.0,0.517,0.4379999999999999,0,2012-04-26,66,23,43,0.348,66,50,16,0.758
21100971,1610612753,1610612766,102.0,95.0,0.402,0.4429999999999999,1,2012-04-25,65,37,28,0.569,65,7,58,0.108
21100972,1610612739,1610612764,85.0,96.0,0.442,0.44,0,2012-04-25,65,21,44,0.3229999999999999,65,19,46,0.292
21100973,1610612754,1610612741,87.0,92.0,0.4379999999999999,0.469,0,2012-04-25,66,42,24,0.636,65,49,16,0.754
21100974,1610612752,1610612746,99.0,93.0,0.4679999999999999,0.486,1,2012-04-25,65,35,30,0.5379999999999999,66,40,26,0.606
21100975,1610612749,1610612755,85.0,90.0,0.444,0.356,0,2012-04-25,65,31,34,0.477,65,35,30,0.5379999999999999
21100976,1610612760,1610612743,101.0,106.0,0.494,0.444,0,2012-04-25,66,47,19,0.7120000000000001,65,37,28,0.569
21100977,1610612756,1610612759,106.0,110.0,0.479,0.466,0,2012-04-25,66,33,33,0.5,65,49,16,0.754
21100966,1610612737,1610612746,109.0,102.0,0.5,0.5,1,2012-04-24,65,39,26,0.6,65,40,25,0.615
21100967,1610612738,1610612748,78.0,66.0,0.4320000000000001,0.384,1,2012-04-24,65,38,27,0.585,65,46,19,0.708
21100968,1610612760,1610612758,118.0,110.0,0.469,0.524,1,2012-04-24,65,47,18,0.723,65,21,44,0.3229999999999999
21100969,1610612762,1610612756,100.0,88.0,0.425,0.405,1,2012-04-24,65,35,30,0.5379999999999999,65,33,32,0.508
21100970,1610612744,1610612740,81.0,83.0,0.418,0.4370000000000001,0,2012-04-24,65,23,42,0.354,65,21,44,0.3229999999999999
21100960,1610612764,1610612766,101.0,73.0,0.5539999999999999,0.342,1,2012-04-23,64,18,46,0.281,64,7,57,0.109
21100961,1610612754,1610612765,103.0,97.0,0.38,0.4579999999999999,1,2012-04-23,65,42,23,0.6459999999999999,65,24,41,0.369
21100962,1610612751,1610612755,87.0,105.0,0.431,0.5379999999999999,0,2012-04-23,65,22,43,0.3379999999999999,64,34,30,0.531
21100963,1610612749,1610612761,92.0,86.0,0.3720000000000001,0.447,1,2012-04-23,64,31,33,0.484,65,22,43,0.3379999999999999
21100964,1610612763,1610612739,109.0,101.0,0.469,0.4629999999999999,1,2012-04-23,65,40,25,0.615,64,21,43,0.3279999999999999
21100965,1610612759,1610612757,124.0,89.0,0.593,0.385,1,2012-04-23,64,48,16,0.75,65,28,37,0.431
21100951,1610612737,1610612752,112.0,113.0,0.539,0.544,0,2012-04-22,64,38,26,0.594,64,34,30,0.531
21100952,1610612747,1610612760,114.0,106.0,0.387,0.366,1,2012-04-22,65,41,24,0.631,64,46,18,0.7190000000000001
21100953,1610612766,1610612758,88.0,114.0,0.4379999999999999,0.552,0,2012-04-22,63,7,56,0.111,64,21,43,0.3279999999999999
21100954,1610612748,1610612745,97.0,88.0,0.412,0.461,1,2012-04-22,64,46,18,0.7190000000000001,65,33,32,0.508
21100955,1610612765,1610612761,76.0,73.0,0.366,0.377,1,2012-04-22,64,24,40,0.375,64,22,42,0.344
21100956,1610612759,1610612739,114.0,98.0,0.545,0.42,1,2012-04-22,63,47,16,0.746,63,21,42,0.3329999999999999
21100957,1610612750,1610612744,88.0,93.0,0.366,0.446,0,2012-04-22,65,26,39,0.4,64,23,41,0.359
21100958,1610612743,1610612753,101.0,74.0,0.564,0.373,1,2012-04-22,64,36,28,0.563,64,36,28,0.563
21100959,1610612746,1610612740,107.0,98.0,0.429,0.493,1,2012-04-22,64,40,24,0.625,64,20,44,0.313
21100943,1610612756,1610612743,107.0,118.0,0.4629999999999999,0.552,0,2012-04-21,64,33,31,0.516,63,35,28,0.556
21100944,1610612754,1610612755,106.0,109.0,0.433,0.449,0,2012-04-21,64,41,23,0.6409999999999999,63,33,30,0.524
21100945,1610612748,1610612764,84.0,86.0,0.4029999999999999,0.414,0,2012-04-21,63,45,18,0.7140000000000001,63,17,46,0.27
21100946,1610612741,1610612742,93.0,83.0,0.452,0.392,1,2012-04-21,64,48,16,0.75,65,36,29,0.5539999999999999
21100947,1610612763,1610612757,93.0,89.0,0.444,0.3720000000000001,1,2012-04-21,64,39,25,0.609,64,28,36,0.4379999999999999
21100948,1610612745,1610612744,99.0,96.0,0.476,0.493,1,2012-04-21,64,33,31,0.516,63,22,41,0.349
21100949,1610612749,1610612751,106.0,95.0,0.452,0.465,1,2012-04-21,63,30,33,0.476,64,22,42,0.344
21100950,1610612762,1610612753,117.0,107.0,0.534,0.4379999999999999,1,2012-04-21,64,34,30,0.531,63,36,27,0.5710000000000001
21100937,1610612766,1610612763,80.0,85.0,0.405,0.4529999999999999,0,2012-04-20,62,7,55,0.113,63,38,25,0.603
21100938,1610612737,1610612738,97.0,92.0,0.514,0.481,1,2012-04-20,63,38,25,0.603,64,37,27,0.578
21100939,1610612739,1610612752,98.0,90.0,0.456,0.422,1,2012-04-20,62,21,41,0.3389999999999999,63,33,30,0.524
21100940,1610612742,1610612744,104.0,94.0,0.469,0.446,1,2012-04-20,64,36,28,0.563,62,22,40,0.355
21100941,1610612759,1610612747,121.0,97.0,0.61,0.434,1,2012-04-20,62,46,16,0.742,64,40,24,0.625
21100942,1610612758,1610612760,92.0,103.0,0.409,0.5329999999999999,0,2012-04-20,63,20,43,0.317,63,46,17,0.73
21100932,1610612754,1610612749,118.0,109.0,0.473,0.42,1,2012-04-19,63,41,22,0.6509999999999999,62,29,33,0.4679999999999999
21100933,1610612765,1610612750,80.0,91.0,0.363,0.466,0,2012-04-19,63,23,40,0.365,64,26,38,0.406
21100934,1610612748,1610612741,83.0,72.0,0.421,0.357,1,2012-04-19,62,45,17,0.726,63,47,16,0.746
21100935,1610612740,1610612745,105.0,99.0,0.471,0.416,1,2012-04-19,63,20,43,0.317,63,32,31,0.508
21100936,1610612756,1610612746,93.0,90.0,0.446,0.446,1,2012-04-19,63,33,30,0.524,63,39,24,0.619
21100918,1610612764,1610612749,121.0,112.0,0.557,0.452,1,2012-04-18,62,16,46,0.258,61,29,32,0.475
21100919,1610612766,1610612741,68.0,100.0,0.298,0.482,0,2012-04-18,61,7,54,0.115,62,47,15,0.758
21100920,1610612739,1610612755,87.0,103.0,0.456,0.524,0,2012-04-18,61,20,41,0.3279999999999999,62,32,30,0.516
21100921,1610612751,1610612752,95.0,104.0,0.449,0.434,0,2012-04-18,63,22,41,0.349,62,33,29,0.532
21100922,1610612737,1610612765,116.0,84.0,0.494,0.348,1,2012-04-18,62,37,25,0.597,62,23,39,0.371
21100923,1610612748,1610612761,96.0,72.0,0.526,0.417,1,2012-04-18,61,44,17,0.721,63,22,41,0.349
21100924,1610612738,1610612753,102.0,98.0,0.5429999999999999,0.462,1,2012-04-18,63,37,26,0.5870000000000001,62,36,26,0.581
21100925,1610612763,1610612740,103.0,91.0,0.506,0.483,1,2012-04-18,62,37,25,0.597,62,19,43,0.306
21100926,1610612742,1610612745,117.0,110.0,0.519,0.5,1,2012-04-18,63,35,28,0.556,62,32,30,0.516
21100927,1610612743,1610612746,98.0,104.0,0.493,0.487,0,2012-04-18,62,34,28,0.5479999999999999,62,39,23,0.629
21100928,1610612756,1610612760,97.0,109.0,0.41,0.45,0,2012-04-18,62,32,30,0.516,62,45,17,0.726
21100929,1610612758,1610612759,102.0,127.0,0.446,0.588,0,2012-04-18,62,20,42,0.3229999999999999,61,45,16,0.738
21100930,1610612757,1610612762,91.0,112.0,0.392,0.475,0,2012-04-18,63,28,35,0.444,63,33,30,0.524
21100931,1610612744,1610612747,87.0,99.0,0.422,0.4679999999999999,0,2012-04-18,61,22,39,0.361,63,40,23,0.635
21100913,1610612755,1610612754,97.0,102.0,0.447,0.416,0,2012-04-17,61,31,30,0.508,62,40,22,0.645
21100914,1610612765,1610612739,116.0,77.0,0.6,0.346,1,2012-04-17,61,23,38,0.377,60,20,40,0.3329999999999999
21100915,1610612752,1610612738,118.0,110.0,0.568,0.545,1,2012-04-17,61,32,29,0.525,62,36,26,0.581
21100916,1610612750,1610612763,84.0,91.0,0.356,0.44,0,2012-04-17,63,25,38,0.397,61,36,25,0.59
21100917,1610612747,1610612759,91.0,112.0,0.488,0.595,0,2012-04-17,62,39,23,0.629,60,44,16,0.733
21100902,1610612761,1610612737,87.0,109.0,0.4429999999999999,0.488,0,2012-04-16,62,22,40,0.355,61,36,25,0.59
21100903,1610612766,1610612740,67.0,75.0,0.303,0.3379999999999999,0,2012-04-16,60,7,53,0.1169999999999999,61,19,42,0.311
21100904,1610612753,1610612755,113.0,100.0,0.5329999999999999,0.5,1,2012-04-16,61,36,25,0.59,60,31,29,0.517
21100905,1610612754,1610612750,111.0,88.0,0.4429999999999999,0.368,1,2012-04-16,61,39,22,0.639,62,25,37,0.4029999999999999
21100906,1610612751,1610612748,98.0,101.0,0.5,0.507,0,2012-04-16,62,22,40,0.355,60,43,17,0.7170000000000001
21100907,1610612741,1610612764,84.0,87.0,0.381,0.382,0,2012-04-16,61,46,15,0.754,61,15,46,0.246
21100908,1610612745,1610612743,102.0,105.0,0.426,0.475,0,2012-04-16,61,32,29,0.525,61,34,27,0.557
21100909,1610612762,1610612742,123.0,121.0,0.4320000000000001,0.429,1,2012-04-16,62,32,30,0.516,62,34,28,0.5479999999999999
21100910,1610612756,1610612757,125.0,107.0,0.6,0.461,1,2012-04-16,61,32,29,0.525,62,28,34,0.452
21100911,1610612746,1610612760,92.0,77.0,0.444,0.375,1,2012-04-16,61,38,23,0.623,61,44,17,0.721
21100912,1610612744,1610612759,99.0,120.0,0.409,0.391,0,2012-04-16,60,22,38,0.3670000000000001,59,43,16,0.7290000000000001
21100893,1610612752,1610612748,85.0,93.0,0.425,0.462,0,2012-04-15,60,31,29,0.517,59,42,17,0.7120000000000001
21100894,1610612747,1610612742,112.0,108.0,0.452,0.466,1,2012-04-15,61,39,22,0.639,61,34,27,0.557
21100895,1610612766,1610612738,82.0,94.0,0.405,0.488,0,2012-04-15,59,7,52,0.119,61,36,25,0.59
21100896,1610612737,1610612761,86.0,102.0,0.4029999999999999,0.5539999999999999,0,2012-04-15,60,35,25,0.583,61,22,39,0.361
21100897,1610612765,1610612741,94.0,100.0,0.3929999999999999,0.429,0,2012-04-15,60,22,38,0.3670000000000001,60,46,14,0.767
21100898,1610612739,1610612753,84.0,100.0,0.373,0.456,0,2012-04-15,59,20,39,0.3389999999999999,60,35,25,0.583
21100899,1610612758,1610612757,104.0,103.0,0.474,0.526,1,2012-04-15,61,20,41,0.3279999999999999,61,28,33,0.4589999999999999
21100900,1610612740,1610612763,88.0,75.0,0.4379999999999999,0.357,1,2012-04-15,60,18,42,0.3,60,35,25,0.583
21100901,1610612743,1610612745,101.0,86.0,0.494,0.368,1,2012-04-15,60,33,27,0.55,60,32,28,0.5329999999999999
21100886,1610612746,1610612744,112.0,104.0,0.5429999999999999,0.4629999999999999,1,2012-04-14,60,37,23,0.617,59,22,37,0.373
21100887,1610612764,1610612739,89.0,98.0,0.4370000000000001,0.515,0,2012-04-14,60,14,46,0.233,58,20,38,0.345
21100888,1610612751,1610612738,82.0,94.0,0.368,0.457,0,2012-04-14,61,22,39,0.361,60,35,25,0.583
21100889,1610612763,1610612762,103.0,98.0,0.486,0.482,1,2012-04-14,59,35,24,0.593,61,31,30,0.508
21100890,1610612750,1610612760,110.0,115.0,0.5,0.44,0,2012-04-14,61,25,36,0.41,60,44,16,0.733
21100891,1610612749,1610612754,99.0,105.0,0.44,0.402,0,2012-04-14,60,29,31,0.483,60,38,22,0.633
21100892,1610612759,1610612756,105.0,91.0,0.526,0.396,1,2012-04-14,58,42,16,0.7240000000000001,60,31,29,0.517
21100874,1610612761,1610612738,84.0,79.0,0.347,0.375,1,2012-04-13,60,21,39,0.35,59,34,25,0.5760000000000001
21100875,1610612755,1610612751,89.0,95.0,0.42,0.42,0,2012-04-13,59,31,28,0.525,60,22,38,0.3670000000000001
21100876,1610612753,1610612737,81.0,109.0,0.3879999999999999,0.506,0,2012-04-13,59,34,25,0.5760000000000001,59,35,24,0.593
21100877,1610612754,1610612739,102.0,83.0,0.411,0.354,1,2012-04-13,59,37,22,0.627,57,19,38,0.3329999999999999
21100878,1610612752,1610612764,103.0,65.0,0.4639999999999999,0.278,1,2012-04-13,59,31,28,0.525,59,14,45,0.237
21100879,1610612748,1610612766,105.0,82.0,0.518,0.446,1,2012-04-13,58,41,17,0.7070000000000001,58,7,51,0.121
21100880,1610612765,1610612749,97.0,113.0,0.474,0.517,0,2012-04-13,59,22,37,0.373,59,29,30,0.4920000000000001
21100881,1610612740,1610612762,96.0,85.0,0.551,0.452,1,2012-04-13,59,17,42,0.288,60,31,29,0.517
21100882,1610612745,1610612756,105.0,112.0,0.429,0.494,0,2012-04-13,59,32,27,0.542,59,31,28,0.525
21100883,1610612760,1610612758,115.0,89.0,0.478,0.389,1,2012-04-13,59,43,16,0.7290000000000001,60,19,41,0.317
21100884,1610612747,1610612743,103.0,97.0,0.507,0.446,1,2012-04-13,60,38,22,0.633,59,32,27,0.542
21100885,1610612757,1610612742,94.0,97.0,0.422,0.482,0,2012-04-13,60,28,32,0.467,60,34,26,0.5670000000000001
21100869,1610612766,1610612765,85.0,109.0,0.4429999999999999,0.524,0,2012-04-12,57,7,50,0.123,58,22,36,0.379
21100870,1610612741,1610612748,96.0,86.0,0.43,0.439,1,2012-04-12,59,45,14,0.763,57,40,17,0.7020000000000001
21100871,1610612750,1610612746,82.0,95.0,0.4029999999999999,0.429,0,2012-04-12,60,25,35,0.417,59,36,23,0.61
21100872,1610612759,1610612763,107.0,97.0,0.487,0.424,1,2012-04-12,57,41,16,0.7190000000000001,58,34,24,0.586
21100873,1610612744,1610612742,103.0,112.0,0.469,0.5,0,2012-04-12,58,22,36,0.379,59,33,26,0.5589999999999999
21100858,1610612761,1610612755,75.0,93.0,0.363,0.532,0,2012-04-11,59,20,39,0.3389999999999999,58,31,27,0.534
21100859,1610612739,1610612754,98.0,104.0,0.455,0.4679999999999999,0,2012-04-11,56,19,37,0.3389999999999999,58,36,22,0.621
21100860,1610612738,1610612737,88.0,86.0,0.416,0.41,1,2012-04-11,58,34,24,0.586,58,34,24,0.586
21100861,1610612749,1610612752,107.0,111.0,0.494,0.513,0,2012-04-11,58,28,30,0.483,58,30,28,0.517
21100862,1610612763,1610612756,104.0,93.0,0.5,0.481,1,2012-04-11,57,34,23,0.596,58,30,28,0.517
21100863,1610612740,1610612758,105.0,96.0,0.5589999999999999,0.434,1,2012-04-11,58,16,42,0.276,59,19,40,0.322
21100864,1610612745,1610612762,91.0,103.0,0.356,0.513,0,2012-04-11,58,32,26,0.552,59,31,28,0.525
21100865,1610612760,1610612746,98.0,100.0,0.408,0.469,0,2012-04-11,58,42,16,0.7240000000000001,58,35,23,0.603
21100866,1610612759,1610612747,84.0,98.0,0.407,0.449,0,2012-04-11,56,40,16,0.7140000000000001,59,37,22,0.627
21100867,1610612743,1610612750,113.0,107.0,0.5,0.5,1,2012-04-11,58,32,26,0.552,59,25,34,0.424
21100868,1610612757,1610612744,118.0,110.0,0.477,0.522,1,2012-04-11,59,28,31,0.475,57,22,35,0.386
21100852,1610612764,1610612753,93.0,85.0,0.5,0.366,1,2012-04-10,58,14,44,0.241,58,34,24,0.586
21100853,1610612748,1610612738,107.0,115.0,0.4479999999999999,0.606,0,2012-04-10,56,40,16,0.7140000000000001,57,33,24,0.579
21100854,1610612739,1610612766,103.0,90.0,0.482,0.4679999999999999,1,2012-04-10,55,19,36,0.345,56,7,49,0.125
21100855,1610612751,1610612755,88.0,107.0,0.386,0.4589999999999999,0,2012-04-10,59,21,38,0.356,57,30,27,0.526
21100856,1610612742,1610612758,110.0,100.0,0.446,0.446,1,2012-04-10,58,32,26,0.552,58,19,39,0.3279999999999999
21100857,1610612741,1610612752,98.0,86.0,0.433,0.425,1,2012-04-10,58,44,14,0.759,57,29,28,0.509
21100842,1610612766,1610612764,85.0,113.0,0.39,0.482,0,2012-04-09,55,7,48,0.127,57,13,44,0.228
21100843,1610612753,1610612765,119.0,89.0,0.525,0.405,1,2012-04-09,57,34,23,0.596,57,21,36,0.368
21100844,1610612754,1610612761,103.0,98.0,0.507,0.48,1,2012-04-09,57,35,22,0.614,58,20,38,0.345
21100845,1610612749,1610612760,89.0,109.0,0.425,0.481,0,2012-04-09,57,28,29,0.491,57,42,15,0.737
21100846,1610612763,1610612746,94.0,85.0,0.5,0.405,1,2012-04-09,56,33,23,0.589,57,34,23,0.596
21100847,1610612740,1610612747,91.0,93.0,0.45,0.466,0,2012-04-09,57,15,42,0.263,58,36,22,0.621
21100848,1610612750,1610612756,90.0,114.0,0.386,0.573,0,2012-04-09,58,25,33,0.431,57,30,27,0.526
21100849,1610612743,1610612744,123.0,84.0,0.545,0.369,1,2012-04-09,57,31,26,0.544,56,22,34,0.3929999999999999
21100850,1610612762,1610612759,91.0,84.0,0.425,0.402,1,2012-04-09,58,30,28,0.517,55,40,15,0.727
21100851,1610612757,1610612745,89.0,94.0,0.3979999999999999,0.4629999999999999,0,2012-04-09,58,27,31,0.466,57,32,25,0.561
21100835,1610612752,1610612741,100.0,99.0,0.382,0.3929999999999999,1,2012-04-08,56,29,27,0.518,57,43,14,0.754
21100836,1610612738,1610612755,103.0,79.0,0.588,0.382,1,2012-04-08,56,32,24,0.5710000000000001,56,29,27,0.518
21100837,1610612751,1610612739,122.0,117.0,0.449,0.4479999999999999,1,2012-04-08,58,21,37,0.362,54,18,36,0.3329999999999999
21100838,1610612748,1610612765,98.0,75.0,0.434,0.373,1,2012-04-08,55,40,15,0.727,56,21,35,0.375
21100839,1610612759,1610612762,114.0,104.0,0.507,0.441,1,2012-04-08,54,40,14,0.741,57,29,28,0.509
21100840,1610612760,1610612761,91.0,75.0,0.417,0.3720000000000001,1,2012-04-08,56,41,15,0.732,57,20,37,0.351
21100841,1610612758,1610612745,87.0,104.0,0.429,0.452,0,2012-04-08,57,19,38,0.3329999999999999,56,31,25,0.5539999999999999
21100827,1610612754,1610612738,72.0,86.0,0.351,0.421,0,2012-04-07,56,34,22,0.607,55,31,24,0.564
21100826,1610612766,1610612737,96.0,116.0,0.469,0.524,0,2012-04-07,54,7,47,0.13,57,34,23,0.596
21100828,1610612755,1610612753,82.0,88.0,0.397,0.363,0,2012-04-07,55,29,26,0.527,56,33,23,0.589
21100829,1610612763,1610612742,94.0,89.0,0.3879999999999999,0.466,1,2012-04-07,55,32,23,0.5820000000000001,57,31,26,0.544
21100830,1610612740,1610612750,99.0,90.0,0.488,0.407,1,2012-04-07,56,15,41,0.268,57,25,32,0.439
21100831,1610612749,1610612757,116.0,94.0,0.5,0.436,1,2012-04-07,56,28,28,0.5,57,27,30,0.474
21100832,1610612756,1610612747,125.0,105.0,0.5,0.485,1,2012-04-07,56,29,27,0.518,57,35,22,0.614
21100833,1610612746,1610612758,109.0,94.0,0.494,0.415,1,2012-04-07,56,34,22,0.607,56,19,37,0.3389999999999999
21100834,1610612744,1610612743,112.0,97.0,0.523,0.4629999999999999,1,2012-04-07,55,22,33,0.4,56,30,26,0.536
21100815,1610612754,1610612760,103.0,98.0,0.412,0.442,1,2012-04-06,55,34,21,0.618,55,40,15,0.727
21100816,1610612761,1610612739,80.0,84.0,0.425,0.342,0,2012-04-06,56,20,36,0.357,53,18,35,0.34
21100817,1610612751,1610612764,110.0,98.0,0.563,0.452,1,2012-04-06,57,20,37,0.351,56,12,44,0.214
21100818,1610612737,1610612765,101.0,96.0,0.481,0.474,1,2012-04-06,56,33,23,0.589,55,21,34,0.382
21100819,1610612748,1610612763,82.0,97.0,0.402,0.4629999999999999,0,2012-04-06,54,39,15,0.722,54,31,23,0.574
21100820,1610612749,1610612766,95.0,90.0,0.407,0.424,1,2012-04-06,55,27,28,0.491,53,7,46,0.132
21100821,1610612742,1610612757,97.0,99.0,0.452,0.436,0,2012-04-06,56,31,25,0.5539999999999999,56,27,29,0.482
21100822,1610612759,1610612740,128.0,103.0,0.607,0.4679999999999999,1,2012-04-06,53,39,14,0.736,55,14,41,0.255
21100823,1610612743,1610612756,105.0,99.0,0.402,0.415,1,2012-04-06,55,30,25,0.545,55,28,27,0.509
21100824,1610612762,1610612744,104.0,98.0,0.481,0.4529999999999999,1,2012-04-06,56,29,27,0.518,54,21,33,0.389
21100825,1610612747,1610612745,107.0,112.0,0.429,0.477,0,2012-04-06,56,35,21,0.625,55,30,25,0.545
21100811,1610612753,1610612752,80.0,96.0,0.417,0.487,0,2012-04-05,55,32,23,0.5820000000000001,55,28,27,0.509
21100812,1610612765,1610612764,99.0,94.0,0.529,0.423,1,2012-04-05,54,21,33,0.389,55,12,43,0.218
21100813,1610612741,1610612738,93.0,86.0,0.413,0.429,1,2012-04-05,56,43,13,0.768,54,30,24,0.556
21100814,1610612758,1610612746,85.0,93.0,0.417,0.45,0,2012-04-05,55,19,36,0.345,55,33,22,0.6
21100799,1610612755,1610612761,78.0,99.0,0.43,0.506,0,2012-04-04,54,29,25,0.537,55,20,35,0.364
21100800,1610612764,1610612754,96.0,109.0,0.4639999999999999,0.579,0,2012-04-04,54,12,42,0.222,54,33,21,0.611
21100801,1610612738,1610612759,86.0,87.0,0.4579999999999999,0.419,0,2012-04-04,53,30,23,0.5660000000000001,52,38,14,0.731
21100802,1610612737,1610612766,120.0,93.0,0.5660000000000001,0.456,1,2012-04-04,55,32,23,0.5820000000000001,52,7,45,0.135
21100803,1610612748,1610612760,98.0,93.0,0.373,0.4320000000000001,1,2012-04-04,53,39,14,0.736,54,40,14,0.741
21100804,1610612749,1610612739,107.0,98.0,0.5710000000000001,0.411,1,2012-04-04,54,26,28,0.481,52,17,35,0.327
21100805,1610612740,1610612743,94.0,92.0,0.522,0.422,1,2012-04-04,54,14,40,0.259,54,29,25,0.537
21100806,1610612750,1610612744,94.0,97.0,0.425,0.477,0,2012-04-04,56,25,31,0.446,53,21,32,0.396
21100807,1610612742,1610612763,95.0,85.0,0.5,0.422,1,2012-04-04,55,31,24,0.564,53,30,23,0.5660000000000001
21100808,1610612762,1610612756,105.0,107.0,0.506,0.451,0,2012-04-04,55,28,27,0.509,54,28,26,0.519
21100809,1610612757,1610612751,101.0,88.0,0.457,0.3720000000000001,1,2012-04-04,55,26,29,0.473,56,19,37,0.3389999999999999
21100810,1610612746,1610612747,108.0,113.0,0.4529999999999999,0.518,0,2012-04-04,54,32,22,0.593,55,35,20,0.636
21100791,1610612761,1610612766,92.0,87.0,0.461,0.4029999999999999,1,2012-04-03,54,19,35,0.352,51,7,44,0.1369999999999999
21100792,1610612739,1610612759,90.0,125.0,0.415,0.593,0,2012-04-03,51,17,34,0.3329999999999999,51,37,14,0.725
21100793,1610612754,1610612752,112.0,104.0,0.477,0.4579999999999999,1,2012-04-03,53,32,21,0.604,54,27,27,0.5
21100794,1610612748,1610612755,99.0,93.0,0.467,0.4579999999999999,1,2012-04-03,52,38,14,0.731,53,29,24,0.547
21100795,1610612765,1610612753,102.0,95.0,0.5660000000000001,0.4579999999999999,1,2012-04-03,53,20,33,0.377,54,32,22,0.593
21100796,1610612763,1610612744,98.0,94.0,0.4629999999999999,0.4629999999999999,1,2012-04-03,52,30,22,0.5770000000000001,52,20,32,0.385
21100797,1610612758,1610612756,100.0,109.0,0.4589999999999999,0.444,0,2012-04-03,54,19,35,0.352,53,27,26,0.509
21100798,1610612747,1610612751,91.0,87.0,0.481,0.4,1,2012-04-03,54,34,20,0.63,55,19,36,0.345
21100785,1610612764,1610612749,98.0,112.0,0.444,0.518,0,2012-04-02,53,12,41,0.226,53,25,28,0.472
21100786,1610612741,1610612745,93.0,99.0,0.482,0.472,0,2012-04-02,55,42,13,0.764,54,29,25,0.537
21100787,1610612760,1610612763,88.0,94.0,0.452,0.391,0,2012-04-02,53,40,13,0.755,51,29,22,0.569
21100788,1610612742,1610612746,75.0,94.0,0.39,0.47,0,2012-04-02,54,30,24,0.556,53,32,21,0.604
21100789,1610612758,1610612750,116.0,108.0,0.506,0.481,1,2012-04-02,53,19,34,0.358,55,25,30,0.455
21100790,1610612757,1610612762,97.0,102.0,0.4320000000000001,0.488,0,2012-04-02,54,25,29,0.4629999999999999,54,28,26,0.519
21100777,1610612760,1610612741,92.0,78.0,0.486,0.33,1,2012-04-01,52,40,12,0.769,54,42,12,0.778
21100778,1610612738,1610612748,91.0,72.0,0.471,0.348,1,2012-04-01,52,30,22,0.5770000000000001,51,37,14,0.725
21100779,1610612761,1610612764,99.0,92.0,0.481,0.479,1,2012-04-01,53,18,35,0.34,52,12,40,0.231
21100780,1610612753,1610612743,101.0,104.0,0.42,0.556,0,2012-04-01,53,32,21,0.604,53,29,24,0.547
21100781,1610612745,1610612754,102.0,104.0,0.436,0.446,0,2012-04-01,53,28,25,0.528,52,31,21,0.596
21100782,1610612756,1610612740,92.0,75.0,0.493,0.416,1,2012-04-01,52,26,26,0.5,53,13,40,0.245
21100783,1610612757,1610612750,119.0,106.0,0.523,0.462,1,2012-04-01,53,25,28,0.472,54,25,29,0.4629999999999999
21100784,1610612747,1610612744,120.0,112.0,0.537,0.489,1,2012-04-01,53,33,20,0.623,51,20,31,0.392
21100769,1610612747,1610612740,88.0,85.0,0.416,0.424,1,2012-03-31,52,32,20,0.615,52,13,39,0.25
21100770,1610612752,1610612739,91.0,75.0,0.395,0.389,1,2012-03-31,53,27,26,0.509,50,17,33,0.34
21100771,1610612755,1610612737,95.0,90.0,0.481,0.473,1,2012-03-31,52,29,23,0.5579999999999999,54,31,23,0.574
21100772,1610612765,1610612766,110.0,107.0,0.517,0.465,1,2012-03-31,52,19,33,0.365,50,7,43,0.14
21100773,1610612749,1610612763,95.0,99.0,0.415,0.42,0,2012-03-31,52,24,28,0.462,50,28,22,0.56
21100774,1610612759,1610612754,112.0,103.0,0.5,0.532,1,2012-03-31,50,36,14,0.72,51,30,21,0.588
21100775,1610612758,1610612751,99.0,111.0,0.433,0.467,0,2012-03-31,52,18,34,0.346,54,19,35,0.352
21100776,1610612746,1610612762,105.0,96.0,0.542,0.455,1,2012-03-31,52,31,21,0.596,53,27,26,0.509
21100757,1610612761,1610612748,101.0,113.0,0.542,0.5710000000000001,0,2012-03-30,52,17,35,0.327,50,37,13,0.74
21100758,1610612764,1610612755,97.0,76.0,0.483,0.366,1,2012-03-30,51,12,39,0.235,51,28,23,0.5489999999999999
21100759,1610612766,1610612743,88.0,99.0,0.3670000000000001,0.521,0,2012-03-30,49,7,42,0.143,52,28,24,0.5379999999999999
21100760,1610612737,1610612752,100.0,90.0,0.507,0.4429999999999999,1,2012-03-30,53,31,22,0.585,52,26,26,0.5
21100761,1610612739,1610612749,84.0,121.0,0.4,0.568,0,2012-03-30,49,17,32,0.347,51,24,27,0.471
21100762,1610612753,1610612742,98.0,100.0,0.449,0.475,0,2012-03-30,52,32,20,0.615,53,30,23,0.5660000000000001
21100763,1610612741,1610612765,83.0,71.0,0.4270000000000001,0.369,1,2012-03-30,53,42,11,0.792,51,18,33,0.353
21100764,1610612745,1610612763,98.0,89.0,0.521,0.3720000000000001,1,2012-03-30,52,28,24,0.5379999999999999,49,27,22,0.551
21100765,1610612750,1610612738,79.0,100.0,0.347,0.489,0,2012-03-30,53,25,28,0.472,51,29,22,0.569
21100766,1610612762,1610612758,103.0,104.0,0.352,0.433,0,2012-03-30,52,27,25,0.519,51,18,33,0.353
21100767,1610612746,1610612757,98.0,97.0,0.52,0.5,1,2012-03-30,51,30,21,0.588,52,24,28,0.462
21100768,1610612744,1610612751,100.0,102.0,0.526,0.4320000000000001,0,2012-03-30,50,20,30,0.4,53,18,35,0.34
21100753,1610612754,1610612764,93.0,89.0,0.392,0.423,1,2012-03-29,50,30,20,0.6,50,11,39,0.22
21100754,1610612748,1610612742,106.0,85.0,0.488,0.423,1,2012-03-29,49,36,13,0.735,52,29,23,0.5579999999999999
21100755,1610612757,1610612740,99.0,93.0,0.488,0.465,1,2012-03-29,51,24,27,0.471,51,13,38,0.255
21100756,1610612747,1610612760,93.0,102.0,0.417,0.462,0,2012-03-29,51,31,20,0.608,51,39,12,0.765
21100743,1610612761,1610612743,105.0,96.0,0.407,0.413,1,2012-03-28,51,17,34,0.3329999999999999,51,27,24,0.529
21100744,1610612752,1610612753,108.0,86.0,0.506,0.449,1,2012-03-28,51,26,25,0.51,51,32,19,0.627
21100745,1610612766,1610612750,83.0,88.0,0.397,0.407,0,2012-03-28,48,7,41,0.146,52,25,27,0.481
21100746,1610612739,1610612765,75.0,87.0,0.345,0.422,0,2012-03-28,48,17,31,0.354,50,18,32,0.36
21100747,1610612738,1610612762,94.0,82.0,0.4679999999999999,0.39,1,2012-03-28,50,28,22,0.56,51,27,24,0.529
21100748,1610612751,1610612754,100.0,84.0,0.488,0.455,1,2012-03-28,52,17,35,0.327,49,29,20,0.5920000000000001
21100749,1610612737,1610612741,77.0,98.0,0.4,0.469,0,2012-03-28,52,30,22,0.5770000000000001,52,41,11,0.7879999999999999
21100750,1610612758,1610612759,112.0,117.0,0.547,0.5379999999999999,0,2012-03-28,50,17,33,0.34,49,35,14,0.7140000000000001
21100751,1610612746,1610612756,103.0,86.0,0.5,0.375,1,2012-03-28,50,29,21,0.58,51,25,26,0.49
21100752,1610612744,1610612740,87.0,102.0,0.446,0.544,0,2012-03-28,49,20,29,0.408,50,13,37,0.26
21100736,1610612755,1610612739,103.0,85.0,0.489,0.4,1,2012-03-27,50,28,22,0.56,47,17,30,0.362
21100737,1610612749,1610612737,108.0,101.0,0.5,0.5,1,2012-03-27,50,23,27,0.46,51,30,21,0.588
21100738,1610612763,1610612750,93.0,86.0,0.425,0.3879999999999999,1,2012-03-27,48,27,21,0.563,51,24,27,0.471
21100739,1610612742,1610612745,90.0,81.0,0.466,0.418,1,2012-03-27,51,29,22,0.569,51,27,24,0.529
21100740,1610612756,1610612759,100.0,107.0,0.471,0.489,0,2012-03-27,50,25,25,0.5,48,34,14,0.708
21100741,1610612757,1610612760,95.0,109.0,0.43,0.57,0,2012-03-27,50,23,27,0.46,50,38,12,0.76
21100742,1610612744,1610612747,101.0,104.0,0.429,0.419,0,2012-03-27,48,20,28,0.417,50,31,19,0.62
21100727,1610612761,1610612753,101.0,117.0,0.473,0.5429999999999999,0,2012-03-26,50,16,34,0.32,50,32,18,0.64
21100728,1610612764,1610612765,77.0,79.0,0.41,0.368,0,2012-03-26,49,11,38,0.2239999999999999,49,17,32,0.347
21100729,1610612766,1610612738,95.0,102.0,0.418,0.452,0,2012-03-26,47,7,40,0.149,49,27,22,0.551
21100730,1610612754,1610612748,105.0,90.0,0.457,0.42,1,2012-03-26,48,29,19,0.604,48,35,13,0.7290000000000001
21100731,1610612751,1610612762,84.0,105.0,0.358,0.519,0,2012-03-26,51,16,35,0.314,50,27,23,0.54
21100732,1610612752,1610612749,89.0,80.0,0.351,0.365,1,2012-03-26,50,25,25,0.5,49,22,27,0.449
21100733,1610612741,1610612743,91.0,108.0,0.473,0.5,0,2012-03-26,51,40,11,0.784,50,27,23,0.54
21100734,1610612745,1610612758,113.0,106.0,0.483,0.4270000000000001,1,2012-03-26,50,27,23,0.54,49,17,32,0.347
21100735,1610612746,1610612740,97.0,85.0,0.5,0.5,1,2012-03-26,49,28,21,0.5710000000000001,49,12,37,0.245
21100719,1610612739,1610612756,83.0,108.0,0.386,0.512,0,2012-03-25,46,17,29,0.37,49,25,24,0.51
21100720,1610612750,1610612743,117.0,100.0,0.455,0.506,1,2012-03-25,50,24,26,0.48,49,26,23,0.531
21100721,1610612738,1610612764,88.0,76.0,0.486,0.345,1,2012-03-25,48,26,22,0.542,48,11,37,0.2289999999999999
21100722,1610612737,1610612762,139.0,133.0,0.449,0.389,1,2012-03-25,50,30,20,0.6,49,26,23,0.531
21100723,1610612759,1610612755,93.0,76.0,0.457,0.412,1,2012-03-25,47,33,14,0.7020000000000001,49,27,22,0.551
21100724,1610612760,1610612748,103.0,87.0,0.527,0.465,1,2012-03-25,49,37,12,0.755,47,35,12,0.745
21100725,1610612757,1610612744,90.0,87.0,0.365,0.4320000000000001,1,2012-03-25,49,23,26,0.469,47,20,27,0.426
21100726,1610612747,1610612763,96.0,102.0,0.425,0.512,0,2012-03-25,49,30,19,0.612,47,26,21,0.5529999999999999
21100710,1610612746,1610612763,101.0,85.0,0.5,0.423,1,2012-03-24,48,27,21,0.563,46,25,21,0.5429999999999999
21100711,1610612764,1610612737,92.0,95.0,0.447,0.487,0,2012-03-24,47,11,36,0.2339999999999999,49,29,20,0.5920000000000001
21100712,1610612751,1610612766,102.0,89.0,0.4429999999999999,0.4429999999999999,1,2012-03-24,50,16,34,0.32,46,7,39,0.152
21100713,1610612752,1610612765,101.0,79.0,0.487,0.368,1,2012-03-24,49,24,25,0.49,48,16,32,0.3329999999999999
21100714,1610612741,1610612761,102.0,101.0,0.3979999999999999,0.4479999999999999,1,2012-03-24,50,40,10,0.8,49,16,33,0.327
21100715,1610612740,1610612759,86.0,89.0,0.457,0.4,0,2012-03-24,48,12,36,0.25,46,32,14,0.696
21100716,1610612745,1610612742,99.0,101.0,0.385,0.4629999999999999,0,2012-03-24,49,26,23,0.531,50,28,22,0.56
21100717,1610612749,1610612754,104.0,125.0,0.44,0.512,0,2012-03-24,48,22,26,0.4579999999999999,47,28,19,0.596
21100718,1610612744,1610612758,111.0,108.0,0.489,0.473,1,2012-03-24,46,20,26,0.435,48,17,31,0.354
21100699,1610612761,1610612752,96.0,79.0,0.4579999999999999,0.376,1,2012-03-23,48,16,32,0.3329999999999999,48,23,25,0.479
21100700,1610612766,1610612749,92.0,112.0,0.405,0.5329999999999999,0,2012-03-23,45,7,38,0.156,47,22,25,0.4679999999999999
21100701,1610612753,1610612739,93.0,80.0,0.4679999999999999,0.3779999999999999,1,2012-03-23,49,31,18,0.633,45,17,28,0.3779999999999999
21100702,1610612754,1610612756,111.0,113.0,0.519,0.488,0,2012-03-23,46,27,19,0.5870000000000001,48,24,24,0.5
21100703,1610612737,1610612751,93.0,84.0,0.4679999999999999,0.4,1,2012-03-23,48,28,20,0.583,49,15,34,0.306
21100704,1610612765,1610612748,73.0,88.0,0.387,0.442,0,2012-03-23,47,16,31,0.34,46,35,11,0.7609999999999999
21100705,1610612755,1610612738,99.0,86.0,0.446,0.486,1,2012-03-23,48,27,21,0.563,47,25,22,0.532
21100706,1610612760,1610612750,149.0,140.0,0.531,0.49,1,2012-03-23,48,36,12,0.75,49,23,26,0.469
21100707,1610612759,1610612742,104.0,87.0,0.489,0.3829999999999999,1,2012-03-23,45,31,14,0.6890000000000001,49,27,22,0.551
21100708,1610612762,1610612743,121.0,102.0,0.593,0.462,1,2012-03-23,48,26,22,0.542,48,26,22,0.542
21100709,1610612747,1610612757,103.0,96.0,0.471,0.439,1,2012-03-23,48,30,18,0.625,48,22,26,0.4579999999999999
21100693,1610612764,1610612754,83.0,85.0,0.423,0.419,0,2012-03-22,46,11,35,0.239,45,27,18,0.6
21100694,1610612749,1610612738,91.0,100.0,0.4,0.483,0,2012-03-22,46,21,25,0.457,46,25,21,0.5429999999999999
21100695,1610612740,1610612746,97.0,90.0,0.5760000000000001,0.389,1,2012-03-22,47,12,35,0.255,47,26,21,0.5529999999999999
21100696,1610612745,1610612744,109.0,83.0,0.471,0.415,1,2012-03-22,48,26,22,0.542,45,19,26,0.422
21100697,1610612758,1610612762,102.0,103.0,0.406,0.473,0,2012-03-22,47,17,30,0.362,47,25,22,0.532
21100698,1610612757,1610612763,97.0,93.0,0.425,0.457,1,2012-03-22,47,22,25,0.4679999999999999,45,25,20,0.556
21100683,1610612761,1610612741,82.0,94.0,0.412,0.439,0,2012-03-21,47,15,32,0.319,49,39,10,0.7959999999999999
21100684,1610612755,1610612752,79.0,82.0,0.387,0.3670000000000001,0,2012-03-21,47,26,21,0.5529999999999999,47,23,24,0.489
21100685,1610612753,1610612756,103.0,93.0,0.47,0.481,1,2012-03-21,48,30,18,0.625,47,23,24,0.489
21100686,1610612751,1610612764,89.0,108.0,0.369,0.482,0,2012-03-21,48,15,33,0.313,45,11,34,0.244
21100687,1610612737,1610612739,103.0,102.0,0.3979999999999999,0.462,1,2012-03-21,47,27,20,0.574,44,17,27,0.386
21100688,1610612740,1610612744,92.0,101.0,0.494,0.4379999999999999,0,2012-03-21,46,11,35,0.239,44,19,25,0.4320000000000001
21100689,1610612760,1610612746,114.0,91.0,0.5379999999999999,0.3670000000000001,1,2012-03-21,47,35,12,0.745,46,26,20,0.565
21100690,1610612759,1610612750,116.0,100.0,0.474,0.4429999999999999,1,2012-03-21,44,30,14,0.682,48,23,25,0.479
21100691,1610612743,1610612765,116.0,115.0,0.5820000000000001,0.506,1,2012-03-21,47,26,21,0.5529999999999999,46,16,30,0.348
21100692,1610612742,1610612747,93.0,109.0,0.4270000000000001,0.584,0,2012-03-21,48,27,21,0.563,47,29,18,0.617
21100676,1610612754,1610612746,102.0,89.0,0.486,0.435,1,2012-03-20,44,26,18,0.591,45,26,19,0.578
21100677,1610612752,1610612761,106.0,87.0,0.481,0.478,1,2012-03-20,46,22,24,0.478,46,15,31,0.326
21100678,1610612748,1610612756,99.0,95.0,0.474,0.45,1,2012-03-20,45,34,11,0.7559999999999999,46,23,23,0.5
21100679,1610612745,1610612747,107.0,104.0,0.488,0.506,1,2012-03-20,47,25,22,0.532,46,28,18,0.609
21100680,1610612762,1610612760,97.0,90.0,0.475,0.423,1,2012-03-20,46,24,22,0.522,46,34,12,0.7390000000000001
21100681,1610612758,1610612763,119.0,110.0,0.534,0.478,1,2012-03-20,46,17,29,0.37,44,25,19,0.568
21100682,1610612757,1610612749,87.0,116.0,0.354,0.578,0,2012-03-20,46,21,25,0.457,45,21,24,0.467
21100670,1610612766,1610612755,80.0,105.0,0.387,0.535,0,2012-03-19,44,7,37,0.159,46,26,20,0.565
21100671,1610612751,1610612739,100.0,105.0,0.42,0.461,0,2012-03-19,47,15,32,0.319,43,17,26,0.395
21100672,1610612737,1610612738,76.0,79.0,0.387,0.392,0,2012-03-19,46,26,20,0.565,45,24,21,0.5329999999999999
21100673,1610612753,1610612741,59.0,85.0,0.353,0.4429999999999999,0,2012-03-19,47,29,18,0.617,48,38,10,0.792
21100674,1610612743,1610612742,95.0,112.0,0.434,0.536,0,2012-03-19,46,25,21,0.5429999999999999,47,27,20,0.574
21100675,1610612744,1610612750,93.0,97.0,0.425,0.473,0,2012-03-19,43,18,25,0.419,47,23,24,0.489
21100662,1610612739,1610612737,87.0,103.0,0.3929999999999999,0.506,0,2012-03-18,42,16,26,0.381,45,26,19,0.578
21100663,1610612746,1610612765,87.0,83.0,0.402,0.3829999999999999,1,2012-03-18,44,26,18,0.591,45,16,29,0.356
21100664,1610612763,1610612764,97.0,92.0,0.4,0.474,1,2012-03-18,43,25,18,0.581,44,10,34,0.2269999999999999
21100665,1610612758,1610612750,115.0,99.0,0.4579999999999999,0.413,1,2012-03-18,45,16,29,0.356,46,22,24,0.478
21100666,1610612748,1610612753,91.0,81.0,0.4589999999999999,0.395,1,2012-03-18,44,33,11,0.75,46,29,17,0.63
21100667,1610612756,1610612745,99.0,86.0,0.471,0.4270000000000001,1,2012-03-18,45,23,22,0.511,46,24,22,0.522
21100668,1610612760,1610612757,111.0,95.0,0.5539999999999999,0.4639999999999999,1,2012-03-18,45,34,11,0.7559999999999999,45,21,24,0.467
21100669,1610612747,1610612762,99.0,103.0,0.452,0.473,0,2012-03-18,45,28,17,0.622,45,23,22,0.511
21100654,1610612746,1610612745,95.0,91.0,0.407,0.486,1,2012-03-17,43,25,18,0.581,45,24,21,0.5329999999999999
21100655,1610612766,1610612761,107.0,103.0,0.507,0.521,1,2012-03-17,43,7,36,0.163,45,15,30,0.3329999999999999
21100656,1610612754,1610612752,88.0,102.0,0.405,0.416,0,2012-03-17,43,25,18,0.581,45,21,24,0.467
21100657,1610612751,1610612740,94.0,102.0,0.419,0.506,0,2012-03-17,46,15,31,0.326,45,11,34,0.244
21100658,1610612741,1610612755,89.0,80.0,0.4029999999999999,0.418,1,2012-03-17,47,37,10,0.787,45,25,20,0.556
21100659,1610612742,1610612759,106.0,99.0,0.4679999999999999,0.494,1,2012-03-17,46,26,20,0.565,43,29,14,0.674
21100660,1610612743,1610612738,98.0,91.0,0.4589999999999999,0.474,1,2012-03-17,45,25,20,0.556,44,23,21,0.523
21100661,1610612762,1610612744,99.0,92.0,0.416,0.413,1,2012-03-17,44,22,22,0.5,42,18,24,0.429
21100643,1610612755,1610612748,78.0,84.0,0.355,0.473,0,2012-03-16,44,25,19,0.568,43,32,11,0.7440000000000001
21100644,1610612753,1610612751,86.0,70.0,0.507,0.337,1,2012-03-16,45,29,16,0.644,45,15,30,0.3329999999999999
21100645,1610612752,1610612754,115.0,100.0,0.506,0.395,1,2012-03-16,44,20,24,0.455,42,25,17,0.595
21100646,1610612737,1610612764,102.0,88.0,0.482,0.487,1,2012-03-16,44,25,19,0.568,43,10,33,0.233
21100647,1610612741,1610612757,89.0,100.0,0.424,0.494,0,2012-03-16,46,36,10,0.7829999999999999,44,21,23,0.477
21100648,1610612763,1610612761,110.0,114.0,0.451,0.481,0,2012-03-16,42,24,18,0.5710000000000001,44,15,29,0.341
21100649,1610612760,1610612759,105.0,114.0,0.4429999999999999,0.517,0,2012-03-16,44,33,11,0.75,42,29,13,0.69
21100650,1610612756,1610612765,109.0,101.0,0.494,0.513,1,2012-03-16,44,22,22,0.5,44,16,28,0.364
21100651,1610612758,1610612738,120.0,95.0,0.535,0.45,1,2012-03-16,44,15,29,0.341,43,23,20,0.535
21100652,1610612747,1610612750,97.0,92.0,0.413,0.402,1,2012-03-16,44,28,16,0.636,45,22,23,0.489
21100653,1610612744,1610612749,98.0,120.0,0.4429999999999999,0.484,0,2012-03-16,41,18,23,0.439,44,20,24,0.455
21100638,1610612740,1610612764,89.0,99.0,0.4529999999999999,0.52,0,2012-03-15,44,10,34,0.2269999999999999,42,10,32,0.238
21100639,1610612742,1610612766,101.0,96.0,0.452,0.417,1,2012-03-15,45,25,20,0.556,42,6,36,0.143
21100640,1610612743,1610612760,90.0,103.0,0.436,0.456,0,2012-03-15,44,24,20,0.545,43,33,10,0.767
21100641,1610612762,1610612750,111.0,105.0,0.417,0.434,1,2012-03-15,43,21,22,0.488,44,22,22,0.5
21100642,1610612746,1610612756,87.0,91.0,0.4589999999999999,0.41,0,2012-03-15,42,24,18,0.5710000000000001,43,21,22,0.488
21100626,1610612754,1610612755,111.0,94.0,0.5660000000000001,0.526,1,2012-03-14,41,25,16,0.61,43,25,18,0.581
21100627,1610612751,1610612761,98.0,84.0,0.481,0.3829999999999999,1,2012-03-14,44,15,29,0.341,43,14,29,0.326
21100628,1610612752,1610612757,121.0,79.0,0.5379999999999999,0.373,1,2012-03-14,43,19,24,0.442,43,20,23,0.465
21100630,1610612749,1610612739,115.0,105.0,0.535,0.447,1,2012-03-14,43,19,24,0.442,41,16,25,0.39
21100631,1610612740,1610612747,101.0,107.0,0.518,0.451,0,2012-03-14,43,10,33,0.233,43,27,16,0.628
21100632,1610612745,1610612766,107.0,87.0,0.536,0.407,1,2012-03-14,44,24,20,0.545,41,6,35,0.146
21100633,1610612759,1610612753,122.0,111.0,0.518,0.523,1,2012-03-14,41,28,13,0.6829999999999999,44,28,16,0.636
21100629,1610612741,1610612748,106.0,102.0,0.4679999999999999,0.447,1,2012-03-14,45,36,9,0.8,42,31,11,0.738
21100634,1610612758,1610612765,112.0,124.0,0.517,0.581,0,2012-03-14,43,14,29,0.326,43,16,27,0.3720000000000001
21100635,1610612756,1610612762,120.0,111.0,0.564,0.522,1,2012-03-14,42,20,22,0.476,42,20,22,0.476
21100636,1610612746,1610612737,96.0,82.0,0.5429999999999999,0.426,1,2012-03-14,41,24,17,0.585,43,24,19,0.5579999999999999
21100637,1610612744,1610612738,103.0,105.0,0.526,0.513,0,2012-03-14,40,18,22,0.45,42,23,19,0.5479999999999999
21100618,1610612753,1610612748,104.0,98.0,0.493,0.44,1,2012-03-13,43,28,15,0.6509999999999999,41,31,10,0.7559999999999999
21100619,1610612739,1610612761,88.0,96.0,0.382,0.5,0,2012-03-13,40,16,24,0.4,42,14,28,0.3329999999999999
21100620,1610612754,1610612757,92.0,75.0,0.488,0.313,1,2012-03-13,40,24,16,0.6,42,20,22,0.476
21100621,1610612763,1610612747,111.0,116.0,0.4479999999999999,0.494,0,2012-03-13,41,24,17,0.585,42,26,16,0.619
21100622,1610612760,1610612745,103.0,104.0,0.4639999999999999,0.461,0,2012-03-13,42,32,10,0.762,43,23,20,0.535
21100623,1610612742,1610612764,107.0,98.0,0.506,0.4379999999999999,1,2012-03-13,44,24,20,0.545,41,9,32,0.22
21100624,1610612743,1610612737,118.0,117.0,0.517,0.467,1,2012-03-13,43,24,19,0.5579999999999999,42,24,18,0.5710000000000001
21100625,1610612758,1610612744,89.0,115.0,0.402,0.505,0,2012-03-13,42,14,28,0.3329999999999999,39,18,21,0.462
21100611,1610612751,1610612749,99.0,105.0,0.487,0.467,0,2012-03-12,43,14,29,0.326,42,18,24,0.429
21100612,1610612741,1610612752,104.0,99.0,0.43,0.4629999999999999,1,2012-03-12,44,35,9,0.795,42,18,24,0.429
21100613,1610612740,1610612766,71.0,73.0,0.385,0.43,0,2012-03-12,42,10,32,0.238,40,6,34,0.15
21100614,1610612759,1610612764,112.0,97.0,0.54,0.4479999999999999,1,2012-03-12,40,27,13,0.675,40,9,31,0.225
21100615,1610612762,1610612765,105.0,90.0,0.542,0.479,1,2012-03-12,41,20,21,0.488,42,15,27,0.357
21100616,1610612756,1610612750,124.0,127.0,0.517,0.562,0,2012-03-12,41,19,22,0.4629999999999999,43,22,21,0.512
21100617,1610612746,1610612738,85.0,94.0,0.373,0.493,0,2012-03-12,40,23,17,0.575,41,22,19,0.537
21100603,1610612752,1610612755,94.0,106.0,0.413,0.506,0,2012-03-11,41,18,23,0.439,42,25,17,0.595
21100604,1610612747,1610612738,97.0,94.0,0.507,0.47,1,2012-03-11,41,25,16,0.61,40,21,19,0.525
21100605,1610612761,1610612749,99.0,105.0,0.465,0.479,0,2012-03-11,41,13,28,0.317,41,17,24,0.415
21100606,1610612753,1610612754,107.0,94.0,0.4679999999999999,0.476,1,2012-03-11,42,27,15,0.643,39,23,16,0.59
21100607,1610612739,1610612745,118.0,107.0,0.476,0.512,1,2012-03-11,39,16,23,0.41,42,22,20,0.524
21100608,1610612743,1610612763,91.0,94.0,0.405,0.507,0,2012-03-11,42,23,19,0.5479999999999999,40,24,16,0.6
21100609,1610612758,1610612737,99.0,106.0,0.4629999999999999,0.512,0,2012-03-11,41,14,27,0.341,41,24,17,0.585
21100610,1610612746,1610612744,93.0,97.0,0.43,0.514,0,2012-03-11,39,23,16,0.59,38,17,21,0.447
21100594,1610612764,1610612757,99.0,110.0,0.476,0.513,0,2012-03-10,39,9,30,0.231,41,20,21,0.488
21100595,1610612748,1610612754,93.0,91.0,0.467,0.375,1,2012-03-10,40,31,9,0.775,38,23,15,0.605
21100596,1610612765,1610612761,105.0,86.0,0.527,0.397,1,2012-03-10,41,15,26,0.366,40,13,27,0.325
21100597,1610612751,1610612745,106.0,112.0,0.531,0.561,0,2012-03-10,42,14,28,0.3329999999999999,41,22,19,0.537
21100598,1610612741,1610612762,111.0,97.0,0.5579999999999999,0.471,1,2012-03-10,43,34,9,0.7909999999999999,40,19,21,0.475
21100599,1610612760,1610612766,122.0,95.0,0.63,0.409,1,2012-03-10,41,32,9,0.78,39,5,34,0.128
21100600,1610612750,1610612740,89.0,95.0,0.413,0.4589999999999999,0,2012-03-10,42,21,21,0.5,41,10,31,0.244
21100601,1610612756,1610612763,98.0,91.0,0.477,0.419,1,2012-03-10,40,19,21,0.475,39,23,16,0.59
21100602,1610612744,1610612742,111.0,87.0,0.541,0.373,1,2012-03-10,37,16,21,0.4320000000000001,43,23,20,0.535
21100584,1610612755,1610612762,104.0,91.0,0.526,0.405,1,2012-03-09,41,24,17,0.585,39,19,20,0.487
21100585,1610612766,1610612751,74.0,83.0,0.349,0.361,0,2012-03-09,38,5,33,0.132,41,14,27,0.341
21100586,1610612738,1610612757,104.0,86.0,0.477,0.431,1,2012-03-09,39,21,18,0.5379999999999999,40,19,21,0.475
21100587,1610612765,1610612737,86.0,85.0,0.5589999999999999,0.425,1,2012-03-09,40,14,26,0.35,40,23,17,0.575
21100588,1610612760,1610612739,90.0,96.0,0.487,0.418,0,2012-03-09,40,31,9,0.775,38,15,23,0.395
21100589,1610612750,1610612747,102.0,105.0,0.457,0.476,0,2012-03-09,41,21,20,0.512,40,24,16,0.6
21100590,1610612749,1610612752,119.0,114.0,0.484,0.5539999999999999,1,2012-03-09,40,16,24,0.4,40,18,22,0.45
21100591,1610612759,1610612746,108.0,120.0,0.487,0.512,0,2012-03-09,39,26,13,0.667,38,23,15,0.605
21100592,1610612743,1610612740,110.0,97.0,0.562,0.4579999999999999,1,2012-03-09,41,23,18,0.561,40,9,31,0.225
21100593,1610612758,1610612742,110.0,97.0,0.506,0.4529999999999999,1,2012-03-09,40,14,26,0.35,42,23,19,0.5479999999999999
21100582,1610612741,1610612753,94.0,99.0,0.407,0.421,0,2012-03-08,42,33,9,0.7859999999999999,41,26,15,0.634
21100583,1610612756,1610612742,96.0,94.0,0.487,0.4370000000000001,1,2012-03-08,39,18,21,0.462,41,23,18,0.561
21100569,1610612761,1610612745,116.0,98.0,0.5920000000000001,0.414,1,2012-03-07,39,13,26,0.3329999999999999,40,21,19,0.525
21100570,1610612755,1610612738,103.0,71.0,0.483,0.35,1,2012-03-07,40,23,17,0.575,38,20,18,0.526
21100571,1610612764,1610612747,106.0,101.0,0.467,0.395,1,2012-03-07,38,9,29,0.237,39,23,16,0.59
21100572,1610612766,1610612762,93.0,99.0,0.471,0.4479999999999999,0,2012-03-07,37,5,32,0.135,38,19,19,0.5
21100573,1610612748,1610612737,89.0,86.0,0.4379999999999999,0.461,1,2012-03-07,39,30,9,0.769,39,23,16,0.59
21100574,1610612751,1610612746,101.0,100.0,0.4579999999999999,0.461,1,2012-03-07,40,13,27,0.325,37,22,15,0.595
21100575,1610612749,1610612741,104.0,106.0,0.477,0.518,0,2012-03-07,39,15,24,0.385,41,33,8,0.805
21100576,1610612760,1610612756,115.0,104.0,0.44,0.452,1,2012-03-07,39,31,8,0.795,38,17,21,0.447
21100577,1610612750,1610612757,106.0,94.0,0.474,0.473,1,2012-03-07,40,21,19,0.525,39,19,20,0.487
21100578,1610612759,1610612752,118.0,105.0,0.541,0.4270000000000001,1,2012-03-07,38,26,12,0.684,39,18,21,0.462
21100579,1610612743,1610612739,99.0,100.0,0.4320000000000001,0.451,0,2012-03-07,40,22,18,0.55,37,14,23,0.3779999999999999
21100580,1610612758,1610612740,99.0,98.0,0.5,0.545,1,2012-03-07,39,13,26,0.3329999999999999,39,9,30,0.231
21100581,1610612744,1610612763,92.0,110.0,0.4429999999999999,0.525,0,2012-03-07,36,15,21,0.417,38,23,15,0.605
21100563,1610612766,1610612753,100.0,84.0,0.475,0.3879999999999999,1,2012-03-06,36,5,31,0.139,40,25,15,0.625
21100564,1610612754,1610612737,96.0,101.0,0.4429999999999999,0.4579999999999999,0,2012-03-06,37,23,14,0.622,38,23,15,0.605
21100565,1610612738,1610612745,97.0,92.0,0.4320000000000001,0.386,1,2012-03-06,37,20,17,0.541,39,21,18,0.5379999999999999
21100566,1610612748,1610612751,108.0,78.0,0.584,0.373,1,2012-03-06,38,29,9,0.763,39,12,27,0.308
21100567,1610612765,1610612747,88.0,85.0,0.3979999999999999,0.42,1,2012-03-06,39,13,26,0.3329999999999999,38,23,15,0.605
21100568,1610612742,1610612752,95.0,85.0,0.3879999999999999,0.381,1,2012-03-06,40,23,17,0.575,38,18,20,0.474
21100554,1610612761,1610612753,88.0,92.0,0.405,0.4429999999999999,0,2012-03-05,38,12,26,0.316,39,25,14,0.6409999999999999
21100555,1610612764,1610612744,100.0,120.0,0.424,0.542,0,2012-03-05,37,8,29,0.216,35,15,20,0.429
21100556,1610612739,1610612762,100.0,109.0,0.457,0.5,0,2012-03-05,36,13,23,0.361,37,18,19,0.486
21100557,1610612741,1610612754,92.0,72.0,0.423,0.342,1,2012-03-05,40,32,8,0.8,36,23,13,0.639
21100558,1610612749,1610612755,97.0,93.0,0.3979999999999999,0.3720000000000001,1,2012-03-05,38,15,23,0.395,39,22,17,0.564
21100559,1610612760,1610612742,95.0,91.0,0.382,0.429,1,2012-03-05,38,30,8,0.789,39,22,17,0.564
21100560,1610612750,1610612746,95.0,94.0,0.4,0.405,1,2012-03-05,39,20,19,0.513,36,22,14,0.611
21100561,1610612743,1610612758,119.0,116.0,0.455,0.4589999999999999,1,2012-03-05,39,22,17,0.564,38,12,26,0.316
21100562,1610612757,1610612740,86.0,74.0,0.431,0.414,1,2012-03-05,38,19,19,0.5,38,9,29,0.237
21100546,1610612738,1610612752,115.0,111.0,0.4370000000000001,0.436,1,2012-03-04,36,19,17,0.528,37,18,19,0.486
21100547,1610612747,1610612748,93.0,83.0,0.493,0.375,1,2012-03-04,37,23,14,0.622,37,28,9,0.757
21100548,1610612761,1610612744,83.0,75.0,0.3720000000000001,0.363,1,2012-03-04,37,12,25,0.324,34,14,20,0.412
21100549,1610612766,1610612751,101.0,104.0,0.3879999999999999,0.485,0,2012-03-04,35,4,31,0.114,38,12,26,0.316
21100550,1610612755,1610612741,91.0,96.0,0.392,0.476,0,2012-03-04,38,22,16,0.579,39,31,8,0.795
21100551,1610612745,1610612746,103.0,105.0,0.43,0.465,0,2012-03-04,38,21,17,0.5529999999999999,35,22,13,0.629
21100552,1610612756,1610612758,96.0,88.0,0.455,0.384,1,2012-03-04,37,17,20,0.4589999999999999,37,12,25,0.324
21100553,1610612759,1610612743,94.0,99.0,0.444,0.419,0,2012-03-04,37,25,12,0.6759999999999999,38,21,17,0.5529999999999999
21100539,1610612764,1610612739,101.0,98.0,0.46,0.446,1,2012-03-03,36,8,28,0.222,35,13,22,0.371
21100540,1610612737,1610612760,97.0,90.0,0.435,0.411,1,2012-03-03,37,22,15,0.595,37,29,8,0.784
21100541,1610612753,1610612749,114.0,98.0,0.519,0.4679999999999999,1,2012-03-03,38,24,14,0.632,37,14,23,0.3779999999999999
21100542,1610612763,1610612765,100.0,83.0,0.493,0.382,1,2012-03-03,37,22,15,0.595,38,12,26,0.316
21100543,1610612740,1610612754,84.0,102.0,0.407,0.4379999999999999,0,2012-03-03,37,9,28,0.243,35,23,12,0.657
21100544,1610612742,1610612762,102.0,96.0,0.48,0.447,1,2012-03-03,38,22,16,0.579,36,17,19,0.472
21100545,1610612757,1610612750,110.0,122.0,0.482,0.5379999999999999,0,2012-03-03,37,18,19,0.486,38,19,19,0.5
21100528,1610612761,1610612763,99.0,102.0,0.528,0.469,0,2012-03-02,36,11,25,0.306,36,21,15,0.583
21100529,1610612738,1610612751,107.0,94.0,0.517,0.447,1,2012-03-02,35,18,17,0.514,37,11,26,0.297
21100530,1610612737,1610612749,99.0,94.0,0.4529999999999999,0.376,1,2012-03-02,36,21,15,0.583,36,14,22,0.389
21100531,1610612739,1610612741,91.0,112.0,0.4379999999999999,0.528,0,2012-03-02,34,13,21,0.382,38,30,8,0.789
21100532,1610612755,1610612744,105.0,83.0,0.472,0.402,1,2012-03-02,37,22,15,0.595,33,14,19,0.424
21100533,1610612740,1610612742,97.0,92.0,0.455,0.446,1,2012-03-02,36,9,27,0.25,37,21,16,0.568
21100534,1610612745,1610612743,105.0,117.0,0.474,0.4429999999999999,0,2012-03-02,37,21,16,0.568,37,20,17,0.541
21100535,1610612759,1610612766,102.0,72.0,0.476,0.373,1,2012-03-02,36,25,11,0.6940000000000001,34,4,30,0.118
21100536,1610612762,1610612748,99.0,98.0,0.422,0.493,1,2012-03-02,35,17,18,0.486,36,28,8,0.778
21100537,1610612756,1610612746,81.0,78.0,0.35,0.368,1,2012-03-02,36,16,20,0.444,34,21,13,0.618
21100538,1610612747,1610612758,115.0,107.0,0.537,0.4370000000000001,1,2012-03-02,36,22,14,0.611,36,12,24,0.3329999999999999
21100524,1610612753,1610612760,102.0,105.0,0.476,0.514,0,2012-03-01,37,23,14,0.622,36,29,7,0.8059999999999999
21100525,1610612756,1610612750,104.0,95.0,0.532,0.395,1,2012-03-01,35,15,20,0.429,37,18,19,0.486
21100526,1610612758,1610612746,100.0,108.0,0.4679999999999999,0.478,0,2012-03-01,35,12,23,0.3429999999999999,33,21,12,0.636
21100527,1610612757,1610612748,93.0,107.0,0.474,0.476,0,2012-03-01,36,18,18,0.5,35,28,7,0.8
21100512,1610612755,1610612760,88.0,92.0,0.411,0.385,0,2012-02-29,36,21,15,0.583,35,28,7,0.8
21100513,1610612764,1610612753,95.0,102.0,0.411,0.4529999999999999,0,2012-02-29,35,7,28,0.2,36,23,13,0.639
21100514,1610612738,1610612749,102.0,96.0,0.46,0.406,1,2012-02-29,34,17,17,0.5,35,14,21,0.4
21100515,1610612752,1610612739,120.0,103.0,0.506,0.4629999999999999,1,2012-02-29,36,18,18,0.5,33,13,20,0.3939999999999999
21100516,1610612737,1610612744,82.0,85.0,0.337,0.41,0,2012-02-29,35,20,15,0.5710000000000001,32,14,18,0.4379999999999999
21100517,1610612765,1610612766,109.0,94.0,0.5,0.439,1,2012-02-29,37,12,25,0.324,33,4,29,0.121
21100518,1610612763,1610612742,96.0,85.0,0.488,0.4429999999999999,1,2012-02-29,35,20,15,0.5710000000000001,36,21,15,0.583
21100519,1610612740,1610612761,84.0,95.0,0.375,0.442,0,2012-02-29,35,8,27,0.2289999999999999,35,11,24,0.314
21100520,1610612759,1610612741,89.0,96.0,0.43,0.42,0,2012-02-29,35,24,11,0.6859999999999999,37,29,8,0.784
21100521,1610612743,1610612757,104.0,95.0,0.484,0.4370000000000001,1,2012-02-29,36,19,17,0.528,35,18,17,0.514
21100522,1610612762,1610612745,104.0,83.0,0.483,0.39,1,2012-02-29,34,16,18,0.471,36,21,15,0.583
21100523,1610612747,1610612750,104.0,85.0,0.488,0.3929999999999999,1,2012-02-29,35,21,14,0.6,36,18,18,0.5
21100503,1610612739,1610612738,83.0,86.0,0.397,0.446,0,2012-02-28,32,13,19,0.406,33,16,17,0.485
21100504,1610612754,1610612744,102.0,78.0,0.44,0.341,1,2012-02-28,34,22,12,0.647,31,13,18,0.419
21100505,1610612765,1610612755,68.0,97.0,0.316,0.5,0,2012-02-28,36,11,25,0.306,35,21,14,0.6
21100506,1610612741,1610612740,99.0,95.0,0.456,0.4039999999999999,1,2012-02-28,36,28,8,0.778,34,8,26,0.235
21100507,1610612749,1610612764,119.0,118.0,0.451,0.483,1,2012-02-28,34,14,20,0.412,34,7,27,0.206
21100508,1610612745,1610612761,88.0,85.0,0.387,0.467,1,2012-02-28,35,21,14,0.6,34,10,24,0.294
21100509,1610612742,1610612751,92.0,93.0,0.36,0.44,0,2012-02-28,35,21,14,0.6,36,11,25,0.306
21100510,1610612758,1610612762,103.0,96.0,0.44,0.471,1,2012-02-28,34,12,22,0.353,33,15,18,0.455
21100511,1610612746,1610612750,97.0,109.0,0.471,0.513,0,2012-02-28,32,20,12,0.625,35,18,17,0.514
21100499,1610612748,1610612752,102.0,88.0,0.494,0.392,1,2012-02-23,34,27,7,0.794,35,17,18,0.486
21100500,1610612737,1610612753,83.0,78.0,0.397,0.3779999999999999,1,2012-02-23,34,20,14,0.588,35,22,13,0.629
21100501,1610612743,1610612759,99.0,114.0,0.446,0.477,0,2012-02-23,35,18,17,0.514,34,24,10,0.706
21100502,1610612760,1610612747,100.0,85.0,0.4679999999999999,0.385,1,2012-02-23,34,27,7,0.794,34,20,14,0.588
21100486,1610612761,1610612765,103.0,93.0,0.526,0.417,1,2012-02-22,33,10,23,0.303,35,11,24,0.314
21100487,1610612764,1610612758,107.0,115.0,0.488,0.4479999999999999,0,2012-02-22,33,7,26,0.212,33,11,22,0.3329999999999999
21100488,1610612766,1610612754,88.0,102.0,0.352,0.4,0,2012-02-22,32,4,28,0.125,33,21,12,0.636
21100489,1610612739,1610612740,84.0,89.0,0.318,0.4039999999999999,0,2012-02-22,31,13,18,0.419,33,8,25,0.242
21100490,1610612760,1610612738,119.0,104.0,0.5,0.486,1,2012-02-22,33,26,7,0.7879999999999999,32,15,17,0.469
21100491,1610612751,1610612753,91.0,108.0,0.469,0.536,0,2012-02-22,35,10,25,0.286,34,22,12,0.647
21100492,1610612752,1610612737,99.0,82.0,0.475,0.395,1,2012-02-22,34,17,17,0.5,33,19,14,0.5760000000000001
21100493,1610612741,1610612749,110.0,91.0,0.544,0.42,1,2012-02-22,35,27,8,0.7709999999999999,33,13,20,0.3939999999999999
21100494,1610612745,1610612755,93.0,87.0,0.462,0.402,1,2012-02-22,34,20,14,0.588,34,20,14,0.588
21100495,1610612750,1610612762,100.0,98.0,0.4029999999999999,0.4589999999999999,1,2012-02-22,34,17,17,0.5,32,15,17,0.469
21100496,1610612756,1610612744,104.0,106.0,0.478,0.4639999999999999,0,2012-02-22,34,14,20,0.412,30,13,17,0.433
21100497,1610612742,1610612747,91.0,96.0,0.4,0.461,0,2012-02-22,34,21,13,0.618,33,20,13,0.606
21100498,1610612746,1610612743,103.0,95.0,0.442,0.402,1,2012-02-22,31,20,11,0.645,34,18,16,0.529
21100481,1610612739,1610612765,101.0,100.0,0.436,0.389,1,2012-02-21,30,13,17,0.433,34,11,23,0.324
21100482,1610612754,1610612740,117.0,108.0,0.5,0.532,1,2012-02-21,32,20,12,0.625,32,7,25,0.2189999999999999
21100483,1610612748,1610612758,120.0,108.0,0.556,0.449,1,2012-02-21,33,26,7,0.7879999999999999,32,10,22,0.313
21100484,1610612763,1610612755,89.0,76.0,0.397,0.365,1,2012-02-21,34,19,15,0.5589999999999999,33,20,13,0.606
21100485,1610612757,1610612759,137.0,97.0,0.593,0.381,1,2012-02-21,34,18,16,0.529,33,23,10,0.6970000000000001
21100470,1610612741,1610612737,90.0,79.0,0.386,0.405,1,2012-02-20,34,26,8,0.765,32,19,13,0.594
21100471,1610612752,1610612751,92.0,100.0,0.4,0.39,0,2012-02-20,33,16,17,0.485,34,10,24,0.294
21100472,1610612749,1610612753,90.0,93.0,0.407,0.434,0,2012-02-20,32,13,19,0.406,33,21,12,0.636
21100473,1610612745,1610612763,97.0,93.0,0.473,0.481,1,2012-02-20,33,19,14,0.5760000000000001,33,18,15,0.545
21100474,1610612742,1610612738,89.0,73.0,0.4039999999999999,0.392,1,2012-02-20,33,21,12,0.636,31,15,16,0.484
21100475,1610612760,1610612740,101.0,93.0,0.45,0.363,1,2012-02-20,32,25,7,0.7809999999999999,31,7,24,0.226
21100476,1610612743,1610612750,103.0,101.0,0.402,0.364,1,2012-02-20,33,18,15,0.545,33,16,17,0.485
21100477,1610612762,1610612759,102.0,106.0,0.476,0.462,0,2012-02-20,31,15,16,0.484,32,23,9,0.7190000000000001
21100478,1610612756,1610612764,104.0,88.0,0.4679999999999999,0.429,1,2012-02-20,33,14,19,0.424,32,7,25,0.2189999999999999
21100479,1610612747,1610612757,103.0,92.0,0.4579999999999999,0.41,1,2012-02-20,32,19,13,0.594,33,17,16,0.515
21100480,1610612744,1610612746,104.0,97.0,0.4579999999999999,0.429,1,2012-02-20,29,12,17,0.414,30,19,11,0.633
21100460,1610612752,1610612742,104.0,97.0,0.465,0.444,1,2012-02-19,32,16,16,0.5,32,20,12,0.625
21100461,1610612748,1610612753,90.0,78.0,0.475,0.365,1,2012-02-19,32,25,7,0.7809999999999999,32,20,12,0.625
21100462,1610612765,1610612738,96.0,81.0,0.3779999999999999,0.444,1,2012-02-19,33,11,22,0.3329999999999999,30,15,15,0.5
21100463,1610612739,1610612758,93.0,92.0,0.36,0.376,1,2012-02-19,29,12,17,0.414,31,10,21,0.3229999999999999
21100464,1610612754,1610612766,108.0,73.0,0.5,0.373,1,2012-02-19,31,19,12,0.613,31,4,27,0.129
21100465,1610612751,1610612749,85.0,92.0,0.341,0.384,0,2012-02-19,33,9,24,0.273,31,13,18,0.419
21100466,1610612745,1610612762,101.0,85.0,0.514,0.395,1,2012-02-19,32,18,14,0.563,30,15,15,0.5
21100467,1610612750,1610612755,92.0,91.0,0.3879999999999999,0.444,1,2012-02-19,32,16,16,0.5,32,20,12,0.625
21100468,1610612760,1610612743,124.0,118.0,0.489,0.485,1,2012-02-19,31,24,7,0.774,32,17,15,0.531
21100469,1610612756,1610612747,102.0,90.0,0.425,0.449,1,2012-02-19,32,13,19,0.406,31,18,13,0.581
21100456,1610612746,1610612759,100.0,103.0,0.4039999999999999,0.435,0,2012-02-18,29,19,10,0.655,31,22,9,0.71
21100457,1610612741,1610612751,85.0,97.0,0.3929999999999999,0.4,0,2012-02-18,33,25,8,0.758,32,9,23,0.281
21100458,1610612763,1610612744,104.0,103.0,0.507,0.4270000000000001,1,2012-02-18,32,18,14,0.563,28,11,17,0.3929999999999999
21100459,1610612757,1610612737,97.0,77.0,0.469,0.411,1,2012-02-18,32,17,15,0.531,31,19,12,0.613
21100445,1610612761,1610612766,91.0,98.0,0.417,0.5,0,2012-02-17,32,9,23,0.281,30,4,26,0.133
21100447,1610612753,1610612749,94.0,85.0,0.434,0.3670000000000001,1,2012-02-17,31,20,11,0.645,30,12,18,0.4
21100448,1610612765,1610612758,114.0,108.0,0.462,0.5,1,2012-02-17,32,10,22,0.313,30,10,20,0.3329999999999999
21100449,1610612739,1610612748,87.0,111.0,0.395,0.506,0,2012-02-17,28,11,17,0.3929999999999999,31,24,7,0.774
21100446,1610612755,1610612742,75.0,82.0,0.337,0.3829999999999999,0,2012-02-17,31,20,11,0.645,31,20,11,0.645
21100450,1610612752,1610612740,85.0,89.0,0.413,0.4270000000000001,0,2012-02-17,31,15,16,0.484,30,7,23,0.233
21100451,1610612763,1610612743,103.0,102.0,0.5,0.494,1,2012-02-17,31,17,14,0.5479999999999999,31,17,14,0.5479999999999999
21100452,1610612745,1610612750,98.0,111.0,0.471,0.5579999999999999,0,2012-02-17,31,17,14,0.5479999999999999,31,15,16,0.484
21100453,1610612760,1610612744,110.0,87.0,0.527,0.348,1,2012-02-17,30,23,7,0.767,27,11,16,0.407
21100454,1610612762,1610612764,114.0,100.0,0.528,0.452,1,2012-02-17,29,15,14,0.517,31,7,24,0.226
21100455,1610612747,1610612756,111.0,99.0,0.53,0.456,1,2012-02-17,30,18,12,0.6,31,12,19,0.387
21100442,1610612754,1610612751,93.0,88.0,0.395,0.467,1,2012-02-16,30,18,12,0.6,31,8,23,0.258
21100443,1610612741,1610612738,89.0,80.0,0.395,0.397,1,2012-02-16,32,25,7,0.7809999999999999,29,15,14,0.517
21100444,1610612757,1610612746,71.0,74.0,0.38,0.385,0,2012-02-16,31,16,15,0.516,28,19,9,0.679
21100429,1610612761,1610612759,106.0,113.0,0.547,0.539,0,2012-02-15,31,9,22,0.29,30,21,9,0.7
21100430,1610612753,1610612755,103.0,87.0,0.5329999999999999,0.424,1,2012-02-15,30,19,11,0.633,30,20,10,0.667
21100431,1610612738,1610612765,88.0,98.0,0.442,0.473,0,2012-02-15,28,15,13,0.536,31,9,22,0.29
21100432,1610612751,1610612763,100.0,105.0,0.514,0.466,0,2012-02-15,30,8,22,0.267,30,16,14,0.5329999999999999
21100433,1610612752,1610612758,100.0,85.0,0.506,0.379,1,2012-02-15,30,15,15,0.5,29,10,19,0.345
21100434,1610612739,1610612754,98.0,87.0,0.4679999999999999,0.368,1,2012-02-15,27,11,16,0.407,29,17,12,0.586
21100435,1610612749,1610612740,89.0,92.0,0.384,0.45,0,2012-02-15,29,12,17,0.414,29,6,23,0.207
21100436,1610612745,1610612760,96.0,95.0,0.425,0.434,1,2012-02-15,30,17,13,0.5670000000000001,29,22,7,0.759
21100437,1610612750,1610612766,102.0,90.0,0.506,0.447,1,2012-02-15,30,14,16,0.467,29,3,26,0.103
21100438,1610612742,1610612743,102.0,84.0,0.4629999999999999,0.357,1,2012-02-15,30,19,11,0.633,30,17,13,0.5670000000000001
21100439,1610612756,1610612737,99.0,101.0,0.536,0.475,0,2012-02-15,30,12,18,0.4,30,19,11,0.633
21100440,1610612744,1610612757,91.0,93.0,0.474,0.405,0,2012-02-15,26,11,15,0.423,30,16,14,0.5329999999999999
21100441,1610612746,1610612764,102.0,84.0,0.422,0.395,1,2012-02-15,27,18,9,0.667,30,7,23,0.233
21100420,1610612761,1610612752,87.0,90.0,0.507,0.413,0,2012-02-14,30,9,21,0.3,29,14,15,0.483
21100421,1610612754,1610612748,90.0,105.0,0.434,0.5,0,2012-02-14,28,17,11,0.607,30,23,7,0.767
21100422,1610612765,1610612759,95.0,99.0,0.4639999999999999,0.434,0,2012-02-14,30,8,22,0.267,29,20,9,0.69
21100423,1610612741,1610612758,121.0,115.0,0.524,0.472,1,2012-02-14,31,24,7,0.774,28,10,18,0.357
21100424,1610612763,1610612745,93.0,83.0,0.479,0.385,1,2012-02-14,29,15,14,0.517,29,16,13,0.552
21100425,1610612760,1610612762,111.0,85.0,0.545,0.356,1,2012-02-14,28,22,6,0.7859999999999999,28,14,14,0.5
21100426,1610612743,1610612756,109.0,92.0,0.513,0.3329999999999999,1,2012-02-14,29,17,12,0.586,29,12,17,0.414
21100427,1610612757,1610612764,109.0,124.0,0.471,0.6,0,2012-02-14,29,15,14,0.517,29,7,22,0.241
21100428,1610612747,1610612737,86.0,78.0,0.44,0.344,1,2012-02-14,29,17,12,0.586,29,18,11,0.621
21100414,1610612766,1610612755,89.0,98.0,0.411,0.434,0,2012-02-13,28,3,25,0.107,29,20,9,0.69
21100415,1610612753,1610612750,102.0,89.0,0.424,0.413,1,2012-02-13,29,18,11,0.621,29,13,16,0.4479999999999999
21100416,1610612749,1610612748,96.0,114.0,0.3929999999999999,0.518,0,2012-02-13,28,12,16,0.429,29,22,7,0.759
21100417,1610612740,1610612762,86.0,80.0,0.4270000000000001,0.411,1,2012-02-13,28,5,23,0.179,27,14,13,0.519
21100418,1610612742,1610612746,96.0,92.0,0.4429999999999999,0.446,1,2012-02-13,29,18,11,0.621,26,17,9,0.654
21100419,1610612744,1610612756,102.0,96.0,0.4529999999999999,0.4629999999999999,1,2012-02-13,25,11,14,0.44,28,12,16,0.429
21100408,1610612761,1610612747,92.0,94.0,0.474,0.4320000000000001,0,2012-02-12,29,9,20,0.31,28,16,12,0.5710000000000001
21100409,1610612738,1610612741,95.0,91.0,0.493,0.386,1,2012-02-12,27,15,12,0.556,30,23,7,0.767
21100410,1610612765,1610612764,77.0,98.0,0.326,0.4679999999999999,0,2012-02-12,29,8,21,0.276,28,6,22,0.214
21100411,1610612737,1610612748,87.0,107.0,0.389,0.4579999999999999,0,2012-02-12,28,18,10,0.643,28,21,7,0.75
21100412,1610612744,1610612745,106.0,97.0,0.506,0.413,1,2012-02-12,24,10,14,0.417,28,16,12,0.5710000000000001
21100413,1610612763,1610612762,88.0,98.0,0.436,0.506,0,2012-02-12,28,14,14,0.5,26,14,12,0.5379999999999999
21100400,1610612766,1610612746,86.0,111.0,0.351,0.526,0,2012-02-11,27,3,24,0.111,25,17,8,0.68
21100401,1610612754,1610612743,109.0,113.0,0.532,0.494,0,2012-02-11,27,17,10,0.63,28,16,12,0.5710000000000001
21100402,1610612739,1610612755,84.0,99.0,0.369,0.4429999999999999,0,2012-02-11,26,10,16,0.385,28,19,9,0.679
21100403,1610612751,1610612759,89.0,103.0,0.402,0.525,0,2012-02-11,29,8,21,0.276,28,19,9,0.679
21100404,1610612750,1610612752,98.0,100.0,0.44,0.476,0,2012-02-11,28,13,15,0.4639999999999999,28,13,15,0.4639999999999999
21100405,1610612742,1610612757,97.0,94.0,0.4639999999999999,0.371,1,2012-02-11,28,17,11,0.607,28,15,13,0.536
21100406,1610612749,1610612753,94.0,99.0,0.419,0.4320000000000001,0,2012-02-11,27,12,15,0.444,28,17,11,0.607
21100407,1610612758,1610612756,84.0,98.0,0.351,0.5,0,2012-02-11,27,10,17,0.37,27,12,15,0.444
21100388,1610612761,1610612738,86.0,74.0,0.44,0.446,1,2012-02-10,28,9,19,0.321,26,14,12,0.5379999999999999
21100389,1610612755,1610612746,77.0,78.0,0.408,0.3879999999999999,0,2012-02-10,27,18,9,0.667,24,16,8,0.667
21100390,1610612764,1610612748,89.0,106.0,0.382,0.494,0,2012-02-10,27,5,22,0.185,27,20,7,0.741
21100391,1610612766,1610612741,64.0,95.0,0.3289999999999999,0.433,0,2012-02-10,26,3,23,0.115,29,23,6,0.7929999999999999
21100392,1610612753,1610612737,87.0,89.0,0.422,0.439,0,2012-02-10,27,16,11,0.593,27,18,9,0.667
21100393,1610612765,1610612751,109.0,92.0,0.544,0.419,1,2012-02-10,28,8,20,0.286,28,8,20,0.286
21100394,1610612739,1610612749,112.0,113.0,0.489,0.408,0,2012-02-10,25,10,15,0.4,26,12,14,0.462
21100395,1610612752,1610612747,92.0,85.0,0.429,0.375,1,2012-02-10,27,12,15,0.444,27,15,12,0.556
21100396,1610612763,1610612754,98.0,92.0,0.466,0.385,1,2012-02-10,27,14,13,0.519,26,17,9,0.654
21100397,1610612740,1610612757,86.0,94.0,0.44,0.515,0,2012-02-10,27,4,23,0.148,27,15,12,0.556
21100398,1610612750,1610612742,97.0,104.0,0.405,0.433,0,2012-02-10,27,13,14,0.481,27,16,11,0.593
21100399,1610612762,1610612760,87.0,101.0,0.475,0.473,0,2012-02-10,25,13,12,0.52,27,21,6,0.778
21100384,1610612738,1610612747,87.0,88.0,0.392,0.396,0,2012-02-09,25,14,11,0.56,26,15,11,0.5770000000000001
21100385,1610612743,1610612744,101.0,109.0,0.435,0.519,0,2012-02-09,27,15,12,0.556,23,9,14,0.391
21100386,1610612756,1610612745,89.0,96.0,0.473,0.488,0,2012-02-09,26,11,15,0.423,27,16,11,0.593
21100387,1610612758,1610612760,106.0,101.0,0.4039999999999999,0.481,1,2012-02-09,26,10,16,0.385,26,20,6,0.769
21100373,1610612761,1610612749,99.0,105.0,0.411,0.4579999999999999,0,2012-02-08,27,8,19,0.296,25,11,14,0.44
21100374,1610612755,1610612759,90.0,100.0,0.409,0.44,0,2012-02-08,26,18,8,0.6920000000000001,27,18,9,0.667
21100375,1610612764,1610612752,93.0,107.0,0.4579999999999999,0.457,0,2012-02-08,26,5,21,0.192,26,11,15,0.423
21100376,1610612753,1610612748,102.0,89.0,0.422,0.474,1,2012-02-08,26,16,10,0.615,26,19,7,0.731
21100377,1610612739,1610612746,99.0,92.0,0.507,0.41,1,2012-02-08,24,10,14,0.417,23,15,8,0.652
21100378,1610612751,1610612765,92.0,99.0,0.423,0.534,0,2012-02-08,27,8,19,0.296,27,7,20,0.259
21100379,1610612737,1610612754,97.0,87.0,0.461,0.44,1,2012-02-08,26,17,9,0.654,25,17,8,0.68
21100380,1610612763,1610612750,85.0,80.0,0.3720000000000001,0.392,1,2012-02-08,26,13,13,0.5,26,13,13,0.5
21100381,1610612740,1610612741,67.0,90.0,0.373,0.4589999999999999,0,2012-02-08,26,4,22,0.154,28,22,6,0.7859999999999999
21100382,1610612743,1610612742,95.0,105.0,0.4579999999999999,0.489,0,2012-02-08,26,15,11,0.5770000000000001,26,15,11,0.5770000000000001
21100383,1610612757,1610612745,96.0,103.0,0.473,0.526,0,2012-02-08,26,14,12,0.5379999999999999,26,15,11,0.5770000000000001
21100367,1610612754,1610612762,104.0,99.0,0.471,0.474,1,2012-02-07,24,17,7,0.708,24,13,11,0.542
21100368,1610612738,1610612766,94.0,84.0,0.506,0.451,1,2012-02-07,24,14,10,0.583,25,3,22,0.12
21100369,1610612748,1610612739,107.0,91.0,0.4639999999999999,0.39,1,2012-02-07,25,19,6,0.76,23,9,14,0.391
21100370,1610612749,1610612756,105.0,107.0,0.481,0.479,0,2012-02-07,24,10,14,0.417,25,11,14,0.44
21100371,1610612750,1610612758,86.0,84.0,0.405,0.3779999999999999,1,2012-02-07,25,13,12,0.52,25,9,16,0.36
21100372,1610612744,1610612760,116.0,119.0,0.55,0.524,0,2012-02-07,22,8,14,0.364,25,20,5,0.8
21100357,1610612755,1610612747,95.0,90.0,0.469,0.42,1,2012-02-06,25,18,7,0.72,25,14,11,0.56
21100358,1610612764,1610612761,111.0,108.0,0.488,0.4,1,2012-02-06,25,5,20,0.2,26,8,18,0.308
21100359,1610612753,1610612746,102.0,107.0,0.465,0.439,0,2012-02-06,25,15,10,0.6,22,15,7,0.682
21100360,1610612751,1610612741,87.0,108.0,0.405,0.556,0,2012-02-06,26,8,18,0.308,27,21,6,0.778
21100361,1610612752,1610612762,99.0,88.0,0.479,0.434,1,2012-02-06,25,10,15,0.4,23,13,10,0.565
21100362,1610612737,1610612756,90.0,99.0,0.3929999999999999,0.519,0,2012-02-06,25,16,9,0.64,24,10,14,0.417
21100363,1610612763,1610612759,84.0,89.0,0.373,0.466,0,2012-02-06,25,12,13,0.48,26,17,9,0.654
21100364,1610612740,1610612758,92.0,100.0,0.42,0.474,0,2012-02-06,25,4,21,0.16,24,9,15,0.375
21100365,1610612743,1610612745,90.0,99.0,0.436,0.4320000000000001,0,2012-02-06,25,15,10,0.6,25,14,11,0.56
21100366,1610612757,1610612760,107.0,111.0,0.423,0.4529999999999999,0,2012-02-06,25,14,11,0.56,24,19,5,0.792
21100355,1610612738,1610612763,98.0,80.0,0.493,0.368,1,2012-02-05,23,13,10,0.565,24,12,12,0.5
21100356,1610612748,1610612761,95.0,89.0,0.449,0.43,1,2012-02-05,24,18,6,0.75,25,8,17,0.32
21100342,1610612764,1610612746,81.0,107.0,0.375,0.542,0,2012-02-04,24,4,20,0.1669999999999999,21,14,7,0.667
21100343,1610612737,1610612755,87.0,98.0,0.4320000000000001,0.5,0,2012-02-04,24,16,8,0.667,24,17,7,0.708
21100344,1610612754,1610612753,81.0,85.0,0.341,0.4029999999999999,0,2012-02-04,23,16,7,0.696,24,15,9,0.625
21100345,1610612752,1610612751,99.0,92.0,0.446,0.417,1,2012-02-04,24,9,15,0.375,25,8,17,0.32
21100346,1610612765,1610612740,89.0,87.0,0.449,0.472,1,2012-02-04,26,6,20,0.231,24,4,20,0.1669999999999999
21100347,1610612739,1610612742,91.0,88.0,0.3979999999999999,0.478,1,2012-02-04,22,9,13,0.409,25,14,11,0.56
21100348,1610612750,1610612745,100.0,91.0,0.451,0.429,1,2012-02-04,24,12,12,0.5,24,13,11,0.542
21100349,1610612749,1610612741,90.0,113.0,0.3979999999999999,0.5329999999999999,0,2012-02-04,23,10,13,0.435,26,20,6,0.769
21100350,1610612759,1610612760,107.0,96.0,0.42,0.4679999999999999,1,2012-02-04,25,16,9,0.64,23,18,5,0.7829999999999999
21100351,1610612762,1610612747,96.0,87.0,0.4479999999999999,0.387,1,2012-02-04,22,13,9,0.591,24,14,10,0.583
21100352,1610612756,1610612766,95.0,89.0,0.4,0.44,1,2012-02-04,23,9,14,0.391,24,3,21,0.125
21100353,1610612758,1610612744,114.0,106.0,0.439,0.433,1,2012-02-04,23,8,15,0.348,21,8,13,0.381
21100354,1610612757,1610612743,117.0,97.0,0.535,0.4429999999999999,1,2012-02-04,24,14,10,0.583,24,15,9,0.625
21100332,1610612761,1610612764,106.0,89.0,0.452,0.379,1,2012-02-03,24,8,16,0.3329999999999999,23,4,19,0.174
21100333,1610612755,1610612748,79.0,99.0,0.395,0.519,0,2012-02-03,23,16,7,0.696,23,17,6,0.7390000000000001
21100334,1610612753,1610612739,102.0,94.0,0.425,0.3670000000000001,1,2012-02-03,23,14,9,0.609,21,8,13,0.381
21100335,1610612751,1610612750,105.0,108.0,0.442,0.439,0,2012-02-03,24,8,16,0.3329999999999999,23,11,12,0.478
21100336,1610612765,1610612749,88.0,80.0,0.42,0.351,1,2012-02-03,25,5,20,0.2,22,10,12,0.455
21100337,1610612738,1610612752,91.0,89.0,0.408,0.425,1,2012-02-03,22,12,10,0.545,23,8,15,0.348
21100338,1610612745,1610612756,99.0,81.0,0.4379999999999999,0.41,1,2012-02-03,23,13,10,0.565,22,8,14,0.364
21100339,1610612760,1610612763,101.0,94.0,0.479,0.425,1,2012-02-03,22,18,4,0.818,23,12,11,0.522
21100340,1610612742,1610612754,87.0,98.0,0.422,0.425,0,2012-02-03,24,14,10,0.583,22,16,6,0.727
21100341,1610612743,1610612747,89.0,93.0,0.44,0.474,0,2012-02-03,23,15,8,0.652,23,14,9,0.609
21100326,1610612737,1610612763,77.0,96.0,0.44,0.482,0,2012-02-02,23,16,7,0.696,22,12,10,0.545
21100327,1610612752,1610612741,102.0,105.0,0.489,0.527,0,2012-02-02,22,8,14,0.364,25,19,6,0.76
21100328,1610612759,1610612740,93.0,81.0,0.4589999999999999,0.446,1,2012-02-02,24,15,9,0.625,23,4,19,0.174
21100329,1610612758,1610612757,95.0,92.0,0.447,0.455,1,2012-02-02,22,7,15,0.318,23,13,10,0.565
21100330,1610612746,1610612743,91.0,112.0,0.4589999999999999,0.534,0,2012-02-02,20,13,7,0.65,22,15,7,0.682
21100331,1610612744,1610612762,119.0,101.0,0.469,0.456,1,2012-02-02,20,8,12,0.4,21,12,9,0.5710000000000001
21100315,1610612755,1610612741,98.0,82.0,0.476,0.4320000000000001,1,2012-02-01,22,16,6,0.727,24,18,6,0.75
21100316,1610612753,1610612764,109.0,103.0,0.452,0.457,1,2012-02-01,22,13,9,0.591,22,4,18,0.182
21100317,1610612738,1610612761,100.0,64.0,0.52,0.342,1,2012-02-01,21,11,10,0.524,23,7,16,0.304
21100318,1610612751,1610612765,99.0,96.0,0.481,0.488,1,2012-02-01,23,8,15,0.348,24,4,20,0.1669999999999999
21100319,1610612749,1610612748,105.0,97.0,0.4429999999999999,0.466,1,2012-02-01,21,10,11,0.476,22,16,6,0.727
21100320,1610612740,1610612756,103.0,120.0,0.519,0.526,0,2012-02-01,22,4,18,0.182,21,8,13,0.381
21100321,1610612742,1610612760,86.0,95.0,0.357,0.407,0,2012-02-01,23,14,9,0.609,21,17,4,0.81
21100322,1610612750,1610612754,99.0,109.0,0.374,0.452,0,2012-02-01,22,10,12,0.455,21,15,6,0.7140000000000001
21100323,1610612759,1610612745,99.0,91.0,0.461,0.456,1,2012-02-01,23,14,9,0.609,22,12,10,0.545
21100324,1610612757,1610612766,112.0,68.0,0.55,0.325,1,2012-02-01,22,13,9,0.591,23,3,20,0.13
21100325,1610612762,1610612746,105.0,107.0,0.469,0.483,0,2012-02-01,20,12,8,0.6,19,13,6,0.684
21100308,1610612761,1610612737,77.0,100.0,0.37,0.513,0,2012-01-31,22,7,15,0.318,22,16,6,0.727
21100309,1610612739,1610612738,90.0,93.0,0.4529999999999999,0.507,0,2012-01-31,20,8,12,0.4,20,10,10,0.5
21100310,1610612754,1610612751,106.0,99.0,0.521,0.473,1,2012-01-31,20,14,6,0.7,22,7,15,0.318
21100311,1610612752,1610612765,113.0,86.0,0.6,0.451,1,2012-01-31,21,8,13,0.381,23,4,19,0.174
21100312,1610612763,1610612743,100.0,97.0,0.384,0.4379999999999999,1,2012-01-31,21,11,10,0.524,21,14,7,0.667
21100313,1610612747,1610612766,106.0,73.0,0.5529999999999999,0.348,1,2012-01-31,22,13,9,0.591,22,3,19,0.136
21100314,1610612744,1610612758,93.0,90.0,0.407,0.4270000000000001,1,2012-01-31,19,7,12,0.368,21,6,15,0.286
21100299,1610612755,1610612753,74.0,69.0,0.375,0.3329999999999999,1,2012-01-30,21,15,6,0.7140000000000001,21,12,9,0.5710000000000001
21100300,1610612764,1610612741,88.0,98.0,0.402,0.4529999999999999,0,2012-01-30,21,4,17,0.19,23,18,5,0.7829999999999999
21100301,1610612748,1610612740,109.0,95.0,0.551,0.5329999999999999,1,2012-01-30,21,16,5,0.762,21,4,17,0.19
21100302,1610612749,1610612765,103.0,82.0,0.514,0.386,1,2012-01-30,20,9,11,0.45,22,4,18,0.182
21100303,1610612763,1610612759,73.0,83.0,0.37,0.4,0,2012-01-30,20,10,10,0.5,22,13,9,0.591
21100304,1610612745,1610612750,108.0,120.0,0.471,0.581,0,2012-01-30,21,12,9,0.5710000000000001,21,10,11,0.476
21100305,1610612762,1610612757,93.0,89.0,0.381,0.4629999999999999,1,2012-01-30,19,12,7,0.632,21,12,9,0.5710000000000001
21100306,1610612756,1610612742,99.0,122.0,0.4379999999999999,0.552,0,2012-01-30,20,7,13,0.35,22,14,8,0.636
21100307,1610612746,1610612760,112.0,100.0,0.563,0.487,1,2012-01-30,18,12,6,0.667,20,16,4,0.8
21100291,1610612748,1610612741,97.0,93.0,0.41,0.4320000000000001,1,2012-01-29,20,15,5,0.75,22,17,5,0.773
21100292,1610612738,1610612739,87.0,88.0,0.522,0.43,0,2012-01-29,19,9,10,0.474,19,8,11,0.421
21100293,1610612751,1610612761,73.0,94.0,0.365,0.515,0,2012-01-29,21,7,14,0.3329999999999999,21,7,14,0.3329999999999999
21100294,1610612753,1610612754,85.0,106.0,0.484,0.511,0,2012-01-29,20,12,8,0.6,19,13,6,0.684
21100295,1610612742,1610612759,101.0,100.0,0.44,0.415,1,2012-01-29,21,13,8,0.619,21,12,9,0.5710000000000001
21100296,1610612740,1610612737,72.0,94.0,0.37,0.444,0,2012-01-29,20,4,16,0.2,21,15,6,0.7140000000000001
21100297,1610612750,1610612747,101.0,106.0,0.385,0.506,0,2012-01-29,20,9,11,0.45,21,12,9,0.5710000000000001
21100298,1610612743,1610612746,105.0,109.0,0.494,0.4529999999999999,0,2012-01-29,20,14,6,0.7,17,11,6,0.647
21100285,1610612755,1610612765,95.0,74.0,0.487,0.349,1,2012-01-28,20,14,6,0.7,21,4,17,0.19
21100286,1610612766,1610612764,99.0,102.0,0.47,0.526,0,2012-01-28,21,3,18,0.143,20,4,16,0.2
21100287,1610612745,1610612752,97.0,84.0,0.494,0.382,1,2012-01-28,20,12,8,0.6,20,7,13,0.35
21100288,1610612749,1610612747,100.0,89.0,0.5,0.439,1,2012-01-28,19,8,11,0.421,20,11,9,0.55
21100289,1610612762,1610612758,96.0,93.0,0.4429999999999999,0.4629999999999999,1,2012-01-28,18,11,7,0.611,20,6,14,0.3
21100290,1610612756,1610612763,86.0,84.0,0.364,0.434,1,2012-01-28,19,7,12,0.368,19,10,9,0.526
21100272,1610612755,1610612766,89.0,72.0,0.449,0.386,1,2012-01-27,19,13,6,0.684,20,3,17,0.15
21100273,1610612738,1610612754,94.0,87.0,0.4579999999999999,0.35,1,2012-01-27,18,9,9,0.5,18,12,6,0.667
21100274,1610612765,1610612737,101.0,107.0,0.409,0.488,0,2012-01-27,20,4,16,0.2,20,14,6,0.7
21100275,1610612739,1610612751,96.0,99.0,0.469,0.456,0,2012-01-27,18,7,11,0.389,20,7,13,0.35
21100276,1610612748,1610612752,99.0,89.0,0.4629999999999999,0.357,1,2012-01-27,19,14,5,0.737,19,7,12,0.368
21100277,1610612741,1610612749,107.0,100.0,0.456,0.424,1,2012-01-27,21,17,4,0.81,18,7,11,0.389
21100278,1610612740,1610612753,93.0,67.0,0.506,0.3929999999999999,1,2012-01-27,19,4,15,0.211,19,12,7,0.632
21100279,1610612745,1610612764,103.0,76.0,0.422,0.364,1,2012-01-27,19,11,8,0.579,19,3,16,0.158
21100280,1610612750,1610612759,87.0,79.0,0.439,0.413,1,2012-01-27,19,9,10,0.474,20,12,8,0.6
21100281,1610612742,1610612762,116.0,101.0,0.5489999999999999,0.4639999999999999,1,2012-01-27,20,12,8,0.6,17,10,7,0.588
21100282,1610612743,1610612761,96.0,81.0,0.457,0.39,1,2012-01-27,19,14,5,0.737,20,6,14,0.3
21100283,1610612757,1610612756,109.0,71.0,0.473,0.3720000000000001,1,2012-01-27,20,12,8,0.6,18,6,12,0.3329999999999999
21100284,1610612744,1610612760,109.0,120.0,0.471,0.477,0,2012-01-27,18,6,12,0.3329999999999999,19,16,3,0.8420000000000001
21100270,1610612753,1610612738,83.0,91.0,0.38,0.466,0,2012-01-26,18,12,6,0.667,17,8,9,0.471
21100271,1610612746,1610612763,98.0,91.0,0.486,0.357,1,2012-01-26,16,10,6,0.625,18,10,8,0.556
21100257,1610612755,1610612751,90.0,97.0,0.4429999999999999,0.451,0,2012-01-25,18,12,6,0.667,19,6,13,0.316
21100258,1610612764,1610612766,92.0,75.0,0.47,0.359,1,2012-01-25,18,3,15,0.1669999999999999,19,3,16,0.158
21100259,1610612739,1610612752,91.0,81.0,0.436,0.421,1,2012-01-25,17,7,10,0.412,18,7,11,0.389
21100260,1610612765,1610612748,98.0,101.0,0.5,0.521,0,2012-01-25,19,4,15,0.211,18,13,5,0.722
21100261,1610612741,1610612754,90.0,95.0,0.4,0.475,0,2012-01-25,20,16,4,0.8,17,12,5,0.706
21100262,1610612745,1610612749,99.0,105.0,0.409,0.429,0,2012-01-25,18,10,8,0.556,17,7,10,0.412
21100263,1610612760,1610612740,101.0,91.0,0.531,0.467,1,2012-01-25,18,15,3,0.833,18,3,15,0.1669999999999999
21100264,1610612742,1610612750,90.0,105.0,0.411,0.442,0,2012-01-25,19,11,8,0.579,18,8,10,0.444
21100265,1610612759,1610612737,105.0,83.0,0.512,0.4379999999999999,1,2012-01-25,19,12,7,0.632,19,13,6,0.684
21100266,1610612762,1610612761,106.0,111.0,0.433,0.4479999999999999,0,2012-01-25,16,10,6,0.625,19,6,13,0.316
21100267,1610612758,1610612743,93.0,122.0,0.436,0.5489999999999999,0,2012-01-25,19,6,13,0.316,18,13,5,0.722
21100268,1610612747,1610612746,96.0,91.0,0.485,0.425,1,2012-01-25,19,11,8,0.579,15,9,6,0.6
21100269,1610612744,1610612757,101.0,93.0,0.519,0.41,1,2012-01-25,17,6,11,0.353,19,11,8,0.579
21100252,1610612766,1610612752,78.0,111.0,0.3289999999999999,0.5,0,2012-01-24,18,3,15,0.1669999999999999,17,7,10,0.412
21100253,1610612754,1610612753,83.0,102.0,0.397,0.4579999999999999,0,2012-01-24,16,11,5,0.688,17,12,5,0.706
21100254,1610612748,1610612739,92.0,85.0,0.457,0.5,1,2012-01-24,17,12,5,0.706,16,6,10,0.375
21100255,1610612756,1610612761,96.0,99.0,0.476,0.415,0,2012-01-24,17,6,11,0.353,18,5,13,0.278
21100256,1610612757,1610612763,97.0,84.0,0.431,0.3779999999999999,1,2012-01-24,18,11,7,0.611,17,10,7,0.588
21100242,1610612755,1610612764,103.0,83.0,0.518,0.4320000000000001,1,2012-01-23,17,12,5,0.706,17,2,15,0.118
21100243,1610612738,1610612753,87.0,56.0,0.423,0.246,1,2012-01-23,16,7,9,0.4379999999999999,16,11,5,0.688
21100244,1610612741,1610612751,110.0,95.0,0.573,0.481,1,2012-01-23,19,16,3,0.8420000000000001,18,5,13,0.278
21100245,1610612749,1610612737,92.0,97.0,0.402,0.4579999999999999,0,2012-01-23,16,6,10,0.375,18,13,5,0.722
21100246,1610612740,1610612759,102.0,104.0,0.506,0.547,0,2012-01-23,17,3,14,0.176,18,11,7,0.611
21100247,1610612760,1610612765,99.0,79.0,0.532,0.341,1,2012-01-23,17,14,3,0.8240000000000001,18,4,14,0.222
21100248,1610612750,1610612745,92.0,107.0,0.413,0.4529999999999999,0,2012-01-23,17,7,10,0.412,17,10,7,0.588
21100249,1610612742,1610612756,93.0,87.0,0.407,0.373,1,2012-01-23,18,11,7,0.611,16,6,10,0.375
21100250,1610612757,1610612758,101.0,89.0,0.466,0.4,1,2012-01-23,17,10,7,0.588,18,6,12,0.3329999999999999
21100251,1610612744,1610612763,90.0,91.0,0.5,0.424,0,2012-01-23,16,5,11,0.313,16,10,6,0.625
21100237,1610612764,1610612738,94.0,100.0,0.481,0.514,0,2012-01-22,16,2,14,0.125,15,6,9,0.4
21100238,1610612746,1610612761,103.0,91.0,0.486,0.358,1,2012-01-22,14,9,5,0.643,17,4,13,0.235
21100239,1610612751,1610612766,97.0,87.0,0.442,0.4679999999999999,1,2012-01-22,17,5,12,0.294,17,3,14,0.176
21100240,1610612748,1610612749,82.0,91.0,0.373,0.35,0,2012-01-22,16,11,5,0.688,15,6,9,0.4
21100241,1610612747,1610612754,96.0,98.0,0.419,0.4679999999999999,0,2012-01-22,18,10,8,0.556,15,11,4,0.733
21100227,1610612737,1610612739,121.0,94.0,0.5539999999999999,0.486,1,2012-01-21,17,12,5,0.706,15,6,9,0.4
21100228,1610612752,1610612743,114.0,119.0,0.4539999999999999,0.418,0,2012-01-21,16,6,10,0.375,17,12,5,0.706
21100229,1610612748,1610612755,113.0,92.0,0.5429999999999999,0.446,1,2012-01-21,15,11,4,0.733,16,11,5,0.688
21100230,1610612765,1610612757,94.0,91.0,0.4479999999999999,0.42,1,2012-01-21,17,4,13,0.235,16,9,7,0.563
21100231,1610612751,1610612760,74.0,84.0,0.31,0.416,0,2012-01-21,16,4,12,0.25,16,13,3,0.813
21100232,1610612741,1610612766,95.0,89.0,0.471,0.473,1,2012-01-21,18,15,3,0.833,16,3,13,0.188
21100233,1610612763,1610612758,128.0,95.0,0.5429999999999999,0.414,1,2012-01-21,15,9,6,0.6,17,6,11,0.353
21100234,1610612740,1610612742,81.0,83.0,0.3670000000000001,0.405,0,2012-01-21,16,3,13,0.188,17,10,7,0.588
21100235,1610612745,1610612759,105.0,102.0,0.557,0.447,1,2012-01-21,16,9,7,0.563,17,10,7,0.588
21100236,1610612762,1610612750,108.0,98.0,0.519,0.446,1,2012-01-21,15,10,5,0.667,16,7,9,0.4379999999999999
21100216,1610612761,1610612757,84.0,94.0,0.366,0.402,0,2012-01-20,16,4,12,0.25,15,9,6,0.6
21100217,1610612755,1610612737,90.0,76.0,0.417,0.4320000000000001,1,2012-01-20,15,11,4,0.733,16,11,5,0.688
21100218,1610612764,1610612743,104.0,108.0,0.421,0.494,0,2012-01-20,15,2,13,0.133,16,11,5,0.688
21100219,1610612738,1610612756,71.0,79.0,0.405,0.449,0,2012-01-20,14,5,9,0.357,15,6,9,0.4
21100220,1610612752,1610612749,86.0,100.0,0.37,0.476,0,2012-01-20,15,6,9,0.4,14,5,9,0.357
21100221,1610612765,1610612763,81.0,98.0,0.439,0.574,0,2012-01-20,16,3,13,0.188,14,8,6,0.5710000000000001
21100222,1610612739,1610612741,75.0,114.0,0.303,0.5539999999999999,0,2012-01-20,14,6,8,0.429,17,14,3,0.8240000000000001
21100223,1610612753,1610612747,92.0,80.0,0.416,0.382,1,2012-01-20,15,11,4,0.733,17,10,7,0.588
21100224,1610612759,1610612758,86.0,88.0,0.3779999999999999,0.434,0,2012-01-20,16,10,6,0.625,16,6,10,0.375
21100225,1610612746,1610612750,98.0,101.0,0.465,0.444,0,2012-01-20,13,8,5,0.615,15,7,8,0.467
21100226,1610612744,1610612754,91.0,94.0,0.4629999999999999,0.422,0,2012-01-20,15,5,10,0.3329999999999999,14,10,4,0.7140000000000001
21100213,1610612748,1610612747,98.0,87.0,0.447,0.42,1,2012-01-19,14,10,4,0.7140000000000001,16,10,6,0.625
21100214,1610612745,1610612740,90.0,88.0,0.3979999999999999,0.3939999999999999,1,2012-01-19,15,8,7,0.5329999999999999,15,3,12,0.2
21100215,1610612762,1610612742,91.0,94.0,0.3879999999999999,0.521,0,2012-01-19,14,9,5,0.643,16,9,7,0.563
21100202,1610612755,1610612743,104.0,108.0,0.439,0.483,0,2012-01-18,14,10,4,0.7140000000000001,15,10,5,0.667
21100203,1610612764,1610612760,105.0,102.0,0.384,0.481,1,2012-01-18,14,2,12,0.143,15,12,3,0.8
21100204,1610612753,1610612759,83.0,85.0,0.3329999999999999,0.429,0,2012-01-18,14,10,4,0.7140000000000001,15,10,5,0.667
21100205,1610612738,1610612761,96.0,73.0,0.479,0.377,1,2012-01-18,13,5,8,0.385,15,4,11,0.267
21100206,1610612751,1610612744,107.0,100.0,0.493,0.514,1,2012-01-18,15,4,11,0.267,14,5,9,0.357
21100207,1610612752,1610612756,88.0,91.0,0.3720000000000001,0.456,0,2012-01-18,14,6,8,0.429,14,5,9,0.357
21100208,1610612737,1610612757,92.0,89.0,0.465,0.38,1,2012-01-18,15,11,4,0.733,14,8,6,0.5710000000000001
21100209,1610612740,1610612763,87.0,93.0,0.486,0.493,0,2012-01-18,14,3,11,0.214,13,7,6,0.5379999999999999
21100210,1610612750,1610612765,93.0,85.0,0.4,0.4429999999999999,1,2012-01-18,14,6,8,0.429,15,3,12,0.2
21100211,1610612758,1610612754,92.0,88.0,0.301,0.436,1,2012-01-18,15,5,10,0.3329999999999999,13,9,4,0.6920000000000001
21100212,1610612746,1610612742,91.0,89.0,0.425,0.42,1,2012-01-18,12,8,4,0.667,15,8,7,0.5329999999999999
21100195,1610612753,1610612766,96.0,89.0,0.462,0.4679999999999999,1,2012-01-17,13,10,3,0.769,15,3,12,0.2
21100196,1610612739,1610612744,95.0,105.0,0.4270000000000001,0.436,0,2012-01-17,13,6,7,0.462,13,5,8,0.385
21100197,1610612748,1610612759,120.0,98.0,0.5820000000000001,0.475,1,2012-01-17,13,9,4,0.6920000000000001,14,9,5,0.643
21100198,1610612741,1610612756,118.0,97.0,0.534,0.514,1,2012-01-17,16,13,3,0.813,13,4,9,0.308
21100199,1610612749,1610612743,95.0,105.0,0.418,0.4270000000000001,0,2012-01-17,13,4,9,0.308,14,9,5,0.643
21100200,1610612745,1610612765,97.0,80.0,0.494,0.41,1,2012-01-17,14,7,7,0.5,14,3,11,0.214
21100201,1610612762,1610612746,108.0,79.0,0.476,0.365,1,2012-01-17,13,9,4,0.6920000000000001,11,7,4,0.636
21100184,1610612752,1610612753,93.0,102.0,0.411,0.507,0,2012-01-16,13,6,7,0.462,12,9,3,0.75
21100185,1610612763,1610612741,102.0,86.0,0.54,0.423,1,2012-01-16,12,6,6,0.5,15,12,3,0.8
21100186,1610612755,1610612749,94.0,82.0,0.44,0.467,1,2012-01-16,13,10,3,0.769,12,4,8,0.3329999999999999
21100187,1610612764,1610612745,106.0,114.0,0.488,0.483,0,2012-01-16,13,1,12,0.077,13,6,7,0.462
21100188,1610612766,1610612739,94.0,102.0,0.442,0.488,0,2012-01-16,14,3,11,0.214,12,6,6,0.5
21100190,1610612740,1610612757,77.0,84.0,0.412,0.472,0,2012-01-16,13,3,10,0.231,13,8,5,0.615
21100191,1610612746,1610612751,101.0,91.0,0.4629999999999999,0.423,1,2012-01-16,10,7,3,0.7,14,3,11,0.214
21100189,1610612737,1610612761,93.0,84.0,0.451,0.423,1,2012-01-16,14,10,4,0.7140000000000001,14,4,10,0.286
21100192,1610612738,1610612760,88.0,97.0,0.391,0.45,0,2012-01-16,12,4,8,0.3329999999999999,14,12,2,0.857
21100193,1610612750,1610612758,99.0,86.0,0.4629999999999999,0.4429999999999999,1,2012-01-16,13,5,8,0.385,14,4,10,0.286
21100194,1610612747,1610612742,73.0,70.0,0.382,0.35,1,2012-01-16,15,10,5,0.667,14,8,6,0.5710000000000001
21100181,1610612765,1610612744,91.0,99.0,0.419,0.521,0,2012-01-15,13,3,10,0.231,12,4,8,0.3329999999999999
21100182,1610612743,1610612762,96.0,106.0,0.4270000000000001,0.518,0,2012-01-15,13,8,5,0.615,12,8,4,0.667
21100183,1610612759,1610612756,102.0,91.0,0.494,0.418,1,2012-01-15,13,9,4,0.6920000000000001,12,4,8,0.3329999999999999
21100170,1610612764,1610612755,90.0,103.0,0.4320000000000001,0.43,0,2012-01-14,12,1,11,0.083,12,9,3,0.75
21100171,1610612766,1610612744,112.0,100.0,0.5,0.417,1,2012-01-14,13,3,10,0.231,11,3,8,0.273
21100172,1610612737,1610612750,93.0,91.0,0.41,0.447,1,2012-01-14,13,9,4,0.6920000000000001,12,4,8,0.3329999999999999
21100173,1610612754,1610612738,97.0,83.0,0.3720000000000001,0.386,1,2012-01-14,12,9,3,0.75,11,4,7,0.364
21100174,1610612741,1610612761,77.0,64.0,0.402,0.349,1,2012-01-14,14,12,2,0.857,13,4,9,0.308
21100175,1610612763,1610612740,108.0,99.0,0.449,0.467,1,2012-01-14,11,5,6,0.455,12,3,9,0.25
21100176,1610612745,1610612757,107.0,105.0,0.419,0.411,1,2012-01-14,12,5,7,0.417,12,7,5,0.583
21100177,1610612760,1610612752,104.0,92.0,0.479,0.41,1,2012-01-14,13,11,2,0.846,12,6,6,0.5
21100178,1610612742,1610612758,99.0,60.0,0.457,0.256,1,2012-01-14,13,8,5,0.615,13,4,9,0.308
21100179,1610612762,1610612751,107.0,94.0,0.519,0.4320000000000001,1,2012-01-14,11,7,4,0.636,13,3,10,0.231
21100180,1610612746,1610612747,102.0,94.0,0.412,0.455,1,2012-01-14,9,6,3,0.667,14,9,5,0.643
21100159,1610612761,1610612754,90.0,95.0,0.446,0.455,0,2012-01-13,12,4,8,0.3329999999999999,11,8,3,0.727
21100160,1610612755,1610612764,120.0,89.0,0.5529999999999999,0.444,1,2012-01-13,11,8,3,0.727,11,1,10,0.091
21100161,1610612766,1610612765,81.0,98.0,0.446,0.488,0,2012-01-13,12,2,10,0.1669999999999999,12,3,9,0.25
21100162,1610612738,1610612741,79.0,88.0,0.413,0.447,0,2012-01-13,10,4,6,0.4,13,11,2,0.846
21100163,1610612740,1610612750,80.0,87.0,0.3779999999999999,0.3429999999999999,0,2012-01-13,11,3,8,0.273,11,4,7,0.364
21100164,1610612745,1610612758,103.0,89.0,0.449,0.4379999999999999,1,2012-01-13,11,4,7,0.364,12,4,8,0.3329999999999999
21100165,1610612742,1610612749,102.0,76.0,0.52,0.3720000000000001,1,2012-01-13,12,7,5,0.583,11,4,7,0.364
21100166,1610612759,1610612757,99.0,83.0,0.514,0.405,1,2012-01-13,12,8,4,0.667,11,7,4,0.636
21100167,1610612756,1610612751,103.0,110.0,0.519,0.5,0,2012-01-13,11,4,7,0.364,12,3,9,0.25
21100168,1610612743,1610612748,117.0,104.0,0.551,0.469,1,2012-01-13,12,8,4,0.667,12,8,4,0.667
21100169,1610612747,1610612739,97.0,92.0,0.487,0.376,1,2012-01-13,13,9,4,0.6920000000000001,11,5,6,0.455
21100154,1610612737,1610612766,111.0,81.0,0.467,0.423,1,2012-01-12,12,8,4,0.667,11,2,9,0.182
21100155,1610612749,1610612765,102.0,93.0,0.474,0.446,1,2012-01-12,10,4,6,0.4,11,2,9,0.182
21100156,1610612763,1610612752,94.0,83.0,0.4529999999999999,0.373,1,2012-01-12,10,4,6,0.4,11,6,5,0.545
21100157,1610612756,1610612739,90.0,101.0,0.4529999999999999,0.4379999999999999,0,2012-01-12,10,4,6,0.4,10,5,5,0.5
21100158,1610612744,1610612753,109.0,117.0,0.524,0.515,0,2012-01-12,10,3,7,0.3,11,8,3,0.727
21100143,1610612761,1610612758,91.0,98.0,0.425,0.37,0,2012-01-11,11,4,7,0.364,11,4,7,0.364
21100144,1610612754,1610612737,96.0,84.0,0.4589999999999999,0.375,1,2012-01-11,10,7,3,0.7,11,7,4,0.636
21100145,1610612752,1610612755,85.0,79.0,0.416,0.395,1,2012-01-11,10,6,4,0.6,10,7,3,0.7
21100146,1610612738,1610612742,85.0,90.0,0.4529999999999999,0.4429999999999999,0,2012-01-11,9,4,5,0.444,11,6,5,0.545
21100147,1610612741,1610612764,78.0,64.0,0.3670000000000001,0.31,1,2012-01-11,12,10,2,0.833,10,1,9,0.1
21100148,1610612740,1610612760,85.0,95.0,0.45,0.479,0,2012-01-11,10,3,7,0.3,12,10,2,0.833
21100149,1610612759,1610612745,101.0,95.0,0.457,0.4270000000000001,1,2012-01-11,11,7,4,0.636,10,3,7,0.3
21100150,1610612743,1610612751,123.0,115.0,0.595,0.518,1,2012-01-11,11,7,4,0.636,11,2,9,0.182
21100151,1610612762,1610612747,87.0,90.0,0.387,0.4270000000000001,0,2012-01-11,10,6,4,0.6,12,8,4,0.667
21100152,1610612757,1610612753,104.0,107.0,0.477,0.586,0,2012-01-11,10,7,3,0.7,10,7,3,0.7
21100153,1610612746,1610612748,95.0,89.0,0.419,0.395,1,2012-01-11,8,5,3,0.625,11,8,3,0.727
21100132,1610612755,1610612758,112.0,85.0,0.5660000000000001,0.395,1,2012-01-10,9,7,2,0.778,10,3,7,0.3
21100133,1610612764,1610612761,93.0,78.0,0.488,0.395,1,2012-01-10,9,1,8,0.111,10,4,6,0.4
21100134,1610612766,1610612745,70.0,82.0,0.341,0.386,0,2012-01-10,10,2,8,0.2,9,3,6,0.3329999999999999
21100135,1610612765,1610612742,86.0,100.0,0.435,0.551,0,2012-01-10,10,2,8,0.2,10,5,5,0.5
21100136,1610612749,1610612759,106.0,103.0,0.518,0.6,1,2012-01-10,9,3,6,0.3329999999999999,10,6,4,0.6
21100137,1610612763,1610612760,95.0,100.0,0.4589999999999999,0.4589999999999999,0,2012-01-10,9,3,6,0.3329999999999999,11,9,2,0.818
21100138,1610612750,1610612741,100.0,111.0,0.423,0.531,0,2012-01-10,10,3,7,0.3,11,9,2,0.818
21100139,1610612762,1610612739,113.0,105.0,0.5920000000000001,0.449,1,2012-01-10,9,6,3,0.667,9,4,5,0.444
21100140,1610612757,1610612746,105.0,97.0,0.514,0.446,1,2012-01-10,9,7,2,0.778,7,4,3,0.5710000000000001
21100141,1610612747,1610612756,99.0,83.0,0.488,0.425,1,2012-01-10,11,7,4,0.636,9,4,5,0.444
21100142,1610612744,1610612748,111.0,106.0,0.4,0.4589999999999999,1,2012-01-10,9,3,6,0.3329999999999999,10,8,2,0.8
21100126,1610612761,1610612750,97.0,87.0,0.442,0.3379999999999999,1,2012-01-09,9,4,5,0.444,9,3,6,0.3329999999999999
21100127,1610612755,1610612754,96.0,86.0,0.5,0.366,1,2012-01-09,8,6,2,0.75,9,6,3,0.667
21100128,1610612751,1610612737,101.0,106.0,0.4679999999999999,0.5379999999999999,0,2012-01-09,10,2,8,0.2,10,7,3,0.7
21100129,1610612752,1610612766,91.0,87.0,0.38,0.415,1,2012-01-09,9,5,4,0.556,9,2,7,0.222
21100130,1610612741,1610612765,92.0,68.0,0.4589999999999999,0.3939999999999999,1,2012-01-09,10,8,2,0.8,9,2,7,0.222
21100131,1610612743,1610612740,81.0,94.0,0.408,0.52,0,2012-01-09,10,6,4,0.6,9,3,6,0.3329999999999999
21100120,1610612764,1610612750,72.0,93.0,0.345,0.45,0,2012-01-08,8,0,8,0.0,8,3,5,0.375
21100121,1610612758,1610612753,97.0,104.0,0.521,0.425,0,2012-01-08,9,3,6,0.3329999999999999,9,6,3,0.667
21100122,1610612760,1610612759,108.0,96.0,0.507,0.417,1,2012-01-08,10,8,2,0.8,9,6,3,0.667
21100123,1610612756,1610612749,109.0,93.0,0.5579999999999999,0.43,1,2012-01-08,8,4,4,0.5,8,2,6,0.25
21100124,1610612757,1610612739,98.0,78.0,0.413,0.3670000000000001,1,2012-01-08,8,6,2,0.75,8,4,4,0.5
21100125,1610612747,1610612763,90.0,82.0,0.473,0.409,1,2012-01-08,10,6,4,0.6,8,3,5,0.375
21100110,1610612737,1610612741,109.0,94.0,0.5660000000000001,0.439,1,2012-01-07,9,6,3,0.667,9,7,2,0.778
21100111,1610612754,1610612766,99.0,77.0,0.506,0.326,1,2012-01-07,8,6,2,0.75,8,2,6,0.25
21100112,1610612751,1610612748,90.0,101.0,0.337,0.5,0,2012-01-07,9,2,7,0.222,9,8,1,0.889
21100113,1610612765,1610612752,80.0,103.0,0.3720000000000001,0.47,0,2012-01-07,8,2,6,0.25,8,4,4,0.5
21100114,1610612755,1610612761,97.0,62.0,0.434,0.318,1,2012-01-07,7,5,2,0.7140000000000001,8,3,5,0.375
21100115,1610612745,1610612760,95.0,98.0,0.4370000000000001,0.424,0,2012-01-07,8,2,6,0.25,9,7,2,0.778
21100116,1610612759,1610612743,121.0,117.0,0.551,0.568,1,2012-01-07,8,6,2,0.75,9,6,3,0.667
21100117,1610612742,1610612740,96.0,81.0,0.4320000000000001,0.406,1,2012-01-07,9,4,5,0.444,8,2,6,0.25
21100118,1610612746,1610612749,92.0,86.0,0.449,0.363,1,2012-01-07,6,4,2,0.667,7,2,5,0.286
21100119,1610612744,1610612762,87.0,88.0,0.414,0.395,0,2012-01-07,8,2,6,0.25,8,5,3,0.625
21100098,1610612761,1610612751,85.0,97.0,0.452,0.3879999999999999,0,2012-01-06,7,3,4,0.429,8,2,6,0.25
21100099,1610612755,1610612765,96.0,73.0,0.4589999999999999,0.36,1,2012-01-06,6,4,2,0.667,7,2,5,0.286
21100100,1610612764,1610612752,96.0,99.0,0.482,0.4379999999999999,0,2012-01-06,7,0,7,0.0,7,3,4,0.429
21100101,1610612766,1610612737,96.0,102.0,0.46,0.442,0,2012-01-06,7,2,5,0.286,8,5,3,0.625
21100102,1610612738,1610612754,74.0,87.0,0.3939999999999999,0.4,0,2012-01-06,8,4,4,0.5,7,5,2,0.7140000000000001
21100103,1610612753,1610612741,83.0,97.0,0.4,0.442,0,2012-01-06,8,5,3,0.625,8,7,1,0.875
21100104,1610612740,1610612743,88.0,96.0,0.4679999999999999,0.4679999999999999,0,2012-01-06,7,2,5,0.286,8,6,2,0.75
21100105,1610612760,1610612745,109.0,94.0,0.525,0.462,1,2012-01-06,8,6,2,0.75,7,2,5,0.286
21100106,1610612750,1610612739,87.0,98.0,0.392,0.4629999999999999,0,2012-01-06,7,2,5,0.286,7,4,3,0.5710000000000001
21100107,1610612762,1610612763,94.0,85.0,0.507,0.413,1,2012-01-06,7,4,3,0.5710000000000001,7,3,4,0.429
21100108,1610612756,1610612757,102.0,77.0,0.4679999999999999,0.325,1,2012-01-06,7,3,4,0.429,7,5,2,0.7140000000000001
21100109,1610612747,1610612744,97.0,90.0,0.481,0.494,1,2012-01-06,9,5,4,0.556,7,2,5,0.286
21100094,1610612737,1610612748,109.0,116.0,0.3829999999999999,0.441,0,2012-01-05,7,4,3,0.5710000000000001,8,7,1,0.875
21100095,1610612759,1610612742,93.0,71.0,0.395,0.351,1,2012-01-05,7,5,2,0.7140000000000001,8,3,5,0.375
21100096,1610612758,1610612749,103.0,100.0,0.407,0.513,1,2012-01-05,8,3,5,0.375,6,2,4,0.3329999999999999
21100097,1610612757,1610612747,107.0,96.0,0.461,0.4679999999999999,1,2012-01-05,6,5,1,0.833,8,4,4,0.5
21100082,1610612761,1610612739,92.0,77.0,0.4679999999999999,0.296,1,2012-01-04,6,3,3,0.5,6,3,3,0.5
21100083,1610612753,1610612764,103.0,85.0,0.4589999999999999,0.366,1,2012-01-04,7,5,2,0.7140000000000001,6,0,6,0.0
21100084,1610612738,1610612751,89.0,70.0,0.493,0.405,1,2012-01-04,7,4,3,0.5710000000000001,7,1,6,0.143
21100085,1610612752,1610612766,110.0,118.0,0.494,0.5529999999999999,0,2012-01-04,6,2,4,0.3329999999999999,6,2,4,0.3329999999999999
21100086,1610612748,1610612754,118.0,83.0,0.525,0.348,1,2012-01-04,7,6,1,0.857,6,4,2,0.667
21100087,1610612765,1610612741,83.0,99.0,0.409,0.526,0,2012-01-04,6,2,4,0.3329999999999999,7,6,1,0.857
21100088,1610612740,1610612755,93.0,101.0,0.4429999999999999,0.477,0,2012-01-04,6,2,4,0.3329999999999999,5,3,2,0.6
21100089,1610612750,1610612763,86.0,90.0,0.402,0.413,0,2012-01-04,6,2,4,0.3329999999999999,6,3,3,0.5
21100090,1610612742,1610612756,98.0,89.0,0.418,0.451,1,2012-01-04,7,3,4,0.429,6,2,4,0.3329999999999999
21100091,1610612759,1610612744,101.0,95.0,0.474,0.4629999999999999,1,2012-01-04,6,4,2,0.667,6,2,4,0.3329999999999999
21100092,1610612743,1610612758,110.0,83.0,0.605,0.3229999999999999,1,2012-01-04,7,5,2,0.7140000000000001,7,2,5,0.286
21100093,1610612746,1610612745,117.0,89.0,0.573,0.461,1,2012-01-04,5,3,2,0.6,6,2,4,0.3329999999999999
21100076,1610612739,1610612766,115.0,101.0,0.5,0.444,1,2012-01-03,5,3,2,0.6,5,1,4,0.2
21100077,1610612741,1610612737,76.0,74.0,0.3379999999999999,0.35,1,2012-01-03,6,5,1,0.833,6,4,2,0.667
21100078,1610612763,1610612758,113.0,96.0,0.5489999999999999,0.41,1,2012-01-03,5,2,3,0.4,6,2,4,0.3329999999999999
21100079,1610612760,1610612757,93.0,103.0,0.434,0.447,0,2012-01-03,7,5,2,0.7140000000000001,5,4,1,0.8
21100080,1610612762,1610612749,85.0,73.0,0.485,0.305,1,2012-01-03,6,3,3,0.5,5,2,3,0.4
21100081,1610612747,1610612745,108.0,99.0,0.526,0.4270000000000001,1,2012-01-03,7,4,3,0.5710000000000001,5,2,3,0.4
21100066,1610612756,1610612744,102.0,91.0,0.4479999999999999,0.5,1,2012-01-02,5,2,3,0.4,5,2,3,0.4
21100067,1610612738,1610612764,100.0,92.0,0.4579999999999999,0.422,1,2012-01-02,6,3,3,0.5,5,0,5,0.0
21100068,1610612751,1610612754,94.0,108.0,0.371,0.526,0,2012-01-02,6,1,5,0.1669999999999999,5,4,1,0.8
21100069,1610612752,1610612761,85.0,90.0,0.359,0.441,0,2012-01-02,5,2,3,0.4,5,2,3,0.4
21100070,1610612748,1610612737,92.0,100.0,0.466,0.476,0,2012-01-02,6,5,1,0.833,5,4,1,0.8
21100071,1610612765,1610612753,89.0,78.0,0.5,0.444,1,2012-01-02,5,2,3,0.4,6,4,2,0.667
21100072,1610612750,1610612759,106.0,96.0,0.5770000000000001,0.439,1,2012-01-02,5,2,3,0.4,5,3,2,0.6
21100073,1610612742,1610612760,100.0,87.0,0.488,0.4029999999999999,1,2012-01-02,6,2,4,0.3329999999999999,6,5,1,0.833
21100074,1610612743,1610612749,91.0,86.0,0.3979999999999999,0.42,1,2012-01-02,6,4,2,0.667,4,2,2,0.5
21100075,1610612762,1610612740,94.0,90.0,0.487,0.5,1,2012-01-02,5,2,3,0.4,5,2,3,0.4
21100057,1610612764,1610612738,86.0,94.0,0.41,0.5,0,2012-01-01,4,0,4,0.0,5,2,3,0.4
21100058,1610612753,1610612761,102.0,96.0,0.493,0.457,1,2012-01-01,5,4,1,0.8,4,1,3,0.25
21100059,1610612748,1610612766,129.0,90.0,0.6,0.38,1,2012-01-01,5,5,0,1.0,4,1,3,0.25
21100060,1610612739,1610612751,98.0,82.0,0.487,0.38,1,2012-01-01,4,2,2,0.5,5,1,4,0.2
21100061,1610612750,1610612742,99.0,82.0,0.424,0.377,1,2012-01-01,4,1,3,0.25,5,1,4,0.2
21100062,1610612741,1610612763,104.0,64.0,0.4639999999999999,0.31,1,2012-01-01,5,4,1,0.8,4,1,3,0.25
21100063,1610612743,1610612747,99.0,90.0,0.465,0.3979999999999999,1,2012-01-01,5,3,2,0.6,6,3,3,0.5
21100064,1610612758,1610612740,96.0,80.0,0.412,0.4039999999999999,1,2012-01-01,5,2,3,0.4,4,2,2,0.5
21100065,1610612746,1610612757,93.0,88.0,0.48,0.423,1,2012-01-01,4,2,2,0.5,4,3,1,0.75
21100050,1610612747,1610612743,92.0,89.0,0.4529999999999999,0.425,1,2011-12-31,5,3,2,0.6,4,2,2,0.5
21100051,1610612765,1610612754,96.0,88.0,0.476,0.395,1,2011-12-31,4,1,3,0.25,4,3,1,0.75
21100052,1610612745,1610612737,95.0,84.0,0.4629999999999999,0.4379999999999999,1,2011-12-31,4,2,2,0.5,4,3,1,0.75
21100053,1610612760,1610612756,107.0,97.0,0.532,0.3979999999999999,1,2011-12-31,5,5,0,1.0,4,1,3,0.25
21100054,1610612758,1610612752,92.0,114.0,0.349,0.449,0,2011-12-31,4,1,3,0.25,4,2,2,0.5
21100055,1610612759,1610612762,104.0,89.0,0.486,0.371,1,2011-12-31,4,3,1,0.75,4,1,3,0.25
21100056,1610612744,1610612755,79.0,107.0,0.382,0.494,0,2011-12-31,4,2,2,0.5,4,2,2,0.5
21100039,1610612766,1610612753,79.0,100.0,0.361,0.44,0,2011-12-30,3,1,2,0.3329999999999999,4,3,1,0.75
21100040,1610612754,1610612739,98.0,91.0,0.3829999999999999,0.386,1,2011-12-30,3,3,0,1.0,3,1,2,0.3329999999999999
21100041,1610612738,1610612765,96.0,85.0,0.522,0.43,1,2011-12-30,4,1,3,0.25,3,0,3,0.0
21100042,1610612737,1610612751,105.0,98.0,0.481,0.4629999999999999,1,2011-12-30,3,3,0,1.0,4,1,3,0.25
21100043,1610612763,1610612745,113.0,93.0,0.563,0.43,1,2011-12-30,3,1,2,0.3329999999999999,3,1,2,0.3329999999999999
21100044,1610612740,1610612756,78.0,93.0,0.289,0.423,0,2011-12-30,3,2,1,0.667,3,1,2,0.3329999999999999
21100045,1610612750,1610612748,101.0,103.0,0.47,0.495,0,2011-12-30,3,0,3,0.0,4,4,0,1.0
21100046,1610612749,1610612764,102.0,81.0,0.534,0.353,1,2011-12-30,3,2,1,0.667,3,0,3,0.0
21100047,1610612742,1610612761,99.0,86.0,0.444,0.4579999999999999,1,2011-12-30,4,1,3,0.25,3,1,2,0.3329999999999999
21100048,1610612762,1610612755,102.0,99.0,0.4429999999999999,0.481,1,2011-12-30,3,1,2,0.3329999999999999,3,1,2,0.3329999999999999
21100049,1610612746,1610612741,101.0,114.0,0.513,0.5,0,2011-12-30,3,1,2,0.3329999999999999,4,3,1,0.75
21100033,1610612753,1610612751,94.0,78.0,0.444,0.377,1,2011-12-29,3,2,1,0.667,3,1,2,0.3329999999999999
21100034,1610612745,1610612759,105.0,85.0,0.506,0.376,1,2011-12-29,2,1,1,0.5,3,2,1,0.667
21100035,1610612760,1610612742,104.0,102.0,0.5870000000000001,0.422,1,2011-12-29,4,4,0,1.0,3,0,3,0.0
21100036,1610612758,1610612741,98.0,108.0,0.422,0.5379999999999999,0,2011-12-29,3,1,2,0.3329999999999999,3,2,1,0.667
21100037,1610612757,1610612743,111.0,102.0,0.519,0.402,1,2011-12-29,3,3,0,1.0,3,2,1,0.667
21100038,1610612747,1610612752,99.0,82.0,0.521,0.313,1,2011-12-29,4,2,2,0.5,3,1,2,0.3329999999999999
21100023,1610612761,1610612754,85.0,90.0,0.456,0.395,0,2011-12-28,2,1,1,0.5,2,2,0,1.0
21100024,1610612766,1610612748,95.0,96.0,0.476,0.462,0,2011-12-28,2,1,1,0.5,3,3,0,1.0
21100025,1610612737,1610612764,101.0,83.0,0.4270000000000001,0.39,1,2011-12-28,2,2,0,1.0,2,0,2,0.0
21100026,1610612765,1610612739,89.0,105.0,0.444,0.5710000000000001,0,2011-12-28,2,0,2,0.0,2,1,1,0.5
21100027,1610612763,1610612760,95.0,98.0,0.391,0.377,0,2011-12-28,2,0,2,0.0,3,3,0,1.0
21100028,1610612740,1610612738,97.0,78.0,0.456,0.3720000000000001,1,2011-12-28,2,2,0,1.0,3,0,3,0.0
21100029,1610612759,1610612746,115.0,90.0,0.563,0.392,1,2011-12-28,2,2,0,1.0,2,1,1,0.5
21100030,1610612743,1610612762,117.0,100.0,0.535,0.481,1,2011-12-28,2,2,0,1.0,2,0,2,0.0
21100031,1610612756,1610612755,83.0,103.0,0.413,0.477,0,2011-12-28,2,0,2,0.0,2,1,1,0.5
21100032,1610612744,1610612752,92.0,78.0,0.455,0.4,1,2011-12-28,3,2,1,0.667,2,1,1,0.5
21100018,1610612751,1610612737,70.0,106.0,0.31,0.442,0,2011-12-27,2,1,1,0.5,1,1,0,1.0
21100019,1610612748,1610612738,115.0,107.0,0.56,0.514,1,2011-12-27,2,2,0,1.0,2,0,2,0.0
21100020,1610612749,1610612750,98.0,95.0,0.426,0.4,1,2011-12-27,2,1,1,0.5,2,0,2,0.0
21100021,1610612757,1610612758,101.0,79.0,0.447,0.3779999999999999,1,2011-12-27,2,2,0,1.0,2,1,1,0.5
21100022,1610612747,1610612762,96.0,71.0,0.423,0.322,1,2011-12-27,3,1,2,0.3329999999999999,1,0,1,0.0
21100006,1610612764,1610612751,84.0,90.0,0.419,0.395,0,2011-12-26,1,0,1,0.0,1,1,0,1.0
21100007,1610612766,1610612749,96.0,95.0,0.442,0.405,1,2011-12-26,1,1,0,1.0,1,0,1,0.0
21100008,1610612753,1610612745,104.0,95.0,0.53,0.439,1,2011-12-26,2,1,1,0.5,1,0,1,0.0
21100009,1610612739,1610612761,96.0,104.0,0.412,0.532,0,2011-12-26,1,0,1,0.0,1,1,0,1.0
21100010,1610612754,1610612765,91.0,79.0,0.368,0.36,1,2011-12-26,1,1,0,1.0,1,0,1,0.0
21100011,1610612750,1610612760,100.0,104.0,0.4479999999999999,0.449,0,2011-12-26,1,0,1,0.0,2,2,0,1.0
21100012,1610612742,1610612743,93.0,115.0,0.421,0.494,0,2011-12-26,2,0,2,0.0,1,1,0,1.0
21100013,1610612759,1610612763,95.0,82.0,0.3979999999999999,0.466,1,2011-12-26,1,1,0,1.0,1,0,1,0.0
21100014,1610612756,1610612740,84.0,85.0,0.395,0.4429999999999999,0,2011-12-26,1,0,1,0.0,1,1,0,1.0
21100015,1610612758,1610612747,100.0,91.0,0.467,0.42,1,2011-12-26,1,1,0,1.0,2,0,2,0.0
21100016,1610612757,1610612755,107.0,103.0,0.412,0.482,1,2011-12-26,1,1,0,1.0,1,0,1,0.0
21100017,1610612744,1610612741,99.0,91.0,0.4679999999999999,0.415,1,2011-12-26,2,1,1,0.5,2,1,1,0.5
21100001,1610612752,1610612738,106.0,104.0,0.473,0.513,1,2011-12-25,1,1,0,1.0,1,0,1,0.0
21100002,1610612742,1610612748,94.0,105.0,0.3779999999999999,0.487,0,2011-12-25,1,0,1,0.0,1,1,0,1.0
21100003,1610612747,1610612741,87.0,88.0,0.474,0.4039999999999999,0,2011-12-25,1,0,1,0.0,1,1,0,1.0
21100004,1610612760,1610612753,97.0,89.0,0.472,0.37,1,2011-12-25,1,1,0,1.0,1,0,1,0.0
21100005,1610612744,1610612746,86.0,105.0,0.39,0.457,0,2011-12-25,1,0,1,0.0,1,1,0,1.0
11100030,1610612737,1610612766,92.0,75.0,0.407,0.4,1,2011-12-22,2,1,1,0.5,2,1,1,0.5
11100029,1610612756,1610612743,85.0,110.0,0.3670000000000001,0.429,0,2011-12-22,2,0,2,0.0,2,2,0,1.0
11100021,1610612753,1610612748,104.0,100.0,0.5,0.414,1,2011-12-21,2,1,1,0.5,2,1,1,0.5
11100024,1610612738,1610612761,81.0,73.0,0.391,0.324,1,2011-12-21,2,2,0,1.0,2,0,2,0.0
11100025,1610612752,1610612751,88.0,82.0,0.337,0.402,1,2011-12-21,2,2,0,1.0,2,0,2,0.0
11100022,1610612740,1610612763,95.0,80.0,0.434,0.3779999999999999,1,2011-12-21,2,2,0,1.0,2,0,2,0.0
11100026,1610612749,1610612750,84.0,85.0,0.4379999999999999,0.414,0,2011-12-21,2,0,2,0.0,2,2,0,1.0
11100027,1610612759,1610612745,97.0,95.0,0.515,0.442,1,2011-12-21,2,1,1,0.5,2,1,1,0.5
11100023,1610612762,1610612757,92.0,89.0,0.413,0.354,1,2011-12-21,2,1,1,0.5,2,1,1,0.5
11100028,1610612746,1610612747,108.0,103.0,0.482,0.5479999999999999,1,2011-12-21,2,2,0,1.0,2,0,2,0.0
11100015,1610612755,1610612764,101.0,94.0,0.417,0.35,1,2011-12-20,2,2,0,1.0,2,0,2,0.0
11100016,1610612739,1610612765,89.0,90.0,0.416,0.371,0,2011-12-20,2,1,1,0.5,2,1,1,0.5
11100017,1610612741,1610612754,93.0,85.0,0.506,0.368,1,2011-12-20,2,2,0,1.0,2,0,2,0.0
11100019,1610612760,1610612742,87.0,83.0,0.43,0.418,1,2011-12-20,2,2,0,1.0,2,0,2,0.0
11100018,1610612743,1610612756,127.0,110.0,0.527,0.446,1,2011-12-20,1,1,0,1.0,1,0,1,0.0
11100020,1610612758,1610612744,95.0,91.0,0.451,0.3879999999999999,1,2011-12-20,2,1,1,0.5,2,1,1,0.5
11100012,1610612766,1610612737,79.0,77.0,0.355,0.392,1,2011-12-19,1,1,0,1.0,1,0,1,0.0
11100013,1610612757,1610612762,110.0,90.0,0.5579999999999999,0.416,1,2011-12-19,1,1,0,1.0,1,0,1,0.0
11100014,1610612747,1610612746,95.0,114.0,0.4479999999999999,0.488,0,2011-12-19,1,0,1,0.0,1,1,0,1.0
11100009,1610612761,1610612738,75.0,76.0,0.384,0.3939999999999999,0,2011-12-18,1,0,1,0.0,1,1,0,1.0
11100010,1610612748,1610612753,118.0,85.0,0.5870000000000001,0.354,1,2011-12-18,1,1,0,1.0,1,0,1,0.0
11100011,1610612742,1610612760,92.0,106.0,0.38,0.564,0,2011-12-18,1,0,1,0.0,1,1,0,1.0
11100005,1610612751,1610612752,83.0,92.0,0.478,0.405,0,2011-12-17,1,0,1,0.0,1,1,0,1.0
11100006,1610612745,1610612759,101.0,87.0,0.476,0.354,1,2011-12-17,1,1,0,1.0,1,0,1,0.0
11100007,1610612750,1610612749,117.0,96.0,0.474,0.3929999999999999,1,2011-12-17,1,1,0,1.0,1,0,1,0.0
11100008,1610612744,1610612758,107.0,96.0,0.494,0.4479999999999999,1,2011-12-17,1,1,0,1.0,1,0,1,0.0
11100001,1610612754,1610612741,86.0,95.0,0.337,0.493,0,2011-12-16,1,0,1,0.0,1,1,0,1.0
11100003,1610612764,1610612755,78.0,103.0,0.3289999999999999,0.506,0,2011-12-16,1,0,1,0.0,1,1,0,1.0
11100004,1610612765,1610612739,87.0,91.0,0.377,0.352,0,2011-12-16,1,0,1,0.0,1,1,0,1.0
11100002,1610612763,1610612740,90.0,97.0,0.5,0.451,0,2011-12-16,1,0,1,0.0,1,1,0,1.0
41000406,1610612748,1610612742,95.0,105.0,0.472,0.5,0,2011-06-12,82,58,24,0.7070000000000001,82,57,25,0.695
41000405,1610612742,1610612748,112.0,103.0,0.565,0.529,1,2011-06-09,82,57,25,0.695,82,58,24,0.7070000000000001
41000404,1610612742,1610612748,86.0,83.0,0.397,0.4270000000000001,1,2011-06-07,82,57,25,0.695,82,58,24,0.7070000000000001
41000403,1610612742,1610612748,86.0,88.0,0.4,0.436,0,2011-06-05,82,57,25,0.695,82,58,24,0.7070000000000001
41000402,1610612748,1610612742,93.0,95.0,0.466,0.48,0,2011-06-02,82,58,24,0.7070000000000001,82,57,25,0.695
41000401,1610612748,1610612742,92.0,84.0,0.3879999999999999,0.373,1,2011-05-31,82,58,24,0.7070000000000001,82,57,25,0.695
41000305,1610612741,1610612748,80.0,83.0,0.358,0.3939999999999999,0,2011-05-26,82,62,20,0.7559999999999999,82,58,24,0.7070000000000001
41000315,1610612742,1610612760,100.0,96.0,0.41,0.4270000000000001,1,2011-05-25,82,57,25,0.695,82,55,27,0.6709999999999999
41000304,1610612748,1610612741,101.0,93.0,0.4270000000000001,0.402,1,2011-05-24,82,58,24,0.7070000000000001,82,62,20,0.7559999999999999
41000314,1610612760,1610612742,105.0,112.0,0.467,0.4320000000000001,0,2011-05-23,82,55,27,0.6709999999999999,82,57,25,0.695
41000303,1610612748,1610612741,96.0,85.0,0.507,0.416,1,2011-05-22,82,58,24,0.7070000000000001,82,62,20,0.7559999999999999
41000313,1610612760,1610612742,87.0,93.0,0.365,0.439,0,2011-05-21,82,55,27,0.6709999999999999,82,57,25,0.695
41000312,1610612742,1610612760,100.0,106.0,0.4379999999999999,0.557,0,2011-05-19,82,57,25,0.695,82,55,27,0.6709999999999999
41000302,1610612741,1610612748,75.0,85.0,0.341,0.471,0,2011-05-18,82,62,20,0.7559999999999999,82,58,24,0.7070000000000001
41000311,1610612742,1610612760,121.0,112.0,0.534,0.472,1,2011-05-17,82,57,25,0.695,82,55,27,0.6709999999999999
41000227,1610612760,1610612763,105.0,90.0,0.481,0.3979999999999999,1,2011-05-15,82,55,27,0.6709999999999999,82,46,36,0.561
41000301,1610612741,1610612748,103.0,82.0,0.4370000000000001,0.471,1,2011-05-15,82,62,20,0.7559999999999999,82,58,24,0.7070000000000001
41000226,1610612763,1610612760,95.0,83.0,0.434,0.419,1,2011-05-13,82,46,36,0.561,82,55,27,0.6709999999999999
41000206,1610612737,1610612741,73.0,93.0,0.365,0.532,0,2011-05-12,82,44,38,0.537,82,62,20,0.7559999999999999
41000215,1610612748,1610612738,97.0,87.0,0.4639999999999999,0.493,1,2011-05-11,82,58,24,0.7070000000000001,82,56,26,0.6829999999999999
41000225,1610612760,1610612763,99.0,72.0,0.474,0.359,1,2011-05-11,82,55,27,0.6709999999999999,82,46,36,0.561
41000205,1610612741,1610612737,95.0,83.0,0.486,0.479,1,2011-05-10,82,62,20,0.7559999999999999,82,44,38,0.537
41000214,1610612738,1610612748,90.0,98.0,0.429,0.4429999999999999,0,2011-05-09,82,56,26,0.6829999999999999,82,58,24,0.7070000000000001
41000224,1610612763,1610612760,123.0,133.0,0.36,0.4529999999999999,0,2011-05-09,82,46,36,0.561,82,55,27,0.6709999999999999
41000234,1610612742,1610612747,122.0,86.0,0.603,0.3779999999999999,1,2011-05-08,82,57,25,0.695,82,57,25,0.695
41000204,1610612737,1610612741,100.0,88.0,0.494,0.41,1,2011-05-08,82,44,38,0.537,82,62,20,0.7559999999999999
41000223,1610612763,1610612760,101.0,93.0,0.3779999999999999,0.366,1,2011-05-07,82,46,36,0.561,82,55,27,0.6709999999999999
41000213,1610612738,1610612748,97.0,81.0,0.5,0.425,1,2011-05-07,82,56,26,0.6829999999999999,82,58,24,0.7070000000000001
41000203,1610612737,1610612741,82.0,99.0,0.471,0.4679999999999999,0,2011-05-06,82,44,38,0.537,82,62,20,0.7559999999999999
41000233,1610612742,1610612747,98.0,92.0,0.4629999999999999,0.476,1,2011-05-06,82,57,25,0.695,82,57,25,0.695
41000202,1610612741,1610612737,86.0,73.0,0.3929999999999999,0.3379999999999999,1,2011-05-04,82,62,20,0.7559999999999999,82,44,38,0.537
41000232,1610612747,1610612742,81.0,93.0,0.41,0.42,0,2011-05-04,82,57,25,0.695,82,57,25,0.695
41000212,1610612748,1610612738,102.0,91.0,0.4529999999999999,0.43,1,2011-05-03,82,58,24,0.7070000000000001,82,56,26,0.6829999999999999
41000222,1610612760,1610612763,111.0,102.0,0.528,0.4429999999999999,1,2011-05-03,82,55,27,0.6709999999999999,82,46,36,0.561
41000201,1610612741,1610612737,95.0,103.0,0.446,0.513,0,2011-05-02,82,62,20,0.7559999999999999,82,44,38,0.537
41000231,1610612747,1610612742,94.0,96.0,0.429,0.494,0,2011-05-02,82,57,25,0.695,82,57,25,0.695
41000221,1610612760,1610612763,101.0,114.0,0.449,0.494,0,2011-05-01,82,55,27,0.6709999999999999,82,46,36,0.561
41000211,1610612748,1610612738,99.0,90.0,0.471,0.4270000000000001,1,2011-05-01,82,58,24,0.7070000000000001,82,56,26,0.6829999999999999
41000146,1610612763,1610612759,99.0,91.0,0.521,0.435,1,2011-04-29,82,46,36,0.561,82,61,21,0.7440000000000001
41000136,1610612737,1610612753,84.0,81.0,0.392,0.433,1,2011-04-28,82,44,38,0.537,82,52,30,0.634
41000156,1610612740,1610612747,80.0,98.0,0.429,0.4589999999999999,0,2011-04-28,82,46,36,0.561,82,57,25,0.695
41000166,1610612757,1610612742,96.0,103.0,0.4429999999999999,0.5,0,2011-04-28,82,48,34,0.585,82,57,25,0.695
41000115,1610612748,1610612755,97.0,91.0,0.4,0.47,1,2011-04-27,82,58,24,0.7070000000000001,82,41,41,0.5
41000145,1610612759,1610612763,110.0,103.0,0.4589999999999999,0.471,1,2011-04-27,82,61,21,0.7440000000000001,82,46,36,0.561
41000175,1610612760,1610612743,100.0,97.0,0.366,0.462,1,2011-04-27,82,55,27,0.6709999999999999,82,50,32,0.61
41000135,1610612753,1610612737,101.0,76.0,0.41,0.362,1,2011-04-26,82,52,30,0.634,82,44,38,0.537
41000105,1610612741,1610612754,116.0,89.0,0.482,0.392,1,2011-04-26,82,62,20,0.7559999999999999,82,37,45,0.451
41000155,1610612747,1610612740,106.0,90.0,0.493,0.493,1,2011-04-26,82,57,25,0.695,82,46,36,0.561
41000144,1610612763,1610612759,104.0,86.0,0.506,0.467,1,2011-04-25,82,46,36,0.561,82,61,21,0.7440000000000001
41000165,1610612742,1610612757,93.0,82.0,0.41,0.4320000000000001,1,2011-04-25,82,57,25,0.695,82,48,34,0.585
41000174,1610612743,1610612760,104.0,101.0,0.386,0.4429999999999999,1,2011-04-25,82,50,32,0.61,82,55,27,0.6709999999999999
41000114,1610612755,1610612748,86.0,82.0,0.405,0.385,1,2011-04-24,82,41,41,0.5,82,58,24,0.7070000000000001
41000124,1610612752,1610612738,89.0,101.0,0.341,0.494,0,2011-04-24,82,42,40,0.512,82,56,26,0.6829999999999999
41000134,1610612737,1610612753,88.0,85.0,0.467,0.392,1,2011-04-24,82,44,38,0.537,82,52,30,0.634
41000154,1610612740,1610612747,93.0,88.0,0.446,0.431,1,2011-04-24,82,46,36,0.561,82,57,25,0.695
41000104,1610612754,1610612741,89.0,84.0,0.392,0.3779999999999999,1,2011-04-23,82,37,45,0.451,82,62,20,0.7559999999999999
41000164,1610612757,1610612742,84.0,82.0,0.42,0.408,1,2011-04-23,82,48,34,0.585,82,57,25,0.695
41000143,1610612763,1610612759,91.0,88.0,0.423,0.413,1,2011-04-23,82,46,36,0.561,82,61,21,0.7440000000000001
41000173,1610612743,1610612760,94.0,97.0,0.3720000000000001,0.363,0,2011-04-23,82,50,32,0.61,82,55,27,0.6709999999999999
41000123,1610612752,1610612738,96.0,113.0,0.434,0.506,0,2011-04-22,82,42,40,0.512,82,56,26,0.6829999999999999
41000133,1610612737,1610612753,88.0,84.0,0.42,0.425,1,2011-04-22,82,44,38,0.537,82,52,30,0.634
41000153,1610612740,1610612747,86.0,100.0,0.4579999999999999,0.487,0,2011-04-22,82,46,36,0.561,82,57,25,0.695
41000103,1610612754,1610612741,84.0,88.0,0.379,0.389,0,2011-04-21,82,37,45,0.451,82,62,20,0.7559999999999999
41000113,1610612755,1610612748,94.0,100.0,0.439,0.456,0,2011-04-21,82,41,41,0.5,82,58,24,0.7070000000000001
41000163,1610612757,1610612742,97.0,92.0,0.48,0.515,1,2011-04-21,82,48,34,0.585,82,57,25,0.695
41000172,1610612760,1610612743,106.0,89.0,0.439,0.391,1,2011-04-20,82,55,27,0.6709999999999999,82,50,32,0.61
41000142,1610612759,1610612763,93.0,87.0,0.4379999999999999,0.3979999999999999,1,2011-04-20,82,61,21,0.7440000000000001,82,46,36,0.561
41000152,1610612747,1610612740,87.0,78.0,0.447,0.391,1,2011-04-20,82,57,25,0.695,82,46,36,0.561
41000122,1610612738,1610612752,96.0,93.0,0.47,0.356,1,2011-04-19,82,56,26,0.6829999999999999,82,42,40,0.512
41000132,1610612753,1610612737,88.0,82.0,0.346,0.395,1,2011-04-19,82,52,30,0.634,82,44,38,0.537
41000162,1610612742,1610612757,101.0,89.0,0.487,0.485,1,2011-04-19,82,57,25,0.695,82,48,34,0.585
41000112,1610612748,1610612755,94.0,73.0,0.472,0.342,1,2011-04-18,82,58,24,0.7070000000000001,82,41,41,0.5
41000102,1610612741,1610612754,96.0,90.0,0.386,0.416,1,2011-04-18,82,62,20,0.7559999999999999,82,37,45,0.451
41000141,1610612759,1610612763,98.0,101.0,0.4,0.552,0,2011-04-17,82,61,21,0.7440000000000001,82,46,36,0.561
41000151,1610612747,1610612740,100.0,109.0,0.4589999999999999,0.519,0,2011-04-17,82,57,25,0.695,82,46,36,0.561
41000121,1610612738,1610612752,87.0,85.0,0.4379999999999999,0.423,1,2011-04-17,82,56,26,0.6829999999999999,82,42,40,0.512
41000171,1610612760,1610612743,107.0,103.0,0.494,0.506,1,2011-04-17,82,55,27,0.6709999999999999,82,50,32,0.61
41000101,1610612741,1610612754,104.0,99.0,0.439,0.4639999999999999,1,2011-04-16,82,62,20,0.7559999999999999,82,37,45,0.451
41000111,1610612748,1610612755,97.0,89.0,0.419,0.412,1,2011-04-16,82,58,24,0.7070000000000001,82,41,41,0.5
41000131,1610612753,1610612737,93.0,103.0,0.4529999999999999,0.514,0,2011-04-16,82,52,30,0.634,82,44,38,0.537
41000161,1610612742,1610612757,89.0,81.0,0.409,0.461,1,2011-04-16,82,57,25,0.695,82,48,34,0.585
21001216,1610612738,1610612752,112.0,102.0,0.565,0.4589999999999999,1,2011-04-13,82,56,26,0.6829999999999999,82,42,40,0.512
21001217,1610612766,1610612737,96.0,85.0,0.5,0.43,1,2011-04-13,82,34,48,0.415,82,44,38,0.537
21001218,1610612739,1610612764,100.0,93.0,0.422,0.433,1,2011-04-13,82,19,63,0.2319999999999999,82,23,59,0.28
21001219,1610612753,1610612754,92.0,74.0,0.4379999999999999,0.307,1,2011-04-13,82,52,30,0.634,82,37,45,0.451
21001220,1610612755,1610612765,100.0,104.0,0.429,0.487,0,2011-04-13,82,41,41,0.5,82,30,52,0.366
21001221,1610612761,1610612748,79.0,97.0,0.4379999999999999,0.457,0,2011-04-13,82,22,60,0.268,82,58,24,0.7070000000000001
21001222,1610612741,1610612751,97.0,92.0,0.43,0.45,1,2011-04-13,82,62,20,0.7559999999999999,82,24,58,0.293
21001223,1610612742,1610612740,121.0,89.0,0.5479999999999999,0.43,1,2011-04-13,82,57,25,0.695,82,46,36,0.561
21001224,1610612750,1610612745,102.0,121.0,0.446,0.5,0,2011-04-13,82,17,65,0.207,82,43,39,0.524
21001225,1610612760,1610612749,106.0,110.0,0.477,0.455,0,2011-04-13,82,55,27,0.6709999999999999,82,35,47,0.4270000000000001
21001226,1610612762,1610612743,107.0,103.0,0.506,0.506,1,2011-04-13,82,39,43,0.476,82,50,32,0.61
21001227,1610612744,1610612757,110.0,86.0,0.511,0.337,1,2011-04-13,82,36,46,0.439,82,48,34,0.585
21001228,1610612746,1610612763,110.0,103.0,0.5429999999999999,0.429,1,2011-04-13,82,32,50,0.39,82,46,36,0.561
21001229,1610612756,1610612759,106.0,103.0,0.402,0.4270000000000001,1,2011-04-13,82,40,42,0.488,82,61,21,0.7440000000000001
21001230,1610612758,1610612747,108.0,116.0,0.455,0.495,0,2011-04-13,82,24,58,0.293,82,57,25,0.695
21001213,1610612752,1610612741,90.0,103.0,0.41,0.434,0,2011-04-12,81,42,39,0.519,81,61,20,0.753
21001214,1610612757,1610612763,102.0,89.0,0.45,0.456,1,2011-04-12,81,48,33,0.593,81,46,35,0.568
21001215,1610612747,1610612759,102.0,93.0,0.456,0.352,1,2011-04-12,81,56,25,0.691,81,61,20,0.753
21001202,1610612737,1610612748,90.0,98.0,0.446,0.522,0,2011-04-11,81,44,37,0.5429999999999999,81,57,24,0.7040000000000001
21001203,1610612751,1610612766,103.0,105.0,0.544,0.57,0,2011-04-11,81,24,57,0.296,81,33,48,0.407
21001204,1610612755,1610612753,85.0,95.0,0.4270000000000001,0.4379999999999999,0,2011-04-11,81,41,40,0.506,81,51,30,0.63
21001205,1610612764,1610612738,95.0,94.0,0.4,0.381,1,2011-04-11,81,23,58,0.284,81,55,26,0.679
21001206,1610612765,1610612739,101.0,110.0,0.514,0.4639999999999999,0,2011-04-11,81,29,52,0.358,81,18,63,0.222
21001207,1610612749,1610612761,93.0,86.0,0.421,0.37,1,2011-04-11,81,34,47,0.42,81,22,59,0.272
21001208,1610612740,1610612762,78.0,90.0,0.3779999999999999,0.552,0,2011-04-11,81,46,35,0.568,81,38,43,0.469
21001209,1610612745,1610612742,91.0,98.0,0.365,0.4579999999999999,0,2011-04-11,81,42,39,0.519,81,56,25,0.691
21001210,1610612743,1610612744,134.0,111.0,0.532,0.444,1,2011-04-11,81,50,31,0.617,81,35,46,0.4320000000000001
21001211,1610612756,1610612750,135.0,127.0,0.5429999999999999,0.547,1,2011-04-11,81,39,42,0.481,81,17,64,0.21
21001212,1610612758,1610612760,112.0,120.0,0.412,0.573,0,2011-04-11,81,24,57,0.296,81,55,26,0.679
21001193,1610612753,1610612741,99.0,102.0,0.4320000000000001,0.6,0,2011-04-10,80,50,30,0.625,80,60,20,0.75
21001194,1610612748,1610612738,100.0,77.0,0.507,0.4529999999999999,1,2011-04-10,80,56,24,0.7,80,55,25,0.688
21001195,1610612766,1610612765,101.0,112.0,0.5379999999999999,0.556,0,2011-04-10,80,32,48,0.4,80,29,51,0.363
21001196,1610612761,1610612751,99.0,92.0,0.513,0.386,1,2011-04-10,80,22,58,0.275,80,24,56,0.3
21001197,1610612763,1610612740,111.0,89.0,0.603,0.413,1,2011-04-10,80,46,34,0.575,80,46,34,0.575
21001198,1610612754,1610612752,109.0,110.0,0.4429999999999999,0.3879999999999999,0,2011-04-10,81,37,44,0.457,80,42,38,0.525
21001199,1610612742,1610612756,115.0,90.0,0.506,0.4270000000000001,1,2011-04-10,80,55,25,0.688,80,38,42,0.475
21001200,1610612744,1610612758,103.0,104.0,0.416,0.451,0,2011-04-10,80,35,45,0.4379999999999999,80,24,56,0.3
21001201,1610612747,1610612760,106.0,120.0,0.469,0.556,0,2011-04-10,80,55,25,0.688,80,54,26,0.675
21001188,1610612764,1610612737,115.0,83.0,0.535,0.434,1,2011-04-09,80,22,58,0.275,80,44,36,0.55
21001189,1610612745,1610612746,99.0,78.0,0.469,0.347,1,2011-04-09,80,42,38,0.525,81,31,50,0.3829999999999999
21001190,1610612749,1610612739,108.0,101.0,0.506,0.481,1,2011-04-09,80,33,47,0.413,80,17,63,0.213
21001191,1610612759,1610612762,111.0,102.0,0.5770000000000001,0.5379999999999999,1,2011-04-09,80,61,19,0.763,80,37,43,0.4629999999999999
21001192,1610612743,1610612750,130.0,106.0,0.523,0.4589999999999999,1,2011-04-09,80,49,31,0.613,80,17,63,0.213
21001176,1610612754,1610612737,114.0,102.0,0.488,0.474,1,2011-04-08,80,37,43,0.4629999999999999,79,44,35,0.557
21001177,1610612751,1610612752,93.0,116.0,0.476,0.494,0,2011-04-08,79,24,55,0.304,79,41,38,0.519
21001178,1610612755,1610612761,98.0,93.0,0.48,0.466,1,2011-04-08,80,41,39,0.513,79,21,58,0.266
21001179,1610612738,1610612764,104.0,88.0,0.507,0.455,1,2011-04-08,79,55,24,0.696,79,21,58,0.266
21001180,1610612739,1610612741,82.0,93.0,0.439,0.488,0,2011-04-08,79,17,62,0.215,79,59,20,0.747
21001181,1610612765,1610612749,110.0,100.0,0.5,0.461,1,2011-04-08,79,28,51,0.354,79,32,47,0.405
21001182,1610612748,1610612766,112.0,103.0,0.565,0.477,1,2011-04-08,79,55,24,0.696,79,32,47,0.405
21001183,1610612763,1610612758,101.0,96.0,0.452,0.421,1,2011-04-08,79,45,34,0.57,79,23,56,0.291
21001184,1610612740,1610612756,109.0,97.0,0.556,0.5,1,2011-04-08,79,46,33,0.5820000000000001,79,38,41,0.481
21001185,1610612760,1610612743,104.0,89.0,0.4629999999999999,0.4029999999999999,1,2011-04-08,79,53,26,0.6709999999999999,79,48,31,0.608
21001186,1610612742,1610612746,107.0,96.0,0.506,0.5,1,2011-04-08,79,54,25,0.684,80,31,49,0.3879999999999999
21001187,1610612757,1610612747,93.0,86.0,0.455,0.395,1,2011-04-08,80,47,33,0.588,79,55,24,0.696
21001174,1610612741,1610612738,97.0,81.0,0.474,0.384,1,2011-04-07,78,58,20,0.7440000000000001,78,54,24,0.6920000000000001
21001175,1610612762,1610612757,87.0,98.0,0.419,0.456,0,2011-04-07,79,37,42,0.4679999999999999,79,46,33,0.5820000000000001
21001162,1610612766,1610612753,102.0,111.0,0.4639999999999999,0.539,0,2011-04-06,78,32,46,0.41,79,50,29,0.633
21001163,1610612754,1610612764,136.0,112.0,0.595,0.46,1,2011-04-06,79,36,43,0.456,78,21,57,0.2689999999999999
21001165,1610612755,1610612752,92.0,97.0,0.413,0.414,0,2011-04-06,79,40,39,0.506,78,40,38,0.513
21001166,1610612761,1610612739,96.0,104.0,0.4379999999999999,0.456,0,2011-04-06,78,21,57,0.2689999999999999,78,17,61,0.218
21001167,1610612765,1610612751,116.0,109.0,0.551,0.488,1,2011-04-06,78,27,51,0.346,78,24,54,0.308
21001164,1610612748,1610612749,85.0,90.0,0.405,0.447,0,2011-04-06,78,54,24,0.6920000000000001,78,32,46,0.41
21001168,1610612750,1610612756,98.0,108.0,0.4370000000000001,0.524,0,2011-04-06,79,17,62,0.215,78,38,40,0.487
21001169,1610612740,1610612745,101.0,93.0,0.457,0.462,1,2011-04-06,78,45,33,0.5770000000000001,79,41,38,0.519
21001170,1610612760,1610612746,112.0,108.0,0.4320000000000001,0.506,1,2011-04-06,78,52,26,0.667,79,31,48,0.392
21001171,1610612759,1610612758,124.0,92.0,0.605,0.3979999999999999,1,2011-04-06,79,60,19,0.759,78,23,55,0.295
21001172,1610612742,1610612743,96.0,104.0,0.488,0.477,0,2011-04-06,78,53,25,0.679,78,48,30,0.615
21001173,1610612744,1610612747,95.0,87.0,0.387,0.429,1,2011-04-06,79,35,44,0.4429999999999999,78,55,23,0.705
21001149,1610612737,1610612759,90.0,97.0,0.486,0.5,0,2011-04-05,78,44,34,0.564,78,59,19,0.7559999999999999
21001150,1610612739,1610612766,99.0,89.0,0.451,0.39,1,2011-04-05,77,16,61,0.208,77,32,45,0.416
21001151,1610612751,1610612750,107.0,105.0,0.472,0.494,1,2011-04-05,77,24,53,0.312,78,17,61,0.218
21001152,1610612753,1610612749,78.0,72.0,0.3879999999999999,0.36,1,2011-04-05,78,49,29,0.628,77,31,46,0.4029999999999999
21001153,1610612764,1610612765,107.0,105.0,0.494,0.439,1,2011-04-05,77,21,56,0.273,77,26,51,0.3379999999999999
21001154,1610612738,1610612755,99.0,82.0,0.526,0.3929999999999999,1,2011-04-05,77,54,23,0.701,78,40,38,0.513
21001155,1610612752,1610612761,131.0,118.0,0.5770000000000001,0.489,1,2011-04-05,77,39,38,0.506,77,21,56,0.273
21001156,1610612741,1610612756,97.0,94.0,0.462,0.4320000000000001,1,2011-04-05,77,57,20,0.74,77,37,40,0.481
21001157,1610612763,1610612746,81.0,82.0,0.395,0.41,0,2011-04-05,78,44,34,0.564,78,31,47,0.397
21001158,1610612745,1610612758,101.0,104.0,0.426,0.53,0,2011-04-05,78,41,37,0.526,77,23,54,0.299
21001159,1610612743,1610612760,94.0,101.0,0.439,0.4429999999999999,0,2011-04-05,77,47,30,0.61,77,51,26,0.662
21001160,1610612757,1610612744,87.0,108.0,0.41,0.5,0,2011-04-05,78,45,33,0.5770000000000001,78,34,44,0.436
21001161,1610612747,1610612762,85.0,86.0,0.3779999999999999,0.4,0,2011-04-05,77,55,22,0.7140000000000001,78,37,41,0.474
21001138,1610612759,1610612756,114.0,97.0,0.483,0.471,1,2011-04-03,77,58,19,0.753,76,37,39,0.487
21001139,1610612747,1610612743,90.0,95.0,0.429,0.439,0,2011-04-03,76,55,21,0.7240000000000001,76,47,29,0.618
21001140,1610612738,1610612765,101.0,90.0,0.6409999999999999,0.425,1,2011-04-03,76,53,23,0.6970000000000001,76,26,50,0.342
21001141,1610612766,1610612764,91.0,97.0,0.43,0.4429999999999999,0,2011-04-03,76,32,44,0.421,76,20,56,0.263
21001142,1610612751,1610612748,94.0,108.0,0.4,0.56,0,2011-04-03,76,23,53,0.303,77,54,23,0.701
21001143,1610612752,1610612739,123.0,107.0,0.482,0.532,1,2011-04-03,76,38,38,0.5,76,15,61,0.1969999999999999
21001144,1610612761,1610612753,102.0,98.0,0.506,0.493,1,2011-04-03,76,21,55,0.276,77,48,29,0.623
21001145,1610612758,1610612762,106.0,97.0,0.519,0.469,1,2011-04-03,76,22,54,0.289,77,36,41,0.4679999999999999
21001146,1610612745,1610612737,114.0,109.0,0.573,0.531,1,2011-04-03,77,41,36,0.532,77,44,33,0.5710000000000001
21001147,1610612740,1610612754,108.0,96.0,0.512,0.457,1,2011-04-03,77,44,33,0.5710000000000001,78,35,43,0.449
21001148,1610612757,1610612742,104.0,96.0,0.534,0.486,1,2011-04-03,77,45,32,0.584,77,53,24,0.688
21001133,1610612741,1610612761,113.0,106.0,0.482,0.506,1,2011-04-02,76,56,20,0.737,75,20,55,0.267
21001134,1610612763,1610612750,106.0,89.0,0.511,0.486,1,2011-04-02,77,44,33,0.5710000000000001,77,17,60,0.221
21001135,1610612749,1610612755,93.0,87.0,0.486,0.402,1,2011-04-02,76,31,45,0.408,77,40,37,0.519
21001136,1610612744,1610612742,99.0,92.0,0.449,0.411,1,2011-04-02,77,33,44,0.429,76,53,23,0.6970000000000001
21001137,1610612746,1610612760,98.0,92.0,0.446,0.415,1,2011-04-02,77,30,47,0.39,76,50,26,0.6579999999999999
21001120,1610612754,1610612749,89.0,88.0,0.462,0.425,1,2011-04-01,77,35,42,0.455,75,30,45,0.4
21001121,1610612753,1610612766,89.0,77.0,0.423,0.452,1,2011-04-01,76,48,28,0.632,75,32,43,0.4270000000000001
21001122,1610612755,1610612751,115.0,90.0,0.563,0.435,1,2011-04-01,76,40,36,0.526,75,23,52,0.307
21001123,1610612764,1610612739,115.0,107.0,0.489,0.4629999999999999,1,2011-04-01,75,19,56,0.253,75,15,60,0.2
21001124,1610612765,1610612741,96.0,101.0,0.52,0.514,0,2011-04-01,75,26,49,0.347,75,55,20,0.733
21001125,1610612737,1610612738,88.0,83.0,0.3670000000000001,0.446,1,2011-04-01,76,44,32,0.579,75,52,23,0.693
21001126,1610612750,1610612748,92.0,111.0,0.42,0.545,0,2011-04-01,76,17,59,0.2239999999999999,76,53,23,0.6970000000000001
21001127,1610612740,1610612763,81.0,93.0,0.449,0.507,0,2011-04-01,76,43,33,0.5660000000000001,76,43,33,0.5660000000000001
21001128,1610612745,1610612759,119.0,114.0,0.447,0.511,1,2011-04-01,76,40,36,0.526,76,57,19,0.75
21001129,1610612756,1610612746,111.0,98.0,0.519,0.444,1,2011-04-01,75,37,38,0.493,76,29,47,0.382
21001130,1610612757,1610612760,98.0,91.0,0.43,0.41,1,2011-04-01,76,44,32,0.579,75,50,25,0.667
21001131,1610612758,1610612743,90.0,99.0,0.3979999999999999,0.488,0,2011-04-01,75,21,54,0.28,75,46,29,0.613
21001132,1610612762,1610612747,85.0,96.0,0.415,0.479,0,2011-04-01,76,36,40,0.474,75,55,20,0.733
21001118,1610612759,1610612738,97.0,107.0,0.433,0.5479999999999999,0,2011-03-31,75,57,18,0.76,74,52,22,0.703
21001119,1610612747,1610612742,110.0,82.0,0.447,0.361,1,2011-03-31,74,54,20,0.73,75,53,22,0.7070000000000001
21001105,1610612737,1610612753,85.0,82.0,0.471,0.416,1,2011-03-30,75,43,32,0.573,75,47,28,0.627
21001106,1610612766,1610612739,98.0,97.0,0.56,0.522,1,2011-03-30,74,32,42,0.4320000000000001,74,15,59,0.203
21001107,1610612754,1610612765,111.0,101.0,0.477,0.506,1,2011-03-30,76,34,42,0.447,74,26,48,0.351
21001108,1610612755,1610612745,108.0,97.0,0.541,0.41,1,2011-03-30,75,39,36,0.52,75,39,36,0.52
21001109,1610612761,1610612749,98.0,104.0,0.513,0.494,0,2011-03-30,74,20,54,0.27,74,30,44,0.405
21001110,1610612764,1610612748,107.0,123.0,0.494,0.5770000000000001,0,2011-03-30,74,18,56,0.243,75,52,23,0.693
21001111,1610612752,1610612751,120.0,116.0,0.5,0.477,1,2011-03-30,75,37,38,0.493,74,23,51,0.311
21001112,1610612763,1610612744,110.0,91.0,0.565,0.47,1,2011-03-30,75,42,33,0.56,76,32,44,0.421
21001113,1610612750,1610612741,91.0,108.0,0.412,0.506,0,2011-03-30,75,17,58,0.2269999999999999,74,54,20,0.73
21001114,1610612740,1610612757,95.0,91.0,0.466,0.5,1,2011-03-30,75,43,32,0.573,75,43,32,0.573
21001115,1610612743,1610612758,104.0,90.0,0.469,0.456,1,2011-03-30,74,45,29,0.608,74,21,53,0.284
21001116,1610612756,1610612760,98.0,116.0,0.45,0.5379999999999999,0,2011-03-30,74,36,38,0.486,74,50,24,0.6759999999999999
21001117,1610612746,1610612742,100.0,106.0,0.467,0.482,0,2011-03-30,75,29,46,0.387,74,53,21,0.716
21001101,1610612739,1610612748,102.0,90.0,0.556,0.423,1,2011-03-29,73,15,58,0.205,74,51,23,0.6890000000000001
21001102,1610612751,1610612745,87.0,112.0,0.416,0.465,0,2011-03-29,73,23,50,0.315,74,39,35,0.527
21001103,1610612760,1610612744,115.0,114.0,0.455,0.423,1,2011-03-29,73,49,24,0.6709999999999999,75,32,43,0.4270000000000001
21001104,1610612758,1610612756,116.0,113.0,0.5329999999999999,0.5,1,2011-03-29,73,21,52,0.288,73,36,37,0.493
21001096,1610612766,1610612749,87.0,86.0,0.485,0.389,1,2011-03-28,73,31,42,0.425,73,29,44,0.397
21001097,1610612754,1610612738,107.0,100.0,0.545,0.5479999999999999,1,2011-03-28,75,33,42,0.44,73,51,22,0.6990000000000001
21000051,1610612752,1610612753,113.0,106.0,0.4320000000000001,0.45,1,2011-03-28,74,36,38,0.486,74,47,27,0.635
21001098,1610612741,1610612755,85.0,97.0,0.413,0.4529999999999999,0,2011-03-28,73,53,20,0.726,74,38,36,0.514
21001099,1610612759,1610612757,92.0,100.0,0.481,0.523,0,2011-03-28,74,57,17,0.77,74,43,31,0.581
21001100,1610612762,1610612764,95.0,100.0,0.419,0.391,0,2011-03-28,75,36,39,0.48,73,18,55,0.247
21001087,1610612755,1610612758,111.0,114.0,0.44,0.447,0,2011-03-27,73,37,36,0.507,72,20,52,0.278
21001088,1610612739,1610612737,83.0,99.0,0.368,0.5,0,2011-03-27,72,14,58,0.1939999999999999,74,42,32,0.568
21001089,1610612748,1610612745,125.0,119.0,0.5,0.483,1,2011-03-27,73,51,22,0.6990000000000001,73,38,35,0.521
21001090,1610612763,1610612759,111.0,104.0,0.545,0.506,1,2011-03-27,74,41,33,0.5539999999999999,73,57,16,0.7809999999999999
21001091,1610612750,1610612738,82.0,85.0,0.375,0.4,0,2011-03-27,74,17,57,0.23,72,51,21,0.708
21001092,1610612760,1610612757,99.0,90.0,0.4270000000000001,0.4320000000000001,1,2011-03-27,72,48,24,0.667,73,42,31,0.575
21001093,1610612744,1610612764,114.0,104.0,0.474,0.416,1,2011-03-27,74,32,42,0.4320000000000001,72,17,55,0.236
21001094,1610612747,1610612740,102.0,84.0,0.482,0.402,1,2011-03-27,73,53,20,0.726,74,42,32,0.568
21001095,1610612756,1610612742,83.0,91.0,0.425,0.381,0,2011-03-27,72,36,36,0.5,73,52,21,0.7120000000000001
21001081,1610612737,1610612751,98.0,87.0,0.5,0.481,1,2011-03-26,73,41,32,0.562,72,23,49,0.319
21001082,1610612766,1610612752,114.0,106.0,0.473,0.3979999999999999,1,2011-03-26,72,30,42,0.417,73,35,38,0.479
21001083,1610612765,1610612754,100.0,88.0,0.513,0.474,1,2011-03-26,73,26,47,0.356,74,32,42,0.4320000000000001
21001084,1610612749,1610612741,87.0,95.0,0.392,0.5,0,2011-03-26,72,29,43,0.4029999999999999,72,53,19,0.736
21001085,1610612762,1610612742,77.0,94.0,0.421,0.455,0,2011-03-26,74,36,38,0.486,72,51,21,0.708
21001086,1610612746,1610612761,94.0,90.0,0.4639999999999999,0.3879999999999999,1,2011-03-26,74,29,45,0.392,73,20,53,0.2739999999999999
21001068,1610612754,1610612758,93.0,110.0,0.352,0.48,0,2011-03-25,73,32,41,0.4379999999999999,71,19,52,0.268
21001069,1610612753,1610612751,95.0,85.0,0.507,0.462,1,2011-03-25,73,47,26,0.644,71,23,48,0.324
21001070,1610612738,1610612766,81.0,83.0,0.408,0.435,0,2011-03-25,71,50,21,0.7040000000000001,71,29,42,0.408
21001071,1610612739,1610612765,97.0,91.0,0.4629999999999999,0.425,1,2011-03-25,71,14,57,0.1969999999999999,72,25,47,0.347
21001072,1610612748,1610612755,111.0,99.0,0.494,0.465,1,2011-03-25,72,50,22,0.6940000000000001,72,37,35,0.514
21001073,1610612752,1610612749,96.0,102.0,0.4,0.506,0,2011-03-25,72,35,37,0.486,71,29,42,0.408
21001074,1610612741,1610612763,99.0,96.0,0.415,0.493,1,2011-03-25,71,52,19,0.732,73,40,33,0.5479999999999999
21001075,1610612760,1610612750,111.0,103.0,0.524,0.476,1,2011-03-25,71,47,24,0.662,73,17,56,0.233
21001076,1610612743,1610612764,114.0,94.0,0.494,0.42,1,2011-03-25,73,44,29,0.603,71,17,54,0.239
21001077,1610612756,1610612740,100.0,106.0,0.493,0.5,0,2011-03-25,71,36,35,0.507,73,42,31,0.575
21001078,1610612757,1610612759,98.0,96.0,0.465,0.513,1,2011-03-25,72,42,30,0.583,72,57,15,0.792
21001079,1610612744,1610612761,138.0,100.0,0.614,0.469,1,2011-03-25,73,31,42,0.425,72,20,52,0.278
21001080,1610612747,1610612746,112.0,104.0,0.5,0.5,1,2011-03-25,72,52,20,0.722,73,28,45,0.384
21001066,1610612742,1610612750,104.0,96.0,0.494,0.488,1,2011-03-24,71,50,21,0.7040000000000001,72,17,55,0.236
21001067,1610612762,1610612740,117.0,121.0,0.512,0.5,0,2011-03-24,73,36,37,0.493,72,41,31,0.569
21001054,1610612766,1610612754,88.0,111.0,0.444,0.542,0,2011-03-23,70,28,42,0.4,72,32,40,0.444
21001055,1610612739,1610612751,94.0,98.0,0.374,0.34,0,2011-03-23,70,13,57,0.186,70,23,47,0.3289999999999999
21001056,1610612755,1610612737,105.0,100.0,0.488,0.481,1,2011-03-23,71,37,34,0.521,72,40,32,0.556
21001057,1610612738,1610612763,87.0,90.0,0.42,0.446,0,2011-03-23,70,50,20,0.7140000000000001,72,40,32,0.556
21001058,1610612765,1610612748,94.0,100.0,0.493,0.484,0,2011-03-23,71,25,46,0.352,71,49,22,0.69
21001059,1610612752,1610612753,99.0,111.0,0.405,0.487,0,2011-03-23,71,35,36,0.493,72,46,26,0.639
21001060,1610612749,1610612758,90.0,97.0,0.457,0.446,0,2011-03-23,70,28,42,0.4,70,18,52,0.257
21001061,1610612760,1610612762,106.0,94.0,0.545,0.449,1,2011-03-23,70,46,24,0.657,72,36,36,0.5
21001062,1610612745,1610612744,131.0,112.0,0.505,0.511,1,2011-03-23,72,38,34,0.528,72,30,42,0.417
21001063,1610612756,1610612761,114.0,106.0,0.467,0.485,1,2011-03-23,70,36,34,0.514,71,20,51,0.282
21001064,1610612743,1610612759,115.0,112.0,0.506,0.4320000000000001,1,2011-03-23,72,43,29,0.597,71,57,14,0.8029999999999999
21001065,1610612746,1610612764,127.0,119.0,0.495,0.48,1,2011-03-23,72,28,44,0.389,70,17,53,0.243
21001051,1610612737,1610612741,81.0,114.0,0.4529999999999999,0.544,0,2011-03-22,71,40,31,0.563,70,51,19,0.7290000000000001
21001052,1610612757,1610612764,111.0,76.0,0.5,0.371,1,2011-03-22,71,41,30,0.5770000000000001,69,17,52,0.246
21001053,1610612747,1610612756,139.0,137.0,0.442,0.481,1,2011-03-22,71,51,20,0.718,69,35,34,0.507
21001044,1610612739,1610612753,86.0,97.0,0.395,0.4679999999999999,0,2011-03-21,69,13,56,0.188,71,45,26,0.634
21001045,1610612751,1610612754,98.0,102.0,0.3979999999999999,0.486,0,2011-03-21,69,22,47,0.319,71,31,40,0.4370000000000001
21001046,1610612752,1610612738,86.0,96.0,0.405,0.4629999999999999,0,2011-03-21,70,35,35,0.5,69,50,19,0.725
21001047,1610612741,1610612758,132.0,92.0,0.613,0.4320000000000001,1,2011-03-21,69,50,19,0.725,69,17,52,0.246
21001048,1610612763,1610612762,103.0,85.0,0.506,0.485,1,2011-03-21,71,39,32,0.5489999999999999,71,36,35,0.507
21001049,1610612759,1610612744,111.0,96.0,0.494,0.452,1,2011-03-21,70,57,13,0.8140000000000001,71,30,41,0.423
21001050,1610612743,1610612761,123.0,90.0,0.478,0.402,1,2011-03-21,71,42,29,0.5920000000000001,70,20,50,0.286
21001035,1610612764,1610612751,98.0,92.0,0.519,0.4370000000000001,1,2011-03-20,68,17,51,0.25,68,22,46,0.324
21001036,1610612737,1610612765,104.0,96.0,0.529,0.5,1,2011-03-20,70,40,30,0.5710000000000001,70,25,45,0.357
21001037,1610612749,1610612752,100.0,95.0,0.431,0.386,1,2011-03-20,69,28,41,0.406,69,35,34,0.507
21001038,1610612750,1610612758,95.0,127.0,0.4429999999999999,0.56,0,2011-03-20,71,17,54,0.239,68,17,51,0.25
21001039,1610612746,1610612756,99.0,108.0,0.452,0.488,0,2011-03-20,71,27,44,0.38,68,35,33,0.515
21001040,1610612745,1610612762,110.0,108.0,0.402,0.433,1,2011-03-20,71,37,34,0.521,70,36,34,0.514
21001041,1610612760,1610612761,93.0,95.0,0.4,0.4320000000000001,0,2011-03-20,69,45,24,0.652,69,20,49,0.29
21001042,1610612742,1610612744,101.0,73.0,0.43,0.351,1,2011-03-20,70,49,21,0.7,70,30,40,0.429
21001043,1610612747,1610612757,84.0,80.0,0.449,0.386,1,2011-03-20,70,50,20,0.7140000000000001,70,40,30,0.5710000000000001
21001029,1610612746,1610612739,100.0,92.0,0.481,0.48,1,2011-03-19,70,27,43,0.386,68,13,55,0.191
21001030,1610612748,1610612743,103.0,98.0,0.507,0.436,1,2011-03-19,70,48,22,0.6859999999999999,70,41,29,0.586
21001031,1610612763,1610612754,99.0,78.0,0.518,0.356,1,2011-03-19,70,38,32,0.5429999999999999,70,30,40,0.429
21001032,1610612740,1610612738,85.0,89.0,0.452,0.515,0,2011-03-19,71,40,31,0.563,68,49,19,0.721
21001033,1610612759,1610612766,109.0,98.0,0.527,0.5,1,2011-03-19,69,56,13,0.812,69,28,41,0.406
21001034,1610612757,1610612755,110.0,101.0,0.514,0.5,1,2011-03-19,69,40,29,0.58,70,36,34,0.514
21001017,1610612754,1610612741,115.0,108.0,0.43,0.407,1,2011-03-18,69,30,39,0.435,68,49,19,0.721
21001018,1610612753,1610612743,85.0,82.0,0.373,0.359,1,2011-03-18,70,44,26,0.629,69,41,28,0.594
21001019,1610612761,1610612764,116.0,107.0,0.5,0.477,1,2011-03-18,68,19,49,0.2789999999999999,67,16,51,0.239
21001020,1610612737,1610612748,85.0,106.0,0.4429999999999999,0.535,0,2011-03-18,69,39,30,0.565,69,47,22,0.6809999999999999
21001021,1610612765,1610612752,99.0,95.0,0.476,0.457,1,2011-03-18,69,25,44,0.362,68,35,33,0.515
21001022,1610612760,1610612766,99.0,82.0,0.528,0.446,1,2011-03-18,68,45,23,0.662,68,28,40,0.412
21001023,1610612742,1610612759,91.0,97.0,0.493,0.434,0,2011-03-18,69,48,21,0.696,68,55,13,0.809
21001024,1610612745,1610612738,93.0,77.0,0.4379999999999999,0.423,1,2011-03-18,70,36,34,0.514,67,48,19,0.716
21001025,1610612749,1610612751,110.0,95.0,0.568,0.4429999999999999,1,2011-03-18,68,27,41,0.397,67,22,45,0.3279999999999999
21001026,1610612756,1610612744,108.0,97.0,0.442,0.422,1,2011-03-18,67,34,33,0.507,69,30,39,0.435
21001027,1610612758,1610612755,80.0,102.0,0.345,0.444,0,2011-03-18,67,16,51,0.239,69,36,33,0.522
21001028,1610612747,1610612750,106.0,98.0,0.476,0.4429999999999999,1,2011-03-18,69,49,20,0.71,70,17,53,0.243
21001014,1610612751,1610612741,73.0,84.0,0.349,0.407,0,2011-03-17,66,22,44,0.3329999999999999,67,49,18,0.731
21001015,1610612752,1610612763,120.0,99.0,0.519,0.461,1,2011-03-17,67,35,32,0.522,69,37,32,0.536
21001016,1610612757,1610612739,111.0,70.0,0.542,0.356,1,2011-03-17,68,39,29,0.574,67,13,54,0.1939999999999999
21001003,1610612737,1610612743,87.0,102.0,0.415,0.534,0,2011-03-16,68,39,29,0.574,68,41,27,0.603
21001004,1610612738,1610612754,92.0,80.0,0.469,0.375,1,2011-03-16,66,48,18,0.727,68,29,39,0.426
21001005,1610612765,1610612761,107.0,93.0,0.519,0.5,1,2011-03-16,68,24,44,0.353,67,18,49,0.2689999999999999
21001006,1610612748,1610612760,85.0,96.0,0.385,0.3979999999999999,0,2011-03-16,68,46,22,0.6759999999999999,67,44,23,0.657
21001007,1610612749,1610612753,89.0,93.0,0.422,0.434,0,2011-03-16,67,26,41,0.3879999999999999,69,43,26,0.623
21001008,1610612740,1610612756,100.0,95.0,0.475,0.4320000000000001,1,2011-03-16,70,40,30,0.5710000000000001,66,33,33,0.5
21001009,1610612745,1610612766,94.0,78.0,0.414,0.3720000000000001,1,2011-03-16,69,35,34,0.507,67,28,39,0.418
21001010,1610612762,1610612750,119.0,104.0,0.5479999999999999,0.42,1,2011-03-16,69,36,33,0.522,69,17,52,0.246
21001011,1610612758,1610612739,93.0,97.0,0.38,0.514,0,2011-03-16,66,16,50,0.242,66,13,53,0.1969999999999999
21001012,1610612744,1610612742,106.0,112.0,0.512,0.519,0,2011-03-16,68,30,38,0.441,68,48,20,0.706
21001013,1610612746,1610612755,94.0,104.0,0.456,0.452,0,2011-03-16,69,26,43,0.377,68,35,33,0.515
21000554,1610612737,1610612749,110.0,85.0,0.63,0.419,1,2011-03-15,67,39,28,0.5820000000000001,66,26,40,0.3939999999999999
21001000,1610612754,1610612752,119.0,117.0,0.523,0.449,1,2011-03-15,67,29,38,0.433,66,34,32,0.515
21001001,1610612741,1610612764,98.0,79.0,0.4,0.431,1,2011-03-15,66,48,18,0.727,66,16,50,0.242
21001002,1610612757,1610612742,104.0,101.0,0.471,0.597,1,2011-03-15,67,38,29,0.5670000000000001,67,47,20,0.701
21000991,1610612751,1610612738,88.0,79.0,0.397,0.412,1,2011-03-14,65,22,43,0.3379999999999999,65,47,18,0.723
21000992,1610612764,1610612760,89.0,116.0,0.3939999999999999,0.488,0,2011-03-14,65,16,49,0.246,66,43,23,0.652
21000993,1610612748,1610612759,110.0,80.0,0.5379999999999999,0.3829999999999999,1,2011-03-14,67,46,21,0.687,67,54,13,0.8059999999999999
21000994,1610612763,1610612746,105.0,82.0,0.536,0.4,1,2011-03-14,68,37,31,0.544,68,26,42,0.382
21000995,1610612740,1610612743,103.0,114.0,0.471,0.5329999999999999,0,2011-03-14,69,39,30,0.565,67,40,27,0.597
21000996,1610612745,1610612756,95.0,93.0,0.412,0.455,1,2011-03-14,68,34,34,0.5,65,33,32,0.508
21000997,1610612762,1610612755,112.0,107.0,0.465,0.423,1,2011-03-14,68,35,33,0.515,67,34,33,0.507
21000998,1610612758,1610612744,129.0,119.0,0.5660000000000001,0.5,1,2011-03-14,65,16,49,0.246,67,30,37,0.4479999999999999
21000999,1610612747,1610612753,97.0,84.0,0.4379999999999999,0.471,1,2011-03-14,68,48,20,0.706,68,42,26,0.618
21000985,1610612739,1610612760,75.0,95.0,0.3379999999999999,0.452,0,2011-03-13,65,12,53,0.185,65,42,23,0.6459999999999999
21000986,1610612761,1610612766,90.0,95.0,0.418,0.515,0,2011-03-13,66,18,48,0.273,66,28,38,0.424
21000987,1610612756,1610612753,88.0,111.0,0.3879999999999999,0.4529999999999999,0,2011-03-13,64,33,31,0.516,67,42,25,0.627
21000988,1610612738,1610612749,87.0,56.0,0.4579999999999999,0.314,1,2011-03-13,64,47,17,0.7340000000000001,65,26,39,0.4
21000989,1610612752,1610612754,93.0,106.0,0.366,0.5710000000000001,0,2011-03-13,65,34,31,0.523,66,28,38,0.424
21000990,1610612744,1610612750,100.0,77.0,0.4370000000000001,0.366,1,2011-03-13,66,30,36,0.455,68,17,51,0.25
21000976,1610612748,1610612763,118.0,85.0,0.58,0.3929999999999999,1,2011-03-12,66,45,21,0.682,67,36,31,0.537
21000977,1610612737,1610612757,91.0,82.0,0.519,0.351,1,2011-03-12,66,38,28,0.5760000000000001,66,37,29,0.561
21000978,1610612764,1610612746,101.0,122.0,0.416,0.518,0,2011-03-12,64,16,48,0.25,67,26,41,0.3879999999999999
21000979,1610612741,1610612762,118.0,100.0,0.526,0.423,1,2011-03-12,65,47,18,0.723,67,34,33,0.507
21000980,1610612749,1610612755,102.0,74.0,0.526,0.397,1,2011-03-12,64,26,38,0.406,66,34,32,0.515
21000981,1610612740,1610612758,115.0,103.0,0.519,0.476,1,2011-03-12,68,39,29,0.574,64,15,49,0.2339999999999999
21000983,1610612745,1610612759,107.0,115.0,0.481,0.477,0,2011-03-12,67,33,34,0.493,66,54,12,0.818
21000982,1610612742,1610612747,91.0,96.0,0.43,0.446,0,2011-03-12,66,47,19,0.7120000000000001,67,47,20,0.701
21000984,1610612743,1610612765,131.0,101.0,0.561,0.5,1,2011-03-12,66,39,27,0.591,67,23,44,0.3429999999999999
21000967,1610612766,1610612757,97.0,92.0,0.429,0.451,1,2011-03-11,65,27,38,0.415,65,37,28,0.569
21000968,1610612751,1610612746,102.0,98.0,0.477,0.451,1,2011-03-11,64,21,43,0.3279999999999999,66,25,41,0.379
21000969,1610612755,1610612738,89.0,86.0,0.413,0.418,1,2011-03-11,65,34,31,0.523,63,46,17,0.73
21000970,1610612761,1610612754,108.0,98.0,0.531,0.449,1,2011-03-11,65,18,47,0.2769999999999999,65,27,38,0.415
21000971,1610612741,1610612737,94.0,76.0,0.45,0.431,1,2011-03-11,64,46,18,0.7190000000000001,65,37,28,0.569
21000972,1610612750,1610612762,122.0,101.0,0.5479999999999999,0.5,1,2011-03-11,67,17,50,0.254,66,34,32,0.515
21000973,1610612760,1610612765,104.0,94.0,0.5,0.487,1,2011-03-11,64,41,23,0.6409999999999999,66,23,43,0.348
21000974,1610612759,1610612758,108.0,103.0,0.494,0.455,1,2011-03-11,65,53,12,0.815,63,15,48,0.238
21000975,1610612744,1610612753,123.0,120.0,0.495,0.476,1,2011-03-11,65,29,36,0.446,66,41,25,0.621
21000964,1610612748,1610612747,94.0,88.0,0.457,0.4,1,2011-03-10,65,44,21,0.677,66,46,20,0.6970000000000001
21000965,1610612742,1610612752,127.0,109.0,0.511,0.425,1,2011-03-10,65,47,18,0.723,64,34,30,0.531
21000966,1610612756,1610612743,97.0,116.0,0.411,0.517,0,2011-03-10,63,33,30,0.524,65,38,27,0.585
21000953,1610612766,1610612741,84.0,101.0,0.457,0.507,0,2011-03-09,64,26,38,0.406,63,45,18,0.7140000000000001
21000954,1610612751,1610612744,94.0,90.0,0.4370000000000001,0.44,1,2011-03-09,63,20,43,0.317,64,28,36,0.4379999999999999
21000955,1610612755,1610612760,105.0,110.0,0.419,0.5,0,2011-03-09,64,33,31,0.516,63,40,23,0.635
21000956,1610612761,1610612762,94.0,96.0,0.456,0.471,0,2011-03-09,64,17,47,0.266,65,34,31,0.523
21000957,1610612738,1610612746,103.0,108.0,0.44,0.52,0,2011-03-09,62,46,16,0.742,65,25,40,0.385
21000958,1610612763,1610612752,108.0,110.0,0.537,0.534,0,2011-03-09,66,36,30,0.545,63,34,29,0.54
21000959,1610612749,1610612739,110.0,90.0,0.551,0.462,1,2011-03-09,63,25,38,0.397,64,12,52,0.188
21000960,1610612750,1610612754,101.0,75.0,0.385,0.296,1,2011-03-09,66,16,50,0.242,64,27,37,0.422
21000961,1610612740,1610612742,93.0,92.0,0.436,0.449,1,2011-03-09,67,38,29,0.5670000000000001,64,46,18,0.7190000000000001
21000962,1610612759,1610612765,111.0,104.0,0.643,0.452,1,2011-03-09,64,52,12,0.813,65,23,42,0.354
21000963,1610612758,1610612753,102.0,106.0,0.41,0.494,0,2011-03-09,62,15,47,0.242,65,41,24,0.631
21000947,1610612737,1610612747,87.0,101.0,0.3979999999999999,0.494,0,2011-03-08,64,37,27,0.578,65,46,19,0.708
21000948,1610612739,1610612744,85.0,95.0,0.365,0.4529999999999999,0,2011-03-08,63,12,51,0.19,63,28,35,0.444
21000949,1610612754,1610612755,100.0,110.0,0.486,0.511,0,2011-03-08,63,27,36,0.429,63,33,30,0.524
21000950,1610612764,1610612749,76.0,95.0,0.376,0.439,0,2011-03-08,63,16,47,0.254,62,24,38,0.387
21000951,1610612748,1610612757,96.0,105.0,0.514,0.506,0,2011-03-08,64,43,21,0.672,64,37,27,0.578
21000952,1610612756,1610612745,113.0,110.0,0.5429999999999999,0.4589999999999999,1,2011-03-08,62,33,29,0.532,66,33,33,0.5
21000940,1610612766,1610612746,87.0,92.0,0.449,0.419,0,2011-03-07,63,26,37,0.413,64,24,40,0.375
21000941,1610612753,1610612757,85.0,89.0,0.465,0.4320000000000001,0,2011-03-07,64,40,24,0.625,63,36,27,0.5710000000000001
21000942,1610612752,1610612762,131.0,109.0,0.561,0.451,1,2011-03-07,62,33,29,0.532,64,33,31,0.516
21000943,1610612741,1610612740,85.0,77.0,0.3829999999999999,0.363,1,2011-03-07,62,44,18,0.71,66,37,29,0.561
21000944,1610612763,1610612760,107.0,101.0,0.518,0.519,1,2011-03-07,65,36,29,0.5539999999999999,62,39,23,0.629
21000945,1610612750,1610612742,105.0,108.0,0.4429999999999999,0.452,0,2011-03-07,65,15,50,0.231,63,46,17,0.73
21000946,1610612758,1610612745,101.0,123.0,0.474,0.53,0,2011-03-07,61,15,46,0.246,65,33,32,0.508
21000931,1610612748,1610612741,86.0,87.0,0.485,0.4589999999999999,0,2011-03-06,63,43,20,0.6829999999999999,61,43,18,0.705
21000932,1610612759,1610612747,83.0,99.0,0.36,0.467,0,2011-03-06,63,51,12,0.81,64,45,19,0.703
21000934,1610612765,1610612764,113.0,102.0,0.516,0.439,1,2011-03-06,64,23,41,0.359,62,16,46,0.258
21000935,1610612755,1610612744,125.0,117.0,0.495,0.49,1,2011-03-06,62,32,30,0.516,62,27,35,0.435
21000933,1610612737,1610612752,79.0,92.0,0.446,0.4679999999999999,0,2011-03-06,63,37,26,0.5870000000000001,61,32,29,0.525
21000936,1610612739,1610612740,81.0,96.0,0.368,0.52,0,2011-03-06,62,12,50,0.1939999999999999,65,37,28,0.569
21000937,1610612760,1610612756,122.0,118.0,0.488,0.475,1,2011-03-06,61,39,22,0.639,61,32,29,0.525
21000938,1610612742,1610612763,103.0,104.0,0.507,0.471,0,2011-03-06,62,45,17,0.726,64,35,29,0.547
21000939,1610612749,1610612738,83.0,89.0,0.413,0.515,0,2011-03-06,61,23,38,0.377,61,46,15,0.754
21000925,1610612751,1610612761,137.0,136.0,0.457,0.423,1,2011-03-05,62,19,43,0.306,63,17,46,0.27
21000926,1610612764,1610612750,103.0,96.0,0.429,0.444,1,2011-03-05,61,16,45,0.262,64,15,49,0.2339999999999999
21000927,1610612745,1610612754,112.0,95.0,0.449,0.413,1,2011-03-05,64,32,32,0.5,62,27,35,0.435
21000928,1610612762,1610612758,109.0,102.0,0.455,0.409,1,2011-03-05,63,33,30,0.524,60,15,45,0.25
21000929,1610612757,1610612766,93.0,69.0,0.4320000000000001,0.426,1,2011-03-05,62,35,27,0.565,62,26,36,0.419
21000930,1610612746,1610612743,100.0,94.0,0.473,0.392,1,2011-03-05,63,23,40,0.365,64,37,27,0.578
21000914,1610612751,1610612761,116.0,103.0,0.556,0.482,1,2011-03-04,61,18,43,0.295,62,17,45,0.2739999999999999
21000915,1610612753,1610612741,81.0,89.0,0.4429999999999999,0.41,0,2011-03-04,63,40,23,0.635,60,42,18,0.7
21000916,1610612755,1610612750,111.0,100.0,0.524,0.473,1,2011-03-04,61,31,30,0.508,63,15,48,0.238
21000917,1610612737,1610612760,104.0,111.0,0.476,0.506,0,2011-03-04,62,37,25,0.597,60,38,22,0.633
21000918,1610612738,1610612744,107.0,103.0,0.534,0.476,1,2011-03-04,60,45,15,0.75,61,27,34,0.4429999999999999
21000919,1610612752,1610612739,115.0,119.0,0.545,0.5,0,2011-03-04,60,31,29,0.517,61,12,49,0.1969999999999999
21000920,1610612763,1610612740,91.0,98.0,0.442,0.5,0,2011-03-04,63,34,29,0.54,64,36,28,0.563
21000921,1610612742,1610612754,116.0,108.0,0.519,0.487,1,2011-03-04,61,45,16,0.738,61,27,34,0.4429999999999999
21000922,1610612749,1610612756,88.0,102.0,0.417,0.5,0,2011-03-04,60,23,37,0.3829999999999999,60,32,28,0.5329999999999999
21000923,1610612759,1610612748,125.0,95.0,0.561,0.474,1,2011-03-04,62,51,11,0.823,62,43,19,0.6940000000000001
21000924,1610612747,1610612766,92.0,84.0,0.382,0.3979999999999999,1,2011-03-04,63,44,19,0.698,61,26,35,0.426
21000912,1610612748,1610612753,96.0,99.0,0.467,0.479,0,2011-03-03,61,43,18,0.705,62,40,22,0.645
21000913,1610612762,1610612743,101.0,103.0,0.518,0.474,0,2011-03-03,62,32,30,0.516,63,37,26,0.5870000000000001
21000902,1610612737,1610612741,83.0,80.0,0.402,0.411,1,2011-03-02,61,37,24,0.607,59,41,18,0.695
21000903,1610612739,1610612759,99.0,109.0,0.396,0.53,0,2011-03-02,60,11,49,0.183,61,50,11,0.82
21000904,1610612764,1610612744,102.0,106.0,0.4039999999999999,0.424,0,2011-03-02,60,15,45,0.25,60,27,33,0.45
21000905,1610612738,1610612756,115.0,103.0,0.537,0.429,1,2011-03-02,59,44,15,0.746,59,31,28,0.525
21000906,1610612765,1610612750,105.0,116.0,0.4379999999999999,0.526,0,2011-03-02,63,22,41,0.349,62,15,47,0.242
21000907,1610612752,1610612740,107.0,88.0,0.545,0.465,1,2011-03-02,59,31,28,0.525,63,35,28,0.556
21000908,1610612760,1610612754,113.0,89.0,0.481,0.341,1,2011-03-02,59,37,22,0.627,60,27,33,0.45
21000909,1610612743,1610612766,120.0,80.0,0.608,0.3670000000000001,1,2011-03-02,62,36,26,0.581,60,26,34,0.433
21000910,1610612758,1610612757,102.0,107.0,0.532,0.46,0,2011-03-02,59,15,44,0.254,61,34,27,0.557
21000911,1610612746,1610612745,106.0,103.0,0.482,0.418,1,2011-03-02,62,22,40,0.355,63,31,32,0.4920000000000001
21000894,1610612754,1610612744,109.0,100.0,0.425,0.4270000000000001,1,2011-03-01,59,27,32,0.4579999999999999,59,26,33,0.441
21000895,1610612753,1610612752,116.0,110.0,0.522,0.3720000000000001,1,2011-03-01,61,39,22,0.639,58,30,28,0.517
21000896,1610612755,1610612742,93.0,101.0,0.444,0.532,0,2011-03-01,60,30,30,0.5,60,44,16,0.733
21000897,1610612761,1610612740,96.0,90.0,0.494,0.439,1,2011-03-01,61,17,44,0.2789999999999999,62,35,27,0.565
21000898,1610612763,1610612759,109.0,93.0,0.528,0.442,1,2011-03-01,62,34,28,0.5479999999999999,60,49,11,0.8170000000000001
21000899,1610612749,1610612765,92.0,90.0,0.422,0.4039999999999999,1,2011-03-01,59,23,36,0.39,62,22,40,0.355
21000900,1610612750,1610612747,79.0,90.0,0.397,0.375,0,2011-03-01,61,14,47,0.23,62,43,19,0.6940000000000001
21000901,1610612757,1610612745,87.0,103.0,0.4320000000000001,0.579,0,2011-03-01,60,33,27,0.55,62,31,31,0.5
21000889,1610612751,1610612756,103.0,104.0,0.472,0.457,0,2011-02-28,60,17,43,0.283,58,31,27,0.534
21000890,1610612764,1610612741,77.0,105.0,0.356,0.481,0,2011-02-28,59,15,44,0.254,58,41,17,0.7070000000000001
21000891,1610612743,1610612737,100.0,90.0,0.488,0.4,1,2011-02-28,61,35,26,0.574,60,36,24,0.6
21000892,1610612762,1610612738,102.0,107.0,0.449,0.476,0,2011-02-28,61,32,29,0.525,58,43,15,0.741
21000893,1610612758,1610612746,105.0,99.0,0.475,0.457,1,2011-02-28,58,15,43,0.259,61,21,40,0.344
21000879,1610612754,1610612756,108.0,110.0,0.4479999999999999,0.441,0,2011-02-27,58,26,32,0.4479999999999999,57,30,27,0.526
21000880,1610612760,1610612747,87.0,90.0,0.447,0.487,0,2011-02-27,58,36,22,0.621,61,42,19,0.6890000000000001
21000881,1610612739,1610612755,91.0,95.0,0.418,0.494,0,2011-02-27,59,11,48,0.186,59,30,29,0.508
21000882,1610612750,1610612744,126.0,123.0,0.447,0.4579999999999999,1,2011-02-27,60,14,46,0.233,58,26,32,0.4479999999999999
21000883,1610612753,1610612766,100.0,86.0,0.515,0.4,1,2011-02-27,60,38,22,0.633,59,26,33,0.441
21000884,1610612761,1610612742,96.0,114.0,0.488,0.484,0,2011-02-27,60,16,44,0.267,59,43,16,0.7290000000000001
21000885,1610612740,1610612745,89.0,91.0,0.474,0.419,0,2011-02-27,61,35,26,0.574,61,30,31,0.4920000000000001
21000886,1610612759,1610612763,95.0,88.0,0.462,0.371,1,2011-02-27,59,49,10,0.831,61,33,28,0.541
21000887,1610612748,1610612752,86.0,91.0,0.4320000000000001,0.3879999999999999,0,2011-02-27,60,43,17,0.7170000000000001,57,30,27,0.526
21000888,1610612757,1610612737,83.0,90.0,0.39,0.42,0,2011-02-27,59,33,26,0.5589999999999999,59,36,23,0.61
21000874,1610612765,1610612762,120.0,116.0,0.5,0.595,1,2011-02-26,61,22,39,0.361,60,32,28,0.5329999999999999
21000873,1610612764,1610612742,99.0,105.0,0.4629999999999999,0.481,0,2011-02-26,58,15,43,0.259,58,42,16,0.7240000000000001
21000875,1610612763,1610612758,120.0,92.0,0.547,0.447,1,2011-02-26,60,33,27,0.55,57,14,43,0.246
21000876,1610612745,1610612751,123.0,108.0,0.512,0.402,1,2011-02-26,60,29,31,0.483,59,17,42,0.288
21000877,1610612749,1610612741,75.0,83.0,0.382,0.41,0,2011-02-26,58,22,36,0.379,57,40,17,0.7020000000000001
21000878,1610612746,1610612738,92.0,99.0,0.461,0.411,0,2011-02-26,60,21,39,0.35,57,42,15,0.737
21000861,1610612766,1610612758,110.0,98.0,0.494,0.434,1,2011-02-25,58,26,32,0.4479999999999999,56,14,42,0.25
21000862,1610612754,1610612762,84.0,95.0,0.348,0.444,0,2011-02-25,57,26,31,0.456,59,32,27,0.542
21000863,1610612755,1610612765,110.0,94.0,0.523,0.474,1,2011-02-25,58,29,29,0.5,60,21,39,0.35
21000864,1610612761,1610612756,92.0,110.0,0.507,0.476,0,2011-02-25,59,16,43,0.271,56,29,27,0.518
21000865,1610612739,1610612752,115.0,109.0,0.424,0.419,1,2011-02-25,58,11,47,0.19,56,29,27,0.518
21000866,1610612748,1610612764,121.0,113.0,0.526,0.473,1,2011-02-25,59,43,16,0.7290000000000001,57,15,42,0.263
21000867,1610612753,1610612760,111.0,88.0,0.5,0.3329999999999999,1,2011-02-25,59,37,22,0.627,57,36,21,0.632
21000868,1610612750,1610612740,81.0,95.0,0.4,0.4379999999999999,0,2011-02-25,59,13,46,0.22,60,35,25,0.583
21000869,1610612759,1610612751,106.0,96.0,0.4629999999999999,0.435,1,2011-02-25,58,48,10,0.828,58,17,41,0.293
21000870,1610612744,1610612737,79.0,95.0,0.371,0.476,0,2011-02-25,57,26,31,0.456,58,35,23,0.603
21000871,1610612747,1610612746,108.0,95.0,0.506,0.3779999999999999,1,2011-02-25,60,41,19,0.6829999999999999,59,21,38,0.356
21000872,1610612757,1610612743,107.0,106.0,0.435,0.419,1,2011-02-25,58,33,25,0.569,60,34,26,0.5670000000000001
21000859,1610612741,1610612748,93.0,89.0,0.415,0.405,1,2011-02-24,56,39,17,0.696,58,42,16,0.7240000000000001
21000860,1610612743,1610612738,89.0,75.0,0.4529999999999999,0.39,1,2011-02-24,59,34,25,0.5760000000000001,56,41,15,0.732
21000847,1610612739,1610612745,119.0,124.0,0.516,0.47,0,2011-02-23,57,10,47,0.175,59,28,31,0.475
21000848,1610612754,1610612765,102.0,101.0,0.442,0.488,1,2011-02-23,56,26,30,0.4639999999999999,59,21,38,0.356
21000849,1610612753,1610612758,105.0,111.0,0.449,0.525,0,2011-02-23,58,36,22,0.621,55,14,41,0.255
21000850,1610612755,1610612764,117.0,94.0,0.513,0.42,1,2011-02-23,57,28,29,0.491,56,15,41,0.268
21000851,1610612761,1610612741,118.0,113.0,0.581,0.4370000000000001,1,2011-02-23,58,16,42,0.276,55,38,17,0.691
21000855,1610612759,1610612760,109.0,105.0,0.446,0.407,1,2011-02-23,57,47,10,0.825,56,36,20,0.643
21000852,1610612752,1610612749,114.0,108.0,0.5,0.439,1,2011-02-23,55,29,26,0.527,57,22,35,0.386
21000853,1610612750,1610612763,95.0,104.0,0.37,0.452,0,2011-02-23,58,13,45,0.2239999999999999,59,32,27,0.542
21000856,1610612742,1610612762,118.0,99.0,0.579,0.455,1,2011-02-23,57,41,16,0.7190000000000001,58,31,27,0.534
21000857,1610612756,1610612737,105.0,97.0,0.526,0.481,1,2011-02-23,55,28,27,0.509,57,34,23,0.596
21000854,1610612740,1610612746,98.0,87.0,0.513,0.471,1,2011-02-23,59,34,25,0.5760000000000001,58,21,37,0.362
21000858,1610612757,1610612747,101.0,106.0,0.481,0.494,0,2011-02-23,57,32,25,0.561,59,40,19,0.6779999999999999
21000838,1610612766,1610612761,114.0,101.0,0.469,0.5,1,2011-02-22,57,25,32,0.439,57,15,42,0.263
21000839,1610612764,1610612754,96.0,113.0,0.3979999999999999,0.4320000000000001,0,2011-02-22,55,15,40,0.273,55,25,30,0.455
21000840,1610612765,1610612745,100.0,108.0,0.441,0.435,0,2011-02-22,58,21,37,0.362,58,27,31,0.466
21000841,1610612748,1610612758,117.0,97.0,0.5670000000000001,0.476,1,2011-02-22,57,42,15,0.737,54,13,41,0.241
21000842,1610612749,1610612750,94.0,88.0,0.38,0.381,1,2011-02-22,56,22,34,0.3929999999999999,57,13,44,0.228
21000843,1610612760,1610612746,111.0,88.0,0.474,0.4579999999999999,1,2011-02-22,55,36,19,0.655,57,21,36,0.368
21000844,1610612743,1610612763,120.0,107.0,0.494,0.5379999999999999,1,2011-02-22,58,33,25,0.569,58,31,27,0.534
21000845,1610612744,1610612738,93.0,115.0,0.3929999999999999,0.556,0,2011-02-22,56,26,30,0.4639999999999999,55,41,14,0.745
21000846,1610612747,1610612737,104.0,80.0,0.485,0.366,1,2011-02-22,58,39,19,0.672,56,34,22,0.607
21000836,1610612741,1610612759,109.0,99.0,0.5379999999999999,0.488,1,2011-02-17,54,38,16,0.7040000000000001,56,46,10,0.821
21000837,1610612756,1610612742,106.0,112.0,0.506,0.524,0,2011-02-17,54,27,27,0.5,56,40,16,0.7140000000000001
21000824,1610612753,1610612764,101.0,76.0,0.452,0.349,1,2011-02-16,57,36,21,0.632,54,15,39,0.278
21000825,1610612761,1610612748,95.0,103.0,0.414,0.493,0,2011-02-16,56,15,41,0.268,56,41,15,0.732
21000826,1610612738,1610612751,94.0,80.0,0.431,0.3879999999999999,1,2011-02-16,54,40,14,0.741,57,17,40,0.298
21000827,1610612739,1610612747,104.0,99.0,0.471,0.425,1,2011-02-16,56,10,46,0.179,57,38,19,0.667
21000828,1610612765,1610612754,115.0,109.0,0.515,0.5,1,2011-02-16,57,21,36,0.368,54,24,30,0.444
21000829,1610612752,1610612737,102.0,90.0,0.481,0.44,1,2011-02-16,54,28,26,0.519,55,34,21,0.618
21000830,1610612750,1610612746,90.0,98.0,0.354,0.456,0,2011-02-16,56,13,43,0.2319999999999999,56,21,35,0.375
21000831,1610612742,1610612758,116.0,100.0,0.556,0.493,1,2011-02-16,55,39,16,0.7090000000000001,53,13,40,0.245
21000832,1610612745,1610612755,105.0,114.0,0.4639999999999999,0.552,0,2011-02-16,57,26,31,0.456,56,27,29,0.482
21000833,1610612749,1610612743,87.0,94.0,0.3879999999999999,0.461,0,2011-02-16,55,21,34,0.382,57,32,25,0.561
21000834,1610612762,1610612744,100.0,107.0,0.455,0.545,0,2011-02-16,57,31,26,0.544,55,26,29,0.473
21000835,1610612757,1610612740,103.0,96.0,0.529,0.5,1,2011-02-16,56,32,24,0.5710000000000001,58,33,25,0.569
21000818,1610612754,1610612748,103.0,110.0,0.419,0.489,0,2011-02-15,53,24,29,0.4529999999999999,55,40,15,0.727
21000819,1610612741,1610612766,106.0,94.0,0.5,0.478,1,2011-02-15,53,37,16,0.698,56,24,32,0.429
21000820,1610612763,1610612755,102.0,91.0,0.467,0.44,1,2011-02-15,57,31,26,0.544,55,26,29,0.473
21000821,1610612760,1610612758,126.0,96.0,0.5,0.402,1,2011-02-15,54,35,19,0.648,52,13,39,0.25
21000822,1610612756,1610612762,102.0,101.0,0.493,0.4579999999999999,1,2011-02-15,53,27,26,0.509,56,31,25,0.5539999999999999
21000823,1610612744,1610612740,102.0,89.0,0.506,0.4529999999999999,1,2011-02-15,54,25,29,0.4629999999999999,57,33,24,0.579
21000812,1610612766,1610612747,109.0,89.0,0.512,0.4379999999999999,1,2011-02-14,55,24,31,0.436,56,38,18,0.679
21000813,1610612751,1610612759,85.0,102.0,0.348,0.45,0,2011-02-14,56,17,39,0.304,55,46,9,0.836
21000814,1610612765,1610612737,79.0,94.0,0.386,0.565,0,2011-02-14,56,20,36,0.357,54,34,20,0.63
21000815,1610612749,1610612746,102.0,78.0,0.515,0.371,1,2011-02-14,54,21,33,0.389,55,20,35,0.364
21000816,1610612750,1610612757,81.0,95.0,0.39,0.44,0,2011-02-14,55,13,42,0.236,55,31,24,0.564
21000817,1610612745,1610612743,121.0,102.0,0.494,0.41,1,2011-02-14,56,26,30,0.4639999999999999,56,31,25,0.5539999999999999
21000804,1610612738,1610612748,85.0,82.0,0.423,0.419,1,2011-02-13,53,39,14,0.736,54,39,15,0.722
21000805,1610612753,1610612747,89.0,75.0,0.487,0.3929999999999999,1,2011-02-13,56,35,21,0.625,55,38,17,0.691
21000806,1610612739,1610612764,100.0,115.0,0.422,0.5429999999999999,0,2011-02-13,55,9,46,0.1639999999999999,53,15,38,0.283
21000807,1610612765,1610612757,100.0,105.0,0.515,0.547,0,2011-02-13,55,20,35,0.364,54,30,24,0.556
21000808,1610612761,1610612746,98.0,93.0,0.4270000000000001,0.416,1,2011-02-13,55,15,40,0.273,54,20,34,0.37
21000809,1610612763,1610612743,116.0,108.0,0.557,0.55,1,2011-02-13,56,30,26,0.536,55,31,24,0.564
21000810,1610612756,1610612758,108.0,113.0,0.467,0.457,0,2011-02-13,52,26,26,0.5,51,13,38,0.255
21000811,1610612744,1610612760,100.0,94.0,0.434,0.525,1,2011-02-13,53,24,29,0.4529999999999999,53,34,19,0.642
21000796,1610612737,1610612766,86.0,88.0,0.402,0.423,0,2011-02-12,53,33,20,0.623,54,23,31,0.426
21000797,1610612751,1610612752,95.0,105.0,0.418,0.43,0,2011-02-12,55,17,38,0.309,53,27,26,0.509
21000798,1610612764,1610612759,94.0,118.0,0.4629999999999999,0.584,0,2011-02-12,52,14,38,0.2689999999999999,54,45,9,0.833
21000799,1610612750,1610612755,87.0,107.0,0.364,0.513,0,2011-02-12,54,13,41,0.241,54,26,28,0.481
21000800,1610612740,1610612741,88.0,97.0,0.406,0.515,0,2011-02-12,56,33,23,0.589,52,36,16,0.6920000000000001
21000801,1610612745,1610612742,102.0,106.0,0.406,0.551,0,2011-02-12,55,25,30,0.455,54,38,16,0.7040000000000001
21000802,1610612749,1610612754,97.0,103.0,0.424,0.478,0,2011-02-12,53,20,33,0.377,52,24,28,0.462
21000803,1610612758,1610612760,97.0,99.0,0.452,0.475,0,2011-02-12,50,12,38,0.24,52,34,18,0.654
21000786,1610612766,1610612751,89.0,94.0,0.426,0.407,0,2011-02-11,53,22,31,0.415,54,17,37,0.315
21000787,1610612754,1610612750,116.0,105.0,0.506,0.422,1,2011-02-11,51,23,28,0.451,53,13,40,0.245
21000788,1610612753,1610612740,93.0,99.0,0.462,0.452,0,2011-02-11,55,34,21,0.618,55,33,22,0.6
21000789,1610612755,1610612759,77.0,71.0,0.354,0.3329999999999999,1,2011-02-11,53,25,28,0.472,53,44,9,0.83
21000790,1610612761,1610612757,96.0,102.0,0.514,0.5429999999999999,0,2011-02-11,54,14,40,0.259,53,29,24,0.547
21000791,1610612739,1610612746,126.0,119.0,0.5,0.4479999999999999,1,2011-02-11,54,9,45,0.1669999999999999,53,20,33,0.377
21000792,1610612765,1610612748,92.0,106.0,0.425,0.507,0,2011-02-11,54,20,34,0.37,53,39,14,0.736
21000793,1610612752,1610612747,96.0,113.0,0.412,0.536,0,2011-02-11,52,26,26,0.5,54,38,16,0.7040000000000001
21000794,1610612763,1610612749,89.0,86.0,0.4320000000000001,0.364,1,2011-02-11,55,29,26,0.527,52,20,32,0.385
21000795,1610612762,1610612756,83.0,95.0,0.436,0.4039999999999999,0,2011-02-11,55,31,24,0.564,51,26,25,0.51
21000783,1610612738,1610612747,86.0,92.0,0.402,0.479,0,2011-02-10,52,38,14,0.731,53,37,16,0.698
21000784,1610612756,1610612744,112.0,88.0,0.524,0.4,1,2011-02-10,50,25,25,0.5,52,23,29,0.442
21000785,1610612743,1610612742,121.0,120.0,0.524,0.536,1,2011-02-10,54,31,23,0.574,53,37,16,0.698
21000773,1610612739,1610612765,94.0,103.0,0.514,0.433,0,2011-02-09,53,8,45,0.151,53,20,33,0.377
21000774,1610612754,1610612766,104.0,103.0,0.476,0.4629999999999999,1,2011-02-09,50,22,28,0.44,52,22,30,0.423
21000775,1610612751,1610612740,103.0,101.0,0.469,0.471,1,2011-02-09,53,16,37,0.302,54,32,22,0.593
21000776,1610612755,1610612753,95.0,99.0,0.42,0.461,0,2011-02-09,52,24,28,0.462,54,34,20,0.63
21000777,1610612761,1610612759,100.0,111.0,0.5,0.58,0,2011-02-09,53,14,39,0.264,52,44,8,0.846
21000778,1610612764,1610612749,100.0,85.0,0.474,0.4320000000000001,1,2011-02-09,51,14,37,0.275,51,20,31,0.392
21000779,1610612752,1610612746,108.0,116.0,0.494,0.547,0,2011-02-09,51,26,25,0.51,52,20,32,0.385
21000780,1610612762,1610612741,86.0,91.0,0.474,0.3979999999999999,0,2011-02-09,54,31,23,0.574,51,35,16,0.6859999999999999
21000781,1610612758,1610612742,100.0,102.0,0.47,0.469,0,2011-02-09,49,12,37,0.245,52,37,15,0.7120000000000001
21000782,1610612744,1610612743,116.0,114.0,0.511,0.53,1,2011-02-09,51,23,28,0.451,53,30,23,0.5660000000000001
21000766,1610612737,1610612755,83.0,117.0,0.407,0.544,0,2011-02-08,52,33,19,0.635,51,24,27,0.471
21000767,1610612753,1610612746,101.0,85.0,0.4320000000000001,0.392,1,2011-02-08,53,33,20,0.623,51,19,32,0.373
21000768,1610612765,1610612759,89.0,100.0,0.434,0.529,0,2011-02-08,52,19,33,0.365,51,43,8,0.843
21000769,1610612748,1610612754,117.0,112.0,0.53,0.512,1,2011-02-08,52,38,14,0.731,49,21,28,0.429
21000770,1610612749,1610612761,92.0,74.0,0.4629999999999999,0.36,1,2011-02-08,50,20,30,0.4,52,14,38,0.2689999999999999
21000771,1610612760,1610612763,101.0,105.0,0.412,0.457,0,2011-02-08,51,33,18,0.647,54,28,26,0.519
21000772,1610612745,1610612750,108.0,112.0,0.451,0.511,0,2011-02-08,54,25,29,0.4629999999999999,52,13,39,0.25
21000758,1610612766,1610612738,94.0,89.0,0.418,0.408,1,2011-02-07,51,22,29,0.431,51,38,13,0.745
21000759,1610612763,1610612747,84.0,93.0,0.3979999999999999,0.4320000000000001,0,2011-02-07,53,27,26,0.509,52,36,16,0.6920000000000001
21000760,1610612740,1610612750,92.0,104.0,0.417,0.43,0,2011-02-07,53,32,21,0.604,51,12,39,0.235
21000761,1610612742,1610612739,99.0,96.0,0.41,0.44,1,2011-02-07,51,36,15,0.706,52,8,44,0.154
21000762,1610612743,1610612745,103.0,108.0,0.455,0.434,0,2011-02-07,52,30,22,0.5770000000000001,53,25,28,0.472
21000763,1610612757,1610612741,109.0,103.0,0.515,0.494,1,2011-02-07,52,28,24,0.5379999999999999,50,34,16,0.68
21000764,1610612758,1610612762,104.0,107.0,0.469,0.489,0,2011-02-07,48,12,36,0.25,53,31,22,0.585
21000765,1610612744,1610612756,92.0,104.0,0.434,0.4370000000000001,0,2011-02-07,50,22,28,0.44,49,24,25,0.49
21000754,1610612748,1610612746,97.0,79.0,0.442,0.325,1,2011-02-06,51,37,14,0.725,50,19,31,0.38
21000755,1610612751,1610612754,86.0,105.0,0.412,0.47,0,2011-02-06,52,15,37,0.288,48,21,27,0.4379999999999999
21000756,1610612752,1610612755,117.0,103.0,0.597,0.542,1,2011-02-06,50,26,24,0.52,50,23,27,0.46
21000757,1610612738,1610612753,91.0,80.0,0.476,0.344,1,2011-02-06,50,38,12,0.76,52,32,20,0.615
21000745,1610612766,1610612742,92.0,101.0,0.371,0.465,0,2011-02-05,50,21,29,0.42,50,35,15,0.7
21000746,1610612764,1610612737,92.0,99.0,0.506,0.466,0,2011-02-05,50,13,37,0.26,51,33,18,0.647
21000747,1610612739,1610612757,105.0,111.0,0.513,0.5379999999999999,0,2011-02-05,51,8,43,0.157,51,27,24,0.529
21000748,1610612740,1610612747,95.0,101.0,0.494,0.474,0,2011-02-05,52,32,20,0.615,51,35,16,0.6859999999999999
21000749,1610612745,1610612763,95.0,93.0,0.395,0.409,1,2011-02-05,52,24,28,0.462,52,27,25,0.519
21000750,1610612749,1610612765,78.0,89.0,0.392,0.515,0,2011-02-05,49,19,30,0.3879999999999999,51,19,32,0.373
21000751,1610612750,1610612743,100.0,113.0,0.389,0.544,0,2011-02-05,50,11,39,0.22,51,30,21,0.588
21000752,1610612762,1610612760,105.0,121.0,0.513,0.5660000000000001,0,2011-02-05,52,30,22,0.5770000000000001,50,33,17,0.66
21000753,1610612744,1610612741,101.0,90.0,0.481,0.475,1,2011-02-05,49,22,27,0.449,49,34,15,0.6940000000000001
21000733,1610612766,1610612748,97.0,109.0,0.473,0.551,0,2011-02-04,49,21,28,0.429,50,36,14,0.72
21000734,1610612754,1610612757,100.0,87.0,0.4029999999999999,0.364,1,2011-02-04,47,20,27,0.426,50,26,24,0.52
21000735,1610612755,1610612752,100.0,98.0,0.47,0.402,1,2011-02-04,49,23,26,0.469,49,25,24,0.51
21000736,1610612761,1610612750,111.0,100.0,0.5479999999999999,0.412,1,2011-02-04,51,14,37,0.275,49,11,38,0.2239999999999999
21000737,1610612764,1610612753,92.0,110.0,0.452,0.457,0,2011-02-04,49,13,36,0.265,51,32,19,0.627
21000738,1610612737,1610612746,101.0,100.0,0.436,0.507,1,2011-02-04,50,32,18,0.64,49,19,30,0.3879999999999999
21000739,1610612765,1610612751,92.0,82.0,0.482,0.442,1,2011-02-04,50,18,32,0.36,51,15,36,0.294
21000740,1610612738,1610612742,97.0,101.0,0.506,0.494,0,2011-02-04,49,37,12,0.755,49,34,15,0.6940000000000001
21000741,1610612763,1610612739,112.0,105.0,0.513,0.475,1,2011-02-04,51,27,24,0.529,50,8,42,0.16
21000742,1610612756,1610612760,107.0,111.0,0.4589999999999999,0.512,0,2011-02-04,48,23,25,0.479,49,32,17,0.653
21000743,1610612758,1610612759,100.0,113.0,0.435,0.5710000000000001,0,2011-02-04,47,12,35,0.255,50,42,8,0.84
21000744,1610612743,1610612762,106.0,113.0,0.4379999999999999,0.4629999999999999,0,2011-02-04,50,29,21,0.58,51,30,21,0.588
21000730,1610612753,1610612748,100.0,104.0,0.424,0.5,0,2011-02-03,50,31,19,0.62,49,35,14,0.7140000000000001
21000731,1610612744,1610612749,100.0,94.0,0.506,0.429,1,2011-02-03,48,21,27,0.4379999999999999,48,19,29,0.396
21000732,1610612747,1610612759,88.0,89.0,0.425,0.412,0,2011-02-03,50,34,16,0.68,49,41,8,0.8370000000000001
21000719,1610612737,1610612761,100.0,87.0,0.5529999999999999,0.436,1,2011-02-02,49,31,18,0.633,50,13,37,0.26
21000720,1610612739,1610612754,112.0,117.0,0.4529999999999999,0.471,0,2011-02-02,49,8,41,0.163,46,19,27,0.413
21000721,1610612751,1610612755,92.0,106.0,0.4629999999999999,0.446,0,2011-02-02,50,15,35,0.3,48,22,26,0.4579999999999999
21000722,1610612765,1610612766,87.0,97.0,0.436,0.507,0,2011-02-02,49,17,32,0.347,48,21,27,0.4379999999999999
21000723,1610612752,1610612742,97.0,113.0,0.42,0.5,0,2011-02-02,48,25,23,0.521,48,33,15,0.688
21000724,1610612750,1610612763,84.0,102.0,0.435,0.489,0,2011-02-02,48,11,37,0.2289999999999999,50,26,24,0.52
21000725,1610612760,1610612740,104.0,93.0,0.529,0.446,1,2011-02-02,48,31,17,0.6459999999999999,51,32,19,0.627
21000726,1610612743,1610612757,109.0,90.0,0.519,0.4270000000000001,1,2011-02-02,49,29,20,0.5920000000000001,49,26,23,0.531
21000727,1610612756,1610612749,92.0,77.0,0.5,0.311,1,2011-02-02,47,23,24,0.489,47,19,28,0.4039999999999999
21000728,1610612762,1610612745,96.0,97.0,0.4529999999999999,0.447,0,2011-02-02,50,29,21,0.58,51,23,28,0.451
21000729,1610612746,1610612741,88.0,106.0,0.4679999999999999,0.513,0,2011-02-02,48,19,29,0.396,48,34,14,0.708
21000715,1610612740,1610612764,97.0,89.0,0.486,0.4579999999999999,1,2011-02-01,50,32,18,0.64,48,13,35,0.271
21000716,1610612757,1610612759,99.0,86.0,0.507,0.4270000000000001,1,2011-02-01,48,26,22,0.542,48,40,8,0.833
21000717,1610612758,1610612738,90.0,95.0,0.4370000000000001,0.447,0,2011-02-01,46,12,34,0.261,48,37,11,0.7709999999999999
21000718,1610612747,1610612745,114.0,106.0,0.484,0.43,1,2011-02-01,49,34,15,0.6940000000000001,50,22,28,0.44
21000708,1610612754,1610612761,104.0,93.0,0.444,0.413,1,2011-01-31,45,18,27,0.4,49,13,36,0.265
21000709,1610612751,1610612743,115.0,99.0,0.532,0.508,1,2011-01-31,49,15,34,0.306,48,28,20,0.583
21000710,1610612748,1610612739,117.0,90.0,0.489,0.39,1,2011-01-31,48,34,14,0.708,48,8,40,0.1669999999999999
21000711,1610612763,1610612753,100.0,97.0,0.5329999999999999,0.474,1,2011-01-31,49,25,24,0.51,49,31,18,0.633
21000712,1610612742,1610612764,102.0,92.0,0.479,0.395,1,2011-01-31,47,32,15,0.6809999999999999,47,13,34,0.2769999999999999
21000713,1610612762,1610612766,83.0,78.0,0.447,0.356,1,2011-01-31,49,29,20,0.5920000000000001,47,20,27,0.426
21000714,1610612746,1610612749,105.0,98.0,0.52,0.493,1,2011-01-31,47,19,28,0.4039999999999999,46,19,27,0.413
21000701,1610612760,1610612748,103.0,108.0,0.405,0.52,0,2011-01-30,47,30,17,0.638,47,33,14,0.7020000000000001
21000702,1610612747,1610612738,96.0,109.0,0.444,0.603,0,2011-01-30,48,33,15,0.688,47,36,11,0.7659999999999999
21000703,1610612753,1610612739,103.0,87.0,0.413,0.434,1,2011-01-30,48,31,17,0.6459999999999999,47,8,39,0.17
21000704,1610612755,1610612743,110.0,99.0,0.551,0.4589999999999999,1,2011-01-30,47,21,26,0.447,47,28,19,0.596
21000705,1610612752,1610612765,124.0,106.0,0.513,0.506,1,2011-01-30,47,25,22,0.532,48,17,31,0.354
21000706,1610612756,1610612740,104.0,102.0,0.481,0.421,1,2011-01-30,46,22,24,0.478,49,31,18,0.633
21000707,1610612744,1610612762,96.0,81.0,0.493,0.3720000000000001,1,2011-01-30,47,20,27,0.426,48,28,20,0.583
21000693,1610612741,1610612754,110.0,89.0,0.477,0.407,1,2011-01-29,47,33,14,0.7020000000000001,44,17,27,0.386
21000694,1610612763,1610612764,107.0,93.0,0.5,0.4270000000000001,1,2011-01-29,48,24,24,0.5,46,13,33,0.283
21000695,1610612750,1610612761,103.0,87.0,0.4379999999999999,0.337,1,2011-01-29,47,11,36,0.2339999999999999,48,13,35,0.271
21000696,1610612742,1610612737,102.0,91.0,0.493,0.461,1,2011-01-29,46,31,15,0.674,48,30,18,0.625
21000697,1610612749,1610612751,91.0,81.0,0.4270000000000001,0.4029999999999999,1,2011-01-29,45,19,26,0.422,48,14,34,0.292
21000698,1610612759,1610612745,108.0,95.0,0.514,0.465,1,2011-01-29,47,40,7,0.851,49,22,27,0.449
21000699,1610612758,1610612740,102.0,96.0,0.5,0.4320000000000001,1,2011-01-29,45,12,33,0.267,48,31,17,0.6459999999999999
21000700,1610612746,1610612766,103.0,88.0,0.43,0.4029999999999999,1,2011-01-29,46,18,28,0.391,46,20,26,0.435
21000681,1610612754,1610612751,124.0,92.0,0.625,0.479,1,2011-01-28,43,17,26,0.395,47,14,33,0.298
21000682,1610612755,1610612763,94.0,99.0,0.461,0.451,0,2011-01-28,46,20,26,0.435,47,23,24,0.489
21000683,1610612761,1610612749,110.0,116.0,0.467,0.5529999999999999,0,2011-01-28,47,13,34,0.2769999999999999,44,18,26,0.409
21000684,1610612737,1610612752,111.0,102.0,0.512,0.471,1,2011-01-28,47,30,17,0.638,46,24,22,0.522
21000685,1610612739,1610612743,103.0,117.0,0.455,0.477,0,2011-01-28,46,8,38,0.174,46,28,18,0.609
21000686,1610612748,1610612765,88.0,87.0,0.452,0.38,1,2011-01-28,46,32,14,0.696,47,17,30,0.362
21000687,1610612741,1610612753,99.0,90.0,0.425,0.41,1,2011-01-28,46,32,14,0.696,47,30,17,0.638
21000688,1610612760,1610612764,124.0,117.0,0.494,0.426,1,2011-01-28,46,30,16,0.652,45,13,32,0.289
21000689,1610612762,1610612750,108.0,100.0,0.441,0.4679999999999999,1,2011-01-28,47,28,19,0.596,46,10,36,0.217
21000690,1610612756,1610612738,88.0,71.0,0.4320000000000001,0.342,1,2011-01-28,45,21,24,0.467,46,35,11,0.7609999999999999
21000691,1610612744,1610612766,113.0,121.0,0.466,0.511,0,2011-01-28,46,19,27,0.413,45,20,25,0.444
21000692,1610612747,1610612758,95.0,100.0,0.413,0.512,0,2011-01-28,47,33,14,0.7020000000000001,44,11,33,0.25
21000678,1610612752,1610612748,93.0,88.0,0.361,0.417,1,2011-01-27,45,24,21,0.5329999999999999,45,31,14,0.6890000000000001
21000679,1610612742,1610612745,111.0,106.0,0.5,0.4639999999999999,1,2011-01-27,45,30,15,0.667,48,22,26,0.4579999999999999
21000680,1610612757,1610612738,78.0,88.0,0.3670000000000001,0.469,0,2011-01-27,47,25,22,0.532,45,35,10,0.778
21000668,1610612754,1610612753,96.0,111.0,0.412,0.5,0,2011-01-26,42,16,26,0.381,46,30,16,0.652
21000669,1610612751,1610612763,93.0,88.0,0.439,0.4379999999999999,1,2011-01-26,46,14,32,0.304,46,22,24,0.478
21000670,1610612761,1610612755,94.0,107.0,0.487,0.494,0,2011-01-26,46,13,33,0.283,45,20,25,0.444
21000671,1610612765,1610612743,100.0,109.0,0.4429999999999999,0.475,0,2011-01-26,46,17,29,0.37,45,27,18,0.6
21000672,1610612749,1610612737,98.0,90.0,0.4320000000000001,0.418,1,2011-01-26,43,17,26,0.395,46,29,17,0.63
21000673,1610612750,1610612760,117.0,118.0,0.465,0.452,0,2011-01-26,45,10,35,0.222,45,29,16,0.644
21000674,1610612745,1610612746,96.0,83.0,0.414,0.364,1,2011-01-26,47,22,25,0.4679999999999999,45,17,28,0.3779999999999999
21000675,1610612756,1610612766,107.0,114.0,0.461,0.506,0,2011-01-26,44,20,24,0.455,44,19,25,0.4320000000000001
21000676,1610612762,1610612759,105.0,112.0,0.547,0.513,0,2011-01-26,46,27,19,0.5870000000000001,46,39,7,0.848
21000677,1610612744,1610612740,103.0,112.0,0.507,0.622,0,2011-01-26,45,19,26,0.422,47,31,16,0.66
21000663,1610612764,1610612743,109.0,120.0,0.512,0.506,0,2011-01-25,44,13,31,0.295,44,26,18,0.591
21000664,1610612738,1610612739,112.0,95.0,0.5,0.4629999999999999,1,2011-01-25,44,34,10,0.773,45,8,37,0.178
21000665,1610612742,1610612746,112.0,105.0,0.5,0.557,1,2011-01-25,44,29,15,0.659,44,17,27,0.386
21000666,1610612758,1610612766,89.0,94.0,0.36,0.451,0,2011-01-25,43,10,33,0.233,43,18,25,0.419
21000667,1610612747,1610612762,120.0,91.0,0.62,0.419,1,2011-01-25,46,33,13,0.7170000000000001,45,27,18,0.6
21000653,1610612751,1610612739,103.0,101.0,0.446,0.452,1,2011-01-24,45,13,32,0.289,44,8,36,0.182
21000654,1610612753,1610612765,96.0,103.0,0.452,0.457,0,2011-01-24,45,29,16,0.644,45,17,28,0.3779999999999999
21000655,1610612755,1610612756,105.0,95.0,0.5429999999999999,0.513,1,2011-01-24,44,19,25,0.4320000000000001,43,20,23,0.465
21000656,1610612761,1610612763,98.0,100.0,0.476,0.441,0,2011-01-24,45,13,32,0.289,45,22,23,0.489
21000657,1610612752,1610612764,115.0,106.0,0.462,0.482,1,2011-01-24,44,23,21,0.523,43,13,30,0.302
21000658,1610612741,1610612749,92.0,83.0,0.395,0.461,1,2011-01-24,45,31,14,0.6890000000000001,42,16,26,0.381
21000659,1610612750,1610612745,125.0,129.0,0.505,0.494,0,2011-01-24,44,10,34,0.2269999999999999,46,21,25,0.457
21000660,1610612740,1610612760,91.0,89.0,0.455,0.465,1,2011-01-24,46,30,16,0.652,44,28,16,0.636
21000661,1610612757,1610612758,81.0,96.0,0.395,0.5,0,2011-01-24,46,25,21,0.5429999999999999,42,10,32,0.238
21000662,1610612744,1610612759,102.0,113.0,0.4589999999999999,0.5,0,2011-01-24,44,19,25,0.4320000000000001,45,38,7,0.8440000000000001
21000652,1610612743,1610612754,121.0,107.0,0.511,0.425,1,2011-01-23,43,25,18,0.581,41,16,25,0.39
21000639,1610612766,1610612737,87.0,103.0,0.4679999999999999,0.507,0,2011-01-22,42,17,25,0.405,45,29,16,0.644
21000640,1610612751,1610612742,86.0,87.0,0.444,0.347,0,2011-01-22,44,12,32,0.273,43,28,15,0.6509999999999999
21000641,1610612764,1610612738,85.0,83.0,0.429,0.43,1,2011-01-22,42,13,29,0.31,43,33,10,0.767
21000642,1610612765,1610612756,75.0,74.0,0.358,0.405,1,2011-01-22,44,16,28,0.364,42,20,22,0.476
21000643,1610612748,1610612761,120.0,103.0,0.525,0.469,1,2011-01-22,44,31,13,0.705,44,13,31,0.295
21000644,1610612755,1610612762,96.0,85.0,0.407,0.42,1,2011-01-22,43,18,25,0.419,44,27,17,0.614
21000645,1610612741,1610612739,92.0,79.0,0.415,0.321,1,2011-01-22,44,30,14,0.682,43,8,35,0.186
21000646,1610612740,1610612759,96.0,72.0,0.469,0.362,1,2011-01-22,45,29,16,0.644,44,37,7,0.841
21000647,1610612760,1610612752,101.0,98.0,0.386,0.43,1,2011-01-22,43,28,15,0.6509999999999999,43,22,21,0.512
21000648,1610612745,1610612753,104.0,118.0,0.389,0.529,0,2011-01-22,45,20,25,0.444,44,29,15,0.659
21000649,1610612749,1610612763,81.0,94.0,0.3779999999999999,0.514,0,2011-01-22,41,16,25,0.39,44,21,23,0.477
21000650,1610612757,1610612754,97.0,92.0,0.422,0.474,1,2011-01-22,45,25,20,0.556,40,16,24,0.4
21000651,1610612746,1610612744,113.0,109.0,0.435,0.4589999999999999,1,2011-01-22,43,17,26,0.395,43,19,24,0.442
21000629,1610612751,1610612765,89.0,74.0,0.5,0.3329999999999999,1,2011-01-21,43,12,31,0.2789999999999999,43,15,28,0.349
21000630,1610612753,1610612761,112.0,72.0,0.472,0.354,1,2011-01-21,43,28,15,0.6509999999999999,43,13,30,0.302
21000634,1610612764,1610612756,91.0,109.0,0.407,0.477,0,2011-01-21,41,12,29,0.293,41,20,21,0.488
21000631,1610612737,1610612740,59.0,100.0,0.291,0.48,0,2011-01-21,44,28,16,0.636,44,28,16,0.636
21000632,1610612738,1610612762,110.0,86.0,0.552,0.4,1,2011-01-21,42,33,9,0.7859999999999999,43,27,16,0.628
21000633,1610612739,1610612749,88.0,102.0,0.382,0.506,0,2011-01-21,42,8,34,0.19,40,16,24,0.4
21000635,1610612763,1610612745,115.0,110.0,0.5329999999999999,0.4579999999999999,1,2011-01-21,43,20,23,0.465,44,20,24,0.455
21000636,1610612759,1610612752,101.0,92.0,0.488,0.3779999999999999,1,2011-01-21,43,37,6,0.86,42,22,20,0.524
21000637,1610612743,1610612747,97.0,107.0,0.474,0.534,0,2011-01-21,42,24,18,0.5710000000000001,45,32,13,0.711
21000638,1610612744,1610612758,119.0,112.0,0.516,0.447,1,2011-01-21,42,19,23,0.452,41,9,32,0.22
21000626,1610612766,1610612755,100.0,97.0,0.481,0.4589999999999999,1,2011-01-20,41,17,24,0.415,42,17,25,0.405
21000627,1610612741,1610612742,82.0,77.0,0.369,0.356,1,2011-01-20,43,29,14,0.674,42,27,15,0.643
21000628,1610612757,1610612746,108.0,93.0,0.564,0.4320000000000001,1,2011-01-20,44,24,20,0.545,42,16,26,0.381
21000613,1610612739,1610612756,98.0,106.0,0.434,0.471,0,2011-01-19,41,8,33,0.195,40,19,21,0.475
21000614,1610612751,1610612762,103.0,95.0,0.493,0.416,1,2011-01-19,42,11,31,0.262,42,27,15,0.643
21000615,1610612753,1610612755,99.0,98.0,0.4529999999999999,0.429,1,2011-01-19,42,27,15,0.643,41,17,24,0.415
21000616,1610612738,1610612765,86.0,82.0,0.447,0.419,1,2011-01-19,41,32,9,0.78,42,15,27,0.357
21000617,1610612749,1610612764,100.0,87.0,0.479,0.4429999999999999,1,2011-01-19,39,15,24,0.385,40,12,28,0.3
21000618,1610612740,1610612763,103.0,102.0,0.481,0.462,1,2011-01-19,43,27,16,0.628,42,19,23,0.452
21000619,1610612745,1610612752,104.0,89.0,0.471,0.422,1,2011-01-19,43,20,23,0.465,41,22,19,0.537
21000620,1610612759,1610612761,104.0,95.0,0.4579999999999999,0.439,1,2011-01-19,42,36,6,0.857,42,13,29,0.31
21000621,1610612742,1610612747,109.0,100.0,0.55,0.5429999999999999,1,2011-01-19,41,27,14,0.659,44,31,13,0.705
21000622,1610612743,1610612760,112.0,107.0,0.512,0.482,1,2011-01-19,41,24,17,0.585,42,27,15,0.643
21000623,1610612758,1610612757,90.0,94.0,0.4270000000000001,0.4320000000000001,0,2011-01-19,40,9,31,0.225,43,23,20,0.535
21000624,1610612744,1610612754,110.0,108.0,0.511,0.457,1,2011-01-19,41,18,23,0.439,39,16,23,0.41
21000625,1610612746,1610612750,126.0,111.0,0.494,0.5,1,2011-01-19,41,16,25,0.39,43,10,33,0.233
21000611,1610612748,1610612737,89.0,93.0,0.364,0.4,0,2011-01-18,43,30,13,0.698,43,28,15,0.6509999999999999
21000612,1610612741,1610612766,82.0,83.0,0.39,0.402,0,2011-01-18,42,28,14,0.667,40,16,24,0.4
21000598,1610612752,1610612756,121.0,129.0,0.489,0.495,0,2011-01-17,40,22,18,0.55,39,18,21,0.462
21000599,1610612764,1610612762,108.0,101.0,0.535,0.45,1,2011-01-17,39,12,27,0.308,41,27,14,0.659
21000600,1610612763,1610612741,84.0,96.0,0.377,0.486,0,2011-01-17,41,19,22,0.4629999999999999,41,28,13,0.6829999999999999
21000601,1610612755,1610612766,96.0,92.0,0.387,0.358,1,2011-01-17,40,17,23,0.425,39,15,24,0.385
21000602,1610612745,1610612749,93.0,84.0,0.368,0.44,1,2011-01-17,42,19,23,0.452,38,14,24,0.368
21000603,1610612740,1610612761,85.0,81.0,0.391,0.446,1,2011-01-17,42,26,16,0.619,41,13,28,0.317
21000604,1610612765,1610612742,103.0,89.0,0.575,0.466,1,2011-01-17,41,15,26,0.366,40,26,14,0.65
21000605,1610612746,1610612754,114.0,107.0,0.5429999999999999,0.4589999999999999,1,2011-01-17,40,15,25,0.375,38,16,22,0.421
21000606,1610612737,1610612758,100.0,98.0,0.47,0.446,1,2011-01-17,42,27,15,0.643,39,9,30,0.231
21000607,1610612744,1610612751,109.0,100.0,0.494,0.488,1,2011-01-17,40,17,23,0.425,41,10,31,0.244
21000608,1610612738,1610612753,109.0,106.0,0.6,0.4589999999999999,1,2011-01-17,40,31,9,0.775,41,26,15,0.634
21000609,1610612757,1610612750,113.0,102.0,0.452,0.4320000000000001,1,2011-01-17,42,22,20,0.524,42,10,32,0.238
21000610,1610612747,1610612760,101.0,94.0,0.5,0.425,1,2011-01-17,43,31,12,0.721,41,27,14,0.659
21000596,1610612746,1610612747,99.0,92.0,0.4370000000000001,0.413,1,2011-01-16,39,14,25,0.359,42,30,12,0.7140000000000001
21000597,1610612759,1610612743,110.0,97.0,0.515,0.43,1,2011-01-16,41,35,6,0.8540000000000001,40,23,17,0.575
21000587,1610612737,1610612745,106.0,112.0,0.494,0.54,0,2011-01-15,41,26,15,0.634,41,18,23,0.439
21000588,1610612766,1610612740,81.0,88.0,0.406,0.451,0,2011-01-15,38,15,23,0.395,41,25,16,0.61
21000589,1610612764,1610612761,98.0,95.0,0.4589999999999999,0.471,1,2011-01-15,38,11,27,0.289,40,13,27,0.325
21000590,1610612765,1610612758,110.0,106.0,0.5579999999999999,0.512,1,2011-01-15,40,14,26,0.35,38,9,29,0.237
21000591,1610612741,1610612748,99.0,96.0,0.4639999999999999,0.442,1,2011-01-15,40,27,13,0.675,42,30,12,0.7140000000000001
21000592,1610612763,1610612742,89.0,70.0,0.474,0.324,1,2011-01-15,40,19,21,0.475,39,26,13,0.667
21000593,1610612750,1610612753,99.0,108.0,0.44,0.444,0,2011-01-15,41,10,31,0.244,40,26,14,0.65
21000594,1610612743,1610612739,127.0,99.0,0.583,0.3779999999999999,1,2011-01-15,39,23,16,0.59,40,8,32,0.2
21000595,1610612757,1610612751,96.0,89.0,0.456,0.5,1,2011-01-15,41,21,20,0.512,40,10,30,0.25
21000576,1610612754,1610612741,86.0,99.0,0.326,0.455,0,2011-01-14,37,16,21,0.4320000000000001,39,26,13,0.667
21000577,1610612755,1610612749,95.0,94.0,0.5710000000000001,0.475,1,2011-01-14,39,16,23,0.41,37,14,23,0.3779999999999999
21000578,1610612761,1610612765,95.0,101.0,0.475,0.446,0,2011-01-14,39,13,26,0.3329999999999999,39,13,26,0.3329999999999999
21000579,1610612738,1610612766,99.0,94.0,0.522,0.421,1,2011-01-14,39,30,9,0.769,37,15,22,0.405
21000580,1610612752,1610612758,83.0,93.0,0.315,0.424,0,2011-01-14,39,22,17,0.564,37,9,28,0.243
21000581,1610612759,1610612742,101.0,89.0,0.45,0.434,1,2011-01-14,40,34,6,0.85,38,26,12,0.684
21000582,1610612745,1610612740,105.0,110.0,0.44,0.476,0,2011-01-14,40,17,23,0.425,40,24,16,0.6
21000583,1610612762,1610612739,121.0,99.0,0.522,0.488,1,2011-01-14,40,27,13,0.675,39,8,31,0.205
21000584,1610612756,1610612757,115.0,111.0,0.5379999999999999,0.481,1,2011-01-14,38,17,21,0.447,40,20,20,0.5
21000585,1610612744,1610612746,122.0,112.0,0.524,0.529,1,2011-01-14,39,16,23,0.41,38,13,25,0.342
21000586,1610612747,1610612751,100.0,88.0,0.493,0.424,1,2011-01-14,41,30,11,0.732,39,10,29,0.256
21000573,1610612750,1610612764,109.0,97.0,0.449,0.474,1,2011-01-13,40,10,30,0.25,37,10,27,0.27
21000574,1610612760,1610612753,125.0,124.0,0.564,0.456,1,2011-01-13,40,27,13,0.675,39,25,14,0.6409999999999999
21000575,1610612743,1610612748,130.0,102.0,0.5329999999999999,0.461,1,2011-01-13,38,22,16,0.579,41,30,11,0.732
21000561,1610612766,1610612741,96.0,91.0,0.4320000000000001,0.471,1,2011-01-12,36,15,21,0.417,38,25,13,0.6579999999999999
21000562,1610612754,1610612742,102.0,89.0,0.446,0.413,1,2011-01-12,36,16,20,0.444,37,26,11,0.703
21000563,1610612761,1610612737,101.0,104.0,0.5429999999999999,0.4379999999999999,0,2011-01-12,38,13,25,0.342,40,26,14,0.65
21000564,1610612738,1610612758,119.0,95.0,0.521,0.514,1,2011-01-12,38,29,9,0.763,36,8,28,0.222
21000565,1610612765,1610612763,99.0,107.0,0.439,0.521,0,2011-01-12,38,12,26,0.316,39,18,21,0.462
21000566,1610612749,1610612759,84.0,91.0,0.395,0.4629999999999999,0,2011-01-12,36,14,22,0.389,39,33,6,0.846
21000567,1610612740,1610612753,92.0,89.0,0.4370000000000001,0.391,1,2011-01-12,39,23,16,0.59,38,25,13,0.6579999999999999
21000568,1610612745,1610612760,112.0,118.0,0.49,0.512,0,2011-01-12,39,17,22,0.436,39,26,13,0.667
21000569,1610612756,1610612751,118.0,109.0,0.4629999999999999,0.477,1,2011-01-12,37,16,21,0.4320000000000001,38,10,28,0.263
21000570,1610612762,1610612752,131.0,125.0,0.584,0.506,1,2011-01-12,39,26,13,0.667,38,22,16,0.579
21000571,1610612744,1610612747,110.0,115.0,0.506,0.512,0,2011-01-12,38,15,23,0.395,40,29,11,0.725
21000572,1610612746,1610612748,111.0,105.0,0.5,0.42,1,2011-01-12,37,13,24,0.351,40,30,10,0.75
21000555,1610612755,1610612754,103.0,111.0,0.477,0.511,0,2011-01-11,38,15,23,0.395,35,15,20,0.429
21000556,1610612764,1610612758,136.0,133.0,0.495,0.491,1,2011-01-11,36,10,26,0.278,35,8,27,0.2289999999999999
21000557,1610612750,1610612759,96.0,107.0,0.3779999999999999,0.4679999999999999,0,2011-01-11,39,9,30,0.231,38,32,6,0.8420000000000001
21000558,1610612743,1610612756,132.0,98.0,0.557,0.368,1,2011-01-11,37,21,16,0.568,36,15,21,0.417
21000559,1610612757,1610612752,86.0,100.0,0.345,0.506,0,2011-01-11,39,20,19,0.513,37,22,15,0.595
21000560,1610612747,1610612739,112.0,57.0,0.535,0.299,1,2011-01-11,39,28,11,0.718,38,8,30,0.211
21000551,1610612766,1610612763,96.0,82.0,0.514,0.391,1,2011-01-10,35,14,21,0.4,38,17,21,0.447
21000552,1610612738,1610612745,102.0,108.0,0.507,0.527,0,2011-01-10,37,28,9,0.757,38,17,21,0.447
21000553,1610612741,1610612765,95.0,82.0,0.455,0.3879999999999999,1,2011-01-10,37,25,12,0.6759999999999999,37,12,25,0.324
21000544,1610612761,1610612758,118.0,112.0,0.585,0.44,1,2011-01-09,37,13,24,0.351,34,8,26,0.235
21000545,1610612746,1610612744,105.0,91.0,0.395,0.39,1,2011-01-09,36,12,24,0.3329999999999999,37,15,22,0.405
21000546,1610612759,1610612750,94.0,91.0,0.423,0.396,1,2011-01-09,37,31,6,0.838,38,9,29,0.237
21000547,1610612756,1610612739,108.0,100.0,0.47,0.368,1,2011-01-09,35,15,20,0.429,37,8,29,0.216
21000548,1610612743,1610612740,87.0,96.0,0.405,0.473,0,2011-01-09,36,20,16,0.556,38,22,16,0.579
21000549,1610612757,1610612748,100.0,107.0,0.418,0.57,0,2011-01-09,38,20,18,0.526,39,30,9,0.769
21000550,1610612747,1610612752,109.0,87.0,0.418,0.36,1,2011-01-09,38,27,11,0.711,36,21,15,0.583
21000536,1610612737,1610612754,108.0,93.0,0.429,0.41,1,2011-01-08,39,25,14,0.6409999999999999,34,14,20,0.412
21000537,1610612766,1610612764,104.0,89.0,0.494,0.439,1,2011-01-08,34,13,21,0.382,35,9,26,0.257
21000538,1610612751,1610612749,92.0,115.0,0.45,0.583,0,2011-01-08,37,10,27,0.27,35,14,21,0.4
21000539,1610612765,1610612755,112.0,109.0,0.446,0.484,1,2011-01-08,36,12,24,0.3329999999999999,37,15,22,0.405
21000540,1610612741,1610612738,90.0,79.0,0.4920000000000001,0.3779999999999999,1,2011-01-08,36,24,12,0.667,36,28,8,0.778
21000541,1610612760,1610612763,109.0,100.0,0.473,0.43,1,2011-01-08,38,25,13,0.6579999999999999,37,17,20,0.4589999999999999
21000542,1610612742,1610612753,107.0,117.0,0.539,0.519,0,2011-01-08,36,26,10,0.722,37,25,12,0.6759999999999999
21000543,1610612745,1610612762,99.0,103.0,0.3779999999999999,0.471,0,2011-01-08,37,16,21,0.4320000000000001,38,25,13,0.6579999999999999
21000525,1610612754,1610612759,87.0,90.0,0.375,0.416,0,2011-01-07,33,14,19,0.424,36,30,6,0.833
21000526,1610612755,1610612741,105.0,99.0,0.563,0.507,1,2011-01-07,36,15,21,0.417,35,23,12,0.657
21000527,1610612764,1610612751,97.0,77.0,0.442,0.346,1,2011-01-07,34,9,25,0.265,36,10,26,0.278
21000528,1610612738,1610612761,122.0,102.0,0.575,0.506,1,2011-01-07,35,28,7,0.8,36,12,24,0.3329999999999999
21000529,1610612753,1610612745,110.0,95.0,0.517,0.415,1,2011-01-07,36,24,12,0.667,36,16,20,0.444
21000530,1610612763,1610612762,110.0,99.0,0.494,0.466,1,2011-01-07,36,17,19,0.472,37,24,13,0.649
21000531,1610612750,1610612757,98.0,108.0,0.487,0.465,0,2011-01-07,37,9,28,0.243,37,20,17,0.541
21000532,1610612749,1610612748,95.0,101.0,0.444,0.3929999999999999,0,2011-01-07,34,13,21,0.382,38,29,9,0.763
21000533,1610612756,1610612752,96.0,121.0,0.4270000000000001,0.5,0,2011-01-07,34,14,20,0.412,35,21,14,0.6
21000534,1610612744,1610612739,116.0,98.0,0.482,0.461,1,2011-01-07,36,15,21,0.417,36,8,28,0.222
21000535,1610612747,1610612740,101.0,97.0,0.506,0.434,1,2011-01-07,37,26,11,0.703,37,21,16,0.568
21000523,1610612742,1610612760,95.0,99.0,0.4679999999999999,0.47,0,2011-01-06,35,26,9,0.743,37,24,13,0.649
21000524,1610612758,1610612743,122.0,102.0,0.564,0.507,1,2011-01-06,33,8,25,0.242,35,20,15,0.5710000000000001
21000512,1610612739,1610612761,105.0,120.0,0.507,0.568,0,2011-01-05,35,8,27,0.2289999999999999,35,12,23,0.3429999999999999
21000513,1610612751,1610612741,96.0,94.0,0.494,0.442,1,2011-01-05,35,10,25,0.286,34,23,11,0.6759999999999999
21000514,1610612753,1610612749,97.0,87.0,0.455,0.3929999999999999,1,2011-01-05,35,23,12,0.657,33,13,20,0.3939999999999999
21000515,1610612755,1610612764,109.0,97.0,0.5670000000000001,0.488,1,2011-01-05,35,14,21,0.4,33,8,25,0.242
21000516,1610612738,1610612759,105.0,103.0,0.613,0.4529999999999999,1,2011-01-05,34,27,7,0.794,35,29,6,0.8290000000000001
21000517,1610612750,1610612766,105.0,108.0,0.447,0.439,0,2011-01-05,36,9,27,0.25,33,12,21,0.364
21000518,1610612740,1610612744,103.0,110.0,0.5,0.481,0,2011-01-05,36,21,15,0.583,35,14,21,0.4
21000519,1610612745,1610612757,100.0,103.0,0.471,0.482,0,2011-01-05,35,16,19,0.457,36,19,17,0.528
21000520,1610612762,1610612737,87.0,110.0,0.3939999999999999,0.506,0,2011-01-05,36,24,12,0.667,38,24,14,0.632
21000521,1610612756,1610612747,95.0,99.0,0.486,0.471,0,2011-01-05,33,14,19,0.424,36,25,11,0.6940000000000001
21000522,1610612746,1610612743,106.0,93.0,0.429,0.375,1,2011-01-05,35,11,24,0.314,34,20,14,0.588
21000505,1610612748,1610612749,101.0,89.0,0.446,0.397,1,2011-01-04,37,28,9,0.757,32,13,19,0.406
21000506,1610612752,1610612759,128.0,115.0,0.5489999999999999,0.537,1,2011-01-04,34,20,14,0.588,34,29,5,0.853
21000507,1610612741,1610612761,111.0,91.0,0.53,0.449,1,2011-01-04,33,23,10,0.6970000000000001,34,11,23,0.324
21000508,1610612763,1610612760,110.0,105.0,0.512,0.513,1,2011-01-04,35,16,19,0.457,36,23,13,0.639
21000509,1610612742,1610612757,84.0,81.0,0.429,0.418,1,2011-01-04,34,26,8,0.765,35,18,17,0.514
21000510,1610612758,1610612737,102.0,108.0,0.4479999999999999,0.513,0,2011-01-04,32,7,25,0.2189999999999999,37,23,14,0.622
21000511,1610612747,1610612765,108.0,83.0,0.472,0.444,1,2011-01-04,35,24,11,0.6859999999999999,35,11,24,0.314
21000499,1610612766,1610612748,82.0,96.0,0.38,0.487,0,2011-01-03,32,11,21,0.344,36,27,9,0.75
21000500,1610612753,1610612744,110.0,90.0,0.494,0.409,1,2011-01-03,34,22,12,0.647,34,13,21,0.382
21000501,1610612738,1610612750,96.0,93.0,0.451,0.417,1,2011-01-03,33,26,7,0.7879999999999999,35,9,26,0.257
21000502,1610612740,1610612755,84.0,77.0,0.449,0.341,1,2011-01-03,35,21,14,0.6,34,13,21,0.382
21000503,1610612743,1610612745,113.0,106.0,0.469,0.429,1,2011-01-03,33,20,13,0.606,34,16,18,0.471
21000504,1610612762,1610612765,102.0,97.0,0.472,0.457,1,2011-01-03,35,24,11,0.6859999999999999,34,11,23,0.324
21000492,1610612752,1610612754,98.0,92.0,0.425,0.374,1,2011-01-02,33,19,14,0.5760000000000001,32,14,18,0.4379999999999999
21000493,1610612746,1610612737,98.0,107.0,0.4629999999999999,0.457,0,2011-01-02,34,10,24,0.294,36,22,14,0.611
21000494,1610612761,1610612738,79.0,93.0,0.3779999999999999,0.5429999999999999,0,2011-01-02,33,11,22,0.3329999999999999,32,25,7,0.7809999999999999
21000495,1610612739,1610612742,95.0,104.0,0.506,0.482,0,2011-01-02,34,8,26,0.235,33,25,8,0.758
21000496,1610612757,1610612745,100.0,85.0,0.4320000000000001,0.413,1,2011-01-02,34,18,16,0.529,33,16,17,0.485
21000497,1610612758,1610612756,94.0,89.0,0.405,0.402,1,2011-01-02,31,7,24,0.226,32,14,18,0.4379999999999999
21000498,1610612747,1610612763,85.0,104.0,0.465,0.456,0,2011-01-02,34,23,11,0.6759999999999999,34,15,19,0.441
21000484,1610612764,1610612740,81.0,92.0,0.429,0.462,0,2011-01-01,32,8,24,0.25,34,20,14,0.588
21000485,1610612741,1610612739,100.0,91.0,0.4379999999999999,0.402,1,2011-01-01,32,22,10,0.688,33,8,25,0.242
21000486,1610612748,1610612744,114.0,107.0,0.493,0.471,1,2011-01-01,35,26,9,0.743,33,13,20,0.3939999999999999
21000487,1610612750,1610612751,103.0,88.0,0.507,0.452,1,2011-01-01,34,9,25,0.265,34,9,25,0.265
21000488,1610612759,1610612760,101.0,74.0,0.467,0.3289999999999999,1,2011-01-01,33,29,4,0.879,35,23,12,0.657
21000489,1610612749,1610612742,99.0,87.0,0.494,0.375,1,2011-01-01,31,13,18,0.419,32,24,8,0.75
21000490,1610612743,1610612758,104.0,86.0,0.4589999999999999,0.422,1,2011-01-01,32,19,13,0.594,30,6,24,0.2
21000491,1610612762,1610612763,98.0,92.0,0.486,0.429,1,2011-01-01,34,23,11,0.6759999999999999,33,14,19,0.424
21000476,1610612738,1610612740,81.0,83.0,0.447,0.434,0,2010-12-31,31,24,7,0.774,33,19,14,0.5760000000000001
21000477,1610612766,1610612744,95.0,96.0,0.422,0.494,0,2010-12-31,31,11,20,0.355,32,13,19,0.406
21000478,1610612754,1610612764,95.0,86.0,0.487,0.3879999999999999,1,2010-12-31,31,14,17,0.452,31,8,23,0.258
21000479,1610612741,1610612751,90.0,81.0,0.395,0.39,1,2010-12-31,31,21,10,0.677,33,9,24,0.273
21000480,1610612745,1610612761,114.0,105.0,0.484,0.417,1,2010-12-31,32,16,16,0.5,32,11,21,0.344
21000481,1610612760,1610612737,103.0,94.0,0.481,0.452,1,2010-12-31,34,23,11,0.6759999999999999,35,21,14,0.6
21000482,1610612756,1610612765,92.0,75.0,0.479,0.408,1,2010-12-31,31,14,17,0.452,33,11,22,0.3329999999999999
21000483,1610612747,1610612755,102.0,98.0,0.512,0.47,1,2010-12-31,33,23,10,0.6970000000000001,33,13,20,0.3939999999999999
21000473,1610612753,1610612752,112.0,103.0,0.477,0.4629999999999999,1,2010-12-30,33,21,12,0.636,32,18,14,0.563
21000474,1610612742,1610612759,93.0,99.0,0.4270000000000001,0.461,0,2010-12-30,31,24,7,0.774,32,28,4,0.875
21000475,1610612757,1610612762,100.0,89.0,0.4589999999999999,0.484,1,2010-12-30,33,17,16,0.515,33,22,11,0.667
21000462,1610612737,1610612744,103.0,93.0,0.512,0.446,1,2010-12-29,34,21,13,0.618,31,12,19,0.387
21000463,1610612766,1610612739,101.0,92.0,0.447,0.405,1,2010-12-29,30,11,19,0.3670000000000001,32,8,24,0.25
21000464,1610612764,1610612754,104.0,90.0,0.3979999999999999,0.412,1,2010-12-29,30,8,22,0.267,30,13,17,0.433
21000465,1610612765,1610612738,104.0,92.0,0.557,0.515,1,2010-12-29,32,11,21,0.344,30,24,6,0.8
21000466,1610612750,1610612743,113.0,119.0,0.488,0.4589999999999999,0,2010-12-29,33,8,25,0.242,31,18,13,0.581
21000467,1610612740,1610612747,88.0,103.0,0.418,0.586,0,2010-12-29,32,18,14,0.563,32,22,10,0.688
21000468,1610612760,1610612751,114.0,93.0,0.5489999999999999,0.479,1,2010-12-29,33,22,11,0.667,32,9,23,0.281
21000469,1610612745,1610612748,119.0,125.0,0.419,0.581,0,2010-12-29,31,15,16,0.484,34,25,9,0.735
21000470,1610612756,1610612755,110.0,123.0,0.494,0.5489999999999999,0,2010-12-29,30,13,17,0.433,32,13,19,0.406
21000471,1610612758,1610612763,100.0,98.0,0.461,0.4370000000000001,1,2010-12-29,29,6,23,0.207,32,14,18,0.4379999999999999
21000472,1610612746,1610612762,95.0,103.0,0.486,0.471,0,2010-12-29,33,10,23,0.303,32,22,10,0.688
21000455,1610612739,1610612753,95.0,110.0,0.4579999999999999,0.506,0,2010-12-28,31,8,23,0.258,32,20,12,0.625
21000456,1610612754,1610612738,83.0,95.0,0.3720000000000001,0.507,0,2010-12-28,29,13,16,0.4479999999999999,29,24,5,0.828
21000457,1610612748,1610612752,106.0,98.0,0.481,0.415,1,2010-12-28,33,24,9,0.727,31,18,13,0.581
21000458,1610612741,1610612749,90.0,77.0,0.474,0.321,1,2010-12-28,30,20,10,0.667,30,12,18,0.4
21000459,1610612742,1610612761,76.0,84.0,0.413,0.478,0,2010-12-28,30,24,6,0.8,31,11,20,0.355
21000460,1610612759,1610612747,97.0,82.0,0.425,0.354,1,2010-12-28,31,27,4,0.871,31,21,10,0.677
21000461,1610612743,1610612757,95.0,77.0,0.4529999999999999,0.4,1,2010-12-28,30,17,13,0.5670000000000001,32,16,16,0.5
21000445,1610612766,1610612765,105.0,100.0,0.526,0.4370000000000001,1,2010-12-27,29,10,19,0.345,31,10,21,0.3229999999999999
21000446,1610612751,1610612753,88.0,104.0,0.392,0.476,0,2010-12-27,31,9,22,0.29,31,19,12,0.613
21000447,1610612763,1610612761,96.0,85.0,0.507,0.5,1,2010-12-27,31,14,17,0.452,30,10,20,0.3329999999999999
21000448,1610612749,1610612737,80.0,95.0,0.373,0.507,0,2010-12-27,29,12,17,0.414,33,20,13,0.606
21000449,1610612750,1610612740,113.0,98.0,0.532,0.424,1,2010-12-27,32,8,24,0.25,31,18,13,0.581
21000450,1610612760,1610612742,93.0,103.0,0.42,0.488,0,2010-12-27,32,21,11,0.6559999999999999,29,24,5,0.828
21000451,1610612745,1610612764,100.0,93.0,0.457,0.4,1,2010-12-27,30,15,15,0.5,29,7,22,0.241
21000452,1610612762,1610612757,91.0,96.0,0.4320000000000001,0.471,0,2010-12-27,31,21,10,0.677,31,16,15,0.516
21000453,1610612758,1610612746,99.0,100.0,0.414,0.482,0,2010-12-27,28,5,23,0.179,32,10,22,0.313
21000454,1610612744,1610612755,110.0,95.0,0.47,0.4320000000000001,1,2010-12-27,30,12,18,0.4,31,12,19,0.387
21000438,1610612746,1610612756,108.0,103.0,0.5329999999999999,0.4479999999999999,1,2010-12-26,31,9,22,0.29,29,13,16,0.4479999999999999
21000439,1610612739,1610612750,97.0,98.0,0.46,0.3879999999999999,0,2010-12-26,30,8,22,0.267,31,7,24,0.226
21000440,1610612765,1610612741,92.0,95.0,0.4270000000000001,0.396,0,2010-12-26,30,10,20,0.3329999999999999,29,19,10,0.655
21000441,1610612754,1610612763,90.0,104.0,0.356,0.4429999999999999,0,2010-12-26,28,13,15,0.4639999999999999,30,13,17,0.433
21000442,1610612740,1610612737,93.0,86.0,0.488,0.397,1,2010-12-26,30,18,12,0.6,32,19,13,0.594
21000443,1610612759,1610612764,94.0,80.0,0.451,0.375,1,2010-12-26,30,26,4,0.867,28,7,21,0.25
21000444,1610612743,1610612755,89.0,95.0,0.4,0.396,0,2010-12-26,29,16,13,0.552,30,12,18,0.4
21000433,1610612752,1610612741,103.0,95.0,0.532,0.44,1,2010-12-25,30,18,12,0.6,28,18,10,0.643
21000434,1610612753,1610612738,86.0,78.0,0.3939999999999999,0.346,1,2010-12-25,30,18,12,0.6,28,23,5,0.821
21000435,1610612747,1610612748,80.0,96.0,0.405,0.4429999999999999,0,2010-12-25,30,21,9,0.7,32,23,9,0.7190000000000001
21000436,1610612760,1610612743,114.0,106.0,0.494,0.529,1,2010-12-25,31,21,10,0.677,28,16,12,0.5710000000000001
21000437,1610612744,1610612757,109.0,102.0,0.482,0.423,1,2010-12-25,29,11,18,0.379,30,15,15,0.5
21000430,1610612753,1610612759,123.0,101.0,0.595,0.422,1,2010-12-23,29,17,12,0.586,29,25,4,0.862
21000431,1610612758,1610612749,79.0,84.0,0.365,0.4320000000000001,0,2010-12-23,27,5,22,0.185,28,12,16,0.429
21000432,1610612756,1610612748,83.0,95.0,0.4,0.451,0,2010-12-23,28,13,15,0.4639999999999999,31,22,9,0.71
21000421,1610612737,1610612739,98.0,84.0,0.506,0.42,1,2010-12-22,31,19,12,0.613,29,8,21,0.276
21000422,1610612761,1610612765,93.0,115.0,0.522,0.511,0,2010-12-22,29,10,19,0.345,29,10,19,0.345
21000423,1610612764,1610612741,80.0,87.0,0.38,0.425,0,2010-12-22,27,7,20,0.259,27,18,9,0.667
21000424,1610612738,1610612755,84.0,80.0,0.3879999999999999,0.431,1,2010-12-22,27,23,4,0.852,29,11,18,0.379
21000425,1610612752,1610612760,112.0,98.0,0.488,0.392,1,2010-12-22,29,17,12,0.586,30,20,10,0.667
21000426,1610612750,1610612762,107.0,112.0,0.425,0.493,0,2010-12-22,30,6,24,0.2,30,21,9,0.7
21000427,1610612740,1610612751,105.0,91.0,0.539,0.457,1,2010-12-22,29,17,12,0.586,30,9,21,0.3
21000428,1610612759,1610612743,109.0,103.0,0.526,0.449,1,2010-12-22,28,25,3,0.893,27,16,11,0.593
21000429,1610612746,1610612745,92.0,97.0,0.402,0.4270000000000001,0,2010-12-22,30,8,22,0.267,29,14,15,0.483
21000415,1610612766,1610612760,81.0,99.0,0.4,0.4370000000000001,0,2010-12-21,28,9,19,0.321,29,20,9,0.69
21000416,1610612753,1610612742,99.0,105.0,0.442,0.5,0,2010-12-21,28,16,12,0.5710000000000001,28,23,5,0.821
21000417,1610612741,1610612755,121.0,76.0,0.645,0.35,1,2010-12-21,26,17,9,0.654,28,11,17,0.3929999999999999
21000418,1610612763,1610612751,94.0,101.0,0.3979999999999999,0.526,0,2010-12-21,29,12,17,0.414,29,9,20,0.31
21000419,1610612758,1610612744,109.0,117.0,0.39,0.472,0,2010-12-21,26,5,21,0.192,28,10,18,0.357
21000420,1610612747,1610612749,79.0,98.0,0.455,0.507,0,2010-12-21,29,21,8,0.7240000000000001,27,11,16,0.407
21000406,1610612737,1610612753,91.0,81.0,0.413,0.352,1,2010-12-20,30,18,12,0.6,27,16,11,0.593
21000407,1610612739,1610612762,90.0,101.0,0.417,0.476,0,2010-12-20,28,8,20,0.286,29,20,9,0.69
21000408,1610612754,1610612740,94.0,93.0,0.425,0.3979999999999999,1,2010-12-20,27,13,14,0.481,28,16,12,0.5710000000000001
21000409,1610612764,1610612766,108.0,75.0,0.521,0.452,1,2010-12-20,26,7,19,0.2689999999999999,27,9,18,0.3329999999999999
21000410,1610612748,1610612742,96.0,98.0,0.405,0.446,0,2010-12-20,30,21,9,0.7,27,22,5,0.815
21000411,1610612759,1610612756,118.0,110.0,0.483,0.535,1,2010-12-20,27,24,3,0.889,27,13,14,0.481
21000412,1610612757,1610612749,106.0,80.0,0.5,0.38,1,2010-12-20,29,15,14,0.517,26,10,16,0.385
21000413,1610612744,1610612745,112.0,121.0,0.512,0.5,0,2010-12-20,27,9,18,0.3329999999999999,28,13,15,0.4639999999999999
21000414,1610612746,1610612750,113.0,90.0,0.518,0.4,1,2010-12-20,29,8,21,0.276,29,6,23,0.207
21000400,1610612738,1610612754,99.0,88.0,0.539,0.354,1,2010-12-19,26,22,4,0.846,26,12,14,0.462
21000401,1610612751,1610612737,89.0,82.0,0.417,0.392,1,2010-12-19,28,8,20,0.286,29,17,12,0.586
21000402,1610612761,1610612747,110.0,120.0,0.471,0.519,0,2010-12-19,28,10,18,0.357,28,21,7,0.75
21000403,1610612765,1610612740,111.0,108.0,0.53,0.4479999999999999,1,2010-12-19,28,9,19,0.321,27,16,11,0.593
21000404,1610612758,1610612745,93.0,102.0,0.385,0.446,0,2010-12-19,25,5,20,0.2,27,12,15,0.444
21000405,1610612760,1610612756,110.0,113.0,0.429,0.575,0,2010-12-19,28,19,9,0.679,26,13,13,0.5
21000392,1610612753,1610612755,89.0,97.0,0.414,0.442,0,2010-12-18,26,16,10,0.615,27,11,16,0.407
21000393,1610612764,1610612748,94.0,95.0,0.425,0.431,0,2010-12-18,25,6,19,0.24,29,21,8,0.7240000000000001
21000394,1610612739,1610612752,109.0,102.0,0.412,0.411,1,2010-12-18,27,8,19,0.296,28,16,12,0.5710000000000001
21000395,1610612741,1610612746,99.0,100.0,0.476,0.507,0,2010-12-18,25,16,9,0.64,28,7,21,0.25
21000396,1610612749,1610612762,86.0,95.0,0.451,0.422,0,2010-12-18,25,10,15,0.4,28,19,9,0.679
21000397,1610612759,1610612763,112.0,106.0,0.512,0.442,1,2010-12-18,26,23,3,0.885,28,12,16,0.429
21000398,1610612743,1610612750,115.0,113.0,0.4529999999999999,0.4639999999999999,1,2010-12-18,26,16,10,0.615,28,6,22,0.214
21000399,1610612757,1610612744,96.0,95.0,0.487,0.444,1,2010-12-18,28,14,14,0.5,26,9,17,0.346
21000381,1610612754,1610612739,108.0,99.0,0.469,0.415,1,2010-12-17,25,12,13,0.48,26,7,19,0.2689999999999999
21000382,1610612752,1610612748,91.0,113.0,0.3929999999999999,0.5489999999999999,0,2010-12-17,27,16,11,0.593,28,20,8,0.7140000000000001
21000383,1610612755,1610612747,81.0,93.0,0.375,0.418,0,2010-12-17,26,10,16,0.385,27,20,7,0.741
21000384,1610612761,1610612751,98.0,92.0,0.465,0.45,1,2010-12-17,27,10,17,0.37,27,7,20,0.259
21000385,1610612737,1610612766,90.0,85.0,0.462,0.379,1,2010-12-17,28,17,11,0.607,26,9,17,0.346
21000386,1610612765,1610612746,88.0,109.0,0.402,0.568,0,2010-12-17,27,8,19,0.296,27,6,21,0.222
21000387,1610612740,1610612762,100.0,71.0,0.507,0.358,1,2010-12-17,26,16,10,0.615,27,18,9,0.667
21000388,1610612760,1610612758,102.0,87.0,0.481,0.4270000000000001,1,2010-12-17,27,19,8,0.7040000000000001,24,5,19,0.208
21000389,1610612745,1610612763,103.0,87.0,0.481,0.365,1,2010-12-17,26,11,15,0.423,27,12,15,0.444
21000390,1610612742,1610612756,106.0,91.0,0.4529999999999999,0.3929999999999999,1,2010-12-17,26,21,5,0.8079999999999999,25,12,13,0.48
21000391,1610612757,1610612750,107.0,102.0,0.506,0.446,1,2010-12-17,27,13,14,0.481,27,6,21,0.222
21000378,1610612751,1610612764,97.0,89.0,0.405,0.397,1,2010-12-16,26,7,19,0.2689999999999999,24,6,18,0.25
21000379,1610612738,1610612737,102.0,90.0,0.53,0.5,1,2010-12-16,25,21,4,0.84,27,16,11,0.593
21000380,1610612743,1610612759,112.0,113.0,0.481,0.518,0,2010-12-16,25,15,10,0.6,25,22,3,0.88
21000367,1610612754,1610612747,94.0,109.0,0.469,0.512,0,2010-12-15,24,11,13,0.4579999999999999,26,19,7,0.731
21000368,1610612752,1610612738,116.0,118.0,0.531,0.523,0,2010-12-15,26,16,10,0.615,24,20,4,0.833
21000369,1610612755,1610612746,105.0,91.0,0.44,0.3979999999999999,1,2010-12-15,25,10,15,0.4,26,5,21,0.192
21000370,1610612761,1610612741,93.0,110.0,0.442,0.531,0,2010-12-15,26,9,17,0.346,24,16,8,0.667
21000371,1610612748,1610612739,101.0,95.0,0.457,0.402,1,2010-12-15,27,19,8,0.7040000000000001,25,7,18,0.28
21000372,1610612763,1610612766,113.0,80.0,0.524,0.412,1,2010-12-15,26,12,14,0.462,25,9,16,0.36
21000373,1610612740,1610612758,94.0,91.0,0.436,0.4639999999999999,1,2010-12-15,25,15,10,0.6,23,5,18,0.217
21000374,1610612760,1610612745,117.0,105.0,0.5770000000000001,0.4629999999999999,1,2010-12-15,26,18,8,0.6920000000000001,25,10,15,0.4
21000375,1610612759,1610612749,92.0,90.0,0.522,0.4429999999999999,1,2010-12-15,24,21,3,0.875,24,10,14,0.417
21000376,1610612756,1610612750,128.0,122.0,0.506,0.5379999999999999,1,2010-12-15,24,12,12,0.5,26,6,20,0.231
21000377,1610612742,1610612757,103.0,98.0,0.541,0.494,1,2010-12-15,25,20,5,0.8,26,12,14,0.462
21000360,1610612766,1610612761,97.0,91.0,0.52,0.4039999999999999,1,2010-12-14,24,9,15,0.375,25,9,16,0.36
21000361,1610612751,1610612755,77.0,82.0,0.341,0.405,0,2010-12-14,25,6,19,0.24,24,9,15,0.375
21000362,1610612764,1610612747,89.0,103.0,0.407,0.4529999999999999,0,2010-12-14,23,6,17,0.261,25,18,7,0.72
21000363,1610612765,1610612737,103.0,80.0,0.474,0.441,1,2010-12-14,26,8,18,0.308,26,16,10,0.615
21000364,1610612745,1610612758,118.0,105.0,0.5,0.525,1,2010-12-14,24,10,14,0.417,22,5,17,0.2269999999999999
21000365,1610612743,1610612753,111.0,94.0,0.5379999999999999,0.436,1,2010-12-14,24,15,9,0.625,25,16,9,0.64
21000366,1610612744,1610612750,108.0,99.0,0.506,0.4589999999999999,1,2010-12-14,25,9,16,0.36,25,6,19,0.24
21000355,1610612748,1610612740,96.0,84.0,0.4429999999999999,0.418,1,2010-12-13,26,18,8,0.6920000000000001,24,14,10,0.583
21000356,1610612741,1610612754,92.0,73.0,0.4679999999999999,0.357,1,2010-12-13,23,15,8,0.652,23,11,12,0.478
21000357,1610612763,1610612757,86.0,73.0,0.3829999999999999,0.3670000000000001,1,2010-12-13,25,11,14,0.44,25,12,13,0.48
21000358,1610612742,1610612749,99.0,103.0,0.487,0.476,0,2010-12-13,24,19,5,0.792,23,10,13,0.435
21000359,1610612762,1610612744,108.0,95.0,0.494,0.395,1,2010-12-13,26,18,8,0.6920000000000001,24,8,16,0.3329999999999999
21000349,1610612752,1610612743,129.0,125.0,0.523,0.506,1,2010-12-12,25,16,9,0.64,23,14,9,0.609
21000350,1610612755,1610612740,88.0,70.0,0.429,0.304,1,2010-12-12,23,8,15,0.348,23,14,9,0.609
21000351,1610612751,1610612747,92.0,99.0,0.4039999999999999,0.415,0,2010-12-12,24,6,18,0.25,24,17,7,0.708
21000353,1610612759,1610612757,95.0,78.0,0.4320000000000001,0.379,1,2010-12-12,23,20,3,0.87,24,12,12,0.5
21000352,1610612760,1610612739,106.0,77.0,0.532,0.3379999999999999,1,2010-12-12,25,17,8,0.68,24,7,17,0.292
21000354,1610612746,1610612753,85.0,94.0,0.381,0.48,0,2010-12-12,25,5,20,0.2,24,16,8,0.667
21000341,1610612746,1610612763,83.0,84.0,0.4579999999999999,0.418,0,2010-12-11,24,5,19,0.208,24,10,14,0.417
21000342,1610612737,1610612754,97.0,83.0,0.452,0.37,1,2010-12-11,25,16,9,0.64,22,11,11,0.5
21000343,1610612766,1610612738,62.0,93.0,0.3379999999999999,0.4370000000000001,0,2010-12-11,23,8,15,0.348,23,19,4,0.826
21000344,1610612765,1610612761,116.0,120.0,0.528,0.629,0,2010-12-11,25,7,18,0.28,24,9,15,0.375
21000345,1610612741,1610612750,113.0,82.0,0.477,0.3979999999999999,1,2010-12-11,22,14,8,0.636,24,6,18,0.25
21000346,1610612742,1610612762,103.0,97.0,0.5,0.444,1,2010-12-11,23,19,4,0.826,25,17,8,0.68
21000347,1610612745,1610612739,110.0,95.0,0.488,0.4270000000000001,1,2010-12-11,23,9,14,0.391,23,7,16,0.304
21000348,1610612758,1610612748,83.0,104.0,0.3670000000000001,0.519,0,2010-12-11,21,5,16,0.238,25,17,8,0.68
21000330,1610612754,1610612766,100.0,92.0,0.442,0.414,1,2010-12-10,21,11,10,0.524,22,8,14,0.364
21000331,1610612761,1610612743,116.0,123.0,0.511,0.5660000000000001,0,2010-12-10,23,8,15,0.348,22,14,8,0.636
21000332,1610612764,1610612752,95.0,101.0,0.417,0.4529999999999999,0,2010-12-10,22,6,16,0.273,24,15,9,0.625
21000333,1610612741,1610612747,88.0,84.0,0.413,0.436,1,2010-12-10,21,13,8,0.619,23,16,7,0.696
21000334,1610612750,1610612765,109.0,99.0,0.519,0.386,1,2010-12-10,23,6,17,0.261,24,7,17,0.292
21000335,1610612740,1610612760,92.0,97.0,0.473,0.5,0,2010-12-10,22,14,8,0.636,24,16,8,0.667
21000336,1610612749,1610612745,97.0,91.0,0.481,0.407,1,2010-12-10,22,9,13,0.409,22,8,14,0.364
21000337,1610612759,1610612737,108.0,92.0,0.532,0.45,1,2010-12-10,22,19,3,0.8640000000000001,24,15,9,0.625
21000338,1610612756,1610612757,94.0,101.0,0.446,0.493,0,2010-12-10,23,11,12,0.478,23,12,11,0.522
21000339,1610612762,1610612753,117.0,105.0,0.539,0.475,1,2010-12-10,24,17,7,0.708,23,15,8,0.652
21000340,1610612744,1610612748,84.0,106.0,0.373,0.526,0,2010-12-10,23,8,15,0.348,24,16,8,0.667
21000327,1610612755,1610612738,101.0,102.0,0.457,0.5589999999999999,0,2010-12-09,22,7,15,0.318,22,18,4,0.818
21000328,1610612742,1610612751,102.0,89.0,0.547,0.416,1,2010-12-09,22,18,4,0.818,23,6,17,0.261
21000329,1610612757,1610612753,97.0,83.0,0.444,0.423,1,2010-12-09,22,11,11,0.5,22,15,7,0.682
21000316,1610612738,1610612743,105.0,89.0,0.5589999999999999,0.423,1,2010-12-08,21,17,4,0.81,21,13,8,0.619
21000317,1610612739,1610612741,83.0,88.0,0.3829999999999999,0.449,0,2010-12-08,22,7,15,0.318,20,12,8,0.6
21000318,1610612752,1610612761,113.0,110.0,0.483,0.477,1,2010-12-08,23,14,9,0.609,22,8,14,0.364
21000319,1610612749,1610612754,97.0,95.0,0.36,0.4320000000000001,1,2010-12-08,21,8,13,0.381,20,10,10,0.5
21000320,1610612750,1610612760,103.0,111.0,0.419,0.519,0,2010-12-08,22,5,17,0.2269999999999999,23,15,8,0.652
21000321,1610612740,1610612765,93.0,74.0,0.5,0.375,1,2010-12-08,21,14,7,0.667,23,7,16,0.304
21000322,1610612759,1610612744,111.0,94.0,0.512,0.451,1,2010-12-08,21,18,3,0.857,22,8,14,0.364
21000323,1610612756,1610612763,98.0,104.0,0.42,0.494,0,2010-12-08,22,11,11,0.5,23,9,14,0.391
21000324,1610612762,1610612748,98.0,111.0,0.507,0.513,0,2010-12-08,23,16,7,0.696,23,15,8,0.652
21000325,1610612758,1610612764,116.0,91.0,0.542,0.413,1,2010-12-08,20,5,15,0.25,21,6,15,0.286
21000326,1610612746,1610612747,86.0,87.0,0.4,0.425,0,2010-12-08,23,5,18,0.217,22,16,6,0.727
21000309,1610612737,1610612751,116.0,101.0,0.603,0.465,1,2010-12-07,23,15,8,0.652,22,6,16,0.273
21000310,1610612766,1610612743,100.0,98.0,0.5,0.425,1,2010-12-07,21,8,13,0.381,20,13,7,0.65
21000311,1610612755,1610612739,117.0,97.0,0.519,0.5,1,2010-12-07,21,7,14,0.3329999999999999,21,7,14,0.3329999999999999
21000312,1610612742,1610612744,105.0,100.0,0.4479999999999999,0.467,1,2010-12-07,21,17,4,0.81,21,8,13,0.381
21000313,1610612745,1610612765,97.0,83.0,0.4579999999999999,0.417,1,2010-12-07,21,8,13,0.381,22,7,15,0.318
21000314,1610612757,1610612756,106.0,99.0,0.446,0.507,1,2010-12-07,21,10,11,0.476,21,11,10,0.524
21000315,1610612747,1610612764,115.0,108.0,0.449,0.5,1,2010-12-07,21,15,6,0.7140000000000001,20,6,14,0.3
21000302,1610612754,1610612761,124.0,100.0,0.5529999999999999,0.42,1,2010-12-06,19,10,9,0.526,21,8,13,0.381
21000303,1610612753,1610612737,74.0,80.0,0.3779999999999999,0.3879999999999999,0,2010-12-06,21,15,6,0.7140000000000001,22,14,8,0.636
21000304,1610612752,1610612750,121.0,114.0,0.529,0.526,1,2010-12-06,22,13,9,0.591,21,5,16,0.238
21000305,1610612741,1610612760,99.0,90.0,0.483,0.354,1,2010-12-06,19,11,8,0.579,22,14,8,0.636
21000306,1610612749,1610612748,78.0,88.0,0.346,0.486,0,2010-12-06,20,7,13,0.35,22,14,8,0.636
21000307,1610612762,1610612763,94.0,85.0,0.42,0.418,1,2010-12-06,22,16,6,0.727,22,8,14,0.364
21000308,1610612746,1610612758,98.0,91.0,0.444,0.365,1,2010-12-06,22,5,17,0.2269999999999999,19,4,15,0.211
21000294,1610612751,1610612738,75.0,100.0,0.375,0.506,0,2010-12-05,21,6,15,0.286,20,16,4,0.8
21000295,1610612761,1610612752,99.0,116.0,0.46,0.489,0,2010-12-05,20,8,12,0.4,21,12,9,0.5710000000000001
21000296,1610612765,1610612739,102.0,92.0,0.469,0.417,1,2010-12-05,21,7,14,0.3329999999999999,20,7,13,0.35
21000297,1610612760,1610612744,114.0,109.0,0.435,0.452,1,2010-12-05,21,14,7,0.667,20,8,12,0.4
21000298,1610612759,1610612740,109.0,84.0,0.586,0.44,1,2010-12-05,20,17,3,0.85,20,13,7,0.65
21000299,1610612743,1610612763,108.0,107.0,0.4529999999999999,0.523,1,2010-12-05,19,13,6,0.684,21,8,13,0.381
21000300,1610612756,1610612764,125.0,108.0,0.58,0.506,1,2010-12-05,20,11,9,0.55,19,6,13,0.316
21000301,1610612757,1610612746,100.0,91.0,0.397,0.408,1,2010-12-05,20,9,11,0.45,21,4,17,0.19
21000288,1610612748,1610612737,89.0,77.0,0.472,0.4,1,2010-12-04,21,13,8,0.619,21,13,8,0.619
21000289,1610612755,1610612766,109.0,91.0,0.519,0.429,1,2010-12-04,20,6,14,0.3,20,7,13,0.35
21000290,1610612741,1610612745,119.0,116.0,0.5,0.449,1,2010-12-04,18,10,8,0.556,20,7,13,0.35
21000291,1610612750,1610612739,129.0,95.0,0.593,0.386,1,2010-12-04,20,5,15,0.25,19,7,12,0.368
21000292,1610612749,1610612753,96.0,85.0,0.4679999999999999,0.415,1,2010-12-04,19,7,12,0.368,20,15,5,0.75
21000293,1610612758,1610612742,103.0,105.0,0.482,0.5,0,2010-12-04,18,4,14,0.222,20,16,4,0.8
21000275,1610612766,1610612751,91.0,84.0,0.36,0.319,1,2010-12-03,19,7,12,0.368,20,6,14,0.3
21000276,1610612761,1610612760,111.0,99.0,0.5489999999999999,0.4370000000000001,1,2010-12-03,19,8,11,0.421,20,13,7,0.65
21000277,1610612764,1610612757,83.0,79.0,0.417,0.3329999999999999,1,2010-12-03,18,6,12,0.3329999999999999,19,8,11,0.421
21000278,1610612737,1610612755,93.0,88.0,0.418,0.434,1,2010-12-03,20,13,7,0.65,19,5,14,0.263
21000279,1610612765,1610612753,91.0,104.0,0.486,0.597,0,2010-12-03,20,6,14,0.3,19,15,4,0.789
21000280,1610612738,1610612741,104.0,92.0,0.531,0.419,1,2010-12-03,19,15,4,0.789,17,9,8,0.529
21000281,1610612763,1610612745,111.0,127.0,0.519,0.595,0,2010-12-03,20,8,12,0.4,19,7,12,0.368
21000282,1610612740,1610612752,92.0,100.0,0.429,0.47,0,2010-12-03,19,13,6,0.684,20,11,9,0.55
21000283,1610612759,1610612750,107.0,101.0,0.4529999999999999,0.415,1,2010-12-03,19,16,3,0.8420000000000001,19,4,15,0.211
21000284,1610612743,1610612746,109.0,104.0,0.4029999999999999,0.433,1,2010-12-03,18,12,6,0.667,20,4,16,0.2
21000285,1610612756,1610612754,105.0,97.0,0.449,0.4679999999999999,1,2010-12-03,19,10,9,0.526,18,9,9,0.5
21000286,1610612762,1610612742,81.0,93.0,0.392,0.526,0,2010-12-03,21,15,6,0.7140000000000001,19,15,4,0.789
21000287,1610612747,1610612758,113.0,80.0,0.5660000000000001,0.4029999999999999,1,2010-12-03,20,14,6,0.7,17,4,13,0.235
21000273,1610612739,1610612748,90.0,118.0,0.355,0.5660000000000001,0,2010-12-02,18,7,11,0.389,20,12,8,0.6
21000274,1610612744,1610612756,101.0,107.0,0.5,0.5479999999999999,0,2010-12-02,19,8,11,0.421,18,9,9,0.5
21000261,1610612737,1610612763,112.0,109.0,0.532,0.524,1,2010-12-01,19,12,7,0.632,19,8,11,0.421
21000262,1610612751,1610612760,120.0,123.0,0.462,0.426,0,2010-12-01,19,6,13,0.316,19,13,6,0.684
21000263,1610612761,1610612764,127.0,108.0,0.58,0.4579999999999999,1,2010-12-01,18,7,11,0.389,17,5,12,0.294
21000264,1610612738,1610612757,99.0,95.0,0.5710000000000001,0.4589999999999999,1,2010-12-01,18,14,4,0.778,18,8,10,0.444
21000265,1610612748,1610612765,97.0,72.0,0.513,0.368,1,2010-12-01,19,11,8,0.579,19,6,13,0.316
21000266,1610612741,1610612753,78.0,107.0,0.423,0.487,0,2010-12-01,16,9,7,0.563,18,14,4,0.778
21000267,1610612740,1610612766,89.0,73.0,0.4679999999999999,0.408,1,2010-12-01,18,13,5,0.722,18,6,12,0.3329999999999999
21000268,1610612742,1610612750,100.0,86.0,0.414,0.39,1,2010-12-01,18,14,4,0.778,18,4,14,0.222
21000269,1610612745,1610612747,109.0,99.0,0.506,0.451,1,2010-12-01,18,6,12,0.3329999999999999,19,13,6,0.684
21000270,1610612743,1610612749,105.0,94.0,0.4529999999999999,0.4,1,2010-12-01,17,11,6,0.647,18,6,12,0.3329999999999999
21000271,1610612762,1610612754,110.0,88.0,0.4589999999999999,0.455,1,2010-12-01,20,15,5,0.75,17,9,8,0.529
21000272,1610612746,1610612759,90.0,85.0,0.493,0.356,1,2010-12-01,19,4,15,0.211,18,15,3,0.833
21000254,1610612739,1610612738,87.0,106.0,0.39,0.506,0,2010-11-30,17,7,10,0.412,17,13,4,0.765
21000255,1610612753,1610612765,90.0,79.0,0.466,0.4270000000000001,1,2010-11-30,17,13,4,0.765,18,6,12,0.3329999999999999
21000256,1610612755,1610612757,88.0,79.0,0.47,0.37,1,2010-11-30,18,5,13,0.278,17,8,9,0.471
21000257,1610612752,1610612751,111.0,100.0,0.513,0.4629999999999999,1,2010-11-30,19,10,9,0.526,18,6,12,0.3329999999999999
21000258,1610612763,1610612747,98.0,96.0,0.488,0.436,1,2010-11-30,18,8,10,0.444,18,13,5,0.722
21000259,1610612758,1610612754,98.0,107.0,0.4429999999999999,0.456,0,2010-11-30,16,4,12,0.25,16,9,7,0.563
21000260,1610612744,1610612759,98.0,118.0,0.471,0.462,0,2010-11-30,18,8,10,0.444,17,15,2,0.882
21000250,1610612748,1610612764,105.0,94.0,0.4589999999999999,0.417,1,2010-11-29,18,10,8,0.556,16,5,11,0.313
21000251,1610612760,1610612740,95.0,89.0,0.3779999999999999,0.439,1,2010-11-29,18,12,6,0.667,17,12,5,0.706
21000252,1610612742,1610612745,101.0,91.0,0.494,0.358,1,2010-11-29,17,13,4,0.765,17,5,12,0.294
21000253,1610612762,1610612749,109.0,88.0,0.5479999999999999,0.347,1,2010-11-29,19,14,5,0.737,17,6,11,0.353
21000242,1610612761,1610612737,78.0,96.0,0.4,0.4679999999999999,0,2010-11-28,17,6,11,0.353,18,11,7,0.611
21000243,1610612765,1610612752,116.0,125.0,0.457,0.466,0,2010-11-28,17,6,11,0.353,18,9,9,0.5
21000244,1610612740,1610612759,95.0,109.0,0.5,0.488,0,2010-11-28,16,12,4,0.75,16,14,2,0.875
21000245,1610612746,1610612762,97.0,109.0,0.4579999999999999,0.586,0,2010-11-28,18,3,15,0.1669999999999999,18,13,5,0.722
21000246,1610612751,1610612757,98.0,96.0,0.525,0.423,1,2010-11-28,17,6,11,0.353,16,8,8,0.5
21000247,1610612745,1610612760,99.0,98.0,0.452,0.494,1,2010-11-28,16,5,11,0.313,17,11,6,0.647
21000248,1610612743,1610612756,138.0,133.0,0.518,0.51,1,2010-11-28,16,10,6,0.625,17,8,9,0.471
21000249,1610612747,1610612754,92.0,95.0,0.386,0.4320000000000001,0,2010-11-28,17,13,4,0.765,15,8,7,0.5329999999999999
21000234,1610612752,1610612737,90.0,99.0,0.473,0.4379999999999999,0,2010-11-27,17,8,9,0.471,17,10,7,0.588
21000235,1610612764,1610612753,99.0,100.0,0.45,0.462,0,2010-11-27,15,5,10,0.3329999999999999,16,12,4,0.75
21000236,1610612739,1610612763,92.0,86.0,0.422,0.424,1,2010-11-27,16,7,9,0.4379999999999999,17,7,10,0.412
21000237,1610612755,1610612751,102.0,86.0,0.512,0.407,1,2010-11-27,17,4,13,0.235,16,5,11,0.313
21000238,1610612750,1610612744,94.0,104.0,0.395,0.506,0,2010-11-27,17,4,13,0.235,17,8,9,0.471
21000239,1610612742,1610612748,106.0,95.0,0.46,0.413,1,2010-11-27,16,12,4,0.75,17,9,8,0.529
21000240,1610612749,1610612766,104.0,101.0,0.4579999999999999,0.478,1,2010-11-27,16,6,10,0.375,17,6,11,0.353
21000241,1610612758,1610612741,85.0,96.0,0.407,0.429,0,2010-11-27,15,4,11,0.267,15,9,6,0.6
21000222,1610612766,1610612745,99.0,89.0,0.4589999999999999,0.418,1,2010-11-26,16,6,10,0.375,15,4,11,0.267
21000223,1610612753,1610612739,111.0,100.0,0.556,0.471,1,2010-11-26,15,11,4,0.733,15,6,9,0.4
21000224,1610612738,1610612761,110.0,101.0,0.539,0.451,1,2010-11-26,16,12,4,0.75,16,6,10,0.375
21000225,1610612765,1610612749,103.0,89.0,0.562,0.386,1,2010-11-26,16,6,10,0.375,15,5,10,0.3329999999999999
21000226,1610612748,1610612755,99.0,90.0,0.449,0.473,1,2010-11-26,16,9,7,0.563,16,3,13,0.188
21000227,1610612754,1610612760,106.0,110.0,0.44,0.389,0,2010-11-26,14,7,7,0.5,16,11,5,0.688
21000228,1610612759,1610612742,94.0,103.0,0.449,0.527,0,2010-11-26,15,13,2,0.867,15,11,4,0.733
21000229,1610612743,1610612741,98.0,97.0,0.4679999999999999,0.3979999999999999,1,2010-11-26,15,9,6,0.6,14,8,6,0.5710000000000001
21000230,1610612756,1610612746,116.0,108.0,0.476,0.506,1,2010-11-26,16,8,8,0.5,17,3,14,0.176
21000231,1610612762,1610612747,102.0,96.0,0.494,0.418,1,2010-11-26,17,12,5,0.706,16,13,3,0.813
21000232,1610612763,1610612744,116.0,111.0,0.525,0.488,1,2010-11-26,16,7,9,0.4379999999999999,16,7,9,0.4379999999999999
21000233,1610612757,1610612740,78.0,97.0,0.395,0.515,0,2010-11-26,15,8,7,0.5329999999999999,15,12,3,0.8
21000220,1610612737,1610612764,116.0,96.0,0.477,0.386,1,2010-11-25,16,9,7,0.563,14,5,9,0.357
21000221,1610612746,1610612758,100.0,82.0,0.507,0.408,1,2010-11-25,16,3,13,0.188,14,4,10,0.286
21000209,1610612766,1610612752,95.0,99.0,0.4479999999999999,0.48,0,2010-11-24,15,5,10,0.3329999999999999,16,8,8,0.5
21000210,1610612739,1610612749,83.0,81.0,0.421,0.3779999999999999,1,2010-11-24,14,6,8,0.429,14,5,9,0.357
21000211,1610612761,1610612755,106.0,90.0,0.481,0.4320000000000001,1,2010-11-24,15,6,9,0.4,15,3,12,0.2
21000212,1610612738,1610612751,89.0,83.0,0.449,0.4629999999999999,1,2010-11-24,15,11,4,0.733,15,5,10,0.3329999999999999
21000213,1610612753,1610612748,104.0,95.0,0.514,0.415,1,2010-11-24,14,10,4,0.7140000000000001,15,8,7,0.5329999999999999
21000214,1610612763,1610612765,105.0,84.0,0.523,0.4,1,2010-11-24,15,6,9,0.4,15,5,10,0.3329999999999999
21000215,1610612750,1610612759,109.0,113.0,0.472,0.3979999999999999,0,2010-11-24,16,4,12,0.25,14,13,1,0.929
21000216,1610612760,1610612742,103.0,111.0,0.482,0.444,0,2010-11-24,15,10,5,0.667,14,10,4,0.7140000000000001
21000217,1610612745,1610612744,111.0,101.0,0.484,0.467,1,2010-11-24,14,4,10,0.286,15,7,8,0.467
21000218,1610612756,1610612741,115.0,123.0,0.426,0.481,0,2010-11-24,15,7,8,0.467,13,8,5,0.615
21000219,1610612762,1610612740,105.0,87.0,0.488,0.42,1,2010-11-24,16,11,5,0.688,14,11,3,0.7859999999999999
21000203,1610612754,1610612739,100.0,89.0,0.4379999999999999,0.422,1,2010-11-23,13,7,6,0.5379999999999999,13,5,8,0.385
21000204,1610612751,1610612737,107.0,101.0,0.475,0.461,1,2010-11-23,14,5,9,0.357,15,8,7,0.5329999999999999
21000205,1610612764,1610612755,116.0,114.0,0.439,0.462,1,2010-11-23,13,5,8,0.385,14,3,11,0.214
21000206,1610612752,1610612766,110.0,107.0,0.521,0.489,1,2010-11-23,15,7,8,0.467,14,5,9,0.357
21000207,1610612742,1610612765,88.0,84.0,0.385,0.425,1,2010-11-23,13,9,4,0.6920000000000001,14,5,9,0.357
21000208,1610612747,1610612741,98.0,91.0,0.395,0.395,1,2010-11-23,15,13,2,0.867,12,7,5,0.583
21000195,1610612737,1610612738,76.0,99.0,0.346,0.5329999999999999,0,2010-11-22,14,8,6,0.5710000000000001,14,10,4,0.7140000000000001
21000196,1610612748,1610612754,77.0,93.0,0.387,0.411,0,2010-11-22,14,8,6,0.5710000000000001,12,6,6,0.5
21000197,1610612760,1610612750,117.0,107.0,0.5479999999999999,0.5,1,2010-11-22,14,10,4,0.7140000000000001,15,4,11,0.267
21000198,1610612745,1610612756,116.0,123.0,0.49,0.5379999999999999,0,2010-11-22,13,3,10,0.231,14,7,7,0.5
21000199,1610612759,1610612753,106.0,97.0,0.494,0.488,1,2010-11-22,13,12,1,0.923,13,9,4,0.6920000000000001
21000200,1610612762,1610612758,94.0,83.0,0.447,0.358,1,2010-11-22,15,10,5,0.667,13,4,9,0.308
21000201,1610612744,1610612743,89.0,106.0,0.402,0.467,0,2010-11-22,14,7,7,0.5,14,8,6,0.5710000000000001
21000202,1610612746,1610612740,99.0,95.0,0.507,0.474,1,2010-11-22,15,2,13,0.133,13,11,2,0.846
21000191,1610612761,1610612738,102.0,101.0,0.447,0.479,1,2010-11-21,14,5,9,0.357,13,9,4,0.6920000000000001
21000192,1610612765,1610612764,115.0,110.0,0.489,0.539,1,2010-11-21,13,5,8,0.385,12,4,8,0.3329999999999999
21000193,1610612758,1610612740,71.0,75.0,0.387,0.322,0,2010-11-21,12,4,8,0.3329999999999999,12,11,1,0.917
21000194,1610612747,1610612744,117.0,89.0,0.557,0.352,1,2010-11-21,14,12,2,0.857,13,7,6,0.5379999999999999
21000182,1610612766,1610612756,123.0,105.0,0.575,0.4589999999999999,1,2010-11-20,13,5,8,0.385,13,6,7,0.462
21000183,1610612754,1610612753,86.0,90.0,0.3929999999999999,0.449,0,2010-11-20,11,5,6,0.455,12,9,3,0.75
21000184,1610612737,1610612742,93.0,98.0,0.481,0.476,0,2010-11-20,13,8,5,0.615,12,8,4,0.667
21000185,1610612763,1610612748,97.0,95.0,0.475,0.481,1,2010-11-20,14,5,9,0.357,13,8,5,0.615
21000186,1610612749,1610612760,81.0,82.0,0.3720000000000001,0.37,0,2010-11-20,13,5,8,0.385,13,9,4,0.6920000000000001
21000187,1610612759,1610612739,116.0,92.0,0.531,0.475,1,2010-11-20,12,11,1,0.917,12,5,7,0.417
21000188,1610612743,1610612751,107.0,103.0,0.475,0.4039999999999999,1,2010-11-20,13,7,6,0.5379999999999999,13,4,9,0.308
21000189,1610612757,1610612762,94.0,103.0,0.38,0.48,0,2010-11-20,14,8,6,0.5710000000000001,14,9,5,0.643
21000190,1610612746,1610612752,115.0,124.0,0.544,0.461,0,2010-11-20,14,1,13,0.071,14,6,8,0.429
21000171,1610612738,1610612760,84.0,89.0,0.485,0.431,0,2010-11-19,12,9,3,0.75,12,8,4,0.667
21000172,1610612755,1610612749,90.0,79.0,0.405,0.3379999999999999,1,2010-11-19,13,3,10,0.231,12,5,7,0.417
21000173,1610612761,1610612745,106.0,96.0,0.488,0.436,1,2010-11-19,13,4,9,0.308,12,3,9,0.25
21000174,1610612764,1610612763,89.0,86.0,0.3779999999999999,0.439,1,2010-11-19,11,4,7,0.364,13,4,9,0.308
21000175,1610612748,1610612766,95.0,87.0,0.425,0.465,1,2010-11-19,12,8,4,0.667,12,4,8,0.3329999999999999
21000176,1610612750,1610612747,95.0,112.0,0.396,0.471,0,2010-11-19,14,4,10,0.286,13,11,2,0.846
21000177,1610612740,1610612739,108.0,101.0,0.4589999999999999,0.349,1,2010-11-19,11,10,1,0.909,11,5,6,0.455
21000178,1610612762,1610612759,82.0,94.0,0.419,0.439,0,2010-11-19,13,8,5,0.615,11,10,1,0.909
21000179,1610612742,1610612741,83.0,88.0,0.4,0.447,0,2010-11-19,11,7,4,0.636,11,7,4,0.636
21000180,1610612758,1610612751,86.0,81.0,0.429,0.457,1,2010-11-19,11,4,7,0.364,12,4,8,0.3329999999999999
21000181,1610612744,1610612752,119.0,125.0,0.516,0.5710000000000001,0,2010-11-19,12,7,5,0.583,13,5,8,0.385
21000168,1610612754,1610612746,107.0,80.0,0.506,0.3329999999999999,1,2010-11-18,10,5,5,0.5,13,1,12,0.077
21000169,1610612753,1610612756,105.0,89.0,0.541,0.456,1,2010-11-18,11,8,3,0.727,12,6,6,0.5
21000170,1610612757,1610612743,86.0,83.0,0.4,0.385,1,2010-11-18,13,8,5,0.615,12,6,6,0.5
21000158,1610612748,1610612756,123.0,96.0,0.547,0.444,1,2010-11-17,11,7,4,0.636,11,6,5,0.545
21000159,1610612755,1610612761,86.0,94.0,0.368,0.466,0,2010-11-17,12,2,10,0.1669999999999999,12,3,9,0.25
21000160,1610612738,1610612764,114.0,83.0,0.6579999999999999,0.3879999999999999,1,2010-11-17,11,9,2,0.818,10,3,7,0.3
21000161,1610612765,1610612747,90.0,103.0,0.3929999999999999,0.446,0,2010-11-17,12,4,8,0.3329999999999999,12,10,2,0.833
21000162,1610612750,1610612746,113.0,111.0,0.534,0.483,1,2010-11-17,13,4,9,0.308,12,1,11,0.083
21000163,1610612740,1610612742,99.0,97.0,0.488,0.507,1,2010-11-17,10,9,1,0.9,10,7,3,0.7
21000164,1610612760,1610612745,116.0,99.0,0.5,0.4679999999999999,1,2010-11-17,11,7,4,0.636,11,3,8,0.273
21000165,1610612762,1610612751,98.0,88.0,0.402,0.376,1,2010-11-17,12,8,4,0.667,11,4,7,0.364
21000166,1610612759,1610612741,103.0,94.0,0.482,0.424,1,2010-11-17,10,9,1,0.9,10,6,4,0.6
21000167,1610612758,1610612752,106.0,113.0,0.449,0.521,0,2010-11-17,10,3,7,0.3,12,4,8,0.3329999999999999
21000151,1610612739,1610612755,101.0,93.0,0.4629999999999999,0.43,1,2010-11-16,10,5,5,0.5,11,2,9,0.182
21000152,1610612754,1610612737,92.0,102.0,0.4429999999999999,0.5,0,2010-11-16,9,4,5,0.444,12,8,4,0.667
21000153,1610612764,1610612761,109.0,94.0,0.563,0.407,1,2010-11-16,9,3,6,0.3329999999999999,11,2,9,0.182
21000154,1610612763,1610612757,99.0,100.0,0.48,0.46,0,2010-11-16,12,4,8,0.3329999999999999,12,7,5,0.583
21000155,1610612749,1610612747,107.0,118.0,0.461,0.5379999999999999,0,2010-11-16,11,5,6,0.455,11,9,2,0.818
21000156,1610612745,1610612741,92.0,95.0,0.479,0.486,0,2010-11-16,10,3,7,0.3,9,6,3,0.667
21000157,1610612743,1610612752,120.0,118.0,0.488,0.439,1,2010-11-16,11,6,5,0.545,11,3,8,0.273
21000144,1610612766,1610612750,113.0,110.0,0.521,0.462,1,2010-11-15,11,4,7,0.364,12,3,9,0.25
21000145,1610612753,1610612763,89.0,72.0,0.4379999999999999,0.363,1,2010-11-15,10,7,3,0.7,11,4,7,0.364
21000146,1610612742,1610612740,98.0,95.0,0.493,0.442,1,2010-11-15,9,7,2,0.778,9,8,1,0.889
21000147,1610612756,1610612743,100.0,94.0,0.4270000000000001,0.416,1,2010-11-15,10,6,4,0.6,10,5,5,0.5
21000148,1610612762,1610612760,108.0,115.0,0.506,0.507,0,2010-11-15,11,7,4,0.636,10,6,4,0.6
21000149,1610612744,1610612765,101.0,97.0,0.424,0.446,1,2010-11-15,11,7,4,0.636,11,4,7,0.364
21000150,1610612746,1610612751,96.0,110.0,0.395,0.597,0,2010-11-15,11,1,10,0.091,10,4,6,0.4
21000139,1610612737,1610612750,111.0,105.0,0.45,0.474,1,2010-11-14,11,7,4,0.636,11,3,8,0.273
21000140,1610612758,1610612765,94.0,100.0,0.4529999999999999,0.539,0,2010-11-14,9,3,6,0.3329999999999999,10,4,6,0.4
21000141,1610612760,1610612759,104.0,117.0,0.452,0.409,0,2010-11-14,9,5,4,0.556,9,8,1,0.889
21000142,1610612752,1610612745,96.0,104.0,0.4370000000000001,0.45,0,2010-11-14,10,3,7,0.3,9,3,6,0.3329999999999999
21000143,1610612747,1610612756,116.0,121.0,0.49,0.512,0,2010-11-14,10,8,2,0.8,9,5,4,0.556
21000130,1610612766,1610612762,95.0,96.0,0.4429999999999999,0.4429999999999999,0,2010-11-13,10,3,7,0.3,10,7,3,0.7
21000131,1610612751,1610612753,90.0,91.0,0.493,0.416,0,2010-11-13,9,3,6,0.3329999999999999,9,6,3,0.667
21000132,1610612739,1610612754,85.0,99.0,0.386,0.456,0,2010-11-13,9,4,5,0.444,8,4,4,0.5
21000133,1610612748,1610612761,109.0,100.0,0.506,0.451,1,2010-11-13,10,6,4,0.6,10,2,8,0.2
21000134,1610612741,1610612764,103.0,96.0,0.447,0.449,1,2010-11-13,8,5,3,0.625,8,2,6,0.25
21000135,1610612763,1610612738,110.0,116.0,0.53,0.5770000000000001,0,2010-11-13,10,4,6,0.4,10,8,2,0.8
21000136,1610612740,1610612757,107.0,87.0,0.481,0.407,1,2010-11-13,8,8,0,1.0,11,6,5,0.545
21000137,1610612749,1610612744,79.0,72.0,0.337,0.341,1,2010-11-13,10,5,5,0.5,10,6,4,0.6
21000138,1610612759,1610612755,116.0,93.0,0.482,0.415,1,2010-11-13,8,7,1,0.875,10,2,8,0.2
21000121,1610612737,1610612762,86.0,90.0,0.493,0.429,0,2010-11-12,10,6,4,0.6,9,6,3,0.667
21000122,1610612754,1610612745,99.0,102.0,0.449,0.5,0,2010-11-12,7,3,4,0.429,8,2,6,0.25
21000123,1610612753,1610612761,106.0,110.0,0.527,0.5,0,2010-11-12,8,5,3,0.625,9,2,7,0.222
21000124,1610612764,1610612766,85.0,93.0,0.419,0.493,0,2010-11-12,7,2,5,0.286,9,3,6,0.3329999999999999
21000125,1610612750,1610612752,112.0,103.0,0.436,0.38,1,2010-11-12,10,3,7,0.3,9,3,6,0.3329999999999999
21000126,1610612742,1610612755,99.0,90.0,0.4429999999999999,0.446,1,2010-11-12,8,6,2,0.75,9,2,7,0.222
21000127,1610612756,1610612758,103.0,89.0,0.519,0.409,1,2010-11-12,8,4,4,0.5,8,3,5,0.375
21000128,1610612760,1610612757,110.0,108.0,0.5479999999999999,0.539,1,2010-11-12,8,5,3,0.625,10,6,4,0.6
21000129,1610612746,1610612765,107.0,113.0,0.4629999999999999,0.476,0,2010-11-12,10,1,9,0.1,9,3,6,0.3329999999999999
21000118,1610612748,1610612738,107.0,112.0,0.5,0.544,0,2010-11-11,9,5,4,0.556,9,7,2,0.778
21000119,1610612741,1610612744,120.0,90.0,0.5479999999999999,0.411,1,2010-11-11,7,4,3,0.5710000000000001,9,6,3,0.667
21000120,1610612743,1610612747,118.0,112.0,0.489,0.408,1,2010-11-11,9,5,4,0.556,9,8,1,0.889
21000108,1610612737,1610612749,91.0,108.0,0.493,0.517,0,2010-11-10,9,6,3,0.667,9,4,5,0.444
21000109,1610612753,1610612762,94.0,104.0,0.43,0.5,0,2010-11-10,7,5,2,0.7140000000000001,8,5,3,0.625
21000110,1610612761,1610612766,96.0,101.0,0.457,0.493,0,2010-11-10,8,1,7,0.125,8,2,6,0.25
21000111,1610612764,1610612745,98.0,91.0,0.4429999999999999,0.391,1,2010-11-10,6,2,4,0.3329999999999999,7,1,6,0.143
21000112,1610612739,1610612751,87.0,95.0,0.442,0.415,0,2010-11-10,8,4,4,0.5,8,3,5,0.375
21000113,1610612752,1610612744,117.0,122.0,0.4679999999999999,0.528,0,2010-11-10,8,3,5,0.375,8,6,2,0.75
21000114,1610612763,1610612742,91.0,106.0,0.452,0.541,0,2010-11-10,9,4,5,0.444,7,5,2,0.7140000000000001
21000115,1610612760,1610612755,109.0,103.0,0.493,0.481,1,2010-11-10,7,4,3,0.5710000000000001,8,2,6,0.25
21000116,1610612759,1610612746,107.0,95.0,0.493,0.465,1,2010-11-10,7,6,1,0.857,9,1,8,0.111
21000117,1610612758,1610612750,89.0,98.0,0.444,0.471,0,2010-11-10,7,3,4,0.429,9,2,7,0.222
21000101,1610612754,1610612743,144.0,113.0,0.644,0.433,1,2010-11-09,6,3,3,0.5,8,4,4,0.5
21000102,1610612751,1610612739,91.0,93.0,0.407,0.439,0,2010-11-09,7,2,5,0.286,7,4,3,0.5710000000000001
21000103,1610612748,1610612762,114.0,116.0,0.439,0.484,0,2010-11-09,8,5,3,0.625,7,4,3,0.5710000000000001
21000104,1610612749,1610612752,107.0,80.0,0.513,0.3779999999999999,1,2010-11-09,8,3,5,0.375,7,3,4,0.429
21000105,1610612740,1610612746,101.0,82.0,0.506,0.4629999999999999,1,2010-11-09,7,7,0,1.0,8,1,7,0.125
21000106,1610612757,1610612765,100.0,78.0,0.5,0.425,1,2010-11-09,9,6,3,0.667,8,2,6,0.25
21000107,1610612747,1610612750,99.0,94.0,0.449,0.38,1,2010-11-09,8,8,0,1.0,8,1,7,0.125
21000095,1610612766,1610612759,91.0,95.0,0.3979999999999999,0.424,0,2010-11-08,7,1,6,0.143,6,5,1,0.833
21000096,1610612753,1610612737,93.0,89.0,0.43,0.474,1,2010-11-08,6,5,1,0.833,8,6,2,0.75
21000097,1610612761,1610612744,102.0,109.0,0.4579999999999999,0.527,0,2010-11-08,7,1,6,0.143,7,5,2,0.7140000000000001
21000098,1610612741,1610612743,94.0,92.0,0.415,0.436,1,2010-11-08,6,3,3,0.5,7,4,3,0.5710000000000001
21000099,1610612763,1610612756,109.0,99.0,0.476,0.475,1,2010-11-08,8,4,4,0.5,7,3,4,0.429
21000100,1610612742,1610612738,89.0,87.0,0.5,0.418,1,2010-11-08,6,4,2,0.667,8,6,2,0.75
21000089,1610612752,1610612755,96.0,106.0,0.4,0.474,0,2010-11-07,6,3,3,0.5,7,2,5,0.286
21000090,1610612737,1610612756,114.0,118.0,0.542,0.556,0,2010-11-07,7,6,1,0.857,6,3,3,0.5
21000091,1610612765,1610612744,102.0,97.0,0.451,0.429,1,2010-11-07,7,2,5,0.286,6,4,2,0.667
21000092,1610612745,1610612750,120.0,94.0,0.442,0.374,1,2010-11-07,6,1,5,0.1669999999999999,7,1,6,0.143
21000093,1610612760,1610612738,83.0,92.0,0.4270000000000001,0.474,0,2010-11-07,6,3,3,0.5,7,6,1,0.857
21000094,1610612747,1610612757,121.0,96.0,0.5489999999999999,0.4270000000000001,1,2010-11-07,7,7,0,1.0,8,5,3,0.625
21000080,1610612766,1610612753,88.0,91.0,0.48,0.415,0,2010-11-06,6,1,5,0.1669999999999999,5,4,1,0.8
21000081,1610612764,1610612739,102.0,107.0,0.4429999999999999,0.476,0,2010-11-06,5,1,4,0.2,6,3,3,0.5
21000082,1610612748,1610612751,101.0,89.0,0.486,0.412,1,2010-11-06,7,5,2,0.7140000000000001,6,2,4,0.3329999999999999
21000083,1610612749,1610612740,81.0,87.0,0.386,0.449,0,2010-11-06,7,2,5,0.286,6,6,0,1.0
21000084,1610612759,1610612745,124.0,121.0,0.485,0.475,1,2010-11-06,5,4,1,0.8,5,0,5,0.0
21000085,1610612742,1610612743,92.0,103.0,0.447,0.451,0,2010-11-06,5,3,2,0.6,6,4,2,0.667
21000086,1610612762,1610612746,109.0,107.0,0.412,0.43,1,2010-11-06,6,3,3,0.5,7,1,6,0.143
21000087,1610612757,1610612761,97.0,84.0,0.4529999999999999,0.368,1,2010-11-06,7,5,2,0.7140000000000001,6,1,5,0.1669999999999999
21000088,1610612758,1610612763,91.0,100.0,0.43,0.482,0,2010-11-06,6,3,3,0.5,7,3,4,0.429
21000068,1610612754,1610612749,90.0,94.0,0.387,0.386,0,2010-11-05,5,2,3,0.4,6,2,4,0.3329999999999999
21000069,1610612753,1610612751,105.0,90.0,0.479,0.429,1,2010-11-05,4,3,1,0.75,5,2,3,0.4
21000070,1610612755,1610612739,116.0,123.0,0.5539999999999999,0.547,0,2010-11-05,6,1,5,0.1669999999999999,5,2,3,0.4
21000071,1610612765,1610612766,97.0,90.0,0.4270000000000001,0.552,1,2010-11-05,6,1,5,0.1669999999999999,5,1,4,0.2
21000072,1610612752,1610612764,112.0,91.0,0.506,0.4529999999999999,1,2010-11-05,5,3,2,0.6,4,1,3,0.25
21000073,1610612738,1610612741,110.0,105.0,0.512,0.494,1,2010-11-05,6,5,1,0.833,5,2,3,0.4
21000074,1610612750,1610612737,103.0,113.0,0.424,0.5429999999999999,0,2010-11-05,6,1,5,0.1669999999999999,6,6,0,1.0
21000075,1610612740,1610612748,96.0,93.0,0.494,0.423,1,2010-11-05,5,5,0,1.0,6,4,2,0.667
21000076,1610612756,1610612763,123.0,118.0,0.426,0.469,1,2010-11-05,5,2,3,0.4,6,2,4,0.3329999999999999
21000077,1610612743,1610612746,111.0,104.0,0.518,0.5,1,2010-11-05,5,3,2,0.6,6,1,5,0.1669999999999999
21000078,1610612744,1610612762,85.0,78.0,0.376,0.395,1,2010-11-05,5,4,1,0.8,5,2,3,0.4
21000079,1610612747,1610612761,108.0,103.0,0.481,0.471,1,2010-11-05,6,6,0,1.0,5,1,4,0.2
21000066,1610612741,1610612752,112.0,120.0,0.519,0.5,0,2010-11-04,4,2,2,0.5,4,2,2,0.5
21000067,1610612757,1610612760,106.0,107.0,0.467,0.494,0,2010-11-04,6,4,2,0.667,5,3,2,0.6
21000054,1610612737,1610612765,94.0,85.0,0.537,0.4,1,2010-11-03,5,5,0,1.0,5,0,5,0.0
21000055,1610612751,1610612766,83.0,85.0,0.4270000000000001,0.431,0,2010-11-03,4,2,2,0.5,4,1,3,0.25
21000056,1610612753,1610612750,128.0,86.0,0.5,0.3329999999999999,1,2010-11-03,3,2,1,0.667,5,1,4,0.2
21000057,1610612755,1610612754,101.0,75.0,0.469,0.315,1,2010-11-03,5,1,4,0.2,4,2,2,0.5
21000058,1610612738,1610612749,105.0,102.0,0.4679999999999999,0.419,1,2010-11-03,5,4,1,0.8,5,1,4,0.2
21000059,1610612745,1610612740,99.0,107.0,0.419,0.456,0,2010-11-03,4,0,4,0.0,4,4,0,1.0
21000060,1610612743,1610612742,101.0,102.0,0.461,0.4639999999999999,0,2010-11-03,4,2,2,0.5,4,3,1,0.75
21000061,1610612762,1610612761,125.0,108.0,0.565,0.456,1,2010-11-03,4,2,2,0.5,4,1,3,0.25
21000062,1610612756,1610612759,110.0,112.0,0.446,0.545,0,2010-11-03,4,1,3,0.25,4,3,1,0.75
21000063,1610612744,1610612763,115.0,109.0,0.413,0.512,1,2010-11-03,4,3,1,0.75,5,2,3,0.4
21000064,1610612746,1610612760,107.0,92.0,0.525,0.3779999999999999,1,2010-11-03,5,1,4,0.2,4,2,2,0.5
21000065,1610612758,1610612747,100.0,112.0,0.44,0.4639999999999999,0,2010-11-03,5,3,2,0.6,5,5,0,1.0
21000047,1610612739,1610612737,88.0,100.0,0.4320000000000001,0.44,0,2010-11-02,4,1,3,0.25,4,4,0,1.0
21000048,1610612764,1610612755,116.0,115.0,0.474,0.55,1,2010-11-02,3,1,2,0.3329999999999999,4,0,4,0.0
21000049,1610612765,1610612738,86.0,109.0,0.449,0.519,0,2010-11-02,4,0,4,0.0,4,3,1,0.75
21000050,1610612748,1610612750,129.0,97.0,0.5820000000000001,0.369,1,2010-11-02,5,4,1,0.8,4,1,3,0.25
21000052,1610612749,1610612757,76.0,90.0,0.375,0.475,0,2010-11-02,4,1,3,0.25,5,4,1,0.8
21000053,1610612747,1610612763,124.0,105.0,0.512,0.413,1,2010-11-02,4,4,0,1.0,4,2,2,0.5
21000044,1610612741,1610612757,110.0,98.0,0.606,0.413,1,2010-11-01,3,2,1,0.667,4,3,1,0.75
21000045,1610612758,1610612761,111.0,108.0,0.477,0.4589999999999999,1,2010-11-01,4,3,1,0.75,3,1,2,0.3329999999999999
21000046,1610612746,1610612759,88.0,97.0,0.4629999999999999,0.481,0,2010-11-01,4,0,4,0.0,3,2,1,0.667
21000040,1610612751,1610612748,78.0,101.0,0.353,0.537,0,2010-10-31,3,2,1,0.667,4,3,1,0.75
21000041,1610612746,1610612742,83.0,99.0,0.341,0.4679999999999999,0,2010-10-31,3,0,3,0.0,3,2,1,0.667
21000042,1610612760,1610612762,99.0,120.0,0.4,0.53,0,2010-10-31,3,2,1,0.667,3,1,2,0.3329999999999999
21000043,1610612747,1610612744,107.0,83.0,0.4429999999999999,0.4039999999999999,1,2010-10-31,3,3,0,1.0,3,2,1,0.667
21000031,1610612737,1610612764,99.0,95.0,0.42,0.5,1,2010-10-30,3,3,0,1.0,2,0,2,0.0
21000032,1610612739,1610612758,104.0,107.0,0.488,0.519,0,2010-10-30,3,1,2,0.3329999999999999,3,2,1,0.667
21000033,1610612752,1610612757,95.0,100.0,0.42,0.487,0,2010-10-30,3,1,2,0.3329999999999999,3,3,0,1.0
21000034,1610612754,1610612755,99.0,86.0,0.416,0.439,1,2010-10-30,3,2,1,0.667,3,0,3,0.0
21000035,1610612741,1610612765,101.0,91.0,0.43,0.3779999999999999,1,2010-10-30,2,1,1,0.5,3,0,3,0.0
21000036,1610612763,1610612750,109.0,89.0,0.462,0.348,1,2010-10-30,3,2,1,0.667,3,1,2,0.3329999999999999
21000037,1610612745,1610612743,94.0,107.0,0.457,0.3779999999999999,0,2010-10-30,3,0,3,0.0,3,2,1,0.667
21000038,1610612749,1610612766,98.0,88.0,0.451,0.469,1,2010-10-30,3,1,2,0.3329999999999999,3,0,3,0.0
21000039,1610612759,1610612740,90.0,99.0,0.3879999999999999,0.5,0,2010-10-30,2,1,1,0.5,3,3,0,1.0
21000019,1610612766,1610612754,101.0,104.0,0.4429999999999999,0.45,0,2010-10-29,2,0,2,0.0,2,1,1,0.5
21000020,1610612751,1610612758,106.0,100.0,0.525,0.419,1,2010-10-29,2,2,0,1.0,2,1,1,0.5
21000021,1610612755,1610612737,101.0,104.0,0.412,0.514,0,2010-10-29,2,0,2,0.0,2,2,0,1.0
21000022,1610612761,1610612739,101.0,81.0,0.476,0.381,1,2010-10-29,2,1,1,0.5,2,1,1,0.5
21000023,1610612738,1610612752,105.0,101.0,0.484,0.435,1,2010-10-29,3,2,1,0.667,2,1,1,0.5
21000024,1610612765,1610612760,104.0,105.0,0.471,0.3879999999999999,0,2010-10-29,2,0,2,0.0,2,2,0,1.0
21000025,1610612748,1610612753,96.0,70.0,0.407,0.304,1,2010-10-29,3,2,1,0.667,2,1,1,0.5
21000026,1610612750,1610612749,96.0,85.0,0.376,0.356,1,2010-10-29,2,1,1,0.5,2,0,2,0.0
21000027,1610612740,1610612743,101.0,95.0,0.494,0.486,1,2010-10-29,2,2,0,1.0,2,1,1,0.5
21000028,1610612742,1610612763,90.0,91.0,0.472,0.3879999999999999,0,2010-10-29,2,1,1,0.5,2,1,1,0.5
21000029,1610612744,1610612746,109.0,91.0,0.531,0.386,1,2010-10-29,2,2,0,1.0,2,0,2,0.0
21000030,1610612756,1610612747,106.0,114.0,0.473,0.484,0,2010-10-29,3,1,2,0.3329999999999999,2,2,0,1.0
21000017,1610612753,1610612764,112.0,83.0,0.5579999999999999,0.3720000000000001,1,2010-10-28,1,1,0,1.0,1,0,1,0.0
21000018,1610612762,1610612756,94.0,110.0,0.429,0.4629999999999999,0,2010-10-28,2,0,2,0.0,2,1,1,0.5
21000004,1610612739,1610612738,95.0,87.0,0.444,0.472,1,2010-10-27,1,1,0,1.0,2,1,1,0.5
21000005,1610612751,1610612765,101.0,98.0,0.488,0.446,1,2010-10-27,1,1,0,1.0,1,0,1,0.0
21000006,1610612755,1610612748,87.0,97.0,0.434,0.478,0,2010-10-27,1,0,1,0.0,2,1,1,0.5
21000007,1610612761,1610612752,93.0,98.0,0.3829999999999999,0.4320000000000001,0,2010-10-27,1,0,1,0.0,1,1,0,1.0
21000008,1610612763,1610612737,104.0,119.0,0.465,0.525,0,2010-10-27,1,0,1,0.0,1,1,0,1.0
21000009,1610612750,1610612758,116.0,117.0,0.473,0.4589999999999999,0,2010-10-27,1,0,1,0.0,1,1,0,1.0
21000010,1610612740,1610612749,95.0,91.0,0.43,0.429,1,2010-10-27,1,1,0,1.0,1,0,1,0.0
21000011,1610612760,1610612741,106.0,95.0,0.41,0.43,1,2010-10-27,1,1,0,1.0,1,0,1,0.0
21000012,1610612742,1610612766,101.0,86.0,0.547,0.397,1,2010-10-27,1,1,0,1.0,1,0,1,0.0
21000013,1610612759,1610612754,122.0,109.0,0.506,0.532,1,2010-10-27,1,1,0,1.0,1,0,1,0.0
21000014,1610612743,1610612762,110.0,88.0,0.4379999999999999,0.386,1,2010-10-27,1,1,0,1.0,1,0,1,0.0
21000015,1610612744,1610612745,132.0,128.0,0.5539999999999999,0.471,1,2010-10-27,1,1,0,1.0,2,0,2,0.0
21000016,1610612746,1610612757,88.0,98.0,0.405,0.409,0,2010-10-27,1,0,1,0.0,2,2,0,1.0
21000001,1610612738,1610612748,88.0,80.0,0.4639999999999999,0.365,1,2010-10-26,1,1,0,1.0,1,0,1,0.0
21000002,1610612757,1610612756,106.0,92.0,0.462,0.486,1,2010-10-26,1,1,0,1.0,1,0,1,0.0
21000003,1610612747,1610612745,112.0,110.0,0.417,0.418,1,2010-10-26,1,1,0,1.0,1,0,1,0.0
11000111,1610612766,1610612737,99.0,66.0,0.493,0.324,1,2010-10-22,8,4,4,0.5,7,2,5,0.286
11000115,1610612761,1610612752,108.0,103.0,0.462,0.507,1,2010-10-22,8,4,4,0.5,8,3,5,0.375
11000118,1610612765,1610612763,103.0,106.0,0.45,0.529,0,2010-10-22,8,3,5,0.375,8,8,0,1.0
11000112,1610612741,1610612754,102.0,74.0,0.4579999999999999,0.35,1,2010-10-22,8,4,4,0.5,7,3,4,0.429
11000117,1610612742,1610612745,97.0,96.0,0.488,0.449,1,2010-10-22,8,4,4,0.5,8,4,4,0.5
11000120,1610612749,1610612750,118.0,119.0,0.43,0.4270000000000001,0,2010-10-22,8,3,5,0.375,8,6,2,0.75
11000116,1610612762,1610612758,82.0,71.0,0.44,0.361,1,2010-10-22,8,8,0,1.0,7,3,4,0.429
11000113,1610612747,1610612744,105.0,102.0,0.412,0.474,1,2010-10-22,8,4,4,0.5,8,3,5,0.375
11000114,1610612756,1610612743,106.0,144.0,0.44,0.6409999999999999,0,2010-10-22,8,2,6,0.25,8,5,3,0.625
11000105,1610612739,1610612749,83.0,77.0,0.413,0.436,1,2010-10-21,8,6,2,0.75,7,3,4,0.429
11000107,1610612760,1610612740,101.0,86.0,0.455,0.415,1,2010-10-21,7,4,3,0.5710000000000001,8,1,7,0.125
11000110,1610612737,1610612748,98.0,89.0,0.424,0.3670000000000001,1,2010-10-21,6,2,4,0.3329999999999999,7,3,4,0.429
11000109,1610612759,1610612745,111.0,103.0,0.465,0.487,1,2010-10-21,7,4,3,0.5710000000000001,7,4,3,0.5710000000000001
11000106,1610612747,1610612744,120.0,99.0,0.56,0.436,1,2010-10-21,7,3,4,0.429,7,3,4,0.429
11000108,1610612757,1610612743,90.0,83.0,0.407,0.356,1,2010-10-21,7,3,4,0.429,7,4,3,0.5710000000000001
11000100,1610612766,1610612740,105.0,98.0,0.4679999999999999,0.436,1,2010-10-20,7,3,4,0.429,7,1,6,0.143
11000101,1610612753,1610612742,101.0,76.0,0.4679999999999999,0.36,1,2010-10-20,7,7,0,1.0,7,3,4,0.429
11000102,1610612755,1610612752,118.0,91.0,0.505,0.349,1,2010-10-20,7,2,5,0.286,7,3,4,0.429
11000103,1610612761,1610612741,103.0,110.0,0.475,0.5,0,2010-10-20,7,3,4,0.429,7,3,4,0.429
11000104,1610612738,1610612751,107.0,92.0,0.568,0.479,1,2010-10-20,8,7,1,0.875,8,3,5,0.375
11000092,1610612739,1610612755,111.0,95.0,0.5579999999999999,0.379,1,2010-10-19,7,5,2,0.7140000000000001,6,1,5,0.1669999999999999
11000094,1610612765,1610612764,98.0,92.0,0.474,0.397,1,2010-10-19,7,3,4,0.429,7,3,4,0.429
11000099,1610612752,1610612751,117.0,111.0,0.474,0.442,1,2010-10-19,6,3,3,0.5,7,3,4,0.429
11000096,1610612750,1610612754,124.0,128.0,0.412,0.455,0,2010-10-19,7,5,2,0.7140000000000001,6,3,3,0.5
11000093,1610612743,1610612760,130.0,115.0,0.5489999999999999,0.47,1,2010-10-19,6,4,2,0.667,6,3,3,0.5
11000095,1610612747,1610612762,74.0,82.0,0.3329999999999999,0.397,0,2010-10-19,6,2,4,0.3329999999999999,7,7,0,1.0
11000097,1610612756,1610612744,92.0,87.0,0.3779999999999999,0.33,1,2010-10-19,7,2,5,0.286,6,3,3,0.5
11000098,1610612746,1610612758,94.0,96.0,0.474,0.3829999999999999,0,2010-10-19,8,1,7,0.125,6,3,3,0.5
11000087,1610612737,1610612753,73.0,102.0,0.308,0.529,0,2010-10-18,5,1,4,0.2,6,6,0,1.0
11000090,1610612748,1610612766,96.0,102.0,0.392,0.565,0,2010-10-18,6,3,3,0.5,6,2,4,0.3329999999999999
11000088,1610612763,1610612740,96.0,91.0,0.493,0.418,1,2010-10-18,7,7,0,1.0,6,1,5,0.1669999999999999
11000091,1610612759,1610612760,102.0,111.0,0.434,0.476,0,2010-10-18,6,3,3,0.5,5,3,2,0.6
11000089,1610612744,1610612757,100.0,78.0,0.444,0.377,1,2010-10-18,5,3,2,0.6,6,2,4,0.3329999999999999
11000082,1610612761,1610612756,121.0,100.0,0.48,0.457,1,2010-10-17,6,3,3,0.5,6,1,5,0.1669999999999999
11000085,1610612752,1610612764,92.0,90.0,0.4,0.418,1,2010-10-17,5,2,3,0.4,6,3,3,0.5
11000083,1610612743,1610612746,108.0,104.0,0.478,0.471,1,2010-10-17,5,3,2,0.6,7,1,6,0.143
11000084,1610612750,1610612749,114.0,109.0,0.513,0.456,1,2010-10-17,6,5,1,0.833,6,3,3,0.5
11000086,1610612747,1610612762,94.0,99.0,0.39,0.507,0,2010-10-17,5,2,3,0.4,6,6,0,1.0
11000081,1610612751,1610612745,85.0,95.0,0.421,0.434,0,2010-10-16,6,3,3,0.5,6,4,2,0.667
11000072,1610612766,1610612765,97.0,94.0,0.469,0.405,1,2010-10-16,5,1,4,0.2,6,2,4,0.3329999999999999
11000074,1610612753,1610612741,105.0,67.0,0.623,0.311,1,2010-10-16,5,5,0,1.0,6,2,4,0.3329999999999999
11000071,1610612746,1610612762,91.0,103.0,0.5,0.541,0,2010-10-16,6,1,5,0.1669999999999999,5,5,0,1.0
11000076,1610612738,1610612752,97.0,84.0,0.486,0.4,1,2010-10-16,7,6,1,0.857,4,1,3,0.25
11000073,1610612763,1610612749,91.0,77.0,0.4379999999999999,0.3289999999999999,1,2010-10-16,6,6,0,1.0,5,3,2,0.6
11000079,1610612740,1610612737,74.0,84.0,0.384,0.406,0,2010-10-16,5,1,4,0.2,4,1,3,0.25
11000075,1610612757,1610612744,118.0,105.0,0.5379999999999999,0.5,1,2010-10-16,5,2,3,0.4,4,2,2,0.5
11000078,1610612747,1610612743,102.0,95.0,0.5,0.436,1,2010-10-16,4,2,2,0.5,4,2,2,0.5
11000068,1610612754,1610612740,101.0,98.0,0.431,0.436,1,2010-10-15,5,2,3,0.4,4,1,3,0.25
11000069,1610612761,1610612738,112.0,117.0,0.4270000000000001,0.507,0,2010-10-15,5,2,3,0.4,6,5,1,0.833
11000070,1610612750,1610612765,99.0,88.0,0.45,0.3379999999999999,1,2010-10-15,5,4,1,0.8,5,2,3,0.4
11000067,1610612741,1610612742,105.0,109.0,0.3979999999999999,0.412,0,2010-10-15,5,2,3,0.4,6,3,3,0.5
11000062,1610612753,1610612766,86.0,73.0,0.416,0.391,1,2010-10-14,4,4,0,1.0,4,0,4,0.0
11000064,1610612764,1610612749,88.0,96.0,0.429,0.4029999999999999,0,2010-10-14,5,3,2,0.6,4,3,1,0.75
11000065,1610612739,1610612759,106.0,80.0,0.519,0.37,1,2010-10-14,5,4,1,0.8,4,2,2,0.5
11000063,1610612762,1610612756,108.0,97.0,0.483,0.4429999999999999,1,2010-10-14,4,4,0,1.0,5,1,4,0.2
11000066,1610612746,1610612743,95.0,100.0,0.349,0.354,0,2010-10-14,5,1,4,0.2,3,2,1,0.667
11000059,1610612745,1610612751,91.0,81.0,0.455,0.392,1,2010-10-13,5,3,2,0.6,5,3,2,0.6
11000053,1610612765,1610612742,96.0,101.0,0.467,0.519,0,2010-10-13,4,2,2,0.5,5,2,3,0.4
11000054,1610612754,1610612750,98.0,86.0,0.418,0.319,1,2010-10-13,4,1,3,0.25,4,3,1,0.75
11000057,1610612761,1610612755,119.0,116.0,0.4589999999999999,0.4270000000000001,1,2010-10-13,4,2,2,0.5,5,1,4,0.2
11000058,1610612752,1610612738,101.0,104.0,0.413,0.487,0,2010-10-13,3,1,2,0.3329999999999999,5,4,1,0.8
11000056,1610612740,1610612748,90.0,76.0,0.361,0.415,1,2010-10-13,3,1,2,0.3329999999999999,5,3,2,0.6
11000055,1610612747,1610612758,98.0,95.0,0.44,0.392,1,2010-10-13,3,1,2,0.3329999999999999,5,2,3,0.4
11000047,1610612755,1610612738,103.0,92.0,0.473,0.5,1,2010-10-12,4,1,3,0.25,4,3,1,0.75
11000050,1610612764,1610612737,107.0,92.0,0.532,0.513,1,2010-10-12,4,3,1,0.75,3,0,3,0.0
11000044,1610612741,1610612761,109.0,90.0,0.526,0.48,1,2010-10-12,4,2,2,0.5,3,1,2,0.3329999999999999
11000045,1610612750,1610612743,122.0,108.0,0.433,0.419,1,2010-10-12,3,3,0,1.0,2,1,1,0.5
11000046,1610612760,1610612763,96.0,116.0,0.429,0.657,0,2010-10-12,3,1,2,0.3329999999999999,4,4,0,1.0
11000052,1610612746,1610612759,99.0,100.0,0.415,0.409,0,2010-10-12,4,1,3,0.25,3,2,1,0.667
11000048,1610612756,1610612762,100.0,105.0,0.45,0.4379999999999999,0,2010-10-12,4,1,3,0.25,3,3,0,1.0
11000049,1610612758,1610612744,116.0,97.0,0.481,0.422,1,2010-10-12,4,2,2,0.5,3,2,1,0.667
11000043,1610612765,1610612737,94.0,85.0,0.52,0.441,1,2010-10-11,3,2,1,0.667,2,0,2,0.0
11000042,1610612742,1610612739,79.0,85.0,0.369,0.371,0,2010-10-11,4,1,3,0.25,4,3,1,0.75
11000041,1610612757,1610612762,100.0,109.0,0.477,0.507,0,2010-10-11,4,1,3,0.25,2,2,0,1.0
11000037,1610612738,1610612761,91.0,87.0,0.53,0.3979999999999999,1,2010-10-10,3,3,0,1.0,2,1,1,0.5
11000039,1610612753,1610612740,135.0,81.0,0.648,0.3289999999999999,1,2010-10-10,3,3,0,1.0,2,0,2,0.0
11000038,1610612745,1610612739,93.0,99.0,0.429,0.48,0,2010-10-10,4,2,2,0.5,3,2,1,0.667
11000040,1610612744,1610612758,95.0,86.0,0.412,0.341,1,2010-10-10,2,2,0,1.0,3,1,2,0.3329999999999999
11000031,1610612751,1610612755,90.0,89.0,0.423,0.354,1,2010-10-09,4,3,1,0.75,3,0,3,0.0
11000032,1610612745,1610612754,126.0,92.0,0.568,0.417,1,2010-10-09,3,2,1,0.667,3,0,3,0.0
11000034,1610612749,1610612766,86.0,78.0,0.359,0.3779999999999999,1,2010-10-09,3,2,1,0.667,3,0,3,0.0
11000035,1610612740,1610612763,90.0,97.0,0.366,0.436,0,2010-10-09,1,0,1,0.0,3,3,0,1.0
11000036,1610612759,1610612748,90.0,73.0,0.4379999999999999,0.375,1,2010-10-09,2,1,1,0.5,3,2,1,0.667
11000033,1610612756,1610612742,98.0,90.0,0.395,0.395,1,2010-10-09,3,1,2,0.3329999999999999,3,1,2,0.3329999999999999
11000027,1610612754,1610612753,86.0,93.0,0.363,0.351,0,2010-10-08,2,0,2,0.0,2,2,0,1.0
11000028,1610612765,1610612749,115.0,110.0,0.512,0.435,1,2010-10-08,2,1,1,0.5,2,1,1,0.5
11000025,1610612741,1610612764,107.0,96.0,0.527,0.462,1,2010-10-08,3,1,2,0.3329999999999999,3,2,1,0.667
11000030,1610612748,1610612760,103.0,96.0,0.4320000000000001,0.356,1,2010-10-08,2,2,0,1.0,2,1,1,0.5
11000026,1610612743,1610612757,109.0,99.0,0.5,0.442,1,2010-10-08,1,1,0,1.0,3,1,2,0.3329999999999999
11000029,1610612744,1610612746,127.0,87.0,0.557,0.3779999999999999,1,2010-10-08,1,1,0,1.0,3,1,2,0.3329999999999999
11000017,1610612737,1610612763,111.0,115.0,0.519,0.449,0,2010-10-07,1,0,1,0.0,2,2,0,1.0
11000018,1610612739,1610612764,83.0,97.0,0.353,0.4039999999999999,0,2010-10-07,2,1,1,0.5,2,2,0,1.0
11000019,1610612751,1610612738,92.0,96.0,0.4,0.425,0,2010-10-07,3,2,1,0.667,2,2,0,1.0
11000022,1610612742,1610612741,88.0,83.0,0.387,0.4270000000000001,1,2010-10-07,2,1,1,0.5,2,0,2,0.0
11000023,1610612745,1610612759,90.0,87.0,0.405,0.37,1,2010-10-07,2,1,1,0.5,1,0,1,0.0
11000021,1610612762,1610612757,100.0,96.0,0.485,0.447,1,2010-10-07,1,1,0,1.0,2,1,1,0.5
11000020,1610612758,1610612746,88.0,120.0,0.413,0.539,0,2010-10-07,2,1,1,0.5,2,1,1,0.5
11000016,1610612750,1610612752,106.0,100.0,0.4,0.4,1,2010-10-06,2,2,0,1.0,2,1,1,0.5
11000012,1610612766,1610612760,93.0,97.0,0.478,0.395,0,2010-10-06,2,0,2,0.0,1,1,0,1.0
11000015,1610612738,1610612755,93.0,65.0,0.4429999999999999,0.2689999999999999,1,2010-10-06,1,1,0,1.0,2,0,2,0.0
11000013,1610612763,1610612754,87.0,85.0,0.465,0.377,1,2010-10-06,1,1,0,1.0,1,0,1,0.0
11000014,1610612756,1610612761,78.0,129.0,0.3779999999999999,0.506,0,2010-10-06,2,0,2,0.0,1,1,0,1.0
11000004,1610612739,1610612766,87.0,72.0,0.364,0.317,1,2010-10-05,1,1,0,1.0,1,0,1,0.0
11000007,1610612755,1610612751,96.0,103.0,0.375,0.507,0,2010-10-05,1,0,1,0.0,2,2,0,1.0
11000011,1610612748,1610612765,105.0,89.0,0.532,0.433,1,2010-10-05,1,1,0,1.0,1,0,1,0.0
11000006,1610612749,1610612741,92.0,83.0,0.508,0.425,1,2010-10-05,1,1,0,1.0,1,0,1,0.0
11000005,1610612745,1610612753,88.0,97.0,0.395,0.481,0,2010-10-05,1,0,1,0.0,1,1,0,1.0
11000010,1610612742,1610612764,94.0,97.0,0.4379999999999999,0.4679999999999999,0,2010-10-05,1,0,1,0.0,1,1,0,1.0
11000008,1610612757,1610612746,115.0,86.0,0.481,0.4379999999999999,1,2010-10-05,1,1,0,1.0,1,0,1,0.0
11000009,1610612758,1610612756,109.0,95.0,0.517,0.486,1,2010-10-05,1,1,0,1.0,1,0,1,0.0
11000003,1610612750,1610612747,111.0,92.0,0.541,0.4429999999999999,1,2010-10-04,1,1,0,1.0,1,0,1,0.0
40900407,1610612747,1610612738,83.0,79.0,0.325,0.408,1,2010-06-17,82,57,25,0.695,82,50,32,0.61
40900406,1610612747,1610612738,89.0,67.0,0.418,0.3329999999999999,1,2010-06-15,82,57,25,0.695,82,50,32,0.61
40900405,1610612738,1610612747,92.0,86.0,0.563,0.397,1,2010-06-13,82,50,32,0.61,82,57,25,0.695
40900404,1610612738,1610612747,96.0,89.0,0.446,0.451,1,2010-06-10,82,50,32,0.61,82,57,25,0.695
40900403,1610612738,1610612747,84.0,91.0,0.4379999999999999,0.447,0,2010-06-08,82,50,32,0.61,82,57,25,0.695
40900402,1610612747,1610612738,94.0,103.0,0.408,0.429,0,2010-06-06,82,57,25,0.695,82,50,32,0.61
40900401,1610612747,1610612738,102.0,89.0,0.487,0.433,1,2010-06-03,82,57,25,0.695,82,50,32,0.61
40900316,1610612756,1610612747,103.0,111.0,0.467,0.47,0,2010-05-29,82,54,28,0.659,82,57,25,0.695
40900306,1610612738,1610612753,96.0,84.0,0.4270000000000001,0.431,1,2010-05-28,82,50,32,0.61,82,59,23,0.72
40900315,1610612747,1610612756,103.0,101.0,0.418,0.4679999999999999,1,2010-05-27,82,57,25,0.695,82,54,28,0.659
40900305,1610612753,1610612738,113.0,92.0,0.522,0.431,1,2010-05-26,82,59,23,0.72,82,50,32,0.61
40900314,1610612756,1610612747,115.0,106.0,0.488,0.495,1,2010-05-25,82,54,28,0.659,82,57,25,0.695
40900304,1610612738,1610612753,92.0,96.0,0.421,0.446,0,2010-05-24,82,50,32,0.61,82,59,23,0.72
40900313,1610612756,1610612747,118.0,109.0,0.4629999999999999,0.483,1,2010-05-23,82,54,28,0.659,82,57,25,0.695
40900303,1610612738,1610612753,94.0,71.0,0.466,0.369,1,2010-05-22,82,50,32,0.61,82,59,23,0.72
40900312,1610612747,1610612756,124.0,112.0,0.5770000000000001,0.494,1,2010-05-19,82,57,25,0.695,82,54,28,0.659
40900302,1610612753,1610612738,92.0,95.0,0.3939999999999999,0.4589999999999999,0,2010-05-18,82,59,23,0.72,82,50,32,0.61
40900311,1610612747,1610612756,128.0,107.0,0.58,0.494,1,2010-05-17,82,57,25,0.695,82,54,28,0.659
40900301,1610612753,1610612738,88.0,92.0,0.416,0.446,0,2010-05-16,82,59,23,0.72,82,50,32,0.61
40900206,1610612738,1610612739,94.0,85.0,0.442,0.384,1,2010-05-13,82,50,32,0.61,82,61,21,0.7440000000000001
40900205,1610612739,1610612738,88.0,120.0,0.412,0.55,0,2010-05-11,82,61,21,0.7440000000000001,82,50,32,0.61
40900214,1610612737,1610612753,84.0,98.0,0.405,0.5539999999999999,0,2010-05-10,82,53,29,0.6459999999999999,82,59,23,0.72
40900234,1610612762,1610612747,96.0,111.0,0.457,0.4579999999999999,0,2010-05-10,82,53,29,0.6459999999999999,82,57,25,0.695
40900204,1610612738,1610612739,97.0,87.0,0.447,0.4029999999999999,1,2010-05-09,82,50,32,0.61,82,61,21,0.7440000000000001
40900224,1610612759,1610612756,101.0,107.0,0.467,0.457,0,2010-05-09,82,50,32,0.61,82,54,28,0.659
40900213,1610612737,1610612753,75.0,105.0,0.349,0.507,0,2010-05-08,82,53,29,0.6459999999999999,82,59,23,0.72
40900233,1610612762,1610612747,110.0,111.0,0.481,0.471,0,2010-05-08,82,53,29,0.6459999999999999,82,57,25,0.695
40900203,1610612738,1610612739,95.0,124.0,0.4270000000000001,0.595,0,2010-05-07,82,50,32,0.61,82,61,21,0.7440000000000001
40900223,1610612759,1610612756,96.0,110.0,0.45,0.532,0,2010-05-07,82,50,32,0.61,82,54,28,0.659
40900212,1610612753,1610612737,112.0,98.0,0.5589999999999999,0.413,1,2010-05-06,82,59,23,0.72,82,53,29,0.6459999999999999
40900222,1610612756,1610612759,110.0,102.0,0.424,0.506,1,2010-05-05,82,54,28,0.659,82,50,32,0.61
40900211,1610612753,1610612737,114.0,71.0,0.524,0.346,1,2010-05-04,82,59,23,0.72,82,53,29,0.6459999999999999
40900232,1610612747,1610612762,111.0,103.0,0.506,0.396,1,2010-05-04,82,57,25,0.695,82,53,29,0.6459999999999999
40900202,1610612739,1610612738,86.0,104.0,0.4,0.513,0,2010-05-03,82,61,21,0.7440000000000001,82,50,32,0.61
40900221,1610612756,1610612759,111.0,102.0,0.519,0.4579999999999999,1,2010-05-03,82,54,28,0.659,82,50,32,0.61
40900127,1610612737,1610612749,95.0,74.0,0.474,0.326,1,2010-05-02,82,53,29,0.6459999999999999,82,46,36,0.561
40900231,1610612747,1610612762,104.0,99.0,0.532,0.447,1,2010-05-02,82,57,25,0.695,82,53,29,0.6459999999999999
40900201,1610612739,1610612738,101.0,93.0,0.487,0.444,1,2010-05-01,82,61,21,0.7440000000000001,82,50,32,0.61
40900126,1610612749,1610612737,69.0,83.0,0.3289999999999999,0.3829999999999999,0,2010-04-30,82,46,36,0.561,82,53,29,0.6459999999999999
40900146,1610612760,1610612747,94.0,95.0,0.365,0.4679999999999999,0,2010-04-30,82,50,32,0.61,82,57,25,0.695
40900176,1610612762,1610612743,112.0,104.0,0.522,0.434,1,2010-04-30,82,53,29,0.6459999999999999,82,53,29,0.6459999999999999
40900156,1610612759,1610612742,97.0,87.0,0.474,0.4379999999999999,1,2010-04-29,82,50,32,0.61,82,55,27,0.6709999999999999
40900166,1610612757,1610612756,90.0,99.0,0.38,0.473,0,2010-04-29,82,50,32,0.61,82,54,28,0.659
40900125,1610612737,1610612749,87.0,91.0,0.434,0.405,0,2010-04-28,82,53,29,0.6459999999999999,82,46,36,0.561
40900175,1610612743,1610612762,116.0,102.0,0.507,0.452,1,2010-04-28,82,53,29,0.6459999999999999,82,53,29,0.6459999999999999
40900135,1610612738,1610612748,96.0,86.0,0.486,0.392,1,2010-04-27,82,50,32,0.61,82,47,35,0.573
40900105,1610612739,1610612741,96.0,94.0,0.466,0.461,1,2010-04-27,82,61,21,0.7440000000000001,82,41,41,0.5
40900155,1610612742,1610612759,103.0,81.0,0.44,0.359,1,2010-04-27,82,55,27,0.6709999999999999,82,50,32,0.61
40900145,1610612747,1610612760,111.0,87.0,0.5379999999999999,0.369,1,2010-04-27,82,57,25,0.695,82,50,32,0.61
40900114,1610612766,1610612753,90.0,99.0,0.451,0.418,0,2010-04-26,82,44,38,0.537,82,59,23,0.72
40900124,1610612749,1610612737,111.0,104.0,0.551,0.475,1,2010-04-26,82,46,36,0.561,82,53,29,0.6459999999999999
40900165,1610612756,1610612757,107.0,88.0,0.466,0.4639999999999999,1,2010-04-26,82,54,28,0.659,82,50,32,0.61
40900134,1610612748,1610612738,101.0,92.0,0.5,0.493,1,2010-04-25,82,47,35,0.573,82,50,32,0.61
40900104,1610612741,1610612739,98.0,121.0,0.374,0.532,0,2010-04-25,82,41,41,0.5,82,61,21,0.7440000000000001
40900154,1610612759,1610612742,92.0,89.0,0.4529999999999999,0.416,1,2010-04-25,82,50,32,0.61,82,55,27,0.6709999999999999
40900174,1610612762,1610612743,117.0,106.0,0.532,0.44,1,2010-04-25,82,53,29,0.6459999999999999,82,53,29,0.6459999999999999
40900113,1610612766,1610612753,86.0,90.0,0.419,0.4429999999999999,0,2010-04-24,82,44,38,0.537,82,59,23,0.72
40900164,1610612757,1610612756,96.0,87.0,0.4429999999999999,0.434,1,2010-04-24,82,50,32,0.61,82,54,28,0.659
40900123,1610612749,1610612737,107.0,89.0,0.513,0.391,1,2010-04-24,82,46,36,0.561,82,53,29,0.6459999999999999
40900144,1610612760,1610612747,110.0,89.0,0.408,0.415,1,2010-04-24,82,50,32,0.61,82,57,25,0.695
40900133,1610612748,1610612738,98.0,100.0,0.506,0.4679999999999999,0,2010-04-23,82,47,35,0.573,82,50,32,0.61
40900153,1610612759,1610612742,94.0,90.0,0.487,0.447,1,2010-04-23,82,50,32,0.61,82,55,27,0.6709999999999999
40900173,1610612762,1610612743,105.0,93.0,0.47,0.431,1,2010-04-23,82,53,29,0.6459999999999999,82,53,29,0.6459999999999999
40900103,1610612741,1610612739,108.0,106.0,0.5,0.439,1,2010-04-22,82,41,41,0.5,82,61,21,0.7440000000000001
40900143,1610612760,1610612747,101.0,96.0,0.413,0.452,1,2010-04-22,82,50,32,0.61,82,57,25,0.695
40900163,1610612757,1610612756,89.0,108.0,0.442,0.529,0,2010-04-22,82,50,32,0.61,82,54,28,0.659
40900112,1610612753,1610612766,92.0,77.0,0.4529999999999999,0.439,1,2010-04-21,82,59,23,0.72,82,44,38,0.537
40900152,1610612742,1610612759,88.0,102.0,0.365,0.482,0,2010-04-21,82,55,27,0.6709999999999999,82,50,32,0.61
40900122,1610612737,1610612749,96.0,86.0,0.475,0.411,1,2010-04-20,82,53,29,0.6459999999999999,82,46,36,0.561
40900132,1610612738,1610612748,106.0,77.0,0.48,0.382,1,2010-04-20,82,50,32,0.61,82,47,35,0.573
40900162,1610612756,1610612757,119.0,90.0,0.523,0.382,1,2010-04-20,82,54,28,0.659,82,50,32,0.61
40900142,1610612747,1610612760,95.0,92.0,0.375,0.392,1,2010-04-20,82,57,25,0.695,82,50,32,0.61
40900102,1610612739,1610612741,112.0,102.0,0.563,0.441,1,2010-04-19,82,61,21,0.7440000000000001,82,41,41,0.5
40900172,1610612743,1610612762,111.0,114.0,0.467,0.529,0,2010-04-19,82,53,29,0.6459999999999999,82,53,29,0.6459999999999999
40900141,1610612747,1610612760,87.0,79.0,0.41,0.4029999999999999,1,2010-04-18,82,57,25,0.695,82,50,32,0.61
40900111,1610612753,1610612766,98.0,89.0,0.446,0.465,1,2010-04-18,82,59,23,0.72,82,44,38,0.537
40900151,1610612742,1610612759,100.0,94.0,0.473,0.5,1,2010-04-18,82,55,27,0.6709999999999999,82,50,32,0.61
40900161,1610612756,1610612757,100.0,105.0,0.418,0.469,0,2010-04-18,82,54,28,0.659,82,50,32,0.61
40900101,1610612739,1610612741,96.0,83.0,0.4639999999999999,0.425,1,2010-04-17,82,61,21,0.7440000000000001,82,41,41,0.5
40900121,1610612737,1610612749,102.0,92.0,0.539,0.451,1,2010-04-17,82,53,29,0.6459999999999999,82,46,36,0.561
40900131,1610612738,1610612748,85.0,76.0,0.4429999999999999,0.397,1,2010-04-17,82,50,32,0.61,82,47,35,0.573
40900171,1610612743,1610612762,126.0,113.0,0.5710000000000001,0.547,1,2010-04-17,82,53,29,0.6459999999999999,82,53,29,0.6459999999999999
20901217,1610612737,1610612739,99.0,83.0,0.544,0.425,1,2010-04-14,82,53,29,0.6459999999999999,82,61,21,0.7440000000000001
20901218,1610612738,1610612749,95.0,106.0,0.474,0.506,0,2010-04-14,82,50,32,0.61,82,46,36,0.561
20901219,1610612766,1610612741,89.0,98.0,0.4,0.474,0,2010-04-14,82,44,38,0.537,82,41,41,0.5
20901220,1610612742,1610612759,96.0,89.0,0.412,0.407,1,2010-04-14,82,55,27,0.6709999999999999,82,50,32,0.61
20901221,1610612745,1610612740,115.0,123.0,0.54,0.638,0,2010-04-14,82,42,40,0.512,82,37,45,0.451
20901222,1610612748,1610612751,94.0,86.0,0.3979999999999999,0.363,1,2010-04-14,82,47,35,0.573,82,12,70,0.146
20901223,1610612750,1610612765,98.0,103.0,0.494,0.481,0,2010-04-14,82,15,67,0.183,82,27,55,0.3289999999999999
20901224,1610612760,1610612763,114.0,105.0,0.532,0.4589999999999999,1,2010-04-14,82,50,32,0.61,82,40,42,0.488
20901225,1610612753,1610612755,125.0,111.0,0.598,0.518,1,2010-04-14,82,59,23,0.72,82,27,55,0.3289999999999999
20901226,1610612761,1610612752,131.0,113.0,0.65,0.433,1,2010-04-14,82,40,42,0.488,82,29,53,0.354
20901227,1610612764,1610612754,98.0,97.0,0.481,0.3979999999999999,1,2010-04-14,82,26,56,0.317,82,32,50,0.39
20901228,1610612746,1610612747,107.0,91.0,0.506,0.395,1,2010-04-14,82,29,53,0.354,82,57,25,0.695
20901229,1610612757,1610612744,116.0,122.0,0.506,0.5,0,2010-04-14,82,50,32,0.61,82,26,56,0.317
20901230,1610612762,1610612756,86.0,100.0,0.375,0.473,0,2010-04-14,82,53,29,0.6459999999999999,82,54,28,0.659
20901213,1610612741,1610612738,101.0,93.0,0.482,0.4379999999999999,1,2010-04-13,81,40,41,0.494,81,50,31,0.617
20901214,1610612744,1610612762,94.0,103.0,0.381,0.482,0,2010-04-13,81,25,56,0.309,81,53,28,0.654
20901215,1610612747,1610612758,106.0,100.0,0.494,0.478,1,2010-04-13,81,57,24,0.7040000000000001,82,25,57,0.305
20901216,1610612756,1610612743,123.0,101.0,0.5379999999999999,0.423,1,2010-04-13,81,53,28,0.654,82,53,29,0.6459999999999999
20901202,1610612754,1610612753,98.0,118.0,0.409,0.481,0,2010-04-12,81,32,49,0.395,81,58,23,0.716
20901203,1610612755,1610612748,105.0,107.0,0.547,0.556,0,2010-04-12,81,27,54,0.3329999999999999,81,46,35,0.568
20901204,1610612765,1610612761,97.0,111.0,0.4679999999999999,0.6,0,2010-04-12,81,26,55,0.321,81,39,42,0.481
20901205,1610612751,1610612766,95.0,105.0,0.3929999999999999,0.494,0,2010-04-12,81,12,69,0.148,81,44,37,0.5429999999999999
20901206,1610612752,1610612764,114.0,103.0,0.513,0.5,1,2010-04-12,81,29,52,0.358,81,25,56,0.309
20901207,1610612749,1610612737,96.0,104.0,0.387,0.527,0,2010-04-12,81,45,36,0.556,81,52,29,0.642
20901208,1610612759,1610612750,133.0,111.0,0.58,0.476,1,2010-04-12,81,50,31,0.617,81,15,66,0.185
20901209,1610612743,1610612763,123.0,101.0,0.46,0.391,1,2010-04-12,81,53,28,0.654,81,40,41,0.494
20901210,1610612757,1610612760,103.0,95.0,0.5,0.469,1,2010-04-12,81,50,31,0.617,81,49,32,0.605
20901211,1610612758,1610612745,107.0,117.0,0.482,0.518,0,2010-04-12,81,25,56,0.309,81,42,39,0.519
20901212,1610612746,1610612742,94.0,117.0,0.4579999999999999,0.542,0,2010-04-12,81,28,53,0.346,81,54,27,0.667
20901195,1610612739,1610612753,92.0,98.0,0.41,0.481,0,2010-04-11,81,61,20,0.753,80,57,23,0.713
20901196,1610612747,1610612757,88.0,91.0,0.425,0.45,0,2010-04-11,80,56,24,0.7,80,49,31,0.613
20901197,1610612761,1610612741,88.0,104.0,0.411,0.494,0,2010-04-11,80,38,42,0.475,80,39,41,0.488
20901199,1610612752,1610612748,98.0,111.0,0.452,0.524,0,2010-04-11,80,28,52,0.35,80,45,35,0.563
20901198,1610612740,1610612750,114.0,86.0,0.524,0.3939999999999999,1,2010-04-11,81,36,45,0.444,80,15,65,0.188
20901200,1610612744,1610612760,120.0,117.0,0.506,0.423,1,2010-04-11,80,25,55,0.313,80,49,31,0.613
20901201,1610612756,1610612745,116.0,106.0,0.488,0.447,1,2010-04-11,80,52,28,0.65,80,41,39,0.513
20901187,1610612766,1610612765,99.0,95.0,0.5379999999999999,0.456,1,2010-04-10,80,43,37,0.5379999999999999,80,26,54,0.325
20901188,1610612754,1610612751,115.0,102.0,0.535,0.524,1,2010-04-10,80,32,48,0.4,80,12,68,0.15
20901189,1610612764,1610612737,95.0,105.0,0.506,0.541,0,2010-04-10,80,25,55,0.313,80,51,29,0.638
20901190,1610612763,1610612755,101.0,120.0,0.493,0.57,0,2010-04-10,80,40,40,0.5,80,27,53,0.3379999999999999
20901191,1610612749,1610612738,90.0,105.0,0.397,0.467,0,2010-04-10,80,45,35,0.563,80,50,30,0.625
20901192,1610612743,1610612759,85.0,104.0,0.392,0.4589999999999999,0,2010-04-10,80,52,28,0.65,80,49,31,0.613
20901193,1610612758,1610612742,108.0,126.0,0.471,0.532,0,2010-04-10,80,25,55,0.313,80,53,27,0.6629999999999999
20901194,1610612746,1610612744,107.0,104.0,0.506,0.402,1,2010-04-10,80,28,52,0.35,79,24,55,0.304
20901174,1610612753,1610612752,118.0,103.0,0.56,0.473,1,2010-04-09,79,56,23,0.7090000000000001,79,28,51,0.354
20901175,1610612755,1610612749,90.0,95.0,0.444,0.416,0,2010-04-09,79,26,53,0.3289999999999999,79,45,34,0.57
20901176,1610612737,1610612761,107.0,101.0,0.409,0.478,1,2010-04-09,79,50,29,0.633,79,38,41,0.481
20901177,1610612738,1610612764,96.0,106.0,0.422,0.487,0,2010-04-09,79,49,30,0.62,79,25,54,0.316
20901178,1610612739,1610612754,113.0,116.0,0.461,0.506,0,2010-04-09,80,61,19,0.763,79,31,48,0.392
20901179,1610612748,1610612765,99.0,106.0,0.557,0.5,0,2010-04-09,79,44,35,0.557,79,26,53,0.3289999999999999
20901180,1610612750,1610612747,88.0,97.0,0.4270000000000001,0.442,0,2010-04-09,79,15,64,0.19,79,56,23,0.7090000000000001
20901181,1610612751,1610612741,127.0,116.0,0.467,0.478,1,2010-04-09,79,12,67,0.152,79,38,41,0.481
20901182,1610612740,1610612762,103.0,114.0,0.494,0.55,0,2010-04-09,80,35,45,0.4379999999999999,80,52,28,0.65
20901183,1610612760,1610612756,96.0,91.0,0.3979999999999999,0.4529999999999999,1,2010-04-09,79,49,30,0.62,79,51,28,0.6459999999999999
20901184,1610612745,1610612766,97.0,90.0,0.442,0.429,1,2010-04-09,79,41,38,0.519,79,42,37,0.532
20901185,1610612759,1610612763,99.0,107.0,0.44,0.489,0,2010-04-09,79,48,31,0.608,79,40,39,0.506
20901186,1610612757,1610612742,77.0,83.0,0.364,0.3379999999999999,0,2010-04-09,79,48,31,0.608,79,52,27,0.6579999999999999
20901171,1610612741,1610612739,109.0,108.0,0.518,0.477,1,2010-04-08,78,38,40,0.487,79,61,18,0.772
20901172,1610612758,1610612746,116.0,94.0,0.5429999999999999,0.476,1,2010-04-08,79,25,54,0.316,79,27,52,0.342
20901173,1610612743,1610612747,98.0,96.0,0.436,0.366,1,2010-04-08,79,52,27,0.6579999999999999,78,55,23,0.705
20901158,1610612754,1610612752,113.0,105.0,0.489,0.449,1,2010-04-07,78,30,48,0.385,78,28,50,0.359
20901159,1610612761,1610612738,104.0,115.0,0.478,0.563,0,2010-04-07,78,38,40,0.487,78,49,29,0.628
20901166,1610612753,1610612764,121.0,94.0,0.579,0.5,1,2010-04-07,78,55,23,0.705,78,24,54,0.308
20901160,1610612765,1610612737,90.0,88.0,0.43,0.434,1,2010-04-07,78,25,53,0.321,78,49,29,0.628
20901161,1610612748,1610612755,99.0,95.0,0.419,0.507,1,2010-04-07,78,44,34,0.564,78,26,52,0.3329999999999999
20901162,1610612749,1610612751,108.0,89.0,0.518,0.395,1,2010-04-07,78,44,34,0.564,78,11,67,0.141
20901163,1610612750,1610612744,107.0,116.0,0.481,0.561,0,2010-04-07,78,15,63,0.192,78,24,54,0.308
20901164,1610612740,1610612766,103.0,104.0,0.481,0.486,0,2010-04-07,79,35,44,0.4429999999999999,78,42,36,0.5379999999999999
20901165,1610612760,1610612743,94.0,98.0,0.4379999999999999,0.402,0,2010-04-07,78,48,30,0.615,78,51,27,0.654
20901168,1610612745,1610612762,113.0,96.0,0.488,0.494,1,2010-04-07,78,40,38,0.513,79,51,28,0.6459999999999999
20901167,1610612742,1610612763,110.0,84.0,0.5529999999999999,0.465,1,2010-04-07,78,51,27,0.654,78,39,39,0.5
20901169,1610612746,1610612757,85.0,93.0,0.494,0.506,0,2010-04-07,78,27,51,0.346,78,48,30,0.615
20901170,1610612756,1610612759,112.0,101.0,0.506,0.476,1,2010-04-07,78,51,27,0.654,78,48,30,0.615
20901149,1610612766,1610612737,109.0,100.0,0.514,0.476,1,2010-04-06,77,41,36,0.532,77,49,28,0.636
20901150,1610612739,1610612761,113.0,101.0,0.56,0.47,1,2010-04-06,78,61,17,0.782,77,38,39,0.494
20901151,1610612755,1610612765,103.0,124.0,0.527,0.627,0,2010-04-06,77,26,51,0.3379999999999999,77,24,53,0.312
20901152,1610612764,1610612744,112.0,94.0,0.518,0.3929999999999999,1,2010-04-06,77,24,53,0.312,77,23,54,0.299
20901153,1610612752,1610612738,104.0,101.0,0.4429999999999999,0.5479999999999999,1,2010-04-06,77,28,49,0.364,77,48,29,0.623
20901154,1610612741,1610612749,74.0,79.0,0.4320000000000001,0.364,0,2010-04-06,77,37,40,0.481,77,43,34,0.5579999999999999
20901155,1610612763,1610612745,103.0,113.0,0.489,0.4370000000000001,0,2010-04-06,77,39,38,0.506,77,39,38,0.506
20901156,1610612762,1610612760,140.0,139.0,0.521,0.5,1,2010-04-06,78,51,27,0.654,77,48,29,0.623
20901157,1610612758,1610612759,86.0,95.0,0.439,0.4679999999999999,0,2010-04-06,78,24,54,0.308,77,48,29,0.623
20901141,1610612738,1610612739,117.0,113.0,0.488,0.513,1,2010-04-04,76,48,28,0.632,77,60,17,0.779
20901142,1610612747,1610612759,81.0,100.0,0.407,0.487,0,2010-04-04,77,55,22,0.7140000000000001,76,47,29,0.618
20901143,1610612754,1610612745,133.0,102.0,0.5760000000000001,0.4479999999999999,1,2010-04-04,77,29,48,0.377,76,38,38,0.5
20901144,1610612753,1610612763,107.0,92.0,0.4629999999999999,0.4,1,2010-04-04,77,54,23,0.701,76,39,37,0.513
20901145,1610612761,1610612744,112.0,113.0,0.391,0.477,0,2010-04-04,76,38,38,0.5,76,23,53,0.303
20901146,1610612764,1610612751,109.0,99.0,0.494,0.486,1,2010-04-04,76,23,53,0.303,77,11,66,0.143
20901147,1610612760,1610612750,116.0,108.0,0.505,0.474,1,2010-04-04,76,48,28,0.632,77,15,62,0.195
20901148,1610612746,1610612752,107.0,113.0,0.494,0.472,0,2010-04-04,77,27,50,0.351,76,27,49,0.355
20901132,1610612755,1610612761,123.0,128.0,0.556,0.563,0,2010-04-03,76,26,50,0.342,75,38,37,0.507
20901133,1610612737,1610612765,91.0,85.0,0.479,0.376,1,2010-04-03,76,49,27,0.645,76,23,53,0.303
20901134,1610612751,1610612740,115.0,87.0,0.5820000000000001,0.3979999999999999,1,2010-04-03,76,11,65,0.145,78,35,43,0.449
20901135,1610612741,1610612766,96.0,88.0,0.4529999999999999,0.422,1,2010-04-03,76,37,39,0.487,76,40,36,0.526
20901136,1610612750,1610612748,84.0,97.0,0.447,0.5,0,2010-04-03,76,15,61,0.1969999999999999,77,43,34,0.5579999999999999
20901137,1610612742,1610612760,116.0,121.0,0.531,0.519,0,2010-04-03,77,50,27,0.649,75,47,28,0.627
20901138,1610612749,1610612756,107.0,98.0,0.5379999999999999,0.474,1,2010-04-03,76,42,34,0.5529999999999999,77,50,27,0.649
20901139,1610612743,1610612746,98.0,90.0,0.4529999999999999,0.474,1,2010-04-03,77,50,27,0.649,76,27,49,0.355
20901140,1610612758,1610612757,87.0,98.0,0.461,0.479,0,2010-04-03,77,24,53,0.312,77,47,30,0.61
20901122,1610612766,1610612749,87.0,86.0,0.375,0.412,1,2010-04-02,75,40,35,0.5329999999999999,75,41,34,0.547
20901123,1610612754,1610612748,96.0,105.0,0.3779999999999999,0.452,0,2010-04-02,76,28,48,0.368,76,42,34,0.5529999999999999
20901124,1610612764,1610612741,87.0,95.0,0.376,0.44,0,2010-04-02,75,22,53,0.293,75,36,39,0.48
20901125,1610612738,1610612745,114.0,119.0,0.518,0.506,0,2010-04-02,75,47,28,0.627,75,38,37,0.507
20901126,1610612739,1610612737,93.0,88.0,0.413,0.411,1,2010-04-02,76,60,16,0.789,75,48,27,0.64
20901127,1610612765,1610612756,94.0,109.0,0.439,0.562,0,2010-04-02,75,23,52,0.307,76,50,26,0.6579999999999999
20901128,1610612763,1610612740,107.0,96.0,0.444,0.441,1,2010-04-02,75,39,36,0.52,77,35,42,0.455
20901129,1610612759,1610612753,112.0,100.0,0.518,0.488,1,2010-04-02,75,46,29,0.613,76,53,23,0.6970000000000001
20901130,1610612744,1610612752,128.0,117.0,0.574,0.483,1,2010-04-02,75,22,53,0.293,75,26,49,0.347
20901131,1610612747,1610612762,106.0,92.0,0.4320000000000001,0.447,1,2010-04-02,76,55,21,0.7240000000000001,77,50,27,0.649
20901120,1610612742,1610612753,82.0,97.0,0.3829999999999999,0.486,0,2010-04-01,76,50,26,0.6579999999999999,75,53,22,0.7070000000000001
20901121,1610612743,1610612757,109.0,92.0,0.494,0.413,1,2010-04-01,76,49,27,0.645,76,46,30,0.605
20901107,1610612737,1610612747,109.0,92.0,0.542,0.4579999999999999,1,2010-03-31,74,48,26,0.649,75,54,21,0.72
20901108,1610612766,1610612755,103.0,84.0,0.467,0.446,1,2010-03-31,74,39,35,0.527,75,26,49,0.347
20901109,1610612739,1610612749,101.0,98.0,0.466,0.456,1,2010-03-31,75,59,16,0.787,74,41,33,0.5539999999999999
20901110,1610612761,1610612746,114.0,92.0,0.61,0.4320000000000001,1,2010-03-31,74,37,37,0.5,75,27,48,0.36
20901111,1610612738,1610612760,104.0,109.0,0.595,0.507,0,2010-03-31,74,47,27,0.635,74,46,28,0.622
20901112,1610612765,1610612748,81.0,98.0,0.4320000000000001,0.493,0,2010-03-31,74,23,51,0.311,75,41,34,0.547
20901113,1610612751,1610612756,105.0,116.0,0.488,0.5660000000000001,0,2010-03-31,75,10,65,0.133,75,49,26,0.653
20901114,1610612763,1610612742,102.0,106.0,0.409,0.4270000000000001,0,2010-03-31,74,38,36,0.514,75,50,25,0.667
20901115,1610612750,1610612758,108.0,99.0,0.561,0.461,1,2010-03-31,75,15,60,0.2,76,24,52,0.316
20901116,1610612740,1610612764,91.0,96.0,0.481,0.5589999999999999,0,2010-03-31,76,35,41,0.461,74,22,52,0.297
20901117,1610612759,1610612745,119.0,102.0,0.568,0.418,1,2010-03-31,74,45,29,0.608,74,37,37,0.5
20901118,1610612757,1610612752,118.0,90.0,0.526,0.4320000000000001,1,2010-03-31,75,46,29,0.613,74,26,48,0.351
20901119,1610612762,1610612744,128.0,104.0,0.529,0.36,1,2010-03-31,76,50,26,0.6579999999999999,74,21,53,0.284
20901102,1610612754,1610612758,102.0,95.0,0.47,0.424,1,2010-03-30,75,28,47,0.373,75,24,51,0.32
20901103,1610612755,1610612760,93.0,111.0,0.474,0.489,0,2010-03-30,74,26,48,0.351,73,45,28,0.616
20901104,1610612741,1610612756,105.0,111.0,0.444,0.447,0,2010-03-30,74,35,39,0.473,74,48,26,0.649
20901105,1610612749,1610612746,107.0,89.0,0.467,0.368,1,2010-03-30,73,41,32,0.562,74,27,47,0.365
20901106,1610612745,1610612764,98.0,94.0,0.452,0.435,1,2010-03-30,73,37,36,0.507,73,21,52,0.288
20901097,1610612766,1610612761,101.0,103.0,0.4639999999999999,0.506,0,2010-03-29,73,38,35,0.521,73,36,37,0.493
20901098,1610612751,1610612759,90.0,84.0,0.376,0.415,1,2010-03-29,74,10,64,0.135,73,44,29,0.603
20901099,1610612740,1610612747,108.0,100.0,0.493,0.418,1,2010-03-29,75,35,40,0.467,74,54,20,0.73
20901100,1610612742,1610612743,109.0,93.0,0.469,0.41,1,2010-03-29,74,49,25,0.662,75,48,27,0.64
20901101,1610612762,1610612752,103.0,98.0,0.513,0.455,1,2010-03-29,75,49,26,0.653,73,26,47,0.356
20901087,1610612739,1610612758,97.0,90.0,0.507,0.43,1,2010-03-28,74,58,16,0.784,74,24,50,0.324
20901088,1610612749,1610612763,108.0,103.0,0.4320000000000001,0.467,1,2010-03-28,72,40,32,0.556,73,38,35,0.521
20901089,1610612737,1610612754,94.0,84.0,0.4479999999999999,0.407,1,2010-03-28,73,47,26,0.644,74,27,47,0.365
20901090,1610612765,1610612741,103.0,110.0,0.4429999999999999,0.5489999999999999,0,2010-03-28,73,23,50,0.315,73,35,38,0.479
20901091,1610612748,1610612761,97.0,94.0,0.529,0.486,1,2010-03-28,74,40,34,0.541,72,35,37,0.486
20901092,1610612753,1610612743,103.0,97.0,0.494,0.525,1,2010-03-28,74,52,22,0.703,74,48,26,0.649
20901093,1610612750,1610612756,105.0,111.0,0.3939999999999999,0.488,0,2010-03-28,74,14,60,0.1889999999999999,73,47,26,0.644
20901094,1610612760,1610612757,87.0,92.0,0.457,0.457,0,2010-03-28,72,44,28,0.611,74,45,29,0.608
20901095,1610612738,1610612759,73.0,94.0,0.365,0.436,0,2010-03-28,73,47,26,0.644,72,44,28,0.611
20901096,1610612746,1610612744,103.0,121.0,0.3779999999999999,0.534,0,2010-03-28,73,27,46,0.37,73,21,52,0.288
20901082,1610612764,1610612762,87.0,103.0,0.384,0.591,0,2010-03-27,72,21,51,0.292,74,48,26,0.649
20901083,1610612741,1610612751,106.0,83.0,0.44,0.358,1,2010-03-27,72,34,38,0.472,73,9,64,0.123
20901084,1610612740,1610612757,101.0,112.0,0.586,0.573,0,2010-03-27,74,34,40,0.4589999999999999,73,44,29,0.603
20901085,1610612745,1610612747,101.0,109.0,0.4320000000000001,0.575,0,2010-03-27,72,36,36,0.5,73,54,19,0.74
20901086,1610612744,1610612742,90.0,111.0,0.3329999999999999,0.484,0,2010-03-27,72,20,52,0.278,73,48,25,0.6579999999999999
20901071,1610612766,1610612764,107.0,96.0,0.5539999999999999,0.479,1,2010-03-26,72,38,34,0.528,71,21,50,0.296
20901072,1610612754,1610612762,122.0,106.0,0.506,0.43,1,2010-03-26,73,27,46,0.37,73,47,26,0.644
20901073,1610612753,1610612750,106.0,97.0,0.456,0.4429999999999999,1,2010-03-26,73,51,22,0.6990000000000001,73,14,59,0.192
20901074,1610612755,1610612737,105.0,98.0,0.494,0.474,1,2010-03-26,73,26,47,0.356,72,46,26,0.639
20901075,1610612761,1610612743,96.0,97.0,0.471,0.412,0,2010-03-26,71,35,36,0.493,73,48,25,0.6579999999999999
20901076,1610612738,1610612758,94.0,86.0,0.4,0.425,1,2010-03-26,72,47,25,0.653,73,24,49,0.3289999999999999
20901077,1610612751,1610612765,118.0,110.0,0.5710000000000001,0.489,1,2010-03-26,72,9,63,0.125,72,23,49,0.319
20901078,1610612760,1610612747,91.0,75.0,0.481,0.392,1,2010-03-26,71,44,27,0.62,72,53,19,0.736
20901079,1610612749,1610612748,74.0,87.0,0.315,0.4920000000000001,0,2010-03-26,71,39,32,0.5489999999999999,73,39,34,0.534
20901080,1610612759,1610612739,102.0,97.0,0.474,0.475,1,2010-03-26,71,43,28,0.606,73,57,16,0.7809999999999999
20901081,1610612756,1610612752,132.0,96.0,0.556,0.3829999999999999,1,2010-03-26,72,46,26,0.639,72,26,46,0.361
20901068,1610612741,1610612748,74.0,103.0,0.3289999999999999,0.519,0,2010-03-25,71,33,38,0.465,72,38,34,0.528
20901069,1610612745,1610612746,93.0,99.0,0.3979999999999999,0.424,0,2010-03-25,71,36,35,0.507,72,27,45,0.375
20901070,1610612757,1610612742,101.0,89.0,0.5,0.444,1,2010-03-25,72,43,29,0.597,72,47,25,0.653
20901057,1610612737,1610612753,86.0,84.0,0.408,0.375,1,2010-03-24,71,46,25,0.648,72,50,22,0.6940000000000001
20901058,1610612738,1610612743,113.0,99.0,0.489,0.486,1,2010-03-24,71,46,25,0.648,72,47,25,0.653
20901059,1610612766,1610612750,108.0,95.0,0.536,0.451,1,2010-03-24,71,37,34,0.521,72,14,58,0.1939999999999999
20901060,1610612754,1610612764,99.0,82.0,0.446,0.365,1,2010-03-24,72,26,46,0.361,70,21,49,0.3
20901061,1610612761,1610612762,87.0,113.0,0.402,0.494,0,2010-03-24,70,35,35,0.5,72,47,25,0.653
20901062,1610612751,1610612758,93.0,79.0,0.39,0.358,1,2010-03-24,71,8,63,0.113,72,24,48,0.3329999999999999
20901063,1610612749,1610612755,86.0,101.0,0.4,0.526,0,2010-03-24,70,39,31,0.557,72,25,47,0.347
20901064,1610612740,1610612739,92.0,105.0,0.44,0.5710000000000001,0,2010-03-24,73,34,39,0.466,72,57,15,0.792
20901065,1610612760,1610612745,122.0,104.0,0.588,0.409,1,2010-03-24,70,43,27,0.614,70,36,34,0.514
20901066,1610612759,1610612747,83.0,92.0,0.375,0.456,0,2010-03-24,70,42,28,0.6,71,53,18,0.746
20901067,1610612744,1610612763,128.0,110.0,0.545,0.456,1,2010-03-24,71,20,51,0.282,72,38,34,0.528
20901053,1610612764,1610612766,86.0,95.0,0.3979999999999999,0.396,0,2010-03-23,69,21,48,0.304,70,36,34,0.514
20901054,1610612765,1610612754,83.0,98.0,0.369,0.434,0,2010-03-23,71,23,48,0.324,71,25,46,0.352
20901055,1610612752,1610612743,109.0,104.0,0.462,0.455,1,2010-03-23,71,26,45,0.366,71,47,24,0.662
20901056,1610612742,1610612746,106.0,96.0,0.462,0.379,1,2010-03-23,71,47,24,0.662,71,26,45,0.366
20901043,1610612755,1610612753,93.0,109.0,0.429,0.522,0,2010-03-22,71,24,47,0.3379999999999999,71,50,21,0.7040000000000001
20901044,1610612751,1610612748,89.0,99.0,0.375,0.5539999999999999,0,2010-03-22,70,7,63,0.1,71,37,34,0.521
20901045,1610612741,1610612745,98.0,88.0,0.474,0.337,1,2010-03-22,70,33,37,0.471,69,36,33,0.522
20901046,1610612749,1610612737,98.0,95.0,0.446,0.526,1,2010-03-22,69,39,30,0.565,70,45,25,0.643
20901047,1610612750,1610612761,100.0,106.0,0.4629999999999999,0.494,0,2010-03-22,71,14,57,0.1969999999999999,69,35,34,0.507
20901048,1610612740,1610612742,115.0,99.0,0.542,0.519,1,2010-03-22,72,34,38,0.472,70,46,24,0.657
20901049,1610612760,1610612759,96.0,99.0,0.452,0.435,0,2010-03-22,69,42,27,0.609,69,42,27,0.609
20901050,1610612762,1610612738,110.0,97.0,0.514,0.446,1,2010-03-22,71,46,25,0.648,70,45,25,0.643
20901051,1610612758,1610612763,85.0,102.0,0.409,0.452,0,2010-03-22,71,24,47,0.3379999999999999,71,38,33,0.535
20901052,1610612744,1610612756,131.0,133.0,0.5,0.536,0,2010-03-22,70,19,51,0.271,71,45,26,0.634
20901036,1610612752,1610612745,112.0,116.0,0.512,0.506,0,2010-03-21,70,25,45,0.357,68,36,32,0.529
20901037,1610612754,1610612760,121.0,101.0,0.517,0.4320000000000001,1,2010-03-21,70,24,46,0.3429999999999999,68,42,26,0.618
20901039,1610612746,1610612758,89.0,102.0,0.4589999999999999,0.5,0,2010-03-21,70,26,44,0.371,70,24,46,0.3429999999999999
20901038,1610612737,1610612759,119.0,114.0,0.469,0.506,1,2010-03-21,69,45,24,0.652,68,41,27,0.603
20901040,1610612739,1610612765,104.0,79.0,0.487,0.41,1,2010-03-21,71,56,15,0.789,70,23,47,0.3289999999999999
20901041,1610612747,1610612764,99.0,92.0,0.529,0.487,1,2010-03-21,70,52,18,0.743,68,21,47,0.309
20901042,1610612756,1610612757,93.0,87.0,0.3879999999999999,0.364,1,2010-03-21,70,44,26,0.629,71,42,29,0.5920000000000001
20901029,1610612755,1610612741,84.0,98.0,0.402,0.45,0,2010-03-20,70,24,46,0.3429999999999999,69,32,37,0.4639999999999999
20901030,1610612748,1610612766,77.0,71.0,0.359,0.292,1,2010-03-20,70,36,34,0.514,69,35,34,0.507
20901031,1610612751,1610612761,90.0,100.0,0.3979999999999999,0.506,0,2010-03-20,69,7,62,0.1009999999999999,68,34,34,0.5
20901032,1610612763,1610612744,123.0,107.0,0.5,0.484,1,2010-03-20,70,37,33,0.529,69,19,50,0.275
20901033,1610612742,1610612738,93.0,102.0,0.4629999999999999,0.52,0,2010-03-20,69,46,23,0.667,69,45,24,0.652
20901034,1610612743,1610612749,97.0,102.0,0.368,0.461,0,2010-03-20,70,47,23,0.6709999999999999,68,38,30,0.5589999999999999
20901035,1610612762,1610612740,106.0,86.0,0.5579999999999999,0.43,1,2010-03-20,70,45,25,0.643,71,33,38,0.465
20901018,1610612754,1610612765,106.0,102.0,0.537,0.434,1,2010-03-19,69,23,46,0.3329999999999999,69,23,46,0.3329999999999999
20901019,1610612761,1610612760,89.0,115.0,0.4379999999999999,0.415,0,2010-03-19,67,33,34,0.493,67,42,25,0.627
20901020,1610612737,1610612766,93.0,92.0,0.419,0.4529999999999999,1,2010-03-19,68,44,24,0.647,68,35,33,0.515
20901021,1610612752,1610612755,92.0,88.0,0.368,0.423,1,2010-03-19,69,25,44,0.362,69,24,45,0.348
20901022,1610612741,1610612739,85.0,92.0,0.3929999999999999,0.413,0,2010-03-19,68,31,37,0.456,70,55,15,0.7859999999999999
20901023,1610612745,1610612738,87.0,94.0,0.395,0.457,0,2010-03-19,67,35,32,0.522,68,44,24,0.647
20901024,1610612759,1610612744,147.0,116.0,0.6459999999999999,0.484,1,2010-03-19,67,41,26,0.612,68,19,49,0.2789999999999999
20901025,1610612756,1610612762,110.0,100.0,0.527,0.386,1,2010-03-19,69,43,26,0.623,69,44,25,0.638
20901026,1610612757,1610612764,76.0,74.0,0.321,0.39,1,2010-03-19,70,42,28,0.6,67,21,46,0.313
20901027,1610612758,1610612749,108.0,114.0,0.444,0.439,0,2010-03-19,69,23,46,0.3329999999999999,67,37,30,0.552
20901028,1610612747,1610612750,104.0,96.0,0.415,0.462,1,2010-03-19,69,51,18,0.7390000000000001,70,14,56,0.2
20901016,1610612748,1610612753,102.0,108.0,0.411,0.455,0,2010-03-18,69,35,34,0.507,70,49,21,0.7
20901017,1610612743,1610612740,93.0,80.0,0.4,0.429,1,2010-03-18,69,47,22,0.6809999999999999,70,33,37,0.471
20901005,1610612766,1610612760,100.0,92.0,0.481,0.451,1,2010-03-17,67,35,32,0.522,66,41,25,0.621
20901006,1610612739,1610612754,99.0,94.0,0.482,0.474,1,2010-03-17,69,54,15,0.7829999999999999,68,22,46,0.324
20901007,1610612755,1610612751,108.0,97.0,0.56,0.41,1,2010-03-17,68,24,44,0.353,68,7,61,0.103
20901008,1610612761,1610612737,106.0,105.0,0.456,0.482,1,2010-03-17,66,33,33,0.5,67,43,24,0.642
20901009,1610612738,1610612752,109.0,97.0,0.506,0.414,1,2010-03-17,67,43,24,0.642,68,24,44,0.353
20901010,1610612753,1610612759,110.0,84.0,0.521,0.425,1,2010-03-17,69,48,21,0.696,66,40,26,0.606
20901011,1610612742,1610612741,113.0,106.0,0.526,0.524,1,2010-03-17,68,46,22,0.6759999999999999,67,31,36,0.4629999999999999
20901012,1610612745,1610612763,107.0,94.0,0.534,0.429,1,2010-03-17,66,35,31,0.53,69,36,33,0.522
20901013,1610612762,1610612750,122.0,100.0,0.5379999999999999,0.436,1,2010-03-17,68,44,24,0.647,69,14,55,0.203
20901014,1610612744,1610612740,131.0,121.0,0.54,0.512,1,2010-03-17,67,19,48,0.284,69,33,36,0.478
20901015,1610612746,1610612749,101.0,93.0,0.531,0.446,1,2010-03-17,69,26,43,0.377,66,36,30,0.545
20900997,1610612754,1610612766,99.0,94.0,0.41,0.465,1,2010-03-16,67,22,45,0.3279999999999999,66,34,32,0.515
20900998,1610612765,1610612739,101.0,113.0,0.462,0.494,0,2010-03-16,68,23,45,0.3379999999999999,68,53,15,0.779
20900999,1610612748,1610612759,76.0,88.0,0.385,0.447,0,2010-03-16,68,35,33,0.515,65,40,25,0.615
20901000,1610612751,1610612737,84.0,108.0,0.385,0.494,0,2010-03-16,67,7,60,0.104,66,43,23,0.652
20901001,1610612763,1610612741,104.0,97.0,0.474,0.436,1,2010-03-16,68,36,32,0.529,66,31,35,0.47
20901002,1610612743,1610612764,97.0,87.0,0.507,0.436,1,2010-03-16,68,46,22,0.6759999999999999,66,21,45,0.318
20901003,1610612756,1610612750,152.0,114.0,0.561,0.462,1,2010-03-16,68,42,26,0.618,68,14,54,0.206
20901004,1610612758,1610612747,99.0,106.0,0.429,0.483,0,2010-03-16,68,23,45,0.3379999999999999,68,50,18,0.735
20900991,1610612755,1610612752,84.0,94.0,0.384,0.4679999999999999,0,2010-03-15,67,23,44,0.3429999999999999,67,24,43,0.358
20900992,1610612738,1610612765,119.0,93.0,0.622,0.485,1,2010-03-15,66,42,24,0.636,67,23,44,0.3429999999999999
20900993,1610612745,1610612743,125.0,123.0,0.57,0.495,1,2010-03-15,65,34,31,0.523,67,45,22,0.672
20900994,1610612762,1610612764,112.0,89.0,0.524,0.369,1,2010-03-15,67,43,24,0.642,65,21,44,0.3229999999999999
20900995,1610612744,1610612747,121.0,124.0,0.48,0.56,0,2010-03-15,66,18,48,0.273,67,49,18,0.731
20900996,1610612746,1610612740,100.0,108.0,0.43,0.565,0,2010-03-15,68,25,43,0.368,68,33,35,0.485
20900983,1610612749,1610612754,98.0,94.0,0.429,0.375,1,2010-03-14,65,36,29,0.5539999999999999,66,21,45,0.318
20900984,1610612739,1610612738,104.0,93.0,0.413,0.4,1,2010-03-14,67,52,15,0.7759999999999999,65,41,24,0.631
20900985,1610612748,1610612755,104.0,91.0,0.494,0.3720000000000001,1,2010-03-14,67,35,32,0.522,66,23,43,0.348
20900986,1610612753,1610612766,89.0,96.0,0.4579999999999999,0.467,0,2010-03-14,68,47,21,0.691,65,34,31,0.523
20900987,1610612760,1610612762,119.0,111.0,0.603,0.506,1,2010-03-14,65,41,24,0.631,66,42,24,0.636
20900988,1610612756,1610612740,120.0,106.0,0.575,0.467,1,2010-03-14,67,41,26,0.612,67,32,35,0.478
20900989,1610612757,1610612761,109.0,98.0,0.4579999999999999,0.5489999999999999,1,2010-03-14,69,41,28,0.594,65,32,33,0.4920000000000001
20900990,1610612758,1610612750,114.0,100.0,0.465,0.418,1,2010-03-14,67,23,44,0.3429999999999999,67,14,53,0.209
20900976,1610612737,1610612765,112.0,99.0,0.63,0.493,1,2010-03-13,65,42,23,0.6459999999999999,66,23,43,0.348
20900977,1610612764,1610612753,95.0,109.0,0.488,0.519,0,2010-03-13,64,21,43,0.3279999999999999,67,47,20,0.701
20900978,1610612763,1610612743,108.0,125.0,0.5,0.588,0,2010-03-13,67,35,32,0.522,66,45,21,0.682
20900979,1610612742,1610612752,94.0,128.0,0.425,0.562,0,2010-03-13,67,45,22,0.672,66,23,43,0.348
20900980,1610612745,1610612751,116.0,108.0,0.523,0.539,1,2010-03-13,64,33,31,0.516,66,7,59,0.106
20900981,1610612759,1610612746,118.0,88.0,0.586,0.451,1,2010-03-13,64,39,25,0.609,67,25,42,0.373
20900982,1610612744,1610612761,124.0,112.0,0.474,0.5660000000000001,1,2010-03-13,65,18,47,0.2769999999999999,64,32,32,0.5
20900964,1610612766,1610612746,106.0,98.0,0.542,0.575,1,2010-03-12,64,33,31,0.516,66,25,41,0.379
20900965,1610612755,1610612739,95.0,100.0,0.477,0.507,0,2010-03-12,65,23,42,0.354,66,51,15,0.773
20900966,1610612738,1610612754,122.0,103.0,0.584,0.486,1,2010-03-12,64,41,23,0.6409999999999999,65,21,44,0.3229999999999999
20900967,1610612748,1610612741,108.0,95.0,0.493,0.487,1,2010-03-12,66,34,32,0.515,65,31,34,0.477
20900968,1610612765,1610612764,101.0,87.0,0.512,0.446,1,2010-03-12,65,23,42,0.354,63,21,42,0.3329999999999999
20900969,1610612763,1610612752,119.0,112.0,0.483,0.455,1,2010-03-12,66,35,31,0.53,65,22,43,0.3379999999999999
20900970,1610612750,1610612759,85.0,103.0,0.39,0.494,0,2010-03-12,66,14,52,0.212,63,38,25,0.603
20900971,1610612740,1610612743,95.0,102.0,0.416,0.4679999999999999,0,2010-03-12,66,32,34,0.485,65,44,21,0.677
20900972,1610612760,1610612751,104.0,102.0,0.519,0.46,1,2010-03-12,64,40,24,0.625,65,7,58,0.108
20900973,1610612749,1610612762,95.0,87.0,0.405,0.417,1,2010-03-12,64,35,29,0.547,65,42,23,0.6459999999999999
20900974,1610612756,1610612747,96.0,102.0,0.425,0.494,0,2010-03-12,66,40,26,0.606,66,48,18,0.727
20900975,1610612758,1610612757,94.0,110.0,0.506,0.514,0,2010-03-12,66,22,44,0.3329999999999999,68,40,28,0.588
20900742,1610612764,1610612737,99.0,105.0,0.494,0.519,0,2010-03-11,62,21,41,0.3389999999999999,64,41,23,0.6409999999999999
20900962,1610612753,1610612741,111.0,82.0,0.551,0.3979999999999999,1,2010-03-11,66,46,20,0.6970000000000001,64,31,33,0.484
20900963,1610612744,1610612757,105.0,110.0,0.475,0.419,0,2010-03-11,64,17,47,0.266,67,39,28,0.5820000000000001
20900953,1610612755,1610612766,87.0,102.0,0.415,0.5,0,2010-03-10,64,23,41,0.359,63,32,31,0.508
20900954,1610612738,1610612763,91.0,111.0,0.4379999999999999,0.55,0,2010-03-10,63,40,23,0.635,65,34,31,0.523
20900955,1610612765,1610612762,104.0,115.0,0.435,0.563,0,2010-03-10,64,22,42,0.344,64,42,22,0.6559999999999999
20900956,1610612748,1610612746,108.0,97.0,0.455,0.4270000000000001,1,2010-03-10,65,33,32,0.508,65,25,40,0.385
20900957,1610612750,1610612743,102.0,110.0,0.389,0.465,0,2010-03-10,65,14,51,0.215,64,43,21,0.672
20900958,1610612760,1610612740,98.0,83.0,0.47,0.43,1,2010-03-10,63,39,24,0.619,65,32,33,0.4920000000000001
20900959,1610612742,1610612751,96.0,87.0,0.44,0.41,1,2010-03-10,66,45,21,0.682,64,7,57,0.109
20900960,1610612759,1610612752,97.0,87.0,0.45,0.4029999999999999,1,2010-03-10,62,37,25,0.597,64,22,42,0.344
20900961,1610612758,1610612761,113.0,90.0,0.505,0.439,1,2010-03-10,65,22,43,0.3379999999999999,63,32,31,0.508
20900945,1610612766,1610612748,83.0,78.0,0.389,0.4029999999999999,1,2010-03-09,62,31,31,0.5,64,32,32,0.5
20900946,1610612754,1610612755,107.0,96.0,0.447,0.4589999999999999,1,2010-03-09,64,21,43,0.3279999999999999,63,23,40,0.365
20900947,1610612753,1610612746,113.0,87.0,0.489,0.43,1,2010-03-09,65,45,20,0.6920000000000001,64,25,39,0.391
20900948,1610612764,1610612745,88.0,96.0,0.422,0.384,0,2010-03-09,61,21,40,0.344,63,32,31,0.508
20900949,1610612741,1610612762,108.0,132.0,0.539,0.542,0,2010-03-09,63,31,32,0.4920000000000001,63,41,22,0.6509999999999999
20900950,1610612749,1610612738,86.0,84.0,0.466,0.441,1,2010-03-09,63,34,29,0.54,62,40,22,0.645
20900951,1610612757,1610612758,88.0,81.0,0.455,0.43,1,2010-03-09,66,38,28,0.5760000000000001,64,21,43,0.3279999999999999
20900952,1610612747,1610612761,109.0,107.0,0.449,0.444,1,2010-03-09,65,47,18,0.723,62,32,30,0.516
20900940,1610612739,1610612759,97.0,95.0,0.474,0.417,1,2010-03-08,65,50,15,0.769,61,36,25,0.59
20900941,1610612752,1610612737,99.0,98.0,0.506,0.425,1,2010-03-08,63,22,41,0.349,63,40,23,0.635
20900942,1610612763,1610612751,107.0,101.0,0.471,0.4589999999999999,1,2010-03-08,64,33,31,0.516,63,7,56,0.111
20900943,1610612750,1610612742,112.0,125.0,0.472,0.5,0,2010-03-08,64,14,50,0.2189999999999999,65,44,21,0.677
20900944,1610612740,1610612744,135.0,131.0,0.5870000000000001,0.588,1,2010-03-08,64,32,32,0.5,63,17,46,0.27
20900934,1610612761,1610612755,101.0,114.0,0.512,0.556,0,2010-03-07,61,32,29,0.525,62,23,39,0.371
20900935,1610612753,1610612747,96.0,94.0,0.411,0.375,1,2010-03-07,64,44,20,0.688,64,46,18,0.7190000000000001
20900936,1610612765,1610612745,110.0,107.0,0.473,0.46,1,2010-03-07,63,22,41,0.349,62,31,31,0.5
20900937,1610612738,1610612764,86.0,83.0,0.411,0.456,1,2010-03-07,61,40,21,0.6559999999999999,60,21,39,0.35
20900938,1610612758,1610612760,102.0,108.0,0.506,0.477,0,2010-03-07,63,21,42,0.3329999999999999,62,38,24,0.613
20900939,1610612743,1610612757,118.0,106.0,0.589,0.4270000000000001,1,2010-03-07,63,42,21,0.667,65,37,28,0.569
20900925,1610612766,1610612744,101.0,90.0,0.46,0.382,1,2010-03-06,61,30,31,0.4920000000000001,62,17,45,0.2739999999999999
20900926,1610612748,1610612737,100.0,94.0,0.425,0.397,1,2010-03-06,63,32,31,0.508,62,40,22,0.645
20900927,1610612752,1610612751,93.0,113.0,0.471,0.5,0,2010-03-06,62,21,41,0.3389999999999999,62,7,55,0.113
20900928,1610612741,1610612742,116.0,122.0,0.522,0.563,0,2010-03-06,62,31,31,0.5,64,43,21,0.672
20900929,1610612763,1610612759,92.0,102.0,0.434,0.488,0,2010-03-06,63,32,31,0.508,60,36,24,0.6
20900930,1610612750,1610612745,98.0,112.0,0.451,0.474,0,2010-03-06,63,14,49,0.222,61,31,30,0.508
20900931,1610612749,1610612739,92.0,85.0,0.405,0.442,1,2010-03-06,62,33,29,0.532,64,49,15,0.7659999999999999
20900932,1610612756,1610612754,113.0,105.0,0.439,0.376,1,2010-03-06,65,40,25,0.615,63,20,43,0.317
20900933,1610612762,1610612746,107.0,85.0,0.452,0.407,1,2010-03-06,62,40,22,0.645,63,25,38,0.397
20900914,1610612766,1610612747,98.0,83.0,0.514,0.363,1,2010-03-05,60,29,31,0.483,63,46,17,0.73
20900915,1610612739,1610612765,99.0,92.0,0.506,0.493,1,2010-03-05,63,49,14,0.778,62,21,41,0.3389999999999999
20900916,1610612755,1610612738,86.0,96.0,0.481,0.507,0,2010-03-05,61,22,39,0.361,60,39,21,0.65
20900917,1610612761,1610612752,102.0,96.0,0.505,0.488,1,2010-03-05,60,32,28,0.5329999999999999,61,21,40,0.344
20900918,1610612764,1610612749,74.0,102.0,0.3779999999999999,0.4579999999999999,0,2010-03-05,59,21,38,0.356,61,32,29,0.525
20900919,1610612737,1610612744,127.0,122.0,0.53,0.5,1,2010-03-05,61,40,21,0.6559999999999999,61,17,44,0.2789999999999999
20900920,1610612751,1610612753,87.0,97.0,0.4,0.442,0,2010-03-05,61,6,55,0.098,63,43,20,0.6829999999999999
20900921,1610612742,1610612758,108.0,100.0,0.488,0.469,1,2010-03-05,63,42,21,0.667,62,21,41,0.3389999999999999
20900922,1610612743,1610612754,122.0,114.0,0.477,0.439,1,2010-03-05,62,41,21,0.6609999999999999,62,20,42,0.3229999999999999
20900923,1610612759,1610612740,102.0,91.0,0.535,0.494,1,2010-03-05,59,35,24,0.593,63,31,32,0.4920000000000001
20900924,1610612746,1610612760,87.0,104.0,0.3720000000000001,0.456,0,2010-03-05,62,25,37,0.4029999999999999,61,37,24,0.607
20900911,1610612741,1610612763,96.0,105.0,0.446,0.526,0,2010-03-04,61,31,30,0.508,62,32,30,0.516
20900912,1610612748,1610612747,114.0,111.0,0.525,0.511,1,2010-03-04,62,31,31,0.5,62,46,16,0.742
20900913,1610612756,1610612762,108.0,116.0,0.575,0.4579999999999999,0,2010-03-04,64,39,25,0.609,61,39,22,0.639
20900899,1610612737,1610612755,112.0,93.0,0.5,0.467,1,2010-03-03,60,39,21,0.65,60,22,38,0.3670000000000001
20900900,1610612753,1610612744,117.0,90.0,0.522,0.4270000000000001,1,2010-03-03,62,42,20,0.677,60,17,43,0.283
20900901,1610612738,1610612766,104.0,80.0,0.535,0.36,1,2010-03-03,59,38,21,0.644,59,28,31,0.475
20900902,1610612751,1610612739,92.0,111.0,0.3929999999999999,0.518,0,2010-03-03,60,6,54,0.1,62,48,14,0.774
20900903,1610612752,1610612765,128.0,104.0,0.5529999999999999,0.461,1,2010-03-03,60,21,39,0.35,61,21,40,0.344
20900904,1610612749,1610612764,100.0,87.0,0.475,0.455,1,2010-03-03,60,31,29,0.517,58,21,37,0.362
20900905,1610612740,1610612763,100.0,104.0,0.5,0.494,0,2010-03-03,62,31,31,0.5,61,31,30,0.508
20900906,1610612742,1610612750,112.0,109.0,0.5,0.532,1,2010-03-03,62,41,21,0.6609999999999999,62,14,48,0.226
20900907,1610612745,1610612758,81.0,84.0,0.39,0.32,0,2010-03-03,60,30,30,0.5,61,21,40,0.344
20900908,1610612743,1610612760,119.0,90.0,0.506,0.325,1,2010-03-03,61,40,21,0.6559999999999999,60,36,24,0.6
20900909,1610612757,1610612754,102.0,79.0,0.4320000000000001,0.434,1,2010-03-03,64,37,27,0.578,61,20,41,0.3279999999999999
20900910,1610612746,1610612756,101.0,127.0,0.4589999999999999,0.556,0,2010-03-03,61,25,36,0.41,63,39,24,0.619
20900895,1610612765,1610612738,100.0,105.0,0.4679999999999999,0.461,0,2010-03-02,60,21,39,0.35,58,37,21,0.638
20900896,1610612748,1610612744,110.0,106.0,0.494,0.512,1,2010-03-02,61,30,31,0.4920000000000001,59,17,42,0.288
20900897,1610612760,1610612758,113.0,107.0,0.5,0.539,1,2010-03-02,59,36,23,0.61,60,20,40,0.3329999999999999
20900898,1610612747,1610612754,122.0,99.0,0.517,0.471,1,2010-03-02,61,46,15,0.754,60,20,40,0.3329999999999999
20900886,1610612766,1610612742,84.0,89.0,0.397,0.4629999999999999,0,2010-03-01,58,28,30,0.483,61,40,21,0.6559999999999999
20900887,1610612739,1610612752,124.0,93.0,0.5670000000000001,0.409,1,2010-03-01,61,47,14,0.77,59,20,39,0.3389999999999999
20900888,1610612755,1610612753,105.0,126.0,0.488,0.584,0,2010-03-01,59,22,37,0.373,61,41,20,0.672
20900889,1610612741,1610612737,92.0,116.0,0.4379999999999999,0.4479999999999999,0,2010-03-01,60,31,29,0.517,59,38,21,0.644
20900890,1610612763,1610612757,93.0,103.0,0.455,0.447,0,2010-03-01,60,30,30,0.5,63,36,27,0.5710000000000001
20900891,1610612740,1610612759,92.0,106.0,0.451,0.506,0,2010-03-01,61,31,30,0.508,58,34,24,0.586
20900892,1610612745,1610612761,116.0,92.0,0.513,0.442,1,2010-03-01,59,30,29,0.508,59,31,28,0.525
20900893,1610612756,1610612743,101.0,85.0,0.447,0.423,1,2010-03-01,62,38,24,0.613,60,39,21,0.65
20900894,1610612746,1610612762,108.0,104.0,0.48,0.4270000000000001,1,2010-03-01,60,25,35,0.417,60,38,22,0.633
20900878,1610612759,1610612756,113.0,110.0,0.506,0.512,1,2010-02-28,57,33,24,0.579,61,37,24,0.607
20900879,1610612747,1610612743,95.0,89.0,0.456,0.359,1,2010-02-28,60,45,15,0.75,59,39,20,0.6609999999999999
20900880,1610612737,1610612749,106.0,102.0,0.433,0.457,1,2010-02-28,58,37,21,0.638,59,30,29,0.508
20900881,1610612751,1610612764,85.0,89.0,0.352,0.422,0,2010-02-28,59,6,53,0.102,57,21,36,0.368
20900882,1610612760,1610612761,119.0,99.0,0.518,0.4370000000000001,1,2010-02-28,58,35,23,0.603,58,31,27,0.534
20900883,1610612753,1610612748,96.0,80.0,0.457,0.39,1,2010-02-28,60,40,20,0.667,60,29,31,0.483
20900884,1610612758,1610612746,97.0,92.0,0.4320000000000001,0.373,1,2010-02-28,59,20,39,0.3389999999999999,59,24,35,0.407
20900885,1610612742,1610612740,108.0,100.0,0.517,0.446,1,2010-02-28,60,39,21,0.65,60,31,29,0.517
20900871,1610612738,1610612751,96.0,104.0,0.5,0.444,0,2010-02-27,57,36,21,0.632,58,6,52,0.103
20900872,1610612748,1610612749,71.0,94.0,0.359,0.481,0,2010-02-27,59,29,30,0.4920000000000001,58,30,28,0.517
20900873,1610612754,1610612741,100.0,90.0,0.473,0.419,1,2010-02-27,59,20,39,0.3389999999999999,59,31,28,0.525
20900874,1610612752,1610612763,109.0,120.0,0.506,0.517,0,2010-02-27,58,20,38,0.345,59,30,29,0.508
20900875,1610612750,1610612757,91.0,110.0,0.456,0.457,0,2010-02-27,61,14,47,0.23,62,35,27,0.565
20900876,1610612762,1610612745,133.0,110.0,0.675,0.4429999999999999,1,2010-02-27,59,38,21,0.644,58,29,29,0.5
20900877,1610612744,1610612765,95.0,88.0,0.412,0.43,1,2010-02-27,58,17,41,0.293,59,21,38,0.356
20900859,1610612761,1610612739,118.0,126.0,0.484,0.512,0,2010-02-26,57,31,26,0.544,60,46,14,0.767
20900860,1610612764,1610612752,116.0,118.0,0.528,0.484,0,2010-02-26,56,20,36,0.357,57,20,37,0.351
20900861,1610612737,1610612742,103.0,111.0,0.4,0.522,0,2010-02-26,57,36,21,0.632,59,38,21,0.644
20900862,1610612741,1610612757,115.0,111.0,0.575,0.512,1,2010-02-26,58,31,27,0.534,61,34,27,0.557
20900863,1610612763,1610612766,89.0,93.0,0.486,0.481,0,2010-02-26,58,29,29,0.5,57,28,29,0.491
20900865,1610612760,1610612750,109.0,92.0,0.5429999999999999,0.407,1,2010-02-26,57,34,23,0.596,60,14,46,0.233
20900866,1610612745,1610612759,109.0,104.0,0.456,0.447,1,2010-02-26,57,29,28,0.509,56,32,24,0.5710000000000001
20900867,1610612743,1610612765,107.0,102.0,0.455,0.446,1,2010-02-26,58,39,19,0.672,58,21,37,0.362
20900870,1610612756,1610612746,125.0,112.0,0.5710000000000001,0.483,1,2010-02-26,60,37,23,0.617,58,24,34,0.414
20900864,1610612740,1610612753,100.0,93.0,0.481,0.494,1,2010-02-26,59,31,28,0.525,59,39,20,0.6609999999999999
20900868,1610612758,1610612762,103.0,99.0,0.545,0.409,1,2010-02-26,58,19,39,0.3279999999999999,58,37,21,0.638
20900869,1610612747,1610612755,99.0,90.0,0.451,0.44,1,2010-02-26,59,44,15,0.746,58,22,36,0.379
20900856,1610612754,1610612749,110.0,112.0,0.4589999999999999,0.488,0,2010-02-25,58,19,39,0.3279999999999999,57,29,28,0.509
20900857,1610612738,1610612739,88.0,108.0,0.407,0.526,0,2010-02-25,56,36,20,0.643,59,45,14,0.763
20900858,1610612744,1610612743,112.0,127.0,0.417,0.511,0,2010-02-25,57,16,41,0.281,57,38,19,0.667
20900845,1610612737,1610612750,98.0,92.0,0.407,0.456,1,2010-02-24,56,36,20,0.643,59,14,45,0.237
20900846,1610612761,1610612757,87.0,101.0,0.447,0.494,0,2010-02-24,56,31,25,0.5539999999999999,60,34,26,0.5670000000000001
20900847,1610612764,1610612763,94.0,99.0,0.481,0.483,0,2010-02-24,55,20,35,0.364,57,29,28,0.509
20900848,1610612741,1610612754,120.0,110.0,0.506,0.409,1,2010-02-24,57,30,27,0.526,57,19,38,0.3329999999999999
20900849,1610612749,1610612740,115.0,95.0,0.516,0.4270000000000001,1,2010-02-24,56,28,28,0.5,58,30,28,0.517
20900850,1610612745,1610612753,92.0,110.0,0.429,0.494,0,2010-02-24,56,28,28,0.5,58,39,19,0.672
20900851,1610612759,1610612760,95.0,87.0,0.423,0.3979999999999999,1,2010-02-24,55,32,23,0.5820000000000001,56,33,23,0.589
20900852,1610612742,1610612747,101.0,96.0,0.4379999999999999,0.487,1,2010-02-24,58,37,21,0.638,58,43,15,0.741
20900853,1610612756,1610612755,106.0,95.0,0.512,0.435,1,2010-02-24,59,36,23,0.61,57,22,35,0.386
20900854,1610612762,1610612766,102.0,93.0,0.476,0.412,1,2010-02-24,57,37,20,0.649,56,27,29,0.482
20900855,1610612746,1610612765,97.0,91.0,0.405,0.442,1,2010-02-24,57,24,33,0.421,57,21,36,0.368
20900837,1610612739,1610612740,105.0,95.0,0.488,0.5,1,2010-02-23,58,44,14,0.759,57,30,27,0.526
20900838,1610612738,1610612752,110.0,106.0,0.557,0.525,1,2010-02-23,55,36,19,0.655,56,19,37,0.3389999999999999
20900839,1610612748,1610612750,88.0,91.0,0.413,0.436,0,2010-02-23,58,29,29,0.5,58,14,44,0.241
20900840,1610612751,1610612757,93.0,102.0,0.493,0.541,0,2010-02-23,57,5,52,0.088,59,33,26,0.5589999999999999
20900841,1610612763,1610612747,98.0,99.0,0.47,0.487,0,2010-02-23,56,28,28,0.5,57,43,14,0.754
20900842,1610612760,1610612756,102.0,104.0,0.442,0.513,0,2010-02-23,55,33,22,0.6,58,35,23,0.603
20900843,1610612758,1610612765,89.0,101.0,0.444,0.584,0,2010-02-23,57,18,39,0.316,56,21,35,0.375
20900844,1610612744,1610612755,102.0,110.0,0.379,0.482,0,2010-02-23,56,16,40,0.286,56,22,34,0.3929999999999999
20900832,1610612764,1610612741,101.0,95.0,0.506,0.462,1,2010-02-22,54,20,34,0.37,56,29,27,0.518
20900833,1610612752,1610612749,67.0,83.0,0.3379999999999999,0.43,0,2010-02-22,55,19,36,0.345,55,27,28,0.491
20900834,1610612742,1610612754,91.0,82.0,0.386,0.369,1,2010-02-22,57,36,21,0.632,56,19,37,0.3389999999999999
20900835,1610612762,1610612737,100.0,105.0,0.482,0.542,0,2010-02-22,56,36,20,0.643,55,35,20,0.636
20900836,1610612746,1610612766,98.0,94.0,0.474,0.436,1,2010-02-22,56,23,33,0.411,55,27,28,0.491
20900823,1610612753,1610612739,101.0,95.0,0.507,0.4629999999999999,1,2010-02-21,57,38,19,0.667,57,43,14,0.754
20900824,1610612743,1610612738,114.0,105.0,0.513,0.529,1,2010-02-21,56,37,19,0.6609999999999999,54,35,19,0.648
20900825,1610612765,1610612759,109.0,101.0,0.451,0.42,1,2010-02-21,55,20,35,0.364,54,31,23,0.574
20900826,1610612751,1610612763,94.0,104.0,0.4479999999999999,0.456,0,2010-02-21,56,5,51,0.089,55,28,27,0.509
20900827,1610612750,1610612760,107.0,109.0,0.457,0.471,0,2010-02-21,57,13,44,0.228,54,33,21,0.611
20900828,1610612740,1610612745,102.0,94.0,0.435,0.435,1,2010-02-21,56,30,26,0.536,55,28,27,0.509
20900829,1610612744,1610612737,108.0,104.0,0.536,0.455,1,2010-02-21,55,16,39,0.291,54,34,20,0.63
20900830,1610612756,1610612758,104.0,88.0,0.461,0.473,1,2010-02-21,57,34,23,0.596,56,18,38,0.321
20900831,1610612757,1610612762,89.0,93.0,0.352,0.3979999999999999,0,2010-02-21,58,32,26,0.552,55,36,19,0.655
20900816,1610612761,1610612764,109.0,104.0,0.521,0.473,1,2010-02-20,55,31,24,0.564,53,19,34,0.358
20900817,1610612752,1610612760,118.0,121.0,0.489,0.483,0,2010-02-20,54,19,35,0.352,53,32,21,0.604
20900818,1610612741,1610612755,122.0,90.0,0.4629999999999999,0.384,1,2010-02-20,55,29,26,0.527,55,21,34,0.382
20900819,1610612742,1610612748,97.0,91.0,0.452,0.4629999999999999,1,2010-02-20,56,35,21,0.625,57,29,28,0.509
20900820,1610612745,1610612754,115.0,125.0,0.467,0.495,0,2010-02-20,54,28,26,0.519,55,19,36,0.345
20900821,1610612749,1610612766,93.0,88.0,0.405,0.44,1,2010-02-20,54,26,28,0.481,54,27,27,0.5
20900822,1610612746,1610612758,99.0,89.0,0.4429999999999999,0.455,1,2010-02-20,55,22,33,0.4,55,18,37,0.327
20900804,1610612766,1610612739,110.0,93.0,0.547,0.39,1,2010-02-19,53,27,26,0.509,56,43,13,0.768
20900805,1610612755,1610612759,106.0,94.0,0.506,0.419,1,2010-02-19,54,21,33,0.389,53,31,22,0.585
20900806,1610612764,1610612743,107.0,97.0,0.46,0.444,1,2010-02-19,52,19,33,0.365,55,36,19,0.655
20900807,1610612765,1610612749,85.0,91.0,0.485,0.3829999999999999,0,2010-02-19,54,19,35,0.352,53,25,28,0.472
20900808,1610612763,1610612748,87.0,100.0,0.382,0.422,0,2010-02-19,54,27,27,0.5,56,29,27,0.518
20900809,1610612750,1610612741,94.0,100.0,0.447,0.4320000000000001,0,2010-02-19,56,13,43,0.2319999999999999,54,28,26,0.519
20900810,1610612751,1610612761,89.0,106.0,0.418,0.597,0,2010-02-19,55,5,50,0.091,54,30,24,0.556
20900811,1610612740,1610612754,107.0,101.0,0.4639999999999999,0.433,1,2010-02-19,55,29,26,0.527,54,18,36,0.3329999999999999
20900812,1610612753,1610612742,85.0,95.0,0.414,0.452,0,2010-02-19,56,37,19,0.6609999999999999,55,34,21,0.618
20900813,1610612756,1610612737,88.0,80.0,0.451,0.395,1,2010-02-19,56,33,23,0.589,53,34,19,0.642
20900814,1610612744,1610612762,89.0,100.0,0.3720000000000001,0.4270000000000001,0,2010-02-19,54,15,39,0.278,54,35,19,0.648
20900815,1610612757,1610612738,76.0,96.0,0.3379999999999999,0.534,0,2010-02-19,57,32,25,0.561,53,35,18,0.66
20900802,1610612739,1610612743,116.0,118.0,0.5,0.46,0,2010-02-18,55,43,12,0.782,54,36,18,0.667
20900803,1610612747,1610612738,86.0,87.0,0.402,0.44,0,2010-02-18,56,42,14,0.75,52,34,18,0.654
20900791,1610612754,1610612759,87.0,90.0,0.422,0.354,0,2010-02-17,53,18,35,0.34,52,31,21,0.596
20900792,1610612753,1610612765,116.0,91.0,0.512,0.425,1,2010-02-17,55,37,18,0.6729999999999999,53,19,34,0.358
20900793,1610612761,1610612763,102.0,109.0,0.449,0.482,0,2010-02-17,53,29,24,0.547,53,27,26,0.509
20900794,1610612764,1610612750,108.0,99.0,0.477,0.481,1,2010-02-17,51,18,33,0.353,55,13,42,0.236
20900795,1610612751,1610612748,84.0,87.0,0.357,0.392,0,2010-02-17,54,5,49,0.093,55,28,27,0.509
20900796,1610612752,1610612741,109.0,115.0,0.457,0.478,0,2010-02-17,53,19,34,0.358,53,27,26,0.509
20900797,1610612749,1610612745,99.0,127.0,0.4039999999999999,0.583,0,2010-02-17,52,24,28,0.462,53,28,25,0.528
20900798,1610612740,1610612762,90.0,98.0,0.386,0.5429999999999999,0,2010-02-17,54,28,26,0.519,53,34,19,0.642
20900799,1610612742,1610612756,107.0,97.0,0.471,0.4629999999999999,1,2010-02-17,54,33,21,0.611,55,32,23,0.5820000000000001
20900800,1610612744,1610612758,130.0,98.0,0.515,0.422,1,2010-02-17,53,15,38,0.283,54,18,36,0.3329999999999999
20900801,1610612746,1610612737,92.0,110.0,0.507,0.544,0,2010-02-17,54,21,33,0.389,52,34,18,0.654
20900781,1610612766,1610612751,94.0,103.0,0.42,0.519,0,2010-02-16,52,26,26,0.5,53,5,48,0.094
20900782,1610612755,1610612748,78.0,105.0,0.379,0.512,0,2010-02-16,53,20,33,0.377,54,27,27,0.5
20900783,1610612765,1610612750,108.0,85.0,0.535,0.4429999999999999,1,2010-02-16,52,19,33,0.365,54,13,41,0.241
20900784,1610612741,1610612752,118.0,85.0,0.605,0.346,1,2010-02-16,52,26,26,0.5,52,19,33,0.365
20900785,1610612763,1610612756,95.0,109.0,0.356,0.5,0,2010-02-16,52,26,26,0.5,54,32,22,0.593
20900786,1610612760,1610612742,99.0,86.0,0.4270000000000001,0.3229999999999999,1,2010-02-16,52,31,21,0.596,53,32,21,0.604
20900787,1610612745,1610612762,95.0,104.0,0.405,0.519,0,2010-02-16,52,27,25,0.519,52,33,19,0.635
20900788,1610612757,1610612746,109.0,87.0,0.493,0.48,1,2010-02-16,56,32,24,0.5710000000000001,53,21,32,0.396
20900789,1610612758,1610612738,92.0,95.0,0.381,0.375,0,2010-02-16,53,18,35,0.34,51,33,18,0.647
20900790,1610612747,1610612744,104.0,94.0,0.447,0.417,1,2010-02-16,55,42,13,0.764,52,14,38,0.2689999999999999
20900779,1610612739,1610612753,115.0,106.0,0.524,0.48,1,2010-02-11,54,43,11,0.7959999999999999,54,36,18,0.667
20900780,1610612743,1610612759,92.0,111.0,0.392,0.532,0,2010-02-11,53,35,18,0.66,51,30,21,0.588
20900769,1610612737,1610612748,76.0,94.0,0.375,0.506,0,2010-02-10,51,33,18,0.647,53,26,27,0.491
20900770,1610612761,1610612755,104.0,93.0,0.471,0.4320000000000001,1,2010-02-10,52,29,23,0.5579999999999999,52,20,32,0.385
20900771,1610612765,1610612758,97.0,103.0,0.407,0.513,0,2010-02-10,51,18,33,0.353,52,18,34,0.346
20900772,1610612751,1610612749,77.0,97.0,0.392,0.5,0,2010-02-10,52,4,48,0.077,51,24,27,0.471
20900773,1610612741,1610612753,87.0,107.0,0.368,0.4679999999999999,0,2010-02-10,51,25,26,0.49,53,36,17,0.679
20900774,1610612750,1610612766,92.0,93.0,0.4589999999999999,0.48,0,2010-02-10,53,13,40,0.245,51,26,25,0.51
20900775,1610612740,1610612738,93.0,85.0,0.4529999999999999,0.472,1,2010-02-10,53,28,25,0.528,50,32,18,0.64
20900776,1610612756,1610612757,101.0,108.0,0.47,0.584,0,2010-02-10,53,31,22,0.585,55,31,24,0.564
20900777,1610612762,1610612747,81.0,96.0,0.44,0.4679999999999999,0,2010-02-10,51,32,19,0.627,54,41,13,0.759
20900778,1610612744,1610612746,132.0,102.0,0.62,0.42,1,2010-02-10,51,14,37,0.275,52,21,31,0.4039999999999999
20900758,1610612766,1610612764,94.0,92.0,0.473,0.4320000000000001,1,2010-02-09,50,25,25,0.5,50,17,33,0.34
20900759,1610612739,1610612751,104.0,97.0,0.527,0.514,1,2010-02-09,53,42,11,0.792,51,4,47,0.078
20900760,1610612754,1610612741,101.0,109.0,0.435,0.506,0,2010-02-09,52,18,34,0.346,50,25,25,0.5
20900761,1610612755,1610612750,119.0,97.0,0.575,0.474,1,2010-02-09,51,20,31,0.392,52,13,39,0.25
20900762,1610612748,1610612745,99.0,66.0,0.519,0.302,1,2010-02-09,52,25,27,0.481,51,27,24,0.529
20900763,1610612752,1610612758,114.0,118.0,0.447,0.469,0,2010-02-09,51,19,32,0.373,51,17,34,0.3329999999999999
20900764,1610612763,1610612737,94.0,108.0,0.5,0.5539999999999999,0,2010-02-09,51,26,25,0.51,50,33,17,0.66
20900765,1610612749,1610612765,81.0,93.0,0.366,0.44,0,2010-02-09,50,23,27,0.46,50,18,32,0.36
20900766,1610612743,1610612742,127.0,91.0,0.608,0.382,1,2010-02-09,52,35,17,0.6729999999999999,52,32,20,0.615
20900767,1610612757,1610612760,77.0,89.0,0.4029999999999999,0.425,0,2010-02-09,54,30,24,0.556,51,30,21,0.588
20900768,1610612746,1610612762,99.0,109.0,0.4579999999999999,0.506,0,2010-02-09,51,21,30,0.412,50,32,18,0.64
20900755,1610612753,1610612740,123.0,117.0,0.542,0.517,1,2010-02-08,52,35,17,0.6729999999999999,52,27,25,0.519
20900756,1610612744,1610612742,117.0,127.0,0.494,0.521,0,2010-02-08,50,13,37,0.26,51,32,19,0.627
20900757,1610612747,1610612759,101.0,89.0,0.4370000000000001,0.4270000000000001,1,2010-02-08,53,40,13,0.755,50,29,21,0.58
20900753,1610612761,1610612758,115.0,104.0,0.561,0.435,1,2010-02-07,51,28,23,0.5489999999999999,50,16,34,0.32
20900754,1610612738,1610612753,89.0,96.0,0.422,0.4629999999999999,0,2010-02-07,49,32,17,0.653,51,34,17,0.667
20900741,1610612766,1610612740,99.0,104.0,0.481,0.506,0,2010-02-06,49,24,25,0.49,51,27,24,0.529
20900743,1610612739,1610612752,113.0,106.0,0.55,0.526,1,2010-02-06,52,41,11,0.7879999999999999,50,19,31,0.38
20900744,1610612765,1610612751,99.0,92.0,0.521,0.4589999999999999,1,2010-02-06,49,17,32,0.347,50,4,46,0.08
20900745,1610612741,1610612748,95.0,91.0,0.402,0.415,1,2010-02-06,49,24,25,0.49,51,24,27,0.471
20900746,1610612750,1610612763,109.0,102.0,0.556,0.517,1,2010-02-06,51,13,38,0.255,50,26,24,0.52
20900747,1610612745,1610612755,95.0,102.0,0.41,0.486,0,2010-02-06,50,27,23,0.54,50,19,31,0.38
20900748,1610612749,1610612754,93.0,81.0,0.43,0.4639999999999999,1,2010-02-06,49,23,26,0.469,51,18,33,0.353
20900749,1610612762,1610612743,116.0,106.0,0.494,0.446,1,2010-02-06,49,31,18,0.633,51,34,17,0.667
20900750,1610612757,1610612747,82.0,99.0,0.4370000000000001,0.488,0,2010-02-06,53,30,23,0.5660000000000001,52,39,13,0.75
20900751,1610612744,1610612760,95.0,104.0,0.42,0.422,0,2010-02-06,49,13,36,0.265,50,29,21,0.58
20900752,1610612746,1610612759,81.0,98.0,0.413,0.43,0,2010-02-06,50,21,29,0.42,49,29,20,0.5920000000000001
20900731,1610612754,1610612765,107.0,83.0,0.519,0.391,1,2010-02-05,50,18,32,0.36,48,16,32,0.3329999999999999
20900732,1610612753,1610612764,91.0,92.0,0.386,0.43,0,2010-02-05,50,33,17,0.66,49,17,32,0.347
20900733,1610612738,1610612751,96.0,87.0,0.5,0.441,1,2010-02-05,48,32,16,0.667,49,4,45,0.0819999999999999
20900734,1610612752,1610612749,107.0,114.0,0.4479999999999999,0.478,0,2010-02-05,49,19,30,0.3879999999999999,48,22,26,0.4579999999999999
20900735,1610612737,1610612741,91.0,81.0,0.4429999999999999,0.434,1,2010-02-05,49,32,17,0.653,48,23,25,0.479
20900736,1610612763,1610612745,83.0,101.0,0.405,0.4379999999999999,0,2010-02-05,49,26,23,0.531,49,27,22,0.551
20900737,1610612740,1610612755,94.0,101.0,0.4679999999999999,0.481,0,2010-02-05,50,26,24,0.52,49,18,31,0.3670000000000001
20900738,1610612742,1610612750,108.0,117.0,0.4270000000000001,0.53,0,2010-02-05,50,31,19,0.62,50,12,38,0.24
20900739,1610612758,1610612756,102.0,114.0,0.444,0.487,0,2010-02-05,49,16,33,0.327,52,31,21,0.596
20900740,1610612747,1610612743,113.0,126.0,0.449,0.5710000000000001,0,2010-02-05,51,38,13,0.745,50,34,16,0.68
20900729,1610612739,1610612748,102.0,86.0,0.486,0.414,1,2010-02-04,51,40,11,0.784,50,24,26,0.48
20900730,1610612757,1610612759,96.0,93.0,0.513,0.44,1,2010-02-04,52,30,22,0.5770000000000001,48,28,20,0.583
20900718,1610612737,1610612746,103.0,97.0,0.456,0.4379999999999999,1,2010-02-03,48,31,17,0.6459999999999999,49,21,28,0.429
20900719,1610612755,1610612741,106.0,103.0,0.523,0.442,1,2010-02-03,48,17,31,0.354,47,23,24,0.489
20900720,1610612761,1610612751,108.0,99.0,0.474,0.4379999999999999,1,2010-02-03,50,27,23,0.54,48,4,44,0.083
20900721,1610612752,1610612764,107.0,85.0,0.523,0.481,1,2010-02-03,48,19,29,0.396,48,16,32,0.3329999999999999
20900722,1610612738,1610612748,107.0,102.0,0.487,0.521,1,2010-02-03,47,31,16,0.66,49,24,25,0.49
20900723,1610612740,1610612760,99.0,103.0,0.451,0.575,0,2010-02-03,49,26,23,0.531,49,28,21,0.5710000000000001
20900724,1610612742,1610612744,110.0,101.0,0.544,0.494,1,2010-02-03,49,31,18,0.633,48,13,35,0.271
20900728,1610612762,1610612757,118.0,105.0,0.627,0.425,1,2010-02-03,48,30,18,0.625,51,29,22,0.569
20900726,1610612758,1610612759,113.0,115.0,0.523,0.524,0,2010-02-03,48,16,32,0.3329999999999999,47,28,19,0.596
20900725,1610612743,1610612756,97.0,109.0,0.4429999999999999,0.494,0,2010-02-03,49,33,16,0.6729999999999999,51,30,21,0.588
20900727,1610612747,1610612766,99.0,97.0,0.4639999999999999,0.451,1,2010-02-03,50,38,12,0.76,48,24,24,0.5
20900711,1610612739,1610612763,105.0,89.0,0.494,0.38,1,2010-02-02,50,39,11,0.78,48,26,22,0.542
20900712,1610612754,1610612761,130.0,115.0,0.524,0.446,1,2010-02-02,49,17,32,0.347,49,26,23,0.531
20900713,1610612753,1610612749,99.0,82.0,0.465,0.363,1,2010-02-02,49,33,16,0.6729999999999999,47,21,26,0.447
20900714,1610612751,1610612765,93.0,97.0,0.452,0.4629999999999999,0,2010-02-02,47,4,43,0.085,47,16,31,0.34
20900715,1610612741,1610612746,82.0,90.0,0.38,0.451,0,2010-02-02,46,23,23,0.5,48,21,27,0.4379999999999999
20900716,1610612760,1610612737,106.0,99.0,0.457,0.48,1,2010-02-02,48,27,21,0.563,47,30,17,0.638
20900717,1610612745,1610612744,119.0,97.0,0.5,0.418,1,2010-02-02,48,26,22,0.542,47,13,34,0.2769999999999999
20900704,1610612764,1610612738,88.0,99.0,0.389,0.5479999999999999,0,2010-02-01,47,16,31,0.34,46,30,16,0.652
20900705,1610612748,1610612749,81.0,97.0,0.364,0.507,0,2010-02-01,48,24,24,0.5,46,21,25,0.457
20900706,1610612763,1610612747,95.0,93.0,0.415,0.466,1,2010-02-01,47,26,21,0.5529999999999999,49,37,12,0.755
20900707,1610612740,1610612756,100.0,109.0,0.456,0.518,0,2010-02-01,48,26,22,0.542,50,29,21,0.58
20900708,1610612743,1610612758,112.0,109.0,0.461,0.488,1,2010-02-01,48,33,15,0.688,47,16,31,0.34
20900709,1610612762,1610612742,104.0,92.0,0.494,0.462,1,2010-02-01,47,29,18,0.617,48,30,18,0.625
20900710,1610612757,1610612766,98.0,79.0,0.5329999999999999,0.406,1,2010-02-01,50,29,21,0.58,47,24,23,0.511
20900695,1610612759,1610612743,89.0,103.0,0.43,0.536,0,2010-01-31,46,27,19,0.5870000000000001,47,32,15,0.6809999999999999
20900696,1610612738,1610612747,89.0,90.0,0.466,0.479,0,2010-01-31,45,29,16,0.644,48,37,11,0.7709999999999999
20900697,1610612739,1610612746,114.0,89.0,0.506,0.422,1,2010-01-31,49,38,11,0.7759999999999999,47,20,27,0.426
20900698,1610612765,1610612753,86.0,91.0,0.392,0.469,0,2010-01-31,46,15,31,0.326,48,32,16,0.667
20900699,1610612751,1610612755,79.0,83.0,0.395,0.365,0,2010-01-31,46,4,42,0.087,47,16,31,0.34
20900700,1610612761,1610612754,117.0,102.0,0.602,0.476,1,2010-01-31,48,26,22,0.542,48,16,32,0.3329999999999999
20900701,1610612745,1610612756,111.0,115.0,0.377,0.482,0,2010-01-31,47,25,22,0.532,49,28,21,0.5710000000000001
20900702,1610612750,1610612752,112.0,91.0,0.5,0.3979999999999999,1,2010-01-31,49,11,38,0.2239999999999999,47,18,29,0.3829999999999999
20900703,1610612760,1610612744,112.0,104.0,0.513,0.4679999999999999,1,2010-01-31,47,26,21,0.5529999999999999,46,13,33,0.283
20900689,1610612753,1610612737,104.0,86.0,0.542,0.395,1,2010-01-30,47,31,16,0.66,46,30,16,0.652
20900690,1610612763,1610612740,102.0,109.0,0.434,0.476,0,2010-01-30,46,25,21,0.5429999999999999,47,26,21,0.5529999999999999
20900691,1610612764,1610612752,106.0,96.0,0.449,0.447,1,2010-01-30,46,16,30,0.348,46,18,28,0.391
20900693,1610612749,1610612748,95.0,84.0,0.4529999999999999,0.3720000000000001,1,2010-01-30,45,20,25,0.444,47,24,23,0.511
20900692,1610612742,1610612757,112.0,114.0,0.472,0.535,0,2010-01-30,47,30,17,0.638,49,28,21,0.5710000000000001
20900694,1610612758,1610612766,96.0,103.0,0.4529999999999999,0.481,0,2010-01-30,46,16,30,0.348,46,24,22,0.522
20900677,1610612754,1610612739,73.0,94.0,0.337,0.4639999999999999,0,2010-01-29,47,16,31,0.34,48,37,11,0.7709999999999999
20900678,1610612755,1610612747,91.0,99.0,0.45,0.457,0,2010-01-29,46,15,31,0.326,47,36,11,0.7659999999999999
20900679,1610612737,1610612738,100.0,91.0,0.474,0.419,1,2010-01-29,45,30,15,0.667,44,29,15,0.659
20900680,1610612765,1610612748,65.0,92.0,0.3939999999999999,0.479,0,2010-01-29,45,15,30,0.3329999999999999,46,24,22,0.522
20900681,1610612750,1610612746,111.0,97.0,0.524,0.415,1,2010-01-29,48,10,38,0.208,46,20,26,0.435
20900682,1610612751,1610612764,79.0,81.0,0.455,0.421,0,2010-01-29,45,4,41,0.089,45,15,30,0.3329999999999999
20900683,1610612740,1610612741,106.0,108.0,0.3939999999999999,0.451,0,2010-01-29,46,25,21,0.5429999999999999,45,23,22,0.511
20900684,1610612760,1610612743,101.0,84.0,0.519,0.4029999999999999,1,2010-01-29,46,25,21,0.5429999999999999,46,31,15,0.674
20900685,1610612745,1610612757,104.0,100.0,0.467,0.457,1,2010-01-29,46,25,21,0.5429999999999999,48,27,21,0.563
20900686,1610612759,1610612763,104.0,97.0,0.483,0.507,1,2010-01-29,45,27,18,0.6,45,25,20,0.556
20900687,1610612762,1610612758,101.0,94.0,0.486,0.434,1,2010-01-29,46,28,18,0.609,45,16,29,0.356
20900688,1610612744,1610612766,110.0,121.0,0.529,0.506,0,2010-01-29,45,13,32,0.289,45,23,22,0.511
20900674,1610612752,1610612761,104.0,106.0,0.4370000000000001,0.494,0,2010-01-28,45,18,27,0.4,47,25,22,0.532
20900675,1610612753,1610612738,96.0,94.0,0.4379999999999999,0.473,1,2010-01-28,46,30,16,0.652,43,29,14,0.674
20900676,1610612756,1610612742,112.0,106.0,0.5479999999999999,0.5,1,2010-01-28,48,27,21,0.563,46,30,16,0.652
20900663,1610612739,1610612750,109.0,95.0,0.5479999999999999,0.389,1,2010-01-27,47,36,11,0.7659999999999999,47,9,38,0.191
20900664,1610612754,1610612747,96.0,118.0,0.419,0.4539999999999999,0,2010-01-27,46,16,30,0.348,46,35,11,0.7609999999999999
20900665,1610612761,1610612748,111.0,103.0,0.568,0.444,1,2010-01-27,46,24,22,0.522,45,23,22,0.511
20900666,1610612765,1610612763,93.0,99.0,0.471,0.442,0,2010-01-27,44,15,29,0.341,44,25,19,0.568
20900667,1610612751,1610612746,103.0,87.0,0.532,0.421,1,2010-01-27,44,4,40,0.091,45,20,25,0.444
20900668,1610612749,1610612755,91.0,88.0,0.435,0.462,1,2010-01-27,44,19,25,0.4320000000000001,45,15,30,0.3329999999999999
20900669,1610612760,1610612741,86.0,96.0,0.369,0.456,0,2010-01-27,45,24,21,0.5329999999999999,44,22,22,0.5
20900670,1610612745,1610612743,92.0,97.0,0.434,0.444,0,2010-01-27,45,24,21,0.5329999999999999,45,31,14,0.6890000000000001
20900671,1610612759,1610612737,105.0,90.0,0.435,0.3979999999999999,1,2010-01-27,44,26,18,0.591,44,29,15,0.659
20900672,1610612757,1610612762,95.0,106.0,0.359,0.603,0,2010-01-27,47,27,20,0.574,45,27,18,0.6
20900673,1610612744,1610612740,110.0,123.0,0.506,0.523,0,2010-01-27,44,13,31,0.295,45,25,20,0.556
20900658,1610612764,1610612747,103.0,115.0,0.494,0.5870000000000001,0,2010-01-26,44,14,30,0.318,45,34,11,0.7559999999999999
20900659,1610612752,1610612750,132.0,105.0,0.505,0.471,1,2010-01-26,44,18,26,0.409,46,9,37,0.196
20900660,1610612742,1610612749,108.0,107.0,0.513,0.5329999999999999,1,2010-01-26,45,30,15,0.667,43,18,25,0.419
20900661,1610612756,1610612766,109.0,114.0,0.4479999999999999,0.446,0,2010-01-26,47,26,21,0.5529999999999999,44,22,22,0.5
20900662,1610612758,1610612744,99.0,96.0,0.38,0.319,1,2010-01-26,44,16,28,0.364,43,13,30,0.302
20900649,1610612755,1610612754,98.0,109.0,0.439,0.518,0,2010-01-25,44,15,29,0.341,45,16,29,0.356
20900650,1610612738,1610612746,95.0,89.0,0.472,0.3879999999999999,1,2010-01-25,42,29,13,0.69,44,20,24,0.455
20900651,1610612748,1610612739,91.0,92.0,0.436,0.452,0,2010-01-25,44,23,21,0.523,46,35,11,0.7609999999999999
20900652,1610612763,1610612753,99.0,94.0,0.4629999999999999,0.423,1,2010-01-25,43,24,19,0.5579999999999999,45,29,16,0.644
20900653,1610612745,1610612737,95.0,102.0,0.3979999999999999,0.476,0,2010-01-25,44,24,20,0.545,43,29,14,0.674
20900654,1610612759,1610612741,93.0,98.0,0.419,0.5379999999999999,0,2010-01-25,43,25,18,0.581,43,21,22,0.488
20900655,1610612743,1610612766,104.0,93.0,0.456,0.472,1,2010-01-25,44,30,14,0.682,43,21,22,0.488
20900656,1610612762,1610612756,124.0,115.0,0.524,0.488,1,2010-01-25,44,26,18,0.591,46,26,20,0.565
20900657,1610612757,1610612740,97.0,98.0,0.476,0.515,0,2010-01-25,46,27,19,0.5870000000000001,44,24,20,0.545
20900646,1610612752,1610612742,78.0,128.0,0.337,0.581,0,2010-01-24,43,17,26,0.395,44,29,15,0.659
20900647,1610612764,1610612746,78.0,92.0,0.395,0.43,0,2010-01-24,43,14,29,0.326,43,20,23,0.465
20900648,1610612761,1610612747,106.0,105.0,0.476,0.4589999999999999,1,2010-01-24,45,23,22,0.511,44,33,11,0.75
20900636,1610612766,1610612753,95.0,106.0,0.3979999999999999,0.4370000000000001,0,2010-01-23,42,21,21,0.5,44,29,15,0.659
20900637,1610612754,1610612755,97.0,107.0,0.447,0.412,0,2010-01-23,44,15,29,0.341,43,15,28,0.349
20900638,1610612739,1610612760,100.0,99.0,0.493,0.384,1,2010-01-23,45,34,11,0.7559999999999999,44,24,20,0.545
20900639,1610612765,1610612757,93.0,97.0,0.4270000000000001,0.479,0,2010-01-23,43,15,28,0.349,45,27,18,0.6
20900640,1610612748,1610612758,115.0,84.0,0.564,0.4379999999999999,1,2010-01-23,43,23,20,0.535,43,15,28,0.349
20900641,1610612745,1610612741,97.0,104.0,0.4,0.534,0,2010-01-23,43,24,19,0.5579999999999999,42,20,22,0.476
20900642,1610612749,1610612750,127.0,94.0,0.57,0.384,1,2010-01-23,42,18,24,0.429,45,9,36,0.2
20900643,1610612743,1610612740,116.0,110.0,0.444,0.457,1,2010-01-23,43,29,14,0.674,43,23,20,0.535
20900644,1610612756,1610612744,112.0,103.0,0.435,0.436,1,2010-01-23,45,26,19,0.578,42,13,29,0.31
20900645,1610612762,1610612751,116.0,83.0,0.611,0.425,1,2010-01-23,43,25,18,0.581,43,3,40,0.07
20900623,1610612753,1610612758,100.0,84.0,0.4320000000000001,0.3329999999999999,1,2010-01-22,43,28,15,0.6509999999999999,42,15,27,0.357
20900624,1610612755,1610612742,92.0,81.0,0.43,0.395,1,2010-01-22,42,14,28,0.3329999999999999,43,28,15,0.6509999999999999
20900625,1610612761,1610612749,101.0,96.0,0.4270000000000001,0.4429999999999999,1,2010-01-22,44,22,22,0.5,41,17,24,0.415
20900626,1610612764,1610612748,88.0,112.0,0.395,0.57,0,2010-01-22,42,14,28,0.3329999999999999,42,22,20,0.524
20900627,1610612737,1610612766,103.0,89.0,0.512,0.4639999999999999,1,2010-01-22,42,28,14,0.667,41,21,20,0.512
20900628,1610612738,1610612757,98.0,95.0,0.487,0.382,1,2010-01-22,41,28,13,0.6829999999999999,44,26,18,0.591
20900629,1610612765,1610612754,93.0,105.0,0.412,0.474,0,2010-01-22,42,15,27,0.357,43,15,28,0.349
20900630,1610612763,1610612760,86.0,84.0,0.392,0.4029999999999999,1,2010-01-22,42,23,19,0.5479999999999999,43,24,19,0.5579999999999999
20900631,1610612750,1610612740,94.0,96.0,0.475,0.4379999999999999,0,2010-01-22,44,9,35,0.205,42,23,19,0.5479999999999999
20900632,1610612752,1610612747,105.0,115.0,0.451,0.5,0,2010-01-22,42,17,25,0.405,43,33,10,0.767
20900633,1610612759,1610612745,109.0,116.0,0.418,0.551,0,2010-01-22,42,25,17,0.595,42,24,18,0.5710000000000001
20900634,1610612744,1610612751,111.0,79.0,0.519,0.356,1,2010-01-22,41,13,28,0.317,42,3,39,0.071
20900635,1610612756,1610612741,104.0,115.0,0.385,0.506,0,2010-01-22,44,25,19,0.568,41,19,22,0.4629999999999999
20900621,1610612739,1610612747,93.0,87.0,0.479,0.386,1,2010-01-21,44,33,11,0.75,42,32,10,0.762
20900622,1610612743,1610612746,105.0,85.0,0.479,0.3779999999999999,1,2010-01-21,42,28,14,0.667,42,19,23,0.452
20900608,1610612737,1610612758,108.0,97.0,0.513,0.471,1,2010-01-20,41,27,14,0.659,41,15,26,0.366
20900609,1610612766,1610612748,104.0,65.0,0.486,0.289,1,2010-01-20,40,21,19,0.525,41,21,20,0.512
20900610,1610612753,1610612754,109.0,98.0,0.493,0.447,1,2010-01-20,42,27,15,0.643,42,14,28,0.3329999999999999
20900611,1610612755,1610612757,90.0,98.0,0.436,0.474,0,2010-01-20,41,13,28,0.317,43,26,17,0.605
20900612,1610612764,1610612742,93.0,94.0,0.444,0.4589999999999999,0,2010-01-20,41,14,27,0.341,42,28,14,0.667
20900613,1610612765,1610612738,92.0,86.0,0.424,0.429,1,2010-01-20,41,15,26,0.366,40,27,13,0.675
20900614,1610612749,1610612761,113.0,107.0,0.467,0.447,1,2010-01-20,40,17,23,0.425,43,21,22,0.488
20900615,1610612750,1610612760,92.0,94.0,0.471,0.4589999999999999,0,2010-01-20,43,9,34,0.209,42,24,18,0.5710000000000001
20900616,1610612740,1610612763,113.0,111.0,0.552,0.529,1,2010-01-20,41,22,19,0.537,41,22,19,0.537
20900617,1610612756,1610612751,118.0,94.0,0.536,0.4370000000000001,1,2010-01-20,43,25,18,0.581,41,3,38,0.073
20900618,1610612759,1610612762,98.0,105.0,0.3929999999999999,0.4679999999999999,0,2010-01-20,41,25,16,0.61,42,24,18,0.5710000000000001
20900619,1610612744,1610612743,118.0,123.0,0.4320000000000001,0.477,0,2010-01-20,40,12,28,0.3,41,27,14,0.659
20900620,1610612746,1610612741,104.0,97.0,0.4629999999999999,0.429,1,2010-01-20,41,19,22,0.4629999999999999,40,18,22,0.45
20900606,1610612739,1610612761,108.0,100.0,0.528,0.482,1,2010-01-19,43,32,11,0.7440000000000001,42,21,21,0.5
20900607,1610612748,1610612754,113.0,83.0,0.563,0.365,1,2010-01-19,40,21,19,0.525,41,14,27,0.341
20900594,1610612752,1610612765,99.0,91.0,0.493,0.406,1,2010-01-18,41,17,24,0.415,40,14,26,0.35
20900595,1610612764,1610612757,97.0,92.0,0.515,0.451,1,2010-01-18,40,14,26,0.35,42,25,17,0.595
20900596,1610612737,1610612760,91.0,94.0,0.4,0.447,0,2010-01-18,40,26,14,0.65,41,23,18,0.561
20900597,1610612766,1610612758,105.0,103.0,0.47,0.488,1,2010-01-18,39,20,19,0.513,40,15,25,0.375
20900598,1610612745,1610612749,101.0,98.0,0.419,0.446,1,2010-01-18,41,23,18,0.561,39,16,23,0.41
20900599,1610612746,1610612751,106.0,95.0,0.556,0.4579999999999999,1,2010-01-18,40,18,22,0.45,40,3,37,0.075
20900600,1610612750,1610612755,108.0,103.0,0.466,0.482,1,2010-01-18,42,9,33,0.214,40,13,27,0.325
20900601,1610612740,1610612759,90.0,97.0,0.4579999999999999,0.423,0,2010-01-18,40,21,19,0.525,40,25,15,0.625
20900602,1610612744,1610612741,114.0,97.0,0.442,0.365,1,2010-01-18,39,12,27,0.308,39,18,21,0.462
20900603,1610612763,1610612756,125.0,118.0,0.506,0.49,1,2010-01-18,40,22,18,0.55,42,24,18,0.5710000000000001
20900604,1610612738,1610612742,90.0,99.0,0.506,0.574,0,2010-01-18,39,27,12,0.6920000000000001,41,27,14,0.659
20900605,1610612747,1610612753,98.0,92.0,0.4270000000000001,0.439,1,2010-01-18,41,32,9,0.78,41,26,15,0.634
20900592,1610612761,1610612742,110.0,88.0,0.489,0.45,1,2010-01-17,41,21,20,0.512,40,26,14,0.65
20900593,1610612743,1610612762,119.0,112.0,0.486,0.519,1,2010-01-17,40,26,14,0.65,41,23,18,0.561
20900585,1610612754,1610612740,96.0,101.0,0.4320000000000001,0.429,0,2010-01-16,40,14,26,0.35,39,21,18,0.5379999999999999
20900584,1610612766,1610612756,125.0,99.0,0.505,0.417,1,2010-01-16,38,19,19,0.5,41,24,17,0.585
20900586,1610612764,1610612758,96.0,86.0,0.475,0.373,1,2010-01-16,39,13,26,0.3329999999999999,39,15,24,0.385
20900587,1610612765,1610612752,94.0,90.0,0.39,0.395,1,2010-01-16,39,14,25,0.359,40,16,24,0.4
20900588,1610612763,1610612759,92.0,86.0,0.434,0.414,1,2010-01-16,39,21,18,0.5379999999999999,39,24,15,0.615
20900589,1610612760,1610612748,98.0,80.0,0.507,0.415,1,2010-01-16,40,22,18,0.55,39,20,19,0.513
20900590,1610612762,1610612749,112.0,95.0,0.564,0.4320000000000001,1,2010-01-16,40,23,17,0.575,38,16,22,0.421
20900591,1610612746,1610612739,101.0,102.0,0.597,0.481,0,2010-01-16,39,17,22,0.436,42,31,11,0.738
20900571,1610612766,1610612759,92.0,76.0,0.461,0.3879999999999999,1,2010-01-15,37,18,19,0.486,38,24,14,0.632
20900572,1610612755,1610612758,98.0,86.0,0.451,0.371,1,2010-01-15,39,13,26,0.3329999999999999,38,15,23,0.395
20900573,1610612737,1610612756,102.0,101.0,0.411,0.442,1,2010-01-15,39,26,13,0.667,40,24,16,0.6
20900574,1610612741,1610612764,121.0,119.0,0.4539999999999999,0.451,1,2010-01-15,38,18,20,0.474,38,12,26,0.316
20900575,1610612765,1610612740,110.0,104.0,0.45,0.481,1,2010-01-15,38,13,25,0.342,38,20,18,0.526
20900576,1610612763,1610612750,135.0,110.0,0.585,0.478,1,2010-01-15,38,20,18,0.526,41,8,33,0.195
20900577,1610612751,1610612754,105.0,121.0,0.42,0.531,0,2010-01-15,39,3,36,0.077,39,14,25,0.359
20900578,1610612752,1610612761,104.0,112.0,0.442,0.534,0,2010-01-15,39,16,23,0.41,40,20,20,0.5
20900579,1610612742,1610612760,99.0,98.0,0.4429999999999999,0.42,1,2010-01-15,39,26,13,0.667,39,21,18,0.5379999999999999
20900580,1610612745,1610612748,106.0,115.0,0.487,0.536,0,2010-01-15,40,22,18,0.55,38,20,18,0.526
20900581,1610612744,1610612749,104.0,113.0,0.471,0.4579999999999999,0,2010-01-15,38,11,27,0.289,37,16,21,0.4320000000000001
20900582,1610612747,1610612746,126.0,86.0,0.5,0.4029999999999999,1,2010-01-15,40,31,9,0.775,38,17,21,0.447
20900583,1610612757,1610612753,102.0,87.0,0.471,0.479,1,2010-01-15,41,25,16,0.61,40,26,14,0.65
20900569,1610612738,1610612741,83.0,96.0,0.451,0.452,0,2010-01-14,38,27,11,0.711,37,17,20,0.4589999999999999
20900570,1610612762,1610612739,97.0,96.0,0.405,0.456,1,2010-01-14,39,22,17,0.564,41,30,11,0.732
20900558,1610612737,1610612764,94.0,82.0,0.435,0.358,1,2010-01-13,38,25,13,0.6579999999999999,37,12,25,0.324
20900559,1610612754,1610612756,122.0,114.0,0.43,0.4270000000000001,1,2010-01-13,38,13,25,0.342,39,24,15,0.615
20900560,1610612755,1610612752,92.0,93.0,0.43,0.45,0,2010-01-13,38,12,26,0.316,38,16,22,0.421
20900561,1610612751,1610612738,87.0,111.0,0.377,0.531,0,2010-01-13,38,3,35,0.079,37,27,10,0.73
20900562,1610612740,1610612746,108.0,94.0,0.517,0.407,1,2010-01-13,37,20,17,0.541,37,17,20,0.4589999999999999
20900563,1610612760,1610612759,108.0,109.0,0.461,0.4529999999999999,0,2010-01-13,38,21,17,0.5529999999999999,37,24,13,0.649
20900564,1610612742,1610612747,95.0,100.0,0.424,0.488,0,2010-01-13,38,25,13,0.6579999999999999,39,30,9,0.769
20900565,1610612745,1610612750,120.0,114.0,0.425,0.387,1,2010-01-13,39,22,17,0.564,40,8,32,0.2
20900566,1610612743,1610612753,115.0,97.0,0.5579999999999999,0.436,1,2010-01-13,39,25,14,0.6409999999999999,39,26,13,0.667
20900567,1610612757,1610612749,120.0,108.0,0.603,0.4529999999999999,1,2010-01-13,40,24,16,0.6,36,15,21,0.417
20900568,1610612744,1610612748,102.0,115.0,0.429,0.56,0,2010-01-13,37,11,26,0.297,37,19,18,0.514
20900553,1610612766,1610612745,102.0,94.0,0.506,0.417,1,2010-01-12,36,17,19,0.472,38,21,17,0.5529999999999999
20900554,1610612764,1610612765,90.0,99.0,0.442,0.4629999999999999,0,2010-01-12,36,12,24,0.3329999999999999,37,12,25,0.324
20900555,1610612763,1610612746,104.0,102.0,0.469,0.5379999999999999,1,2010-01-12,37,19,18,0.514,36,17,19,0.472
20900556,1610612759,1610612747,105.0,85.0,0.573,0.436,1,2010-01-12,36,23,13,0.639,38,29,9,0.763
20900557,1610612758,1610612753,88.0,109.0,0.349,0.506,0,2010-01-12,37,15,22,0.405,38,26,12,0.684
20900544,1610612754,1610612761,105.0,101.0,0.425,0.395,1,2010-01-11,37,12,25,0.324,39,19,20,0.487
20900545,1610612755,1610612740,96.0,92.0,0.418,0.407,1,2010-01-11,37,12,25,0.324,36,19,17,0.528
20900546,1610612738,1610612737,96.0,102.0,0.5539999999999999,0.455,0,2010-01-11,36,26,10,0.722,37,24,13,0.649
20900547,1610612741,1610612765,120.0,87.0,0.5710000000000001,0.413,1,2010-01-11,36,16,20,0.444,36,11,25,0.306
20900548,1610612760,1610612752,106.0,88.0,0.466,0.382,1,2010-01-11,37,21,16,0.568,37,15,22,0.405
20900549,1610612743,1610612750,105.0,94.0,0.4629999999999999,0.37,1,2010-01-11,38,24,14,0.632,39,8,31,0.205
20900550,1610612756,1610612749,105.0,101.0,0.494,0.386,1,2010-01-11,38,24,14,0.632,35,15,20,0.429
20900551,1610612762,1610612748,118.0,89.0,0.5710000000000001,0.407,1,2010-01-11,38,21,17,0.5529999999999999,36,18,18,0.5
20900552,1610612744,1610612739,114.0,117.0,0.424,0.531,0,2010-01-11,36,11,25,0.306,40,30,10,0.75
20900538,1610612761,1610612738,107.0,114.0,0.481,0.506,0,2010-01-10,38,19,19,0.5,35,26,9,0.743
20900539,1610612764,1610612740,110.0,115.0,0.5870000000000001,0.525,0,2010-01-10,35,12,23,0.3429999999999999,35,19,16,0.5429999999999999
20900540,1610612746,1610612748,94.0,84.0,0.419,0.3929999999999999,1,2010-01-10,35,17,18,0.486,35,18,17,0.514
20900541,1610612759,1610612751,97.0,85.0,0.456,0.395,1,2010-01-10,35,22,13,0.629,37,3,34,0.081
20900542,1610612757,1610612739,94.0,106.0,0.514,0.5,0,2010-01-10,39,23,16,0.59,39,29,10,0.7440000000000001
20900543,1610612747,1610612749,95.0,77.0,0.4,0.341,1,2010-01-10,37,29,8,0.784,34,15,19,0.441
20900530,1610612766,1610612763,89.0,87.0,0.423,0.407,1,2010-01-09,35,16,19,0.457,36,18,18,0.5
20900531,1610612753,1610612737,113.0,81.0,0.524,0.397,1,2010-01-09,37,25,12,0.6759999999999999,36,23,13,0.639
20900532,1610612765,1610612755,94.0,104.0,0.414,0.574,0,2010-01-09,35,11,24,0.314,36,11,25,0.306
20900533,1610612741,1610612750,110.0,96.0,0.518,0.43,1,2010-01-09,35,15,20,0.429,38,8,30,0.211
20900534,1610612760,1610612754,108.0,102.0,0.514,0.396,1,2010-01-09,36,20,16,0.556,36,11,25,0.306
20900535,1610612742,1610612762,93.0,111.0,0.413,0.532,0,2010-01-09,37,25,12,0.6759999999999999,37,20,17,0.541
20900536,1610612745,1610612752,105.0,96.0,0.494,0.52,1,2010-01-09,37,21,16,0.568,36,15,21,0.417
20900537,1610612758,1610612743,102.0,100.0,0.487,0.446,1,2010-01-09,36,15,21,0.417,37,23,14,0.622
20900518,1610612755,1610612761,106.0,108.0,0.4579999999999999,0.513,0,2010-01-08,35,10,25,0.286,37,19,18,0.514
20900519,1610612764,1610612753,104.0,97.0,0.425,0.429,1,2010-01-08,34,12,22,0.353,36,24,12,0.667
20900520,1610612737,1610612738,93.0,85.0,0.494,0.408,1,2010-01-08,35,23,12,0.657,34,25,9,0.735
20900521,1610612763,1610612762,91.0,89.0,0.429,0.3979999999999999,1,2010-01-08,35,18,17,0.514,36,19,17,0.528
20900522,1610612750,1610612754,116.0,109.0,0.5,0.435,1,2010-01-08,37,8,29,0.216,35,11,24,0.314
20900523,1610612740,1610612751,103.0,99.0,0.4639999999999999,0.446,1,2010-01-08,34,18,16,0.529,36,3,33,0.083
20900524,1610612749,1610612741,96.0,93.0,0.4,0.407,1,2010-01-08,33,15,18,0.455,34,14,20,0.412
20900525,1610612759,1610612742,103.0,112.0,0.526,0.494,0,2010-01-08,34,21,13,0.618,36,25,11,0.6940000000000001
20900526,1610612756,1610612748,105.0,109.0,0.434,0.419,0,2010-01-08,37,23,14,0.622,34,18,16,0.529
20900527,1610612757,1610612747,107.0,98.0,0.507,0.4320000000000001,1,2010-01-08,38,23,15,0.605,36,28,8,0.778
20900528,1610612743,1610612739,99.0,97.0,0.449,0.467,1,2010-01-08,36,23,13,0.639,38,28,10,0.737
20900529,1610612744,1610612758,108.0,101.0,0.481,0.44,1,2010-01-08,35,11,24,0.314,35,14,21,0.4
20900517,1610612752,1610612766,97.0,93.0,0.534,0.416,1,2010-01-07,35,15,20,0.429,34,15,19,0.441
20900507,1610612737,1610612751,119.0,89.0,0.573,0.418,1,2010-01-06,34,22,12,0.647,35,3,32,0.086
20900508,1610612739,1610612764,121.0,98.0,0.573,0.44,1,2010-01-06,37,28,9,0.757,33,11,22,0.3329999999999999
20900509,1610612753,1610612761,103.0,108.0,0.419,0.5489999999999999,0,2010-01-06,35,24,11,0.6859999999999999,36,18,18,0.5
20900510,1610612748,1610612738,106.0,112.0,0.408,0.537,0,2010-01-06,33,17,16,0.515,33,25,8,0.758
20900511,1610612750,1610612744,101.0,107.0,0.44,0.46,0,2010-01-06,36,7,29,0.1939999999999999,34,10,24,0.294
20900512,1610612760,1610612740,92.0,97.0,0.4429999999999999,0.493,0,2010-01-06,35,19,16,0.5429999999999999,33,17,16,0.515
20900513,1610612759,1610612765,112.0,92.0,0.581,0.447,1,2010-01-06,33,21,12,0.636,34,11,23,0.324
20900514,1610612756,1610612745,118.0,110.0,0.544,0.4479999999999999,1,2010-01-06,36,23,13,0.639,36,20,16,0.556
20900515,1610612762,1610612763,117.0,94.0,0.568,0.405,1,2010-01-06,35,19,16,0.5429999999999999,34,17,17,0.5
20900516,1610612746,1610612747,102.0,91.0,0.46,0.384,1,2010-01-06,34,16,18,0.471,35,28,7,0.8
20900498,1610612766,1610612741,113.0,108.0,0.513,0.512,1,2010-01-05,33,15,18,0.455,33,14,19,0.424
20900499,1610612754,1610612753,97.0,90.0,0.429,0.384,1,2010-01-05,34,11,23,0.324,34,24,10,0.706
20900500,1610612755,1610612764,97.0,104.0,0.487,0.519,0,2010-01-05,34,10,24,0.294,32,11,21,0.344
20900501,1610612751,1610612749,76.0,98.0,0.379,0.456,0,2010-01-05,34,3,31,0.088,32,14,18,0.4379999999999999
20900502,1610612742,1610612765,98.0,93.0,0.442,0.475,1,2010-01-05,35,24,11,0.6859999999999999,33,11,22,0.3329999999999999
20900503,1610612743,1610612744,123.0,122.0,0.511,0.5529999999999999,1,2010-01-05,35,22,13,0.629,33,9,24,0.273
20900504,1610612757,1610612763,105.0,109.0,0.526,0.519,0,2010-01-05,37,22,15,0.595,33,17,16,0.515
20900505,1610612758,1610612756,109.0,113.0,0.447,0.451,0,2010-01-05,34,14,20,0.412,35,22,13,0.629
20900506,1610612747,1610612745,88.0,79.0,0.456,0.4029999999999999,1,2010-01-05,34,28,6,0.8240000000000001,35,20,15,0.5710000000000001
20900494,1610612748,1610612737,92.0,75.0,0.4679999999999999,0.352,1,2010-01-04,32,17,15,0.531,33,21,12,0.636
20900495,1610612741,1610612760,85.0,98.0,0.354,0.488,0,2010-01-04,32,14,18,0.4379999999999999,34,19,15,0.5589999999999999
20900496,1610612762,1610612740,87.0,91.0,0.379,0.436,0,2010-01-04,34,18,16,0.529,32,16,16,0.5
20900497,1610612746,1610612757,105.0,95.0,0.5770000000000001,0.506,1,2010-01-04,33,15,18,0.455,36,22,14,0.611
20900489,1610612739,1610612766,88.0,91.0,0.479,0.493,0,2010-01-03,36,27,9,0.75,32,14,18,0.4379999999999999
20900490,1610612752,1610612754,132.0,89.0,0.521,0.407,1,2010-01-03,34,14,20,0.412,33,10,23,0.303
20900491,1610612761,1610612759,91.0,86.0,0.429,0.413,1,2010-01-03,35,17,18,0.486,32,20,12,0.625
20900492,1610612743,1610612755,105.0,108.0,0.532,0.5,0,2010-01-03,34,21,13,0.618,33,10,23,0.303
20900493,1610612747,1610612742,131.0,96.0,0.634,0.3779999999999999,1,2010-01-03,33,27,6,0.818,34,23,11,0.6759999999999999
20900477,1610612751,1610612739,86.0,94.0,0.387,0.395,0,2010-01-02,33,3,30,0.091,35,27,8,0.7709999999999999
20900478,1610612748,1610612766,97.0,107.0,0.462,0.522,0,2010-01-02,31,16,15,0.516,31,13,18,0.419
20900479,1610612754,1610612750,122.0,111.0,0.49,0.449,1,2010-01-02,32,10,22,0.313,35,7,28,0.2
20900480,1610612764,1610612759,86.0,97.0,0.4379999999999999,0.507,0,2010-01-02,31,10,21,0.3229999999999999,31,20,11,0.645
20900481,1610612738,1610612761,103.0,96.0,0.514,0.493,1,2010-01-02,32,24,8,0.75,34,16,18,0.471
20900482,1610612741,1610612753,101.0,93.0,0.425,0.359,1,2010-01-02,31,14,17,0.452,33,24,9,0.727
20900483,1610612740,1610612745,99.0,95.0,0.447,0.486,1,2010-01-02,31,15,16,0.484,34,20,14,0.588
20900484,1610612749,1610612760,103.0,97.0,0.396,0.429,1,2010-01-02,31,13,18,0.419,33,18,15,0.545
20900485,1610612756,1610612763,103.0,128.0,0.455,0.531,0,2010-01-02,34,21,13,0.618,32,16,16,0.5
20900486,1610612762,1610612743,95.0,105.0,0.507,0.512,0,2010-01-02,33,18,15,0.545,33,21,12,0.636
20900487,1610612757,1610612744,105.0,89.0,0.486,0.43,1,2010-01-02,35,22,13,0.629,32,9,23,0.281
20900488,1610612758,1610612742,91.0,99.0,0.402,0.486,0,2010-01-02,33,14,19,0.424,33,23,10,0.6970000000000001
20900474,1610612737,1610612752,108.0,112.0,0.46,0.511,0,2010-01-01,32,21,11,0.6559999999999999,33,13,20,0.3939999999999999
20900475,1610612750,1610612753,94.0,106.0,0.43,0.45,0,2010-01-01,34,7,27,0.206,32,24,8,0.75
20900476,1610612747,1610612758,109.0,108.0,0.4529999999999999,0.544,1,2010-01-01,32,26,6,0.813,32,14,18,0.4379999999999999
20900469,1610612765,1610612741,87.0,98.0,0.386,0.478,0,2009-12-31,32,11,21,0.344,30,13,17,0.433
20900470,1610612745,1610612742,97.0,94.0,0.444,0.451,1,2009-12-31,33,20,13,0.606,32,22,10,0.688
20900471,1610612759,1610612748,108.0,78.0,0.532,0.44,1,2009-12-31,30,19,11,0.633,30,16,14,0.5329999999999999
20900472,1610612760,1610612762,87.0,86.0,0.473,0.411,1,2009-12-31,32,18,14,0.563,32,18,14,0.563
20900473,1610612746,1610612755,104.0,88.0,0.547,0.376,1,2009-12-31,32,14,18,0.4379999999999999,32,9,23,0.281
20900459,1610612739,1610612737,106.0,101.0,0.474,0.482,1,2009-12-30,34,26,8,0.765,31,21,10,0.677
20900460,1610612754,1610612763,110.0,121.0,0.483,0.506,0,2009-12-30,31,9,22,0.29,31,15,16,0.484
20900461,1610612753,1610612749,117.0,92.0,0.5579999999999999,0.392,1,2009-12-30,31,23,8,0.742,30,12,18,0.4
20900462,1610612761,1610612766,107.0,103.0,0.44,0.542,1,2009-12-30,33,16,17,0.485,30,12,18,0.4
20900463,1610612751,1610612752,104.0,95.0,0.512,0.446,1,2009-12-30,32,3,29,0.094,32,12,20,0.375
20900464,1610612750,1610612762,103.0,107.0,0.526,0.457,0,2009-12-30,33,7,26,0.212,31,18,13,0.581
20900465,1610612740,1610612748,95.0,91.0,0.436,0.41,1,2009-12-30,30,14,16,0.467,29,16,13,0.552
20900466,1610612756,1610612738,116.0,98.0,0.506,0.422,1,2009-12-30,33,21,12,0.636,31,23,8,0.742
20900467,1610612757,1610612746,103.0,99.0,0.506,0.493,1,2009-12-30,34,21,13,0.618,31,13,18,0.419
20900468,1610612758,1610612755,106.0,116.0,0.472,0.525,0,2009-12-30,31,14,17,0.452,31,9,22,0.29
20900452,1610612737,1610612739,84.0,95.0,0.4429999999999999,0.494,0,2009-12-29,30,21,9,0.7,33,25,8,0.758
20900453,1610612764,1610612760,98.0,110.0,0.402,0.544,0,2009-12-29,30,10,20,0.3329999999999999,31,17,14,0.5479999999999999
20900454,1610612765,1610612752,87.0,104.0,0.418,0.513,0,2009-12-29,31,11,20,0.355,31,12,19,0.387
20900455,1610612741,1610612754,104.0,95.0,0.528,0.411,1,2009-12-29,29,12,17,0.414,30,9,21,0.3
20900456,1610612745,1610612740,108.0,100.0,0.487,0.5,1,2009-12-29,32,19,13,0.594,29,13,16,0.4479999999999999
20900457,1610612759,1610612750,117.0,99.0,0.477,0.396,1,2009-12-29,29,18,11,0.621,32,7,25,0.2189999999999999
20900458,1610612747,1610612744,124.0,118.0,0.483,0.5539999999999999,1,2009-12-29,31,25,6,0.8059999999999999,31,9,22,0.29
20900445,1610612766,1610612749,94.0,84.0,0.42,0.385,1,2009-12-28,29,12,17,0.414,29,12,17,0.414
20900446,1610612751,1610612760,89.0,105.0,0.4529999999999999,0.474,0,2009-12-28,31,2,29,0.065,30,16,14,0.5329999999999999
20900447,1610612763,1610612764,116.0,111.0,0.4679999999999999,0.436,1,2009-12-28,30,14,16,0.467,29,10,19,0.345
20900448,1610612756,1610612747,118.0,103.0,0.489,0.435,1,2009-12-28,32,20,12,0.625,30,24,6,0.8
20900449,1610612757,1610612755,93.0,104.0,0.422,0.5770000000000001,0,2009-12-28,33,20,13,0.606,30,8,22,0.267
20900450,1610612758,1610612743,106.0,101.0,0.4629999999999999,0.415,1,2009-12-28,30,14,16,0.467,32,20,12,0.625
20900451,1610612744,1610612738,103.0,99.0,0.46,0.5,1,2009-12-28,30,9,21,0.3,30,23,7,0.767
20900439,1610612761,1610612765,102.0,95.0,0.524,0.4,1,2009-12-27,32,15,17,0.469,30,11,19,0.3670000000000001
20900440,1610612739,1610612745,108.0,83.0,0.473,0.3289999999999999,1,2009-12-27,32,24,8,0.75,31,18,13,0.581
20900441,1610612748,1610612754,114.0,80.0,0.495,0.307,1,2009-12-27,28,16,12,0.5710000000000001,29,9,20,0.31
20900442,1610612752,1610612759,88.0,95.0,0.442,0.506,0,2009-12-27,30,11,19,0.3670000000000001,28,17,11,0.607
20900443,1610612743,1610612742,96.0,104.0,0.382,0.5,0,2009-12-27,31,20,11,0.645,31,22,9,0.71
20900444,1610612746,1610612738,92.0,90.0,0.507,0.47,1,2009-12-27,30,13,17,0.433,29,23,6,0.7929999999999999
20900429,1610612742,1610612763,106.0,101.0,0.524,0.4429999999999999,1,2009-12-26,30,21,9,0.7,29,13,16,0.4479999999999999
20900430,1610612754,1610612737,98.0,110.0,0.444,0.506,0,2009-12-26,28,9,19,0.321,29,21,8,0.7240000000000001
20900431,1610612751,1610612745,93.0,98.0,0.469,0.415,0,2009-12-26,30,2,28,0.067,30,18,12,0.6
20900432,1610612741,1610612740,96.0,85.0,0.462,0.418,1,2009-12-26,28,11,17,0.3929999999999999,28,13,15,0.4639999999999999
20900433,1610612750,1610612764,101.0,89.0,0.374,0.395,1,2009-12-26,31,7,24,0.226,28,10,18,0.357
20900434,1610612760,1610612766,98.0,91.0,0.47,0.4320000000000001,1,2009-12-26,29,15,14,0.517,28,11,17,0.3929999999999999
20900435,1610612749,1610612759,97.0,112.0,0.4270000000000001,0.597,0,2009-12-26,28,12,16,0.429,27,16,11,0.593
20900436,1610612762,1610612755,97.0,76.0,0.522,0.3379999999999999,1,2009-12-26,30,17,13,0.5670000000000001,29,7,22,0.241
20900437,1610612758,1610612747,103.0,112.0,0.4,0.439,0,2009-12-26,29,13,16,0.4479999999999999,29,24,5,0.828
20900438,1610612744,1610612756,132.0,127.0,0.5710000000000001,0.534,1,2009-12-26,29,8,21,0.276,31,19,12,0.613
20900424,1610612752,1610612748,87.0,93.0,0.41,0.4270000000000001,0,2009-12-25,29,11,18,0.379,27,15,12,0.556
20900425,1610612753,1610612738,77.0,86.0,0.3329999999999999,0.425,0,2009-12-25,30,22,8,0.733,28,23,5,0.821
20900426,1610612747,1610612739,87.0,102.0,0.365,0.535,0,2009-12-25,28,23,5,0.821,31,23,8,0.742
20900427,1610612756,1610612746,124.0,93.0,0.537,0.402,1,2009-12-25,30,19,11,0.633,29,12,17,0.414
20900428,1610612757,1610612743,107.0,96.0,0.526,0.451,1,2009-12-25,32,20,12,0.625,30,20,10,0.667
20900414,1610612753,1610612745,102.0,87.0,0.4589999999999999,0.39,1,2009-12-23,29,22,7,0.759,29,17,12,0.586
20900415,1610612765,1610612761,64.0,94.0,0.2789999999999999,0.5379999999999999,0,2009-12-23,29,11,18,0.379,31,14,17,0.452
20900416,1610612748,1610612762,80.0,70.0,0.36,0.375,1,2009-12-23,26,14,12,0.5379999999999999,29,16,13,0.552
20900417,1610612751,1610612750,99.0,103.0,0.442,0.478,0,2009-12-23,29,2,27,0.069,30,6,24,0.2
20900418,1610612749,1610612764,97.0,109.0,0.356,0.522,0,2009-12-23,27,12,15,0.444,27,10,17,0.37
20900419,1610612740,1610612744,108.0,102.0,0.417,0.476,1,2009-12-23,27,13,14,0.481,28,7,21,0.25
20900420,1610612759,1610612757,94.0,98.0,0.514,0.455,0,2009-12-23,26,15,11,0.5770000000000001,31,19,12,0.613
20900421,1610612743,1610612737,124.0,104.0,0.544,0.481,1,2009-12-23,29,20,9,0.69,28,20,8,0.7140000000000001
20900422,1610612756,1610612760,113.0,117.0,0.5,0.478,0,2009-12-23,29,18,11,0.621,28,14,14,0.5
20900423,1610612758,1610612739,104.0,117.0,0.446,0.511,0,2009-12-23,28,13,15,0.4639999999999999,30,22,8,0.733
20900405,1610612766,1610612765,88.0,76.0,0.486,0.3779999999999999,1,2009-12-22,27,11,16,0.407,28,11,17,0.3929999999999999
20900406,1610612764,1610612755,105.0,98.0,0.47,0.507,1,2009-12-22,26,9,17,0.346,28,7,21,0.25
20900407,1610612738,1610612754,103.0,94.0,0.38,0.446,1,2009-12-22,27,22,5,0.815,27,9,18,0.3329999999999999
20900408,1610612752,1610612741,88.0,81.0,0.4,0.405,1,2009-12-22,28,11,17,0.3929999999999999,27,10,17,0.37
20900409,1610612763,1610612744,121.0,108.0,0.5429999999999999,0.5,1,2009-12-22,28,13,15,0.4639999999999999,27,7,20,0.259
20900410,1610612750,1610612737,87.0,112.0,0.411,0.489,0,2009-12-22,29,5,24,0.172,27,20,7,0.741
20900411,1610612742,1610612757,81.0,85.0,0.3879999999999999,0.405,0,2009-12-22,29,20,9,0.69,30,18,12,0.6
20900412,1610612745,1610612746,108.0,99.0,0.481,0.506,1,2009-12-22,28,17,11,0.607,28,12,16,0.429
20900413,1610612747,1610612760,111.0,108.0,0.444,0.451,1,2009-12-22,27,23,4,0.852,27,13,14,0.481
20900400,1610612754,1610612749,81.0,84.0,0.356,0.422,0,2009-12-21,26,9,17,0.346,26,12,14,0.462
20900401,1610612753,1610612762,104.0,99.0,0.485,0.4039999999999999,1,2009-12-21,28,21,7,0.75,28,16,12,0.5710000000000001
20900402,1610612741,1610612758,98.0,102.0,0.475,0.439,0,2009-12-21,26,10,16,0.385,27,13,14,0.481
20900403,1610612759,1610612746,103.0,87.0,0.506,0.439,1,2009-12-21,25,15,10,0.6,27,12,15,0.444
20900404,1610612756,1610612739,91.0,109.0,0.474,0.526,0,2009-12-21,28,18,10,0.643,29,21,8,0.7240000000000001
20900393,1610612761,1610612740,98.0,92.0,0.471,0.389,1,2009-12-20,30,13,17,0.433,26,12,14,0.462
20900394,1610612763,1610612743,102.0,96.0,0.478,0.405,1,2009-12-20,27,12,15,0.444,28,19,9,0.679
20900395,1610612738,1610612750,122.0,104.0,0.519,0.422,1,2009-12-20,26,21,5,0.8079999999999999,28,5,23,0.179
20900396,1610612765,1610612747,81.0,93.0,0.418,0.41,0,2009-12-20,27,11,16,0.407,26,22,4,0.846
20900397,1610612748,1610612757,95.0,102.0,0.494,0.514,0,2009-12-20,25,13,12,0.52,29,17,12,0.586
20900398,1610612742,1610612739,102.0,95.0,0.475,0.455,1,2009-12-20,28,20,8,0.7140000000000001,28,20,8,0.7140000000000001
20900399,1610612752,1610612766,98.0,94.0,0.451,0.452,1,2009-12-20,27,10,17,0.37,26,10,16,0.385
20900384,1610612766,1610612762,102.0,110.0,0.493,0.532,0,2009-12-19,25,10,15,0.4,27,16,11,0.593
20900385,1610612753,1610612757,92.0,83.0,0.421,0.3720000000000001,1,2009-12-19,27,20,7,0.741,28,16,12,0.5710000000000001
20900386,1610612755,1610612746,107.0,112.0,0.457,0.529,0,2009-12-19,27,7,20,0.259,26,12,14,0.462
20900387,1610612741,1610612737,101.0,98.0,0.481,0.414,1,2009-12-19,25,10,15,0.4,26,19,7,0.731
20900388,1610612751,1610612747,84.0,103.0,0.3779999999999999,0.494,0,2009-12-19,28,2,26,0.071,25,21,4,0.84
20900389,1610612745,1610612760,95.0,90.0,0.422,0.449,1,2009-12-19,27,16,11,0.593,26,13,13,0.5
20900390,1610612749,1610612758,95.0,96.0,0.4270000000000001,0.455,0,2009-12-19,25,11,14,0.44,26,12,14,0.462
20900391,1610612759,1610612754,100.0,99.0,0.424,0.481,1,2009-12-19,24,14,10,0.583,25,9,16,0.36
20900392,1610612756,1610612764,121.0,95.0,0.516,0.364,1,2009-12-19,27,18,9,0.667,25,8,17,0.32
20900373,1610612761,1610612751,118.0,95.0,0.59,0.461,1,2009-12-18,29,12,17,0.414,27,2,25,0.074
20900374,1610612737,1610612762,96.0,83.0,0.446,0.429,1,2009-12-18,25,19,6,0.76,26,15,11,0.5770000000000001
20900375,1610612738,1610612755,97.0,98.0,0.45,0.402,0,2009-12-18,25,20,5,0.8,26,7,19,0.2689999999999999
20900376,1610612739,1610612749,85.0,82.0,0.424,0.364,1,2009-12-18,27,20,7,0.741,24,11,13,0.4579999999999999
20900377,1610612763,1610612754,107.0,94.0,0.472,0.407,1,2009-12-18,26,11,15,0.423,24,9,15,0.375
20900378,1610612750,1610612758,112.0,96.0,0.547,0.429,1,2009-12-18,27,5,22,0.185,25,11,14,0.44
20900379,1610612740,1610612743,98.0,92.0,0.482,0.4679999999999999,1,2009-12-18,25,12,13,0.48,27,19,8,0.7040000000000001
20900380,1610612752,1610612746,95.0,91.0,0.469,0.4579999999999999,1,2009-12-18,26,9,17,0.346,25,11,14,0.44
20900381,1610612760,1610612765,109.0,98.0,0.5,0.4639999999999999,1,2009-12-18,25,13,12,0.52,26,11,15,0.423
20900382,1610612742,1610612745,108.0,116.0,0.421,0.4629999999999999,0,2009-12-18,27,19,8,0.7040000000000001,26,15,11,0.5770000000000001
20900383,1610612744,1610612764,109.0,118.0,0.47,0.505,0,2009-12-18,26,7,19,0.2689999999999999,24,8,16,0.3329999999999999
20900370,1610612741,1610612752,98.0,89.0,0.449,0.36,1,2009-12-17,24,9,15,0.375,25,8,17,0.32
20900371,1610612748,1610612753,104.0,86.0,0.519,0.436,1,2009-12-17,24,13,11,0.542,26,19,7,0.731
20900372,1610612757,1610612756,105.0,102.0,0.449,0.481,1,2009-12-17,27,16,11,0.593,26,17,9,0.654
20900358,1610612737,1610612763,110.0,97.0,0.484,0.5,1,2009-12-16,24,18,6,0.75,25,10,15,0.4
20900359,1610612754,1610612766,101.0,98.0,0.479,0.4270000000000001,1,2009-12-16,23,9,14,0.391,24,10,14,0.417
20900360,1610612753,1610612761,118.0,99.0,0.573,0.4379999999999999,1,2009-12-16,25,19,6,0.76,28,11,17,0.3929999999999999
20900361,1610612755,1610612739,101.0,108.0,0.444,0.466,0,2009-12-16,25,6,19,0.24,26,19,7,0.731
20900362,1610612751,1610612762,92.0,108.0,0.4320000000000001,0.563,0,2009-12-16,26,2,24,0.077,25,15,10,0.6
20900363,1610612749,1610612747,106.0,107.0,0.424,0.474,0,2009-12-16,23,11,12,0.478,24,20,4,0.833
20900364,1610612750,1610612746,95.0,120.0,0.385,0.522,0,2009-12-16,26,4,22,0.154,24,11,13,0.4579999999999999
20900365,1610612740,1610612765,95.0,87.0,0.493,0.455,1,2009-12-16,24,11,13,0.4579999999999999,25,11,14,0.44
20900366,1610612760,1610612742,86.0,100.0,0.42,0.493,0,2009-12-16,24,12,12,0.5,26,19,7,0.731
20900367,1610612743,1610612745,111.0,101.0,0.47,0.444,1,2009-12-16,26,19,7,0.731,25,14,11,0.56
20900368,1610612758,1610612764,112.0,109.0,0.465,0.4320000000000001,1,2009-12-16,24,11,13,0.4579999999999999,23,7,16,0.304
20900369,1610612744,1610612759,91.0,103.0,0.425,0.481,0,2009-12-16,25,7,18,0.28,23,13,10,0.565
20900351,1610612766,1610612752,94.0,87.0,0.4679999999999999,0.4529999999999999,1,2009-12-15,23,10,13,0.435,24,8,16,0.3329999999999999
20900352,1610612739,1610612751,99.0,89.0,0.5820000000000001,0.39,1,2009-12-15,25,18,7,0.72,25,2,23,0.08
20900353,1610612748,1610612761,115.0,95.0,0.517,0.452,1,2009-12-15,23,12,11,0.522,27,11,16,0.407
20900354,1610612741,1610612747,87.0,96.0,0.385,0.456,0,2009-12-15,23,8,15,0.348,23,19,4,0.826
20900355,1610612745,1610612765,107.0,96.0,0.547,0.4379999999999999,1,2009-12-15,24,14,10,0.583,24,11,13,0.4579999999999999
20900356,1610612756,1610612759,116.0,104.0,0.516,0.465,1,2009-12-15,25,17,8,0.68,22,12,10,0.545
20900357,1610612757,1610612758,95.0,88.0,0.474,0.447,1,2009-12-15,26,15,11,0.5770000000000001,23,10,13,0.435
20900344,1610612753,1610612754,106.0,98.0,0.419,0.477,1,2009-12-14,24,18,6,0.75,22,8,14,0.364
20900345,1610612755,1610612744,117.0,101.0,0.495,0.441,1,2009-12-14,24,6,18,0.25,24,7,17,0.292
20900346,1610612763,1610612738,105.0,110.0,0.512,0.525,0,2009-12-14,24,10,14,0.417,24,20,4,0.833
20900347,1610612742,1610612740,94.0,90.0,0.551,0.4379999999999999,1,2009-12-14,25,18,7,0.72,23,10,13,0.435
20900348,1610612743,1610612760,102.0,93.0,0.4,0.392,1,2009-12-14,25,18,7,0.72,23,12,11,0.522
20900349,1610612762,1610612750,108.0,110.0,0.506,0.482,0,2009-12-14,24,14,10,0.583,25,4,21,0.16
20900350,1610612746,1610612764,97.0,95.0,0.4270000000000001,0.3879999999999999,1,2009-12-14,23,10,13,0.435,22,7,15,0.318
20900339,1610612761,1610612745,101.0,88.0,0.5,0.368,1,2009-12-13,26,11,15,0.423,23,13,10,0.565
20900340,1610612737,1610612751,130.0,107.0,0.5329999999999999,0.506,1,2009-12-13,23,17,6,0.7390000000000001,24,2,22,0.083
20900341,1610612748,1610612763,90.0,118.0,0.4379999999999999,0.528,0,2009-12-13,22,11,11,0.5,23,10,13,0.435
20900342,1610612760,1610612739,89.0,102.0,0.435,0.476,0,2009-12-13,22,12,10,0.545,24,17,7,0.708
20900343,1610612746,1610612759,90.0,115.0,0.442,0.573,0,2009-12-13,22,9,13,0.409,21,12,9,0.5710000000000001
20900331,1610612764,1610612754,113.0,114.0,0.5489999999999999,0.422,0,2009-12-12,21,7,14,0.3329999999999999,21,8,13,0.381
20900332,1610612765,1610612744,104.0,95.0,0.542,0.472,1,2009-12-12,23,11,12,0.478,23,7,16,0.304
20900333,1610612741,1610612738,80.0,106.0,0.326,0.4320000000000001,0,2009-12-12,22,8,14,0.364,23,19,4,0.826
20900334,1610612742,1610612766,98.0,97.0,0.3979999999999999,0.42,1,2009-12-12,24,17,7,0.708,22,9,13,0.409
20900335,1610612749,1610612757,108.0,101.0,0.495,0.402,1,2009-12-12,22,11,11,0.5,25,14,11,0.56
20900336,1610612743,1610612756,105.0,99.0,0.41,0.545,1,2009-12-12,24,17,7,0.708,24,16,8,0.667
20900337,1610612762,1610612747,102.0,94.0,0.519,0.4629999999999999,1,2009-12-12,23,14,9,0.609,22,18,4,0.818
20900338,1610612758,1610612750,120.0,100.0,0.526,0.43,1,2009-12-12,22,10,12,0.455,24,3,21,0.125
20900320,1610612754,1610612751,107.0,91.0,0.467,0.363,1,2009-12-11,20,7,13,0.35,23,2,21,0.087
20900321,1610612755,1610612745,91.0,96.0,0.415,0.446,0,2009-12-11,23,5,18,0.217,22,13,9,0.591
20900322,1610612761,1610612737,89.0,111.0,0.486,0.518,0,2009-12-11,25,10,15,0.4,22,16,6,0.727
20900323,1610612748,1610612742,93.0,106.0,0.402,0.488,0,2009-12-11,21,11,10,0.524,23,16,7,0.696
20900324,1610612741,1610612744,96.0,91.0,0.417,0.381,1,2009-12-11,21,8,13,0.381,22,7,15,0.318
20900325,1610612739,1610612757,104.0,99.0,0.544,0.4629999999999999,1,2009-12-11,23,16,7,0.696,24,14,10,0.583
20900326,1610612763,1610612760,94.0,102.0,0.413,0.4639999999999999,0,2009-12-11,22,9,13,0.409,21,12,9,0.5710000000000001
20900327,1610612740,1610612752,96.0,113.0,0.4,0.551,0,2009-12-11,22,10,12,0.455,23,8,15,0.348
20900328,1610612759,1610612766,104.0,85.0,0.591,0.4270000000000001,1,2009-12-11,20,11,9,0.55,21,9,12,0.429
20900329,1610612747,1610612750,104.0,92.0,0.4529999999999999,0.4320000000000001,1,2009-12-11,21,18,3,0.857,23,3,20,0.13
20900330,1610612756,1610612753,106.0,103.0,0.477,0.421,1,2009-12-11,23,16,7,0.696,23,17,6,0.7390000000000001
20900317,1610612765,1610612743,101.0,99.0,0.434,0.447,1,2009-12-10,22,10,12,0.455,23,16,7,0.696
20900318,1610612764,1610612738,102.0,104.0,0.482,0.493,0,2009-12-10,20,7,13,0.35,22,18,4,0.818
20900319,1610612762,1610612753,120.0,111.0,0.5,0.461,1,2009-12-10,22,13,9,0.591,22,17,5,0.773
20900308,1610612737,1610612741,118.0,83.0,0.5,0.364,1,2009-12-09,21,15,6,0.7140000000000001,20,7,13,0.35
20900309,1610612754,1610612757,91.0,102.0,0.413,0.494,0,2009-12-09,19,6,13,0.316,23,14,9,0.609
20900310,1610612755,1610612765,86.0,90.0,0.44,0.4589999999999999,0,2009-12-09,22,5,17,0.2269999999999999,21,9,12,0.429
20900311,1610612751,1610612744,89.0,105.0,0.43,0.494,0,2009-12-09,22,2,20,0.091,21,7,14,0.3329999999999999
20900312,1610612749,1610612761,117.0,95.0,0.525,0.485,1,2009-12-09,21,10,11,0.476,24,10,14,0.417
20900313,1610612750,1610612740,96.0,97.0,0.526,0.47,0,2009-12-09,22,3,19,0.136,21,10,11,0.476
20900314,1610612745,1610612739,95.0,85.0,0.405,0.4,1,2009-12-09,21,12,9,0.5710000000000001,22,15,7,0.682
20900315,1610612759,1610612758,118.0,106.0,0.5529999999999999,0.523,1,2009-12-09,19,10,9,0.526,21,9,12,0.429
20900316,1610612747,1610612762,101.0,77.0,0.462,0.337,1,2009-12-09,20,17,3,0.85,21,12,9,0.5710000000000001
20900300,1610612766,1610612743,107.0,95.0,0.461,0.4529999999999999,1,2009-12-08,20,9,11,0.45,22,16,6,0.727
20900301,1610612761,1610612750,94.0,88.0,0.325,0.371,1,2009-12-08,23,10,13,0.435,21,3,18,0.143
20900302,1610612738,1610612749,98.0,89.0,0.522,0.43,1,2009-12-08,21,17,4,0.81,20,9,11,0.45
20900303,1610612741,1610612751,101.0,103.0,0.466,0.452,0,2009-12-08,19,7,12,0.368,21,2,19,0.095
20900304,1610612763,1610612739,111.0,109.0,0.44,0.444,1,2009-12-08,21,9,12,0.429,21,15,6,0.7140000000000001
20900305,1610612740,1610612758,96.0,94.0,0.5,0.506,1,2009-12-08,20,9,11,0.45,20,9,11,0.45
20900306,1610612742,1610612756,102.0,101.0,0.447,0.4429999999999999,1,2009-12-08,22,15,7,0.682,22,15,7,0.682
20900307,1610612746,1610612753,86.0,97.0,0.4,0.451,0,2009-12-08,21,9,12,0.429,21,17,4,0.81
20900296,1610612755,1610612743,83.0,93.0,0.402,0.392,0,2009-12-07,21,5,16,0.238,21,16,5,0.762
20900297,1610612752,1610612757,93.0,84.0,0.41,0.47,1,2009-12-07,22,7,15,0.318,22,13,9,0.591
20900298,1610612760,1610612744,104.0,88.0,0.422,0.434,1,2009-12-07,20,11,9,0.55,20,6,14,0.3
20900299,1610612762,1610612759,104.0,101.0,0.532,0.486,1,2009-12-07,20,12,8,0.6,18,9,9,0.5
20900291,1610612752,1610612751,106.0,97.0,0.4679999999999999,0.494,1,2009-12-06,21,6,15,0.286,20,1,19,0.05
20900292,1610612749,1610612739,86.0,101.0,0.376,0.473,0,2009-12-06,19,9,10,0.474,20,15,5,0.75
20900293,1610612765,1610612764,98.0,94.0,0.4270000000000001,0.436,1,2009-12-06,20,8,12,0.4,19,7,12,0.368
20900294,1610612758,1610612748,102.0,115.0,0.4679999999999999,0.586,0,2009-12-06,19,9,10,0.474,20,11,9,0.55
20900295,1610612747,1610612756,108.0,88.0,0.469,0.446,1,2009-12-06,19,16,3,0.8420000000000001,21,15,6,0.7140000000000001
20900282,1610612766,1610612755,106.0,105.0,0.487,0.429,1,2009-12-05,19,8,11,0.421,20,5,15,0.25
20900283,1610612741,1610612761,78.0,110.0,0.39,0.482,0,2009-12-05,18,7,11,0.389,22,9,13,0.409
20900284,1610612750,1610612762,108.0,101.0,0.5710000000000001,0.5,1,2009-12-05,20,3,17,0.15,19,11,8,0.579
20900285,1610612759,1610612743,99.0,106.0,0.471,0.481,0,2009-12-05,17,9,8,0.529,20,15,5,0.75
20900286,1610612742,1610612737,75.0,80.0,0.373,0.36,0,2009-12-05,21,14,7,0.667,20,14,6,0.7
20900287,1610612756,1610612758,115.0,107.0,0.4320000000000001,0.433,1,2009-12-05,20,15,5,0.75,18,9,9,0.5
20900288,1610612757,1610612745,90.0,89.0,0.478,0.442,1,2009-12-05,21,13,8,0.619,20,11,9,0.55
20900289,1610612744,1610612753,118.0,126.0,0.472,0.527,0,2009-12-05,19,6,13,0.316,20,16,4,0.8
20900290,1610612746,1610612754,88.0,72.0,0.349,0.375,1,2009-12-05,20,9,11,0.45,18,6,12,0.3329999999999999
20900272,1610612764,1610612761,107.0,109.0,0.368,0.451,0,2009-12-04,18,7,11,0.389,21,8,13,0.381
20900273,1610612737,1610612752,107.0,114.0,0.456,0.5770000000000001,0,2009-12-04,19,13,6,0.684,20,5,15,0.25
20900274,1610612739,1610612741,101.0,87.0,0.513,0.423,1,2009-12-04,19,14,5,0.737,17,7,10,0.412
20900275,1610612765,1610612749,105.0,96.0,0.574,0.434,1,2009-12-04,19,7,12,0.368,18,9,9,0.5
20900276,1610612763,1610612742,98.0,82.0,0.4589999999999999,0.352,1,2009-12-04,20,8,12,0.4,20,14,6,0.7
20900277,1610612751,1610612766,97.0,91.0,0.391,0.452,1,2009-12-04,19,1,18,0.053,18,7,11,0.389
20900278,1610612740,1610612750,98.0,89.0,0.5,0.424,1,2009-12-04,19,8,11,0.421,19,2,17,0.105
20900279,1610612760,1610612738,87.0,105.0,0.471,0.565,0,2009-12-04,19,10,9,0.526,20,16,4,0.8
20900280,1610612762,1610612754,96.0,87.0,0.435,0.397,1,2009-12-04,18,11,7,0.611,17,6,11,0.353
20900281,1610612747,1610612748,108.0,107.0,0.43,0.487,1,2009-12-04,18,15,3,0.833,19,10,9,0.526
20900269,1610612759,1610612738,83.0,90.0,0.42,0.462,0,2009-12-03,16,9,7,0.563,19,15,4,0.789
20900270,1610612743,1610612748,114.0,96.0,0.474,0.4270000000000001,1,2009-12-03,19,14,5,0.737,18,10,8,0.556
20900271,1610612744,1610612745,109.0,111.0,0.451,0.488,0,2009-12-03,18,6,12,0.3329999999999999,19,11,8,0.579
20900259,1610612737,1610612761,146.0,115.0,0.591,0.512,1,2009-12-02,18,13,5,0.722,20,7,13,0.35
20900260,1610612739,1610612756,107.0,90.0,0.484,0.4,1,2009-12-02,18,13,5,0.722,19,14,5,0.737
20900261,1610612753,1610612752,118.0,104.0,0.551,0.4639999999999999,1,2009-12-02,19,15,4,0.789,19,4,15,0.211
20900262,1610612764,1610612749,104.0,102.0,0.5429999999999999,0.442,1,2009-12-02,17,7,10,0.412,17,9,8,0.529
20900263,1610612751,1610612742,101.0,117.0,0.442,0.5870000000000001,0,2009-12-02,18,0,18,0.0,19,14,5,0.737
20900264,1610612741,1610612765,92.0,85.0,0.478,0.385,1,2009-12-02,16,7,9,0.4379999999999999,18,6,12,0.3329999999999999
20900265,1610612750,1610612763,95.0,97.0,0.5,0.4529999999999999,0,2009-12-02,18,2,16,0.111,19,7,12,0.368
20900266,1610612760,1610612755,117.0,106.0,0.506,0.5,1,2009-12-02,18,10,8,0.556,19,5,14,0.263
20900267,1610612758,1610612754,110.0,105.0,0.506,0.435,1,2009-12-02,17,9,8,0.529,16,6,10,0.375
20900268,1610612746,1610612745,85.0,102.0,0.4529999999999999,0.507,0,2009-12-02,19,8,11,0.421,18,10,8,0.556
20900253,1610612766,1610612738,90.0,108.0,0.405,0.545,0,2009-12-01,17,7,10,0.412,18,14,4,0.778
20900254,1610612761,1610612764,102.0,106.0,0.429,0.476,0,2009-12-01,19,7,12,0.368,16,6,10,0.375
20900255,1610612752,1610612756,126.0,99.0,0.495,0.455,1,2009-12-01,18,4,14,0.222,18,14,4,0.778
20900256,1610612743,1610612744,135.0,107.0,0.547,0.436,1,2009-12-01,18,13,5,0.722,17,6,11,0.353
20900257,1610612757,1610612748,100.0,107.0,0.391,0.5329999999999999,0,2009-12-01,20,12,8,0.6,17,10,7,0.588
20900258,1610612747,1610612740,110.0,99.0,0.521,0.477,1,2009-12-01,17,14,3,0.8240000000000001,18,7,11,0.389
20900249,1610612749,1610612741,99.0,97.0,0.424,0.425,1,2009-11-30,16,9,7,0.563,15,6,9,0.4
20900250,1610612742,1610612755,104.0,102.0,0.46,0.407,1,2009-11-30,18,13,5,0.722,18,5,13,0.278
20900251,1610612762,1610612763,120.0,93.0,0.584,0.474,1,2009-11-30,17,10,7,0.588,18,6,12,0.3329999999999999
20900252,1610612744,1610612754,126.0,107.0,0.563,0.442,1,2009-11-30,16,6,10,0.375,15,6,9,0.4
20900239,1610612765,1610612737,94.0,88.0,0.44,0.5,1,2009-11-29,17,6,11,0.353,17,12,5,0.706
20900241,1610612761,1610612756,94.0,113.0,0.391,0.512,0,2009-11-29,18,7,11,0.389,17,14,3,0.8240000000000001
20900240,1610612746,1610612763,98.0,88.0,0.5,0.487,1,2009-11-29,18,8,10,0.444,17,6,11,0.353
20900242,1610612748,1610612738,85.0,92.0,0.418,0.522,0,2009-11-29,16,9,7,0.563,17,13,4,0.765
20900243,1610612752,1610612753,102.0,114.0,0.506,0.506,0,2009-11-29,17,3,14,0.176,18,14,4,0.778
20900244,1610612760,1610612745,91.0,100.0,0.48,0.4039999999999999,0,2009-11-29,17,9,8,0.529,17,9,8,0.529
20900245,1610612759,1610612755,97.0,89.0,0.487,0.3929999999999999,1,2009-11-29,15,9,6,0.6,17,5,12,0.294
20900246,1610612743,1610612750,100.0,106.0,0.417,0.512,0,2009-11-29,17,12,5,0.706,17,2,15,0.118
20900247,1610612758,1610612740,112.0,96.0,0.53,0.4629999999999999,1,2009-11-29,16,8,8,0.5,17,7,10,0.412
20900248,1610612747,1610612751,106.0,87.0,0.5,0.43,1,2009-11-29,16,13,3,0.813,17,0,17,0.0
20900234,1610612764,1610612766,76.0,92.0,0.39,0.461,0,2009-11-28,15,5,10,0.3329999999999999,16,7,9,0.4379999999999999
20900235,1610612739,1610612742,111.0,95.0,0.5770000000000001,0.472,1,2009-11-28,17,12,5,0.706,17,12,5,0.706
20900236,1610612749,1610612753,98.0,100.0,0.411,0.506,0,2009-11-28,15,8,7,0.5329999999999999,17,13,4,0.765
20900237,1610612762,1610612757,108.0,92.0,0.606,0.4529999999999999,1,2009-11-28,16,9,7,0.563,19,12,7,0.632
20900238,1610612744,1610612747,97.0,130.0,0.391,0.5429999999999999,0,2009-11-28,15,5,10,0.3329999999999999,15,12,3,0.8
20900222,1610612766,1610612739,94.0,87.0,0.473,0.456,1,2009-11-27,15,6,9,0.4,16,11,5,0.688
20900223,1610612748,1610612764,84.0,94.0,0.415,0.488,0,2009-11-27,15,9,6,0.6,14,5,9,0.357
20900224,1610612755,1610612737,86.0,100.0,0.449,0.514,0,2009-11-27,16,5,11,0.313,16,12,4,0.75
20900225,1610612738,1610612761,116.0,103.0,0.623,0.557,1,2009-11-27,16,12,4,0.75,17,7,10,0.412
20900226,1610612765,1610612746,96.0,104.0,0.396,0.5870000000000001,0,2009-11-27,16,5,11,0.313,17,7,10,0.412
20900227,1610612754,1610612742,92.0,113.0,0.434,0.446,0,2009-11-27,14,6,8,0.429,16,12,4,0.75
20900228,1610612760,1610612749,108.0,90.0,0.475,0.3779999999999999,1,2009-11-27,16,9,7,0.563,14,8,6,0.5710000000000001
20900229,1610612745,1610612759,84.0,92.0,0.359,0.451,0,2009-11-27,16,8,8,0.5,14,8,6,0.5710000000000001
20900230,1610612743,1610612752,128.0,125.0,0.536,0.489,1,2009-11-27,16,12,4,0.75,16,3,13,0.188
20900231,1610612750,1610612756,95.0,120.0,0.407,0.593,0,2009-11-27,16,1,15,0.063,16,13,3,0.813
20900232,1610612757,1610612763,96.0,106.0,0.407,0.5379999999999999,0,2009-11-27,18,12,6,0.667,16,6,10,0.375
20900233,1610612758,1610612751,109.0,96.0,0.5489999999999999,0.3829999999999999,1,2009-11-27,15,7,8,0.467,16,0,16,0.0
20900220,1610612737,1610612753,76.0,93.0,0.3879999999999999,0.4379999999999999,0,2009-11-26,15,11,4,0.733,16,12,4,0.75
20900221,1610612762,1610612741,105.0,86.0,0.608,0.42,1,2009-11-26,15,8,7,0.5329999999999999,14,6,8,0.429
20900208,1610612766,1610612761,116.0,81.0,0.452,0.345,1,2009-11-25,14,5,9,0.357,16,7,9,0.4379999999999999
20900209,1610612754,1610612746,86.0,73.0,0.376,0.322,1,2009-11-25,13,6,7,0.462,16,6,10,0.375
20900210,1610612738,1610612755,113.0,110.0,0.487,0.476,1,2009-11-25,15,11,4,0.733,15,5,10,0.3329999999999999
20900211,1610612753,1610612748,98.0,99.0,0.416,0.3879999999999999,0,2009-11-25,15,11,4,0.733,14,9,5,0.643
20900212,1610612765,1610612739,88.0,98.0,0.392,0.5,0,2009-11-25,15,5,10,0.3329999999999999,15,11,4,0.733
20900213,1610612750,1610612743,111.0,124.0,0.444,0.525,0,2009-11-25,15,1,14,0.067,15,11,4,0.733
20900214,1610612740,1610612749,102.0,99.0,0.366,0.396,1,2009-11-25,16,7,9,0.4379999999999999,13,8,5,0.615
20900215,1610612745,1610612742,99.0,130.0,0.4579999999999999,0.655,0,2009-11-25,15,8,7,0.5329999999999999,15,11,4,0.733
20900216,1610612759,1610612744,118.0,104.0,0.518,0.465,1,2009-11-25,13,7,6,0.5379999999999999,14,5,9,0.357
20900217,1610612756,1610612763,126.0,111.0,0.619,0.479,1,2009-11-25,15,12,3,0.8,15,5,10,0.3329999999999999
20900218,1610612757,1610612751,93.0,83.0,0.5,0.444,1,2009-11-25,17,12,5,0.706,15,0,15,0.0
20900219,1610612758,1610612752,111.0,97.0,0.483,0.385,1,2009-11-25,14,6,8,0.429,15,3,12,0.2
20900202,1610612761,1610612754,123.0,112.0,0.5579999999999999,0.4529999999999999,1,2009-11-24,15,7,8,0.467,12,5,7,0.417
20900203,1610612764,1610612755,108.0,107.0,0.473,0.4039999999999999,1,2009-11-24,13,4,9,0.308,14,5,9,0.357
20900204,1610612742,1610612744,103.0,111.0,0.4629999999999999,0.477,0,2009-11-24,14,10,4,0.7140000000000001,13,5,8,0.385
20900205,1610612743,1610612751,101.0,87.0,0.481,0.389,1,2009-11-24,14,10,4,0.7140000000000001,14,0,14,0.0
20900206,1610612762,1610612760,94.0,104.0,0.494,0.487,0,2009-11-24,14,7,7,0.5,15,8,7,0.5329999999999999
20900207,1610612747,1610612752,100.0,90.0,0.465,0.389,1,2009-11-24,14,11,3,0.7859999999999999,14,3,11,0.214
20900198,1610612763,1610612758,116.0,105.0,0.539,0.494,1,2009-11-23,14,5,9,0.357,13,5,8,0.385
20900199,1610612759,1610612749,112.0,98.0,0.513,0.494,1,2009-11-23,12,6,6,0.5,12,8,4,0.667
20900200,1610612757,1610612741,122.0,98.0,0.575,0.4629999999999999,1,2009-11-23,16,11,5,0.688,13,6,7,0.462
20900201,1610612746,1610612750,91.0,87.0,0.422,0.434,1,2009-11-23,15,6,9,0.4,14,1,13,0.071
20900192,1610612761,1610612753,96.0,104.0,0.442,0.41,0,2009-11-22,14,6,8,0.429,14,11,3,0.7859999999999999
20900193,1610612752,1610612738,105.0,107.0,0.4320000000000001,0.412,0,2009-11-22,13,3,10,0.231,14,10,4,0.7140000000000001
20900194,1610612766,1610612754,104.0,88.0,0.5,0.41,1,2009-11-22,13,4,9,0.308,11,5,6,0.455
20900195,1610612748,1610612740,102.0,101.0,0.521,0.396,1,2009-11-22,13,8,5,0.615,15,6,9,0.4
20900196,1610612756,1610612765,117.0,91.0,0.575,0.4270000000000001,1,2009-11-22,14,11,3,0.7859999999999999,14,5,9,0.357
20900197,1610612747,1610612760,101.0,85.0,0.4039999999999999,0.3720000000000001,1,2009-11-22,13,10,3,0.769,14,7,7,0.5
20900183,1610612751,1610612752,91.0,98.0,0.411,0.425,0,2009-11-21,13,0,13,0.0,12,3,9,0.25
20900184,1610612739,1610612755,97.0,91.0,0.48,0.42,1,2009-11-21,14,10,4,0.7140000000000001,13,5,8,0.385
20900185,1610612763,1610612749,98.0,103.0,0.4629999999999999,0.4579999999999999,0,2009-11-21,13,4,9,0.308,11,8,3,0.727
20900186,1610612740,1610612737,96.0,88.0,0.435,0.3720000000000001,1,2009-11-21,14,6,8,0.429,14,11,3,0.7859999999999999
20900187,1610612745,1610612758,113.0,106.0,0.478,0.506,1,2009-11-21,14,8,6,0.5710000000000001,12,5,7,0.417
20900188,1610612759,1610612764,106.0,84.0,0.465,0.3329999999999999,1,2009-11-21,11,5,6,0.455,12,3,9,0.25
20900189,1610612743,1610612741,112.0,93.0,0.488,0.444,1,2009-11-21,13,9,4,0.6920000000000001,12,6,6,0.5
20900190,1610612762,1610612765,100.0,97.0,0.4379999999999999,0.45,1,2009-11-21,13,7,6,0.5379999999999999,13,5,8,0.385
20900191,1610612757,1610612750,106.0,78.0,0.5,0.377,1,2009-11-21,15,10,5,0.667,13,1,12,0.077
20900173,1610612754,1610612739,95.0,105.0,0.469,0.462,0,2009-11-20,10,5,5,0.5,13,9,4,0.6920000000000001
20900174,1610612755,1610612763,97.0,102.0,0.457,0.519,0,2009-11-20,12,5,7,0.417,12,4,8,0.3329999999999999
20900175,1610612761,1610612748,120.0,113.0,0.5770000000000001,0.4379999999999999,1,2009-11-20,13,6,7,0.462,12,7,5,0.583
20900176,1610612737,1610612745,105.0,103.0,0.5,0.424,1,2009-11-20,13,11,2,0.846,13,7,6,0.5379999999999999
20900177,1610612738,1610612753,78.0,83.0,0.345,0.414,0,2009-11-20,13,9,4,0.6920000000000001,13,10,3,0.769
20900178,1610612760,1610612764,127.0,108.0,0.537,0.471,1,2009-11-20,13,7,6,0.5379999999999999,11,3,8,0.273
20900179,1610612742,1610612758,104.0,102.0,0.452,0.531,1,2009-11-20,13,10,3,0.769,11,5,6,0.455
20900180,1610612749,1610612766,95.0,88.0,0.415,0.508,1,2009-11-20,10,7,3,0.7,12,3,9,0.25
20900181,1610612744,1610612757,108.0,94.0,0.476,0.418,1,2009-11-20,12,4,8,0.3329999999999999,14,9,5,0.643
20900182,1610612746,1610612743,106.0,99.0,0.493,0.486,1,2009-11-20,14,5,9,0.357,12,8,4,0.667
20900170,1610612740,1610612756,110.0,103.0,0.402,0.4579999999999999,1,2009-11-19,13,5,8,0.385,13,10,3,0.769
20900171,1610612759,1610612762,83.0,90.0,0.4270000000000001,0.462,0,2009-11-19,10,4,6,0.4,12,6,6,0.5
20900172,1610612747,1610612741,108.0,93.0,0.457,0.452,1,2009-11-19,12,9,3,0.75,11,6,5,0.545
20900158,1610612737,1610612748,105.0,90.0,0.4270000000000001,0.4429999999999999,1,2009-11-18,12,10,2,0.833,11,7,4,0.636
20900159,1610612754,1610612752,103.0,110.0,0.442,0.479,0,2009-11-18,9,5,4,0.556,11,2,9,0.182
20900160,1610612753,1610612760,108.0,94.0,0.481,0.41,1,2009-11-18,12,9,3,0.75,12,6,6,0.5
20900161,1610612755,1610612766,86.0,84.0,0.43,0.423,1,2009-11-18,11,5,6,0.455,11,3,8,0.273
20900162,1610612764,1610612739,108.0,91.0,0.429,0.449,1,2009-11-18,10,3,7,0.3,12,8,4,0.667
20900163,1610612738,1610612744,109.0,95.0,0.525,0.4629999999999999,1,2009-11-18,12,9,3,0.75,11,3,8,0.273
20900164,1610612763,1610612746,106.0,91.0,0.5429999999999999,0.476,1,2009-11-18,11,3,8,0.273,13,4,9,0.308
20900165,1610612749,1610612751,99.0,85.0,0.476,0.385,1,2009-11-18,9,6,3,0.667,12,0,12,0.0
20900166,1610612750,1610612745,84.0,97.0,0.456,0.433,0,2009-11-18,12,1,11,0.083,12,7,5,0.583
20900167,1610612762,1610612761,104.0,91.0,0.488,0.374,1,2009-11-18,11,5,6,0.455,12,5,7,0.417
20900168,1610612742,1610612759,99.0,94.0,0.4,0.436,1,2009-11-18,12,9,3,0.75,9,4,5,0.444
20900169,1610612757,1610612765,87.0,81.0,0.471,0.3879999999999999,1,2009-11-18,13,9,4,0.6920000000000001,12,5,7,0.417
20900150,1610612739,1610612744,114.0,108.0,0.5820000000000001,0.466,1,2009-11-17,11,8,3,0.727,10,3,7,0.3
20900151,1610612748,1610612760,87.0,100.0,0.431,0.481,0,2009-11-17,10,7,3,0.7,11,6,5,0.545
20900152,1610612751,1610612754,83.0,91.0,0.363,0.392,0,2009-11-17,11,0,11,0.0,8,5,3,0.625
20900153,1610612740,1610612746,110.0,102.0,0.457,0.476,1,2009-11-17,12,4,8,0.3329999999999999,12,4,8,0.3329999999999999
20900154,1610612745,1610612756,105.0,111.0,0.4429999999999999,0.519,0,2009-11-17,11,6,5,0.545,12,10,2,0.833
20900155,1610612743,1610612761,130.0,112.0,0.615,0.462,1,2009-11-17,11,8,3,0.727,11,5,6,0.455
20900156,1610612758,1610612741,87.0,101.0,0.4320000000000001,0.47,0,2009-11-17,10,5,5,0.5,10,6,4,0.6
20900157,1610612747,1610612765,106.0,93.0,0.472,0.472,1,2009-11-17,11,8,3,0.727,11,5,6,0.455
20900147,1610612737,1610612757,99.0,95.0,0.429,0.4629999999999999,1,2009-11-16,11,9,2,0.818,12,8,4,0.667
20900148,1610612753,1610612766,97.0,91.0,0.429,0.507,1,2009-11-16,11,8,3,0.727,10,3,7,0.3
20900149,1610612749,1610612742,113.0,115.0,0.444,0.512,0,2009-11-16,8,5,3,0.625,11,8,3,0.727
20900143,1610612765,1610612742,90.0,95.0,0.4579999999999999,0.439,0,2009-11-15,10,5,5,0.5,10,7,3,0.7
20900144,1610612760,1610612746,93.0,101.0,0.3879999999999999,0.481,0,2009-11-15,10,5,5,0.5,11,4,7,0.364
20900145,1610612756,1610612761,101.0,100.0,0.449,0.455,1,2009-11-15,11,9,2,0.818,10,5,5,0.5
20900146,1610612747,1610612745,91.0,101.0,0.381,0.418,0,2009-11-15,10,7,3,0.7,10,6,4,0.6
20900133,1610612737,1610612740,121.0,98.0,0.545,0.44,1,2009-11-14,10,8,2,0.8,11,3,8,0.273
20900134,1610612766,1610612757,74.0,80.0,0.366,0.422,0,2009-11-14,9,3,6,0.3329999999999999,11,8,3,0.727
20900135,1610612754,1610612738,113.0,104.0,0.526,0.476,1,2009-11-14,7,4,3,0.5710000000000001,11,8,3,0.727
20900136,1610612764,1610612765,103.0,106.0,0.456,0.457,0,2009-11-14,9,2,7,0.222,9,5,4,0.556
20900137,1610612739,1610612762,107.0,103.0,0.513,0.527,1,2009-11-14,10,7,3,0.7,10,4,6,0.4
20900138,1610612748,1610612751,81.0,80.0,0.3929999999999999,0.429,1,2009-11-14,9,7,2,0.778,10,0,10,0.0
20900139,1610612741,1610612755,94.0,88.0,0.449,0.42,1,2009-11-14,9,5,4,0.556,10,4,6,0.4
20900140,1610612763,1610612750,97.0,87.0,0.488,0.482,1,2009-11-14,10,2,8,0.2,11,1,10,0.091
20900141,1610612749,1610612744,129.0,125.0,0.527,0.561,1,2009-11-14,7,5,2,0.7140000000000001,9,3,6,0.3329999999999999
20900142,1610612759,1610612760,98.0,101.0,0.4679999999999999,0.4679999999999999,0,2009-11-14,8,4,4,0.5,9,5,4,0.556
20900124,1610612753,1610612751,88.0,72.0,0.446,0.3289999999999999,1,2009-11-13,10,7,3,0.7,9,0,9,0.0
20900125,1610612755,1610612762,90.0,112.0,0.479,0.512,0,2009-11-13,9,4,5,0.444,9,4,5,0.444
20900126,1610612752,1610612744,107.0,121.0,0.488,0.583,0,2009-11-13,10,1,9,0.1,8,3,5,0.375
20900127,1610612738,1610612737,86.0,97.0,0.493,0.452,0,2009-11-13,10,8,2,0.8,9,7,2,0.778
20900128,1610612750,1610612742,77.0,89.0,0.326,0.4,0,2009-11-13,10,1,9,0.1,9,6,3,0.667
20900129,1610612740,1610612757,78.0,86.0,0.3670000000000001,0.379,0,2009-11-13,10,3,7,0.3,10,7,3,0.7
20900130,1610612758,1610612745,109.0,100.0,0.481,0.416,1,2009-11-13,9,5,4,0.556,9,5,4,0.556
20900131,1610612743,1610612747,105.0,79.0,0.435,0.348,1,2009-11-13,10,7,3,0.7,9,7,2,0.778
20900132,1610612746,1610612761,89.0,104.0,0.471,0.513,0,2009-11-13,10,3,7,0.3,9,5,4,0.556
20900122,1610612748,1610612739,104.0,111.0,0.461,0.48,0,2009-11-12,8,6,2,0.75,9,6,3,0.667
20900123,1610612747,1610612756,121.0,102.0,0.5760000000000001,0.365,1,2009-11-12,8,7,1,0.875,10,8,2,0.8
20900109,1610612754,1610612744,108.0,94.0,0.447,0.402,1,2009-11-11,6,3,3,0.5,7,2,5,0.286
20900110,1610612761,1610612741,99.0,89.0,0.409,0.3979999999999999,1,2009-11-11,8,4,4,0.5,8,4,4,0.5
20900111,1610612738,1610612762,105.0,86.0,0.532,0.4679999999999999,1,2009-11-11,9,8,1,0.889,8,3,5,0.375
20900112,1610612765,1610612766,98.0,75.0,0.556,0.4379999999999999,1,2009-11-11,8,4,4,0.5,8,3,5,0.375
20900113,1610612751,1610612755,79.0,82.0,0.4,0.39,0,2009-11-11,8,0,8,0.0,8,4,4,0.5
20900114,1610612752,1610612737,101.0,114.0,0.471,0.5429999999999999,0,2009-11-11,9,1,8,0.111,8,6,2,0.75
20900115,1610612749,1610612743,108.0,102.0,0.488,0.3979999999999999,1,2009-11-11,6,4,2,0.667,9,6,3,0.667
20900116,1610612750,1610612757,84.0,107.0,0.442,0.5529999999999999,0,2009-11-11,9,1,8,0.111,9,6,3,0.667
20900117,1610612753,1610612739,93.0,102.0,0.451,0.481,0,2009-11-11,9,6,3,0.667,8,5,3,0.625
20900118,1610612745,1610612763,104.0,79.0,0.5,0.395,1,2009-11-11,8,5,3,0.625,9,1,8,0.111
20900119,1610612759,1610612742,92.0,83.0,0.425,0.354,1,2009-11-11,7,4,3,0.5710000000000001,8,5,3,0.625
20900120,1610612746,1610612760,79.0,83.0,0.359,0.422,0,2009-11-11,9,3,6,0.3329999999999999,8,4,4,0.5
20900121,1610612756,1610612740,124.0,104.0,0.5539999999999999,0.447,1,2009-11-11,9,8,1,0.889,9,3,6,0.3329999999999999
20900103,1610612766,1610612753,81.0,93.0,0.442,0.469,0,2009-11-10,7,3,4,0.429,8,6,2,0.75
20900104,1610612748,1610612764,90.0,76.0,0.446,0.4029999999999999,1,2009-11-10,7,6,1,0.857,8,2,6,0.25
20900105,1610612741,1610612743,89.0,90.0,0.4370000000000001,0.417,0,2009-11-10,7,4,3,0.5710000000000001,8,6,2,0.75
20900106,1610612763,1610612757,79.0,93.0,0.3720000000000001,0.457,0,2009-11-10,8,1,7,0.125,8,5,3,0.625
20900107,1610612742,1610612745,121.0,103.0,0.5539999999999999,0.4270000000000001,1,2009-11-10,7,5,2,0.7140000000000001,7,4,3,0.5710000000000001
20900108,1610612758,1610612760,101.0,98.0,0.447,0.397,1,2009-11-10,8,4,4,0.5,7,3,4,0.429
20900098,1610612755,1610612756,115.0,119.0,0.537,0.532,0,2009-11-09,7,3,4,0.429,8,7,1,0.875
20900099,1610612752,1610612762,93.0,95.0,0.4320000000000001,0.457,0,2009-11-09,8,1,7,0.125,7,3,4,0.429
20900100,1610612759,1610612761,131.0,124.0,0.483,0.5920000000000001,1,2009-11-09,6,3,3,0.5,7,3,4,0.429
20900101,1610612744,1610612750,146.0,105.0,0.5710000000000001,0.447,1,2009-11-09,6,2,4,0.3329999999999999,8,1,7,0.125
20900102,1610612746,1610612740,84.0,112.0,0.43,0.5,0,2009-11-09,8,3,5,0.375,8,3,5,0.375
20900092,1610612765,1610612755,88.0,81.0,0.444,0.436,1,2009-11-08,7,3,4,0.429,6,3,3,0.5
20900093,1610612764,1610612756,90.0,102.0,0.391,0.477,0,2009-11-08,7,2,5,0.286,7,6,1,0.857
20900094,1610612760,1610612753,102.0,74.0,0.5710000000000001,0.368,1,2009-11-08,6,3,3,0.5,7,5,2,0.7140000000000001
20900095,1610612757,1610612750,116.0,93.0,0.5,0.446,1,2009-11-08,7,4,3,0.5710000000000001,7,1,6,0.143
20900096,1610612758,1610612744,120.0,107.0,0.494,0.506,1,2009-11-08,7,3,4,0.429,5,1,4,0.2
20900097,1610612747,1610612740,104.0,88.0,0.469,0.365,1,2009-11-08,7,6,1,0.857,7,2,5,0.286
20900085,1610612737,1610612743,125.0,100.0,0.517,0.41,1,2009-11-07,7,5,2,0.7140000000000001,7,5,2,0.7140000000000001
20900086,1610612751,1610612738,76.0,86.0,0.431,0.449,0,2009-11-07,7,0,7,0.0,8,7,1,0.875
20900087,1610612741,1610612766,93.0,90.0,0.5,0.395,1,2009-11-07,6,4,2,0.667,6,3,3,0.5
20900088,1610612742,1610612761,129.0,101.0,0.624,0.439,1,2009-11-07,6,4,2,0.667,6,3,3,0.5
20900089,1610612749,1610612752,102.0,87.0,0.466,0.413,1,2009-11-07,5,3,2,0.6,7,1,6,0.143
20900090,1610612762,1610612758,99.0,104.0,0.487,0.493,0,2009-11-07,6,2,4,0.3329999999999999,6,2,4,0.3329999999999999
20900091,1610612746,1610612763,113.0,110.0,0.5,0.461,1,2009-11-07,7,3,4,0.429,7,1,6,0.143
20900072,1610612766,1610612737,103.0,83.0,0.47,0.3979999999999999,1,2009-11-06,5,3,2,0.6,6,4,2,0.667
20900073,1610612754,1610612764,102.0,86.0,0.4,0.3929999999999999,1,2009-11-06,5,2,3,0.4,6,2,4,0.3329999999999999
20900074,1610612753,1610612765,110.0,103.0,0.474,0.514,1,2009-11-06,6,5,1,0.833,6,2,4,0.3329999999999999
20900075,1610612755,1610612751,97.0,94.0,0.5,0.47,1,2009-11-06,5,3,2,0.6,6,0,6,0.0
20900076,1610612738,1610612756,103.0,110.0,0.517,0.5,0,2009-11-06,7,6,1,0.857,6,5,1,0.833
20900077,1610612748,1610612743,96.0,88.0,0.493,0.472,1,2009-11-06,6,5,1,0.833,6,5,1,0.833
20900078,1610612750,1610612749,72.0,87.0,0.392,0.415,0,2009-11-06,6,1,5,0.1669999999999999,4,2,2,0.5
20900079,1610612740,1610612761,90.0,107.0,0.48,0.506,0,2009-11-06,6,2,4,0.3329999999999999,5,3,2,0.6
20900080,1610612752,1610612739,91.0,100.0,0.444,0.535,0,2009-11-06,6,1,5,0.1669999999999999,7,4,3,0.5710000000000001
20900081,1610612745,1610612760,105.0,94.0,0.5379999999999999,0.435,1,2009-11-06,6,4,2,0.667,5,2,3,0.4
20900082,1610612744,1610612746,90.0,118.0,0.345,0.579,0,2009-11-06,4,1,3,0.25,6,2,4,0.3329999999999999
20900083,1610612747,1610612763,114.0,98.0,0.505,0.456,1,2009-11-06,6,5,1,0.833,6,1,5,0.1669999999999999
20900084,1610612757,1610612759,96.0,84.0,0.4320000000000001,0.38,1,2009-11-06,6,3,3,0.5,5,2,3,0.4
20900070,1610612739,1610612741,85.0,86.0,0.407,0.409,0,2009-11-05,6,3,3,0.5,5,3,2,0.6
20900071,1610612762,1610612759,113.0,99.0,0.53,0.4320000000000001,1,2009-11-05,5,2,3,0.4,4,2,2,0.5
20900060,1610612753,1610612756,122.0,100.0,0.523,0.455,1,2009-11-04,5,4,1,0.8,5,4,1,0.8
20900061,1610612761,1610612765,110.0,99.0,0.434,0.446,1,2009-11-04,4,2,2,0.5,5,2,3,0.4
20900062,1610612764,1610612748,89.0,93.0,0.3779999999999999,0.486,0,2009-11-04,5,2,3,0.4,5,4,1,0.8
20900063,1610612751,1610612743,94.0,122.0,0.38,0.53,0,2009-11-04,5,0,5,0.0,5,5,0,1.0
20900064,1610612752,1610612754,89.0,101.0,0.395,0.4629999999999999,0,2009-11-04,5,1,4,0.2,4,1,3,0.25
20900065,1610612750,1610612738,90.0,92.0,0.52,0.446,0,2009-11-04,5,1,4,0.2,6,6,0,1.0
20900066,1610612745,1610612747,102.0,103.0,0.4529999999999999,0.419,0,2009-11-04,5,3,2,0.6,5,4,1,0.8
20900067,1610612740,1610612742,114.0,107.0,0.5,0.4589999999999999,1,2009-11-04,5,2,3,0.4,5,3,2,0.6
20900068,1610612758,1610612737,105.0,113.0,0.417,0.541,0,2009-11-04,5,1,4,0.2,5,4,1,0.8
20900069,1610612744,1610612763,113.0,105.0,0.54,0.488,1,2009-11-04,3,1,2,0.3329999999999999,5,1,4,0.2
20900051,1610612739,1610612764,102.0,90.0,0.419,0.391,1,2009-11-03,5,3,2,0.6,4,2,2,0.5
20900052,1610612754,1610612743,93.0,111.0,0.396,0.4270000000000001,0,2009-11-03,3,0,3,0.0,4,4,0,1.0
20900053,1610612755,1610612738,74.0,105.0,0.363,0.569,0,2009-11-03,4,2,2,0.5,5,5,0,1.0
20900054,1610612765,1610612753,85.0,80.0,0.375,0.3670000000000001,1,2009-11-03,4,2,2,0.5,4,3,1,0.75
20900055,1610612748,1610612756,96.0,104.0,0.4,0.506,0,2009-11-03,4,3,1,0.75,4,4,0,1.0
20900056,1610612741,1610612749,83.0,81.0,0.392,0.396,1,2009-11-03,4,2,2,0.5,3,1,2,0.3329999999999999
20900057,1610612760,1610612747,98.0,101.0,0.4320000000000001,0.521,0,2009-11-03,4,2,2,0.5,4,3,1,0.75
20900058,1610612742,1610612762,96.0,85.0,0.395,0.415,1,2009-11-03,4,3,1,0.75,4,1,3,0.25
20900059,1610612757,1610612737,91.0,97.0,0.424,0.4629999999999999,0,2009-11-03,5,2,3,0.4,4,3,1,0.75
20900046,1610612766,1610612751,79.0,68.0,0.324,0.373,1,2009-11-02,4,2,2,0.5,4,0,4,0.0
20900047,1610612752,1610612740,117.0,111.0,0.462,0.488,1,2009-11-02,4,1,3,0.25,4,1,3,0.25
20900048,1610612762,1610612745,96.0,113.0,0.451,0.5,0,2009-11-02,3,1,2,0.3329999999999999,4,3,1,0.75
20900049,1610612758,1610612763,127.0,116.0,0.484,0.455,1,2009-11-02,4,1,3,0.25,4,1,3,0.25
20900050,1610612746,1610612750,93.0,90.0,0.4270000000000001,0.42,1,2009-11-02,5,1,4,0.2,4,1,3,0.25
20900039,1610612761,1610612753,116.0,125.0,0.541,0.439,0,2009-11-01,3,1,2,0.3329999999999999,3,3,0,1.0
20900040,1610612738,1610612740,97.0,87.0,0.539,0.42,1,2009-11-01,4,4,0,1.0,3,1,2,0.3329999999999999
20900041,1610612748,1610612741,95.0,87.0,0.486,0.409,1,2009-11-01,3,3,0,1.0,3,1,2,0.3329999999999999
20900042,1610612760,1610612757,74.0,83.0,0.3429999999999999,0.406,0,2009-11-01,3,2,1,0.667,4,2,2,0.5
20900043,1610612743,1610612763,133.0,123.0,0.5529999999999999,0.578,1,2009-11-01,3,3,0,1.0,3,1,2,0.3329999999999999
20900044,1610612756,1610612750,120.0,112.0,0.5,0.4639999999999999,1,2009-11-01,3,3,0,1.0,3,1,2,0.3329999999999999
20900045,1610612747,1610612737,118.0,110.0,0.529,0.449,1,2009-11-01,3,2,1,0.667,3,2,1,0.667
20900032,1610612764,1610612751,123.0,104.0,0.615,0.4629999999999999,1,2009-10-31,3,2,1,0.667,3,0,3,0.0
20900033,1610612739,1610612766,90.0,79.0,0.581,0.426,1,2009-10-31,4,2,2,0.5,3,1,2,0.3329999999999999
20900034,1610612752,1610612755,127.0,141.0,0.47,0.607,0,2009-10-31,3,0,3,0.0,3,2,1,0.667
20900035,1610612745,1610612757,111.0,107.0,0.506,0.514,1,2009-10-31,3,2,1,0.667,3,1,2,0.3329999999999999
20900036,1610612749,1610612765,96.0,85.0,0.41,0.4370000000000001,1,2009-10-31,2,1,1,0.5,3,1,2,0.3329999999999999
20900037,1610612759,1610612758,113.0,94.0,0.581,0.446,1,2009-10-31,3,2,1,0.667,3,0,3,0.0
20900038,1610612746,1610612742,84.0,93.0,0.4270000000000001,0.417,0,2009-10-31,4,0,4,0.0,3,2,1,0.667
20900019,1610612766,1610612752,102.0,100.0,0.38,0.3879999999999999,1,2009-10-30,2,1,1,0.5,2,0,2,0.0
20900020,1610612755,1610612749,99.0,86.0,0.457,0.4,1,2009-10-30,2,1,1,0.5,1,0,1,0.0
20900021,1610612737,1610612764,100.0,89.0,0.41,0.4429999999999999,1,2009-10-30,2,2,0,1.0,2,1,1,0.5
20900022,1610612738,1610612741,118.0,90.0,0.581,0.415,1,2009-10-30,3,3,0,1.0,2,1,1,0.5
20900023,1610612765,1610612760,83.0,91.0,0.371,0.434,0,2009-10-30,2,1,1,0.5,2,2,0,1.0
20900024,1610612754,1610612748,83.0,96.0,0.3670000000000001,0.435,0,2009-10-30,2,0,2,0.0,2,2,0,1.0
20900025,1610612763,1610612761,115.0,107.0,0.512,0.4429999999999999,1,2009-10-30,2,1,1,0.5,2,1,1,0.5
20900026,1610612750,1610612739,87.0,104.0,0.419,0.476,0,2009-10-30,2,1,1,0.5,3,1,2,0.3329999999999999
20900027,1610612751,1610612753,85.0,95.0,0.3829999999999999,0.493,0,2009-10-30,2,0,2,0.0,2,2,0,1.0
20900028,1610612740,1610612758,97.0,92.0,0.452,0.375,1,2009-10-30,2,1,1,0.5,2,0,2,0.0
20900029,1610612762,1610612746,111.0,98.0,0.5,0.4589999999999999,1,2009-10-30,2,1,1,0.5,3,0,3,0.0
20900030,1610612756,1610612744,123.0,101.0,0.536,0.424,1,2009-10-30,2,2,0,1.0,2,0,2,0.0
20900031,1610612747,1610612742,80.0,94.0,0.395,0.416,0,2009-10-30,2,1,1,0.5,2,1,1,0.5
20900017,1610612741,1610612759,92.0,85.0,0.417,0.423,1,2009-10-29,1,1,0,1.0,2,1,1,0.5
20900018,1610612757,1610612743,94.0,97.0,0.346,0.4589999999999999,0,2009-10-29,2,1,1,0.5,2,2,0,1.0
20900005,1610612737,1610612754,120.0,109.0,0.529,0.534,1,2009-10-28,1,1,0,1.0,1,0,1,0.0
20900006,1610612753,1610612755,120.0,106.0,0.556,0.5,1,2009-10-28,1,1,0,1.0,1,0,1,0.0
20900007,1610612761,1610612739,101.0,91.0,0.4529999999999999,0.349,1,2009-10-28,1,1,0,1.0,2,0,2,0.0
20900008,1610612738,1610612766,92.0,59.0,0.434,0.311,1,2009-10-28,2,2,0,1.0,1,0,1,0.0
20900009,1610612748,1610612752,115.0,93.0,0.5660000000000001,0.379,1,2009-10-28,1,1,0,1.0,1,0,1,0.0
20900010,1610612763,1610612765,74.0,96.0,0.361,0.514,0,2009-10-28,1,0,1,0.0,1,1,0,1.0
20900011,1610612750,1610612751,95.0,93.0,0.366,0.42,1,2009-10-28,1,1,0,1.0,1,0,1,0.0
20900012,1610612760,1610612758,102.0,89.0,0.513,0.405,1,2009-10-28,1,1,0,1.0,1,0,1,0.0
20900013,1610612759,1610612740,113.0,96.0,0.523,0.5,1,2009-10-28,1,1,0,1.0,1,0,1,0.0
20900014,1610612743,1610612762,114.0,105.0,0.483,0.457,1,2009-10-28,1,1,0,1.0,1,0,1,0.0
20900015,1610612744,1610612745,107.0,108.0,0.494,0.465,0,2009-10-28,1,0,1,0.0,2,1,1,0.5
20900016,1610612746,1610612756,107.0,109.0,0.5579999999999999,0.513,0,2009-10-28,2,0,2,0.0,1,1,0,1.0
20900001,1610612739,1610612738,89.0,95.0,0.414,0.444,0,2009-10-27,1,0,1,0.0,1,1,0,1.0
20900002,1610612742,1610612764,91.0,102.0,0.395,0.4639999999999999,0,2009-10-27,1,0,1,0.0,1,1,0,1.0
20900003,1610612757,1610612745,96.0,87.0,0.429,0.37,1,2009-10-27,1,1,0,1.0,1,0,1,0.0
20900004,1610612747,1610612746,99.0,92.0,0.412,0.4479999999999999,1,2009-10-27,1,1,0,1.0,1,0,1,0.0
10900108,1610612766,1610612763,92.0,95.0,0.434,0.3979999999999999,0,2009-10-23,8,2,6,0.25,8,3,5,0.375
10900109,1610612754,1610612759,114.0,112.0,0.4429999999999999,0.488,1,2009-10-23,7,3,4,0.429,7,4,3,0.5710000000000001
10900110,1610612741,1610612764,93.0,70.0,0.434,0.373,1,2009-10-23,8,6,2,0.75,8,4,4,0.5
10900111,1610612750,1610612761,98.0,90.0,0.425,0.4,1,2009-10-23,8,3,5,0.375,8,2,6,0.25
10900117,1610612751,1610612755,110.0,88.0,0.514,0.4,1,2009-10-23,7,1,6,0.143,8,5,3,0.625
10900118,1610612753,1610612737,123.0,86.0,0.613,0.375,1,2009-10-23,8,8,0,1.0,7,5,2,0.7140000000000001
10900113,1610612749,1610612765,93.0,95.0,0.4,0.471,0,2009-10-23,8,3,5,0.375,8,4,4,0.5
10900114,1610612745,1610612742,94.0,98.0,0.405,0.424,0,2009-10-23,8,4,4,0.5,7,5,2,0.7140000000000001
10900112,1610612758,1610612762,85.0,95.0,0.3879999999999999,0.434,0,2009-10-23,7,2,5,0.286,8,6,2,0.75
10900115,1610612746,1610612740,91.0,88.0,0.44,0.444,1,2009-10-23,8,6,2,0.75,8,2,6,0.25
10900116,1610612747,1610612743,105.0,119.0,0.456,0.57,0,2009-10-23,8,6,2,0.75,8,4,4,0.5
10900102,1610612748,1610612737,87.0,92.0,0.368,0.5710000000000001,0,2009-10-22,7,2,5,0.286,6,5,1,0.833
10900106,1610612765,1610612750,114.0,122.0,0.586,0.534,0,2009-10-22,7,3,4,0.429,7,2,5,0.286
10900103,1610612760,1610612758,89.0,104.0,0.397,0.525,0,2009-10-22,7,2,5,0.286,6,2,4,0.3329999999999999
10900104,1610612747,1610612743,106.0,89.0,0.444,0.414,1,2009-10-22,7,6,1,0.857,7,3,4,0.429
10900105,1610612756,1610612757,93.0,113.0,0.462,0.483,0,2009-10-22,8,4,4,0.5,8,4,4,0.5
10900107,1610612744,1610612740,126.0,92.0,0.625,0.3979999999999999,1,2009-10-22,8,4,4,0.5,7,2,5,0.286
10900098,1610612751,1610612752,92.0,94.0,0.375,0.415,0,2009-10-21,6,0,6,0.0,7,5,2,0.7140000000000001
10900099,1610612753,1610612754,117.0,87.0,0.4679999999999999,0.3979999999999999,1,2009-10-21,7,7,0,1.0,6,2,4,0.3329999999999999
10900100,1610612739,1610612738,82.0,96.0,0.472,0.5,0,2009-10-21,8,4,4,0.5,8,6,2,0.75
10900101,1610612748,1610612763,99.0,93.0,0.5,0.405,1,2009-10-21,6,2,4,0.3329999999999999,7,2,5,0.286
10900088,1610612755,1610612764,89.0,90.0,0.425,0.4579999999999999,0,2009-10-20,7,5,2,0.7140000000000001,7,4,3,0.5710000000000001
10900089,1610612766,1610612749,94.0,87.0,0.478,0.429,1,2009-10-20,7,2,5,0.286,7,3,4,0.429
10900094,1610612752,1610612738,108.0,103.0,0.4379999999999999,0.488,1,2009-10-20,6,4,2,0.667,7,5,2,0.7140000000000001
10900095,1610612739,1610612742,96.0,66.0,0.4579999999999999,0.3379999999999999,1,2009-10-20,7,4,3,0.5710000000000001,6,4,2,0.667
10900096,1610612760,1610612759,102.0,119.0,0.483,0.56,0,2009-10-20,6,2,4,0.3329999999999999,6,4,2,0.667
10900090,1610612743,1610612750,129.0,100.0,0.588,0.396,1,2009-10-20,6,3,3,0.5,6,1,5,0.1669999999999999
10900091,1610612756,1610612758,143.0,127.0,0.471,0.5,1,2009-10-20,7,4,3,0.5710000000000001,5,1,4,0.2
10900092,1610612757,1610612762,97.0,108.0,0.413,0.531,0,2009-10-20,7,3,4,0.429,7,5,2,0.7140000000000001
10900093,1610612747,1610612744,113.0,107.0,0.506,0.512,1,2009-10-20,6,5,1,0.833,7,3,4,0.429
10900085,1610612737,1610612764,113.0,95.0,0.5579999999999999,0.422,1,2009-10-19,5,4,1,0.8,6,3,3,0.5
10900086,1610612741,1610612753,98.0,101.0,0.5,0.465,0,2009-10-19,7,5,2,0.7140000000000001,6,6,0,1.0
10900087,1610612745,1610612760,105.0,85.0,0.514,0.4270000000000001,1,2009-10-19,7,4,3,0.5710000000000001,5,2,3,0.4
10900080,1610612761,1610612738,82.0,101.0,0.4370000000000001,0.5,0,2009-10-18,7,2,5,0.286,6,5,1,0.833
10900084,1610612756,1610612755,94.0,116.0,0.382,0.452,0,2009-10-18,6,3,3,0.5,6,5,1,0.833
10900081,1610612766,1610612762,103.0,110.0,0.4,0.519,0,2009-10-18,6,1,5,0.1669999999999999,6,4,2,0.667
10900082,1610612757,1610612743,98.0,96.0,0.397,0.441,1,2009-10-18,6,3,3,0.5,5,2,3,0.4
10900083,1610612747,1610612746,114.0,108.0,0.4479999999999999,0.488,1,2009-10-18,5,4,1,0.8,6,4,2,0.667
10900072,1610612746,1610612762,103.0,96.0,0.522,0.466,1,2009-10-17,5,4,1,0.8,5,3,2,0.6
10900073,1610612763,1610612765,115.0,94.0,0.526,0.451,1,2009-10-17,6,2,4,0.3329999999999999,6,3,3,0.5
10900074,1610612740,1610612754,108.0,96.0,0.433,0.402,1,2009-10-17,6,2,4,0.3329999999999999,5,2,3,0.4
10900077,1610612749,1610612750,101.0,87.0,0.481,0.386,1,2009-10-17,6,3,3,0.5,5,1,4,0.2
10900078,1610612742,1610612739,93.0,82.0,0.493,0.3779999999999999,1,2009-10-17,5,4,1,0.8,6,3,3,0.5
10900075,1610612758,1610612744,101.0,94.0,0.442,0.4,1,2009-10-17,4,1,3,0.25,6,3,3,0.5
10900076,1610612747,1610612766,91.0,87.0,0.406,0.375,1,2009-10-17,4,3,1,0.75,5,1,4,0.2
10900067,1610612754,1610612745,119.0,104.0,0.489,0.3670000000000001,1,2009-10-16,4,2,2,0.5,6,3,3,0.5
10900070,1610612752,1610612751,93.0,89.0,0.402,0.384,1,2009-10-16,4,2,2,0.5,5,0,5,0.0
10900068,1610612741,1610612750,94.0,90.0,0.4320000000000001,0.341,1,2009-10-16,6,5,1,0.833,4,1,3,0.25
10900071,1610612759,1610612739,105.0,98.0,0.44,0.4029999999999999,1,2009-10-16,5,3,2,0.6,5,3,2,0.6
10900069,1610612756,1610612755,115.0,113.0,0.4370000000000001,0.41,1,2009-10-16,5,3,2,0.6,5,4,1,0.8
10900062,1610612761,1610612745,112.0,124.0,0.5,0.56,0,2009-10-15,6,2,4,0.3329999999999999,5,3,2,0.6
10900065,1610612748,1610612740,97.0,81.0,0.4679999999999999,0.3670000000000001,1,2009-10-15,5,1,4,0.2,5,1,4,0.2
10900066,1610612742,1610612765,113.0,88.0,0.5579999999999999,0.418,1,2009-10-15,4,3,1,0.75,5,3,2,0.6
10900063,1610612762,1610612757,99.0,96.0,0.522,0.3979999999999999,1,2009-10-15,4,3,1,0.75,5,2,3,0.4
10900064,1610612747,1610612758,98.0,92.0,0.422,0.419,1,2009-10-15,3,2,1,0.667,3,0,3,0.0
10900055,1610612739,1610612764,104.0,109.0,0.487,0.551,0,2009-10-14,4,3,1,0.75,5,3,2,0.6
10900060,1610612738,1610612761,106.0,90.0,0.4639999999999999,0.4589999999999999,1,2009-10-14,5,4,1,0.8,5,2,3,0.4
10900056,1610612763,1610612737,96.0,111.0,0.514,0.52,0,2009-10-14,5,1,4,0.2,4,3,1,0.75
10900057,1610612750,1610612741,94.0,99.0,0.39,0.447,0,2009-10-14,3,1,2,0.3329999999999999,5,4,1,0.8
10900058,1610612760,1610612748,96.0,91.0,0.4629999999999999,0.493,1,2009-10-14,4,2,2,0.5,4,0,4,0.0
10900061,1610612759,1610612746,90.0,93.0,0.4429999999999999,0.513,0,2009-10-14,4,2,2,0.5,4,3,1,0.75
10900059,1610612757,1610612756,104.0,110.0,0.488,0.5,0,2009-10-14,4,2,2,0.5,4,2,2,0.5
10900050,1610612751,1610612738,88.0,91.0,0.426,0.456,0,2009-10-13,4,0,4,0.0,4,3,1,0.75
10900051,1610612765,1610612764,98.0,101.0,0.405,0.4679999999999999,0,2009-10-13,4,3,1,0.75,4,2,2,0.5
10900054,1610612752,1610612755,85.0,93.0,0.309,0.4589999999999999,0,2009-10-13,3,1,2,0.3329999999999999,4,4,0,1.0
10900052,1610612741,1610612749,87.0,86.0,0.425,0.365,1,2009-10-13,4,3,1,0.75,5,2,3,0.4
10900053,1610612740,1610612753,86.0,121.0,0.389,0.609,0,2009-10-13,4,1,3,0.25,5,5,0,1.0
10900045,1610612737,1610612766,107.0,90.0,0.467,0.406,1,2009-10-12,3,2,1,0.667,4,1,3,0.25
10900047,1610612763,1610612753,83.0,102.0,0.431,0.48,0,2009-10-12,4,1,3,0.25,4,4,0,1.0
10900048,1610612760,1610612756,110.0,105.0,0.471,0.4039999999999999,1,2009-10-12,3,1,2,0.3329999999999999,3,1,2,0.3329999999999999
10900049,1610612745,1610612749,92.0,96.0,0.3779999999999999,0.439,0,2009-10-12,4,2,2,0.5,4,2,2,0.5
10900119,1610612746,1610612744,124.0,117.0,0.5,0.512,1,2009-10-12,3,2,1,0.667,5,3,2,0.6
10900039,1610612743,1610612754,128.0,112.0,0.465,0.418,1,2009-10-11,4,2,2,0.5,3,1,2,0.3329999999999999
10900040,1610612738,1610612751,100.0,93.0,0.452,0.405,1,2009-10-11,3,2,1,0.667,3,0,3,0.0
10900041,1610612761,1610612764,100.0,93.0,0.3879999999999999,0.44,1,2009-10-11,4,2,2,0.5,3,1,2,0.3329999999999999
10900042,1610612748,1610612759,93.0,95.0,0.434,0.48,0,2009-10-11,3,0,3,0.0,3,2,1,0.667
10900043,1610612765,1610612737,100.0,91.0,0.493,0.395,1,2009-10-11,3,3,0,1.0,2,1,1,0.5
10900044,1610612742,1610612763,114.0,107.0,0.5,0.494,1,2009-10-11,3,2,1,0.667,3,1,2,0.3329999999999999
10900036,1610612740,1610612760,88.0,79.0,0.368,0.3779999999999999,1,2009-10-10,3,1,2,0.3329999999999999,2,0,2,0.0
10900037,1610612766,1610612739,96.0,102.0,0.478,0.451,0,2009-10-10,3,1,2,0.3329999999999999,2,2,0,1.0
10900038,1610612749,1610612741,98.0,86.0,0.446,0.4,1,2009-10-10,3,1,2,0.3329999999999999,3,2,1,0.667
10900035,1610612756,1610612744,101.0,104.0,0.4039999999999999,0.422,0,2009-10-10,2,1,1,0.5,4,3,1,0.75
10900027,1610612755,1610612751,93.0,92.0,0.416,0.493,1,2009-10-09,3,3,0,1.0,2,0,2,0.0
10900028,1610612764,1610612742,115.0,123.0,0.532,0.47,0,2009-10-09,2,1,1,0.5,2,1,1,0.5
10900029,1610612753,1610612745,113.0,104.0,0.494,0.435,1,2009-10-09,3,3,0,1.0,3,2,1,0.667
10900032,1610612738,1610612752,96.0,82.0,0.439,0.377,1,2009-10-09,2,1,1,0.5,2,1,1,0.5
10900030,1610612750,1610612761,97.0,112.0,0.405,0.539,0,2009-10-09,2,1,1,0.5,3,1,2,0.3329999999999999
10900031,1610612747,1610612744,91.0,110.0,0.473,0.532,0,2009-10-09,2,1,1,0.5,3,2,1,0.667
10900034,1610612746,1610612757,97.0,85.0,0.526,0.382,1,2009-10-09,2,1,1,0.5,3,2,1,0.667
10900025,1610612754,1610612743,126.0,104.0,0.525,0.3779999999999999,1,2009-10-08,2,1,1,0.5,3,1,2,0.3329999999999999
10900024,1610612766,1610612740,108.0,101.0,0.446,0.421,1,2009-10-08,2,1,1,0.5,2,0,2,0.0
10900016,1610612761,1610612755,79.0,84.0,0.395,0.37,0,2009-10-07,2,0,2,0.0,2,2,0,1.0
10900017,1610612737,1610612740,108.0,102.0,0.487,0.444,1,2009-10-07,1,1,0,1.0,1,0,1,0.0
10900018,1610612753,1610612748,90.0,86.0,0.397,0.3379999999999999,1,2009-10-07,2,2,0,1.0,2,0,2,0.0
10900022,1610612765,1610612749,113.0,104.0,0.5589999999999999,0.434,1,2009-10-07,2,2,0,1.0,2,0,2,0.0
10900019,1610612763,1610612760,99.0,91.0,0.4529999999999999,0.472,1,2009-10-07,2,1,1,0.5,1,0,1,0.0
10900023,1610612745,1610612738,96.0,90.0,0.384,0.426,1,2009-10-07,2,2,0,1.0,1,0,1,0.0
10900020,1610612758,1610612757,86.0,89.0,0.431,0.4629999999999999,0,2009-10-07,2,0,2,0.0,2,2,0,1.0
10900021,1610612747,1610612744,118.0,101.0,0.478,0.41,1,2009-10-07,1,1,0,1.0,2,1,1,0.5
10900014,1610612741,1610612762,102.0,101.0,0.507,0.4270000000000001,1,2009-10-06,2,2,0,1.0,2,1,1,0.5
10900009,1610612764,1610612763,101.0,92.0,0.3979999999999999,0.411,1,2009-10-06,1,1,0,1.0,1,0,1,0.0
10900010,1610612739,1610612766,92.0,87.0,0.4,0.429,1,2009-10-06,1,1,0,1.0,1,0,1,0.0
10900013,1610612755,1610612761,107.0,98.0,0.507,0.41,1,2009-10-06,1,1,0,1.0,1,0,1,0.0
10900015,1610612759,1610612745,85.0,99.0,0.354,0.494,0,2009-10-06,1,0,1,0.0,1,1,0,1.0
10900012,1610612757,1610612758,98.0,86.0,0.462,0.37,1,2009-10-06,1,1,0,1.0,1,0,1,0.0
10900007,1610612765,1610612748,87.0,83.0,0.476,0.366,1,2009-10-05,1,1,0,1.0,1,0,1,0.0
10900008,1610612742,1610612753,105.0,110.0,0.392,0.421,0,2009-10-05,1,0,1,0.0,1,1,0,1.0
10900004,1610612752,1610612751,115.0,107.0,0.4320000000000001,0.441,1,2009-10-04,1,1,0,1.0,1,0,1,0.0
10900006,1610612750,1610612749,117.0,103.0,0.508,0.4429999999999999,1,2009-10-04,1,1,0,1.0,1,0,1,0.0
10900005,1610612744,1610612746,108.0,101.0,0.4370000000000001,0.493,1,2009-10-04,1,1,0,1.0,1,0,1,0.0
10900002,1610612754,1610612741,95.0,104.0,0.431,0.417,0,2009-10-02,1,0,1,0.0,1,1,0,1.0
10900001,1610612762,1610612743,103.0,87.0,0.4320000000000001,0.475,1,2009-10-01,1,1,0,1.0,1,0,1,0.0
40800405,1610612753,1610612747,86.0,99.0,0.415,0.4379999999999999,0,2009-06-14,82,59,23,0.72,82,65,17,0.7929999999999999
40800404,1610612753,1610612747,91.0,99.0,0.419,0.418,0,2009-06-11,82,59,23,0.72,82,65,17,0.7929999999999999
40800403,1610612753,1610612747,108.0,104.0,0.625,0.513,1,2009-06-09,82,59,23,0.72,82,65,17,0.7929999999999999
40800402,1610612747,1610612753,101.0,96.0,0.462,0.418,1,2009-06-07,82,65,17,0.7929999999999999,82,59,23,0.72
40800401,1610612747,1610612753,100.0,75.0,0.461,0.299,1,2009-06-04,82,65,17,0.7929999999999999,82,59,23,0.72
40800306,1610612753,1610612739,103.0,90.0,0.4629999999999999,0.4429999999999999,1,2009-05-30,82,59,23,0.72,82,66,16,0.805
40800316,1610612743,1610612747,92.0,119.0,0.4379999999999999,0.573,0,2009-05-29,82,54,28,0.659,82,65,17,0.7929999999999999
40800305,1610612739,1610612753,112.0,102.0,0.5,0.4579999999999999,1,2009-05-28,82,66,16,0.805,82,59,23,0.72
40800315,1610612747,1610612743,103.0,94.0,0.487,0.386,1,2009-05-27,82,65,17,0.7929999999999999,82,54,28,0.659
40800304,1610612753,1610612739,116.0,114.0,0.5,0.4479999999999999,1,2009-05-26,82,59,23,0.72,82,66,16,0.805
40800314,1610612743,1610612747,120.0,101.0,0.442,0.415,1,2009-05-25,82,54,28,0.659,82,65,17,0.7929999999999999
40800303,1610612753,1610612739,99.0,89.0,0.429,0.3720000000000001,1,2009-05-24,82,59,23,0.72,82,66,16,0.805
40800313,1610612743,1610612747,97.0,103.0,0.3929999999999999,0.4579999999999999,0,2009-05-23,82,54,28,0.659,82,65,17,0.7929999999999999
40800302,1610612739,1610612753,96.0,95.0,0.455,0.479,1,2009-05-22,82,66,16,0.805,82,59,23,0.72
40800312,1610612747,1610612743,103.0,106.0,0.455,0.4429999999999999,0,2009-05-21,82,65,17,0.7929999999999999,82,54,28,0.659
40800301,1610612739,1610612753,106.0,107.0,0.489,0.551,0,2009-05-20,82,66,16,0.805,82,59,23,0.72
40800311,1610612747,1610612743,105.0,103.0,0.411,0.486,1,2009-05-19,82,65,17,0.7929999999999999,82,54,28,0.659
40800227,1610612747,1610612745,89.0,70.0,0.467,0.368,1,2009-05-17,82,65,17,0.7929999999999999,82,53,29,0.6459999999999999
40800217,1610612738,1610612753,82.0,101.0,0.392,0.514,0,2009-05-17,82,62,20,0.7559999999999999,82,59,23,0.72
40800226,1610612745,1610612747,95.0,80.0,0.507,0.357,1,2009-05-14,82,53,29,0.6459999999999999,82,65,17,0.7929999999999999
40800216,1610612753,1610612738,83.0,75.0,0.366,0.416,1,2009-05-14,82,59,23,0.72,82,62,20,0.7559999999999999
40800235,1610612743,1610612742,124.0,110.0,0.585,0.514,1,2009-05-13,82,54,28,0.659,82,50,32,0.61
40800225,1610612747,1610612745,118.0,78.0,0.512,0.326,1,2009-05-12,82,65,17,0.7929999999999999,82,53,29,0.6459999999999999
40800215,1610612738,1610612753,92.0,88.0,0.423,0.45,1,2009-05-12,82,62,20,0.7559999999999999,82,59,23,0.72
40800234,1610612742,1610612743,119.0,117.0,0.506,0.481,1,2009-05-11,82,50,32,0.61,82,54,28,0.659
40800204,1610612737,1610612739,74.0,84.0,0.315,0.429,0,2009-05-11,82,47,35,0.573,82,66,16,0.805
40800224,1610612745,1610612747,99.0,87.0,0.45,0.447,1,2009-05-10,82,53,29,0.6459999999999999,82,65,17,0.7929999999999999
40800214,1610612753,1610612738,94.0,95.0,0.4,0.528,0,2009-05-10,82,59,23,0.72,82,62,20,0.7559999999999999
40800233,1610612742,1610612743,105.0,106.0,0.4,0.42,0,2009-05-09,82,50,32,0.61,82,54,28,0.659
40800203,1610612737,1610612739,82.0,97.0,0.447,0.507,0,2009-05-09,82,47,35,0.573,82,66,16,0.805
40800223,1610612745,1610612747,94.0,108.0,0.417,0.439,0,2009-05-08,82,53,29,0.6459999999999999,82,65,17,0.7929999999999999
40800213,1610612753,1610612738,117.0,96.0,0.591,0.43,1,2009-05-08,82,59,23,0.72,82,62,20,0.7559999999999999
40800202,1610612739,1610612737,105.0,85.0,0.535,0.349,1,2009-05-07,82,66,16,0.805,82,47,35,0.573
40800222,1610612747,1610612745,111.0,98.0,0.5,0.4589999999999999,1,2009-05-06,82,65,17,0.7929999999999999,82,53,29,0.6459999999999999
40800212,1610612738,1610612753,112.0,94.0,0.512,0.4429999999999999,1,2009-05-06,82,62,20,0.7559999999999999,82,59,23,0.72
40800232,1610612743,1610612742,117.0,105.0,0.5,0.474,1,2009-05-05,82,54,28,0.659,82,50,32,0.61
40800201,1610612739,1610612737,99.0,72.0,0.4679999999999999,0.4379999999999999,1,2009-05-05,82,66,16,0.805,82,47,35,0.573
40800221,1610612747,1610612745,92.0,100.0,0.4429999999999999,0.479,0,2009-05-04,82,65,17,0.7929999999999999,82,53,29,0.6459999999999999
40800211,1610612738,1610612753,90.0,95.0,0.385,0.4320000000000001,0,2009-05-04,82,62,20,0.7559999999999999,82,59,23,0.72
40800137,1610612737,1610612748,91.0,78.0,0.408,0.413,1,2009-05-03,82,47,35,0.573,82,43,39,0.524
40800231,1610612743,1610612742,109.0,95.0,0.5479999999999999,0.488,1,2009-05-03,82,54,28,0.659,82,50,32,0.61
40800117,1610612738,1610612741,109.0,99.0,0.449,0.39,1,2009-05-02,82,62,20,0.7559999999999999,82,41,41,0.5
40800136,1610612748,1610612737,98.0,72.0,0.473,0.37,1,2009-05-01,82,43,39,0.524,82,47,35,0.573
40800116,1610612741,1610612738,128.0,127.0,0.495,0.434,1,2009-04-30,82,41,41,0.5,82,62,20,0.7559999999999999
40800126,1610612755,1610612753,89.0,114.0,0.408,0.537,0,2009-04-30,82,41,41,0.5,82,59,23,0.72
40800176,1610612745,1610612757,92.0,76.0,0.462,0.423,1,2009-04-30,82,53,29,0.6459999999999999,82,54,28,0.659
40800135,1610612737,1610612748,106.0,91.0,0.486,0.477,1,2009-04-29,82,47,35,0.573,82,43,39,0.524
40800155,1610612743,1610612740,107.0,86.0,0.514,0.382,1,2009-04-29,82,54,28,0.659,82,49,33,0.598
40800115,1610612738,1610612741,106.0,104.0,0.488,0.4,1,2009-04-28,82,62,20,0.7559999999999999,82,41,41,0.5
40800125,1610612753,1610612755,91.0,78.0,0.434,0.426,1,2009-04-28,82,59,23,0.72,82,41,41,0.5
40800165,1610612759,1610612742,93.0,106.0,0.52,0.514,0,2009-04-28,82,54,28,0.659,82,50,32,0.61
40800175,1610612757,1610612745,88.0,77.0,0.4579999999999999,0.452,1,2009-04-28,82,54,28,0.659,82,53,29,0.6459999999999999
40800134,1610612748,1610612737,71.0,81.0,0.377,0.424,0,2009-04-27,82,43,39,0.524,82,47,35,0.573
40800154,1610612740,1610612743,63.0,121.0,0.315,0.5660000000000001,0,2009-04-27,82,49,33,0.598,82,54,28,0.659
40800145,1610612747,1610612762,107.0,96.0,0.45,0.402,1,2009-04-27,82,65,17,0.7929999999999999,82,48,34,0.585
40800114,1610612741,1610612738,121.0,118.0,0.484,0.421,1,2009-04-26,82,41,41,0.5,82,62,20,0.7559999999999999
40800104,1610612765,1610612739,78.0,99.0,0.397,0.473,0,2009-04-26,82,39,43,0.476,82,66,16,0.805
40800124,1610612755,1610612753,81.0,84.0,0.3879999999999999,0.471,0,2009-04-26,82,41,41,0.5,82,59,23,0.72
40800174,1610612745,1610612757,89.0,88.0,0.3979999999999999,0.457,1,2009-04-26,82,53,29,0.6459999999999999,82,54,28,0.659
40800153,1610612740,1610612743,95.0,93.0,0.435,0.405,1,2009-04-25,82,49,33,0.598,82,54,28,0.659
40800164,1610612742,1610612759,99.0,90.0,0.384,0.4429999999999999,1,2009-04-25,82,50,32,0.61,82,54,28,0.659
40800133,1610612748,1610612737,107.0,78.0,0.469,0.3670000000000001,1,2009-04-25,82,43,39,0.524,82,47,35,0.573
40800144,1610612762,1610612747,94.0,108.0,0.442,0.519,0,2009-04-25,82,48,34,0.585,82,65,17,0.7929999999999999
40800103,1610612765,1610612739,68.0,79.0,0.38,0.412,0,2009-04-24,82,39,43,0.476,82,66,16,0.805
40800123,1610612755,1610612753,96.0,94.0,0.521,0.425,1,2009-04-24,82,41,41,0.5,82,59,23,0.72
40800173,1610612745,1610612757,86.0,83.0,0.4639999999999999,0.421,1,2009-04-24,82,53,29,0.6459999999999999,82,54,28,0.659
40800113,1610612741,1610612738,86.0,107.0,0.375,0.481,0,2009-04-23,82,41,41,0.5,82,62,20,0.7559999999999999
40800163,1610612742,1610612759,88.0,67.0,0.472,0.321,1,2009-04-23,82,50,32,0.61,82,54,28,0.659
40800143,1610612762,1610612747,88.0,86.0,0.44,0.368,1,2009-04-23,82,48,34,0.585,82,65,17,0.7929999999999999
40800122,1610612753,1610612755,96.0,87.0,0.43,0.467,1,2009-04-22,82,59,23,0.72,82,41,41,0.5
40800132,1610612737,1610612748,93.0,108.0,0.442,0.556,0,2009-04-22,82,47,35,0.573,82,43,39,0.524
40800152,1610612743,1610612740,108.0,93.0,0.5,0.4589999999999999,1,2009-04-22,82,54,28,0.659,82,49,33,0.598
40800102,1610612739,1610612765,94.0,82.0,0.424,0.395,1,2009-04-21,82,66,16,0.805,82,39,43,0.476
40800172,1610612757,1610612745,107.0,103.0,0.514,0.5,1,2009-04-21,82,54,28,0.659,82,53,29,0.6459999999999999
40800142,1610612747,1610612762,119.0,109.0,0.6,0.494,1,2009-04-21,82,65,17,0.7929999999999999,82,48,34,0.585
40800112,1610612738,1610612741,118.0,115.0,0.49,0.5,1,2009-04-20,82,62,20,0.7559999999999999,82,41,41,0.5
40800162,1610612759,1610612742,105.0,84.0,0.532,0.4029999999999999,1,2009-04-20,82,54,28,0.659,82,50,32,0.61
40800141,1610612747,1610612762,113.0,100.0,0.556,0.391,1,2009-04-19,82,65,17,0.7929999999999999,82,48,34,0.585
40800121,1610612753,1610612755,98.0,100.0,0.487,0.512,0,2009-04-19,82,59,23,0.72,82,41,41,0.5
40800131,1610612737,1610612748,90.0,64.0,0.462,0.366,1,2009-04-19,82,47,35,0.573,82,43,39,0.524
40800151,1610612743,1610612740,113.0,84.0,0.507,0.3720000000000001,1,2009-04-19,82,54,28,0.659,82,49,33,0.598
40800111,1610612738,1610612741,103.0,105.0,0.3939999999999999,0.4270000000000001,0,2009-04-18,82,62,20,0.7559999999999999,82,41,41,0.5
40800101,1610612739,1610612765,102.0,84.0,0.529,0.462,1,2009-04-18,82,66,16,0.805,82,39,43,0.476
40800161,1610612759,1610612742,97.0,105.0,0.469,0.5379999999999999,0,2009-04-18,82,54,28,0.659,82,50,32,0.61
40800171,1610612757,1610612745,81.0,108.0,0.417,0.585,0,2009-04-18,82,54,28,0.659,82,53,29,0.6459999999999999
20801217,1610612738,1610612764,115.0,107.0,0.529,0.494,1,2009-04-15,82,62,20,0.7559999999999999,82,19,63,0.2319999999999999
20801218,1610612741,1610612761,98.0,109.0,0.424,0.478,0,2009-04-15,82,41,41,0.5,82,33,49,0.402
20801219,1610612739,1610612755,110.0,111.0,0.517,0.528,0,2009-04-15,82,66,16,0.805,82,41,41,0.5
20801220,1610612742,1610612745,95.0,84.0,0.481,0.402,1,2009-04-15,82,50,32,0.61,82,53,29,0.6459999999999999
20801221,1610612754,1610612749,115.0,108.0,0.476,0.431,1,2009-04-15,82,36,46,0.439,82,34,48,0.415
20801222,1610612763,1610612737,98.0,90.0,0.507,0.434,1,2009-04-15,82,24,58,0.293,82,47,35,0.573
20801223,1610612748,1610612765,102.0,96.0,0.4639999999999999,0.414,1,2009-04-15,82,43,39,0.524,82,39,43,0.476
20801224,1610612750,1610612758,90.0,97.0,0.421,0.4589999999999999,0,2009-04-15,82,24,58,0.293,82,17,65,0.207
20801225,1610612752,1610612751,102.0,73.0,0.447,0.313,1,2009-04-15,82,32,50,0.39,82,34,48,0.415
20801226,1610612753,1610612766,98.0,73.0,0.457,0.353,1,2009-04-15,82,59,23,0.72,82,35,47,0.4270000000000001
20801227,1610612759,1610612740,105.0,98.0,0.494,0.487,1,2009-04-15,82,54,28,0.659,82,49,33,0.598
20801228,1610612746,1610612760,85.0,126.0,0.4379999999999999,0.539,0,2009-04-15,82,19,63,0.2319999999999999,82,23,59,0.28
20801229,1610612756,1610612744,117.0,113.0,0.426,0.462,1,2009-04-15,82,46,36,0.561,82,29,53,0.354
20801230,1610612757,1610612743,104.0,76.0,0.527,0.337,1,2009-04-15,82,54,28,0.659,82,54,28,0.659
20801214,1610612737,1610612748,81.0,79.0,0.423,0.397,1,2009-04-14,81,47,34,0.58,81,42,39,0.519
20801215,1610612755,1610612738,98.0,100.0,0.4629999999999999,0.519,0,2009-04-14,81,40,41,0.494,81,61,20,0.753
20801216,1610612747,1610612762,125.0,112.0,0.5579999999999999,0.493,1,2009-04-14,82,65,17,0.7929999999999999,82,48,34,0.585
20801202,1610612754,1610612739,109.0,117.0,0.4479999999999999,0.46,0,2009-04-13,81,35,46,0.4320000000000001,81,66,15,0.815
20801203,1610612764,1610612761,96.0,97.0,0.4679999999999999,0.406,0,2009-04-13,81,19,62,0.235,81,32,49,0.395
20801204,1610612765,1610612741,88.0,91.0,0.4,0.462,0,2009-04-13,81,39,42,0.481,81,41,40,0.506
20801205,1610612751,1610612766,91.0,87.0,0.408,0.452,1,2009-04-13,81,34,47,0.42,81,35,46,0.4320000000000001
20801206,1610612749,1610612753,98.0,80.0,0.4429999999999999,0.318,1,2009-04-13,81,34,47,0.42,81,58,23,0.716
20801207,1610612742,1610612750,96.0,94.0,0.451,0.451,1,2009-04-13,81,49,32,0.605,81,24,57,0.296
20801208,1610612745,1610612740,86.0,66.0,0.4589999999999999,0.346,1,2009-04-13,81,53,28,0.654,81,49,32,0.605
20801209,1610612743,1610612758,118.0,98.0,0.4589999999999999,0.471,1,2009-04-13,81,54,27,0.667,81,16,65,0.198
20801210,1610612762,1610612746,106.0,85.0,0.455,0.4379999999999999,1,2009-04-13,81,48,33,0.593,81,19,62,0.235
20801211,1610612756,1610612763,119.0,110.0,0.5429999999999999,0.506,1,2009-04-13,81,45,36,0.556,81,23,58,0.284
20801212,1610612757,1610612760,113.0,83.0,0.511,0.402,1,2009-04-13,81,53,28,0.654,81,22,59,0.272
20801213,1610612744,1610612759,72.0,101.0,0.341,0.435,0,2009-04-13,81,29,52,0.358,81,53,28,0.654
20801196,1610612740,1610612742,102.0,92.0,0.556,0.425,1,2009-04-12,80,49,31,0.613,80,48,32,0.6
20801197,1610612739,1610612738,107.0,76.0,0.551,0.358,1,2009-04-12,80,65,15,0.813,80,60,20,0.75
20801198,1610612748,1610612752,122.0,105.0,0.563,0.4429999999999999,1,2009-04-12,80,42,38,0.525,81,31,50,0.3829999999999999
20801199,1610612761,1610612755,111.0,104.0,0.5379999999999999,0.41,1,2009-04-12,80,31,49,0.3879999999999999,80,40,40,0.5
20801200,1610612758,1610612759,92.0,95.0,0.42,0.412,0,2009-04-12,80,16,64,0.2,80,52,28,0.65
20801201,1610612747,1610612763,92.0,75.0,0.452,0.366,1,2009-04-12,81,64,17,0.79,80,23,57,0.288
20801189,1610612754,1610612765,106.0,102.0,0.455,0.5,1,2009-04-11,80,35,45,0.4379999999999999,80,39,41,0.488
20801190,1610612751,1610612753,103.0,93.0,0.5429999999999999,0.455,1,2009-04-11,80,33,47,0.413,80,58,22,0.725
20801191,1610612750,1610612756,97.0,110.0,0.416,0.482,0,2009-04-11,80,24,56,0.3,80,44,36,0.55
20801192,1610612741,1610612766,113.0,106.0,0.476,0.5,1,2009-04-11,80,40,40,0.5,80,35,45,0.4379999999999999
20801193,1610612749,1610612760,115.0,98.0,0.524,0.424,1,2009-04-11,80,33,47,0.413,80,22,58,0.275
20801194,1610612762,1610612744,108.0,118.0,0.42,0.5479999999999999,0,2009-04-11,80,47,33,0.588,80,29,51,0.363
20801195,1610612746,1610612757,72.0,87.0,0.38,0.444,0,2009-04-11,80,19,61,0.238,80,52,28,0.65
20801177,1610612755,1610612739,92.0,102.0,0.4579999999999999,0.4679999999999999,0,2009-04-10,79,40,39,0.506,79,64,15,0.81
20801178,1610612737,1610612754,122.0,118.0,0.519,0.483,1,2009-04-10,80,46,34,0.575,79,34,45,0.43
20801179,1610612738,1610612748,105.0,98.0,0.469,0.47,1,2009-04-10,79,60,19,0.759,79,41,38,0.519
20801176,1610612753,1610612752,95.0,105.0,0.4379999999999999,0.44,0,2009-04-10,79,58,21,0.7340000000000001,80,31,49,0.3879999999999999
20801180,1610612765,1610612751,100.0,93.0,0.535,0.474,1,2009-04-10,79,39,40,0.494,79,32,47,0.405
20801181,1610612763,1610612756,106.0,89.0,0.488,0.474,1,2009-04-10,79,23,56,0.291,79,43,36,0.544
20801182,1610612760,1610612766,84.0,81.0,0.4679999999999999,0.3329999999999999,1,2009-04-10,79,22,57,0.278,79,35,44,0.4429999999999999
20801183,1610612761,1610612764,98.0,100.0,0.4270000000000001,0.506,0,2009-04-10,79,30,49,0.38,80,19,61,0.238
20801184,1610612742,1610612740,100.0,92.0,0.4,0.421,1,2009-04-10,79,48,31,0.608,79,48,31,0.608
20801185,1610612759,1610612762,105.0,99.0,0.5,0.4429999999999999,1,2009-04-10,79,51,28,0.6459999999999999,79,47,32,0.595
20801186,1610612757,1610612747,106.0,98.0,0.4270000000000001,0.447,1,2009-04-10,79,51,28,0.6459999999999999,80,63,17,0.7879999999999999
20801187,1610612744,1610612745,109.0,113.0,0.439,0.494,0,2009-04-10,79,28,51,0.354,80,52,28,0.65
20801188,1610612746,1610612758,109.0,78.0,0.56,0.326,1,2009-04-10,79,19,60,0.241,79,16,63,0.203
20801173,1610612741,1610612755,113.0,99.0,0.524,0.521,1,2009-04-09,79,39,40,0.494,78,40,38,0.513
20801174,1610612758,1610612745,98.0,115.0,0.44,0.54,0,2009-04-09,78,16,62,0.205,79,51,28,0.6459999999999999
20801175,1610612747,1610612743,116.0,102.0,0.425,0.444,1,2009-04-09,79,63,16,0.797,80,53,27,0.6629999999999999
20801162,1610612739,1610612764,98.0,86.0,0.447,0.425,1,2009-04-08,78,63,15,0.8079999999999999,79,18,61,0.228
20801163,1610612754,1610612761,130.0,101.0,0.5489999999999999,0.384,1,2009-04-08,78,34,44,0.436,78,30,48,0.385
20801164,1610612753,1610612763,81.0,78.0,0.431,0.426,1,2009-04-08,78,58,20,0.7440000000000001,78,22,56,0.282
20801169,1610612759,1610612757,83.0,95.0,0.473,0.527,0,2009-04-08,78,50,28,0.6409999999999999,78,50,28,0.6409999999999999
20801165,1610612738,1610612751,106.0,104.0,0.519,0.452,1,2009-04-08,78,59,19,0.7559999999999999,78,32,46,0.41
20801166,1610612752,1610612765,86.0,113.0,0.364,0.5379999999999999,0,2009-04-08,79,30,49,0.38,78,38,40,0.487
20801167,1610612749,1610612737,105.0,113.0,0.494,0.53,0,2009-04-08,79,32,47,0.405,79,45,34,0.57
20801168,1610612740,1610612756,100.0,105.0,0.467,0.514,0,2009-04-08,78,48,30,0.615,78,43,35,0.551
20801170,1610612743,1610612760,122.0,112.0,0.537,0.471,1,2009-04-08,79,53,26,0.6709999999999999,78,21,57,0.2689999999999999
20801171,1610612742,1610612762,130.0,101.0,0.5489999999999999,0.4529999999999999,1,2009-04-08,78,47,31,0.603,78,47,31,0.603
20801172,1610612744,1610612750,97.0,105.0,0.442,0.457,0,2009-04-08,78,28,50,0.359,79,24,55,0.304
20801153,1610612766,1610612755,101.0,98.0,0.4589999999999999,0.422,1,2009-04-07,78,35,43,0.449,77,40,37,0.519
20801154,1610612761,1610612737,110.0,118.0,0.537,0.506,0,2009-04-07,77,30,47,0.39,78,44,34,0.564
20801155,1610612748,1610612740,87.0,93.0,0.392,0.425,0,2009-04-07,78,41,37,0.526,77,48,29,0.623
20801156,1610612763,1610612757,93.0,96.0,0.522,0.493,0,2009-04-07,77,22,55,0.286,77,49,28,0.636
20801157,1610612760,1610612759,89.0,99.0,0.4529999999999999,0.476,0,2009-04-07,77,21,56,0.273,77,50,27,0.649
20801158,1610612741,1610612752,110.0,103.0,0.433,0.506,1,2009-04-07,78,38,40,0.487,78,30,48,0.385
20801159,1610612745,1610612753,93.0,83.0,0.439,0.38,1,2009-04-07,78,50,28,0.6409999999999999,77,57,20,0.74
20801160,1610612758,1610612747,104.0,122.0,0.442,0.511,0,2009-04-07,77,16,61,0.208,78,62,16,0.795
20801161,1610612746,1610612750,77.0,87.0,0.358,0.469,0,2009-04-07,78,18,60,0.231,78,23,55,0.295
20801142,1610612739,1610612759,101.0,81.0,0.534,0.392,1,2009-04-05,77,62,15,0.805,76,49,27,0.645
20801143,1610612742,1610612756,140.0,116.0,0.6,0.494,1,2009-04-05,77,46,31,0.597,77,42,35,0.545
20801144,1610612765,1610612766,104.0,97.0,0.494,0.407,1,2009-04-05,77,37,40,0.481,77,34,43,0.442
20801145,1610612761,1610612752,103.0,112.0,0.4429999999999999,0.506,0,2009-04-05,76,30,46,0.395,77,30,47,0.39
20801146,1610612745,1610612757,102.0,88.0,0.514,0.452,1,2009-04-05,77,49,28,0.636,76,48,28,0.632
20801147,1610612750,1610612743,87.0,110.0,0.414,0.5329999999999999,0,2009-04-05,77,22,55,0.286,78,52,26,0.667
20801148,1610612740,1610612762,94.0,108.0,0.535,0.536,0,2009-04-05,76,47,29,0.618,77,47,30,0.61
20801149,1610612760,1610612754,99.0,117.0,0.44,0.5,0,2009-04-05,76,21,55,0.276,77,33,44,0.429
20801150,1610612751,1610612755,96.0,67.0,0.439,0.351,1,2009-04-05,77,32,45,0.416,76,40,36,0.526
20801151,1610612758,1610612744,100.0,105.0,0.424,0.374,0,2009-04-05,76,16,60,0.211,77,28,49,0.364
20801152,1610612747,1610612746,88.0,85.0,0.423,0.37,1,2009-04-05,77,61,16,0.792,77,18,59,0.2339999999999999
20801135,1610612752,1610612761,95.0,102.0,0.451,0.4,0,2009-04-04,76,29,47,0.382,75,30,45,0.4
20801136,1610612741,1610612751,103.0,94.0,0.421,0.423,1,2009-04-04,77,37,40,0.481,76,31,45,0.408
20801137,1610612755,1610612765,95.0,90.0,0.48,0.37,1,2009-04-04,75,40,35,0.5329999999999999,76,36,40,0.474
20801138,1610612737,1610612753,82.0,88.0,0.39,0.38,0,2009-04-04,77,43,34,0.5579999999999999,76,57,19,0.75
20801139,1610612764,1610612748,104.0,118.0,0.507,0.551,0,2009-04-04,78,18,60,0.231,77,41,36,0.532
20801140,1610612749,1610612763,102.0,107.0,0.481,0.515,0,2009-04-04,78,32,46,0.41,76,22,54,0.289
20801141,1610612743,1610612746,120.0,104.0,0.531,0.4639999999999999,1,2009-04-04,77,51,26,0.662,76,18,58,0.237
20801125,1610612766,1610612748,92.0,97.0,0.513,0.5,0,2009-04-03,76,34,42,0.447,76,40,36,0.526
20801126,1610612754,1610612759,121.0,126.0,0.516,0.5489999999999999,0,2009-04-03,76,32,44,0.421,75,49,26,0.653
20801127,1610612738,1610612737,104.0,92.0,0.5329999999999999,0.356,1,2009-04-03,77,58,19,0.753,76,43,33,0.5660000000000001
20801128,1610612763,1610612742,107.0,102.0,0.5379999999999999,0.494,1,2009-04-03,75,21,54,0.28,76,45,31,0.5920000000000001
20801129,1610612760,1610612757,72.0,107.0,0.365,0.473,0,2009-04-03,75,21,54,0.28,75,48,27,0.64
20801130,1610612753,1610612739,116.0,87.0,0.537,0.369,1,2009-04-03,75,56,19,0.747,76,61,15,0.8029999999999999
20801131,1610612762,1610612750,102.0,103.0,0.48,0.5329999999999999,0,2009-04-03,76,46,30,0.605,76,22,54,0.289
20801132,1610612756,1610612758,139.0,111.0,0.547,0.4579999999999999,1,2009-04-03,76,42,34,0.5529999999999999,75,16,59,0.213
20801133,1610612744,1610612740,111.0,103.0,0.4679999999999999,0.43,1,2009-04-03,76,27,49,0.355,75,47,28,0.627
20801134,1610612747,1610612745,93.0,81.0,0.395,0.425,1,2009-04-03,76,60,16,0.789,76,48,28,0.632
20801122,1610612755,1610612749,105.0,95.0,0.507,0.467,1,2009-04-02,74,39,35,0.527,77,32,45,0.416
20801123,1610612764,1610612739,109.0,101.0,0.506,0.47,1,2009-04-02,77,18,59,0.2339999999999999,75,61,14,0.813
20801124,1610612743,1610612762,114.0,104.0,0.467,0.366,1,2009-04-02,76,50,26,0.6579999999999999,75,46,29,0.613
20801113,1610612753,1610612761,95.0,99.0,0.408,0.494,0,2009-04-01,74,55,19,0.743,74,29,45,0.392
20801114,1610612738,1610612766,111.0,109.0,0.532,0.461,1,2009-04-01,76,57,19,0.75,75,34,41,0.4529999999999999
20801115,1610612751,1610612765,111.0,98.0,0.513,0.4679999999999999,1,2009-04-01,75,31,44,0.413,75,36,39,0.48
20801116,1610612763,1610612764,112.0,107.0,0.481,0.482,1,2009-04-01,74,20,54,0.27,76,17,59,0.2239999999999999
20801117,1610612749,1610612747,98.0,104.0,0.452,0.472,0,2009-04-01,76,32,44,0.421,75,59,16,0.787
20801118,1610612742,1610612748,98.0,96.0,0.4579999999999999,0.4379999999999999,1,2009-04-01,75,45,30,0.6,75,39,36,0.52
20801119,1610612756,1610612745,114.0,109.0,0.5429999999999999,0.5,1,2009-04-01,75,41,34,0.547,75,48,27,0.64
20801120,1610612744,1610612758,143.0,141.0,0.535,0.439,1,2009-04-01,75,26,49,0.347,74,16,58,0.216
20801121,1610612746,1610612740,98.0,104.0,0.5,0.531,0,2009-04-01,75,18,57,0.24,74,47,27,0.635
20801104,1610612766,1610612747,94.0,84.0,0.515,0.392,1,2009-03-31,74,34,40,0.4589999999999999,74,58,16,0.784
20801105,1610612739,1610612765,79.0,73.0,0.386,0.354,1,2009-03-31,74,61,13,0.8240000000000001,74,36,38,0.486
20801106,1610612754,1610612741,107.0,105.0,0.5,0.519,1,2009-03-31,75,32,43,0.4270000000000001,76,36,40,0.474
20801107,1610612755,1610612737,98.0,85.0,0.4679999999999999,0.446,1,2009-03-31,73,38,35,0.521,75,43,32,0.573
20801108,1610612750,1610612742,88.0,108.0,0.3979999999999999,0.5539999999999999,0,2009-03-31,75,21,54,0.28,74,44,30,0.595
20801109,1610612759,1610612760,95.0,96.0,0.475,0.493,0,2009-03-31,74,48,26,0.649,74,21,53,0.284
20801110,1610612743,1610612752,111.0,104.0,0.5479999999999999,0.447,1,2009-03-31,75,49,26,0.653,75,29,46,0.387
20801111,1610612757,1610612762,125.0,104.0,0.618,0.487,1,2009-03-31,74,47,27,0.635,74,46,28,0.622
20801112,1610612758,1610612740,110.0,111.0,0.487,0.537,0,2009-03-31,73,16,57,0.2189999999999999,73,46,27,0.63
20801100,1610612748,1610612753,95.0,101.0,0.4529999999999999,0.507,0,2009-03-30,74,39,35,0.527,73,55,18,0.753
20801101,1610612751,1610612749,78.0,107.0,0.371,0.481,0,2009-03-30,74,30,44,0.405,75,32,43,0.4270000000000001
20801102,1610612762,1610612752,112.0,104.0,0.545,0.507,1,2009-03-30,73,46,27,0.63,74,29,45,0.392
20801103,1610612744,1610612763,109.0,114.0,0.435,0.506,0,2009-03-30,74,25,49,0.3379999999999999,73,19,54,0.26
20801091,1610612739,1610612742,102.0,74.0,0.426,0.362,1,2009-03-29,73,60,13,0.8220000000000001,73,43,30,0.589
20801092,1610612737,1610612747,86.0,76.0,0.3929999999999999,0.35,1,2009-03-29,74,43,31,0.581,73,58,15,0.795
20801093,1610612750,1610612751,108.0,99.0,0.514,0.455,1,2009-03-29,74,21,53,0.284,73,30,43,0.411
20801094,1610612761,1610612741,134.0,129.0,0.5429999999999999,0.5529999999999999,1,2009-03-29,73,28,45,0.384,75,36,39,0.48
20801095,1610612765,1610612755,101.0,97.0,0.528,0.4629999999999999,1,2009-03-29,73,36,37,0.493,72,37,35,0.514
20801096,1610612738,1610612760,103.0,84.0,0.47,0.361,1,2009-03-29,75,56,19,0.747,73,20,53,0.2739999999999999
20801097,1610612754,1610612764,124.0,115.0,0.516,0.429,1,2009-03-29,74,31,43,0.419,75,17,58,0.2269999999999999
20801098,1610612740,1610612759,90.0,86.0,0.375,0.4029999999999999,1,2009-03-29,72,45,27,0.625,73,48,25,0.6579999999999999
20801099,1610612758,1610612756,126.0,118.0,0.516,0.495,1,2009-03-29,72,16,56,0.222,74,40,34,0.541
20801083,1610612741,1610612754,112.0,106.0,0.506,0.4579999999999999,1,2009-03-28,74,36,38,0.486,73,30,43,0.411
20801084,1610612766,1610612752,96.0,85.0,0.494,0.376,1,2009-03-28,73,33,40,0.452,73,29,44,0.397
20801085,1610612764,1610612765,96.0,98.0,0.4429999999999999,0.4679999999999999,0,2009-03-28,74,17,57,0.23,72,35,37,0.486
20801086,1610612748,1610612749,102.0,85.0,0.481,0.369,1,2009-03-28,73,39,34,0.534,74,31,43,0.419
20801087,1610612745,1610612746,110.0,93.0,0.524,0.4629999999999999,1,2009-03-28,74,48,26,0.649,74,18,56,0.243
20801088,1610612743,1610612744,129.0,116.0,0.551,0.42,1,2009-03-28,74,48,26,0.649,73,25,48,0.342
20801089,1610612762,1610612756,104.0,99.0,0.434,0.371,1,2009-03-28,72,45,27,0.625,73,40,33,0.5479999999999999
20801090,1610612757,1610612763,86.0,66.0,0.416,0.412,1,2009-03-28,73,46,27,0.63,72,18,54,0.25
20801073,1610612753,1610612749,110.0,94.0,0.512,0.391,1,2009-03-27,72,54,18,0.75,73,31,42,0.425
20801074,1610612755,1610612766,95.0,100.0,0.4639999999999999,0.514,0,2009-03-27,71,37,34,0.521,72,32,40,0.444
20801075,1610612761,1610612760,112.0,96.0,0.505,0.417,1,2009-03-27,72,27,45,0.375,72,20,52,0.278
20801076,1610612737,1610612738,93.0,99.0,0.422,0.474,0,2009-03-27,73,42,31,0.575,74,55,19,0.743
20801077,1610612739,1610612750,107.0,85.0,0.534,0.41,1,2009-03-27,72,59,13,0.8190000000000001,73,20,53,0.2739999999999999
20801078,1610612751,1610612747,95.0,103.0,0.47,0.471,0,2009-03-27,72,30,42,0.417,72,58,14,0.8059999999999999
20801079,1610612752,1610612740,103.0,93.0,0.487,0.43,1,2009-03-27,72,29,43,0.4029999999999999,71,44,27,0.62
20801080,1610612742,1610612743,101.0,103.0,0.356,0.56,0,2009-03-27,72,43,29,0.597,73,47,26,0.644
20801081,1610612759,1610612746,111.0,98.0,0.561,0.513,1,2009-03-27,72,48,24,0.667,73,18,55,0.247
20801082,1610612758,1610612763,95.0,113.0,0.47,0.527,0,2009-03-27,71,15,56,0.211,71,18,53,0.254
20801070,1610612765,1610612747,77.0,92.0,0.395,0.455,0,2009-03-26,71,34,37,0.479,71,57,14,0.8029999999999999
20801071,1610612741,1610612748,106.0,87.0,0.526,0.4589999999999999,1,2009-03-26,73,35,38,0.479,72,38,34,0.528
20801072,1610612757,1610612756,129.0,109.0,0.602,0.5,1,2009-03-26,72,45,27,0.625,72,40,32,0.556
20801059,1610612737,1610612759,92.0,102.0,0.474,0.547,0,2009-03-25,72,42,30,0.583,71,47,24,0.662
20801060,1610612739,1610612751,98.0,87.0,0.471,0.41,1,2009-03-25,71,58,13,0.8170000000000001,71,30,41,0.423
20801061,1610612754,1610612748,90.0,88.0,0.4429999999999999,0.373,1,2009-03-25,72,30,42,0.417,71,38,33,0.535
20801062,1610612755,1610612750,96.0,88.0,0.408,0.364,1,2009-03-25,70,37,33,0.529,72,20,52,0.278
20801063,1610612761,1610612749,115.0,106.0,0.479,0.478,1,2009-03-25,71,26,45,0.366,72,31,41,0.431
20801064,1610612764,1610612766,95.0,93.0,0.4639999999999999,0.467,1,2009-03-25,73,17,56,0.233,71,31,40,0.4370000000000001
20801065,1610612752,1610612746,135.0,140.0,0.5539999999999999,0.5770000000000001,0,2009-03-25,71,28,43,0.3939999999999999,72,18,54,0.25
20801066,1610612740,1610612743,88.0,101.0,0.426,0.4320000000000001,0,2009-03-25,70,44,26,0.629,72,46,26,0.639
20801067,1610612753,1610612738,84.0,82.0,0.37,0.434,1,2009-03-25,71,53,18,0.746,73,54,19,0.74
20801068,1610612742,1610612744,128.0,106.0,0.585,0.475,1,2009-03-25,71,43,28,0.606,72,25,47,0.347
20801069,1610612756,1610612762,118.0,114.0,0.5489999999999999,0.4529999999999999,1,2009-03-25,71,40,31,0.563,71,44,27,0.62
20801055,1610612741,1610612765,99.0,91.0,0.44,0.482,1,2009-03-24,72,34,38,0.472,70,34,36,0.486
20801056,1610612760,1610612747,89.0,107.0,0.415,0.5,0,2009-03-24,71,20,51,0.282,70,56,14,0.8
20801057,1610612759,1610612744,107.0,106.0,0.519,0.457,1,2009-03-24,70,46,24,0.657,71,25,46,0.352
20801058,1610612762,1610612745,99.0,86.0,0.447,0.348,1,2009-03-24,70,44,26,0.629,73,47,26,0.644
20801048,1610612737,1610612750,109.0,97.0,0.529,0.44,1,2009-03-23,71,42,29,0.5920000000000001,71,20,51,0.282
20801049,1610612764,1610612741,99.0,101.0,0.396,0.447,0,2009-03-23,72,16,56,0.222,71,33,38,0.465
20801050,1610612738,1610612746,90.0,77.0,0.479,0.4370000000000001,1,2009-03-23,72,54,18,0.75,71,17,54,0.239
20801051,1610612748,1610612763,94.0,82.0,0.469,0.435,1,2009-03-23,70,38,32,0.5429999999999999,70,17,53,0.243
20801052,1610612752,1610612753,102.0,106.0,0.414,0.446,0,2009-03-23,70,28,42,0.4,70,52,18,0.743
20801053,1610612756,1610612743,118.0,115.0,0.506,0.447,1,2009-03-23,70,39,31,0.557,71,45,26,0.634
20801054,1610612757,1610612755,108.0,114.0,0.406,0.514,0,2009-03-23,71,44,27,0.62,69,36,33,0.522
20801041,1610612765,1610612748,96.0,101.0,0.449,0.5,0,2009-03-22,69,34,35,0.493,69,37,32,0.536
20801042,1610612759,1610612745,85.0,87.0,0.415,0.466,0,2009-03-22,69,45,24,0.652,72,47,25,0.653
20801043,1610612750,1610612760,90.0,97.0,0.43,0.446,0,2009-03-22,70,20,50,0.286,70,20,50,0.286
20801044,1610612761,1610612746,100.0,76.0,0.44,0.387,1,2009-03-22,70,25,45,0.357,70,17,53,0.243
20801045,1610612751,1610612739,88.0,96.0,0.41,0.474,0,2009-03-22,70,30,40,0.429,70,57,13,0.8140000000000001
20801046,1610612740,1610612744,99.0,89.0,0.4529999999999999,0.395,1,2009-03-22,69,44,25,0.638,70,25,45,0.357
20801047,1610612758,1610612755,100.0,112.0,0.4379999999999999,0.597,0,2009-03-22,70,15,55,0.214,68,35,33,0.515
20801034,1610612739,1610612737,102.0,96.0,0.487,0.429,1,2009-03-21,69,56,13,0.812,70,41,29,0.586
20801035,1610612766,1610612754,83.0,108.0,0.42,0.526,0,2009-03-21,70,31,39,0.4429999999999999,71,29,42,0.408
20801036,1610612753,1610612752,110.0,103.0,0.487,0.424,1,2009-03-21,69,51,18,0.7390000000000001,69,28,41,0.406
20801037,1610612763,1610612738,87.0,105.0,0.3929999999999999,0.562,0,2009-03-21,69,17,52,0.246,71,53,18,0.746
20801038,1610612741,1610612747,109.0,117.0,0.506,0.495,0,2009-03-21,70,32,38,0.457,69,55,14,0.797
20801039,1610612749,1610612757,84.0,96.0,0.395,0.43,0,2009-03-21,71,31,40,0.4370000000000001,70,44,26,0.629
20801040,1610612756,1610612764,128.0,96.0,0.5539999999999999,0.4,1,2009-03-21,69,38,31,0.551,71,16,55,0.225
20801023,1610612754,1610612742,92.0,94.0,0.405,0.422,0,2009-03-20,70,28,42,0.4,70,42,28,0.6
20801024,1610612761,1610612766,89.0,102.0,0.4479999999999999,0.506,0,2009-03-20,69,24,45,0.348,69,31,38,0.449
20801025,1610612751,1610612748,96.0,88.0,0.446,0.41,1,2009-03-20,69,30,39,0.435,68,36,32,0.529
20801026,1610612752,1610612758,94.0,121.0,0.3979999999999999,0.5529999999999999,0,2009-03-20,68,28,40,0.412,69,15,54,0.217
20801027,1610612765,1610612746,108.0,90.0,0.557,0.493,1,2009-03-20,68,34,34,0.5,69,17,52,0.246
20801028,1610612740,1610612763,96.0,84.0,0.475,0.431,1,2009-03-20,68,43,25,0.632,68,17,51,0.25
20801029,1610612760,1610612762,94.0,101.0,0.4479999999999999,0.488,0,2009-03-20,69,19,50,0.275,69,43,26,0.623
20801030,1610612745,1610612750,107.0,88.0,0.477,0.425,1,2009-03-20,71,46,25,0.648,69,20,49,0.29
20801031,1610612759,1610612738,77.0,80.0,0.416,0.415,0,2009-03-20,68,45,23,0.662,70,52,18,0.743
20801032,1610612743,1610612764,116.0,105.0,0.53,0.457,1,2009-03-20,70,45,25,0.643,70,16,54,0.2289999999999999
20801033,1610612744,1610612755,119.0,111.0,0.565,0.38,1,2009-03-20,69,25,44,0.362,67,34,33,0.507
20801020,1610612737,1610612742,95.0,87.0,0.455,0.4039999999999999,1,2009-03-19,69,41,28,0.594,69,41,28,0.594
20801021,1610612739,1610612757,97.0,92.0,0.43,0.421,1,2009-03-19,68,55,13,0.809,69,43,26,0.623
20801022,1610612747,1610612744,114.0,106.0,0.5,0.457,1,2009-03-19,68,54,14,0.794,68,24,44,0.353
20801009,1610612738,1610612748,112.0,108.0,0.5489999999999999,0.478,1,2009-03-18,69,51,18,0.7390000000000001,67,36,31,0.537
20801010,1610612766,1610612758,104.0,88.0,0.485,0.391,1,2009-03-18,68,30,38,0.441,68,14,54,0.206
20801011,1610612754,1610612757,85.0,95.0,0.405,0.425,0,2009-03-18,69,28,41,0.406,68,43,25,0.632
20801012,1610612752,1610612751,89.0,115.0,0.442,0.588,0,2009-03-18,67,28,39,0.418,68,29,39,0.426
20801013,1610612763,1610612743,109.0,111.0,0.477,0.487,0,2009-03-18,67,17,50,0.254,69,44,25,0.638
20801014,1610612749,1610612753,80.0,106.0,0.377,0.48,0,2009-03-18,70,31,39,0.4429999999999999,68,50,18,0.735
20801015,1610612740,1610612750,94.0,93.0,0.456,0.419,1,2009-03-18,67,42,25,0.627,68,20,48,0.294
20801016,1610612760,1610612741,96.0,103.0,0.476,0.525,0,2009-03-18,68,19,49,0.2789999999999999,69,32,37,0.4639999999999999
20801017,1610612745,1610612765,106.0,101.0,0.5,0.384,1,2009-03-18,70,45,25,0.643,67,33,34,0.493
20801018,1610612756,1610612755,126.0,116.0,0.5760000000000001,0.5489999999999999,1,2009-03-18,68,37,31,0.544,66,34,32,0.515
20801019,1610612746,1610612764,123.0,108.0,0.588,0.529,1,2009-03-18,68,17,51,0.25,69,16,53,0.2319999999999999
20801001,1610612737,1610612758,119.0,97.0,0.5579999999999999,0.392,1,2009-03-17,68,40,28,0.588,67,14,53,0.209
20801002,1610612739,1610612753,97.0,93.0,0.4639999999999999,0.456,1,2009-03-17,67,54,13,0.8059999999999999,67,49,18,0.731
20801003,1610612741,1610612738,127.0,121.0,0.53,0.494,1,2009-03-17,68,31,37,0.456,68,50,18,0.735
20801004,1610612742,1610612765,103.0,101.0,0.5670000000000001,0.424,1,2009-03-17,68,41,27,0.603,66,33,33,0.5
20801005,1610612759,1610612750,93.0,86.0,0.425,0.466,1,2009-03-17,67,45,22,0.672,67,20,47,0.299
20801006,1610612762,1610612764,103.0,88.0,0.506,0.356,1,2009-03-17,68,42,26,0.618,68,16,52,0.235
20801007,1610612744,1610612746,127.0,120.0,0.536,0.412,1,2009-03-17,67,24,43,0.358,67,16,51,0.239
20801008,1610612747,1610612755,93.0,94.0,0.5,0.442,0,2009-03-17,67,53,14,0.7909999999999999,65,34,31,0.523
20800996,1610612766,1610612761,112.0,86.0,0.494,0.38,1,2009-03-16,67,29,38,0.433,68,24,44,0.353
20800997,1610612763,1610612757,92.0,103.0,0.439,0.487,0,2009-03-16,66,17,49,0.258,67,42,25,0.627
20800998,1610612740,1610612745,84.0,95.0,0.397,0.451,0,2009-03-16,66,41,25,0.621,69,44,25,0.638
20800999,1610612760,1610612759,78.0,76.0,0.358,0.418,1,2009-03-16,67,19,48,0.284,66,44,22,0.667
20801000,1610612743,1610612751,121.0,96.0,0.455,0.487,1,2009-03-16,68,43,25,0.632,67,28,39,0.418
20800990,1610612761,1610612754,110.0,87.0,0.4529999999999999,0.376,1,2009-03-15,67,24,43,0.358,68,28,40,0.412
20800985,1610612737,1610612757,98.0,80.0,0.512,0.4639999999999999,1,2009-03-15,67,39,28,0.5820000000000001,66,41,25,0.621
20800987,1610612765,1610612763,84.0,89.0,0.469,0.471,0,2009-03-15,65,33,32,0.508,65,17,48,0.262
20800988,1610612749,1610612738,86.0,77.0,0.326,0.377,1,2009-03-15,69,31,38,0.449,67,50,17,0.746
20800989,1610612755,1610612748,85.0,77.0,0.423,0.412,1,2009-03-15,64,33,31,0.516,66,36,30,0.545
20800991,1610612747,1610612742,107.0,100.0,0.525,0.3979999999999999,1,2009-03-15,66,53,13,0.8029999999999999,67,40,27,0.597
20800986,1610612739,1610612752,98.0,93.0,0.476,0.3720000000000001,1,2009-03-15,66,53,13,0.8029999999999999,66,28,38,0.424
20800992,1610612753,1610612762,105.0,87.0,0.444,0.3720000000000001,1,2009-03-15,66,49,17,0.742,67,41,26,0.612
20800993,1610612764,1610612758,106.0,104.0,0.474,0.44,1,2009-03-15,67,16,51,0.239,66,14,52,0.212
20800994,1610612744,1610612756,130.0,154.0,0.484,0.621,0,2009-03-15,66,23,43,0.348,67,36,31,0.537
20800995,1610612746,1610612751,107.0,105.0,0.5,0.507,1,2009-03-15,66,16,50,0.242,66,28,38,0.424
20800979,1610612748,1610612762,140.0,129.0,0.462,0.485,1,2009-03-14,65,36,29,0.5539999999999999,66,41,25,0.621
20800980,1610612750,1610612766,108.0,100.0,0.531,0.5,1,2009-03-14,66,20,46,0.303,66,28,38,0.424
20800981,1610612741,1610612740,97.0,79.0,0.471,0.4320000000000001,1,2009-03-14,67,30,37,0.4479999999999999,65,41,24,0.631
20800982,1610612745,1610612759,85.0,88.0,0.418,0.42,0,2009-03-14,68,43,25,0.632,65,44,21,0.677
20800983,1610612743,1610612746,107.0,94.0,0.462,0.39,1,2009-03-14,67,42,25,0.627,65,15,50,0.231
20800984,1610612756,1610612760,106.0,95.0,0.487,0.4629999999999999,1,2009-03-14,66,35,31,0.53,66,18,48,0.273
20800968,1610612766,1610612745,86.0,91.0,0.425,0.507,0,2009-03-13,65,28,37,0.431,67,43,24,0.642
20800969,1610612755,1610612741,104.0,101.0,0.535,0.455,1,2009-03-13,63,32,31,0.508,66,29,37,0.439
20800970,1610612761,1610612765,95.0,99.0,0.406,0.494,0,2009-03-13,66,23,43,0.348,64,33,31,0.516
20800971,1610612764,1610612753,103.0,112.0,0.487,0.512,0,2009-03-13,66,15,51,0.2269999999999999,65,48,17,0.738
20800972,1610612737,1610612754,101.0,87.0,0.477,0.411,1,2009-03-13,66,38,28,0.5760000000000001,67,28,39,0.418
20800973,1610612738,1610612763,102.0,92.0,0.5,0.423,1,2009-03-13,66,50,16,0.758,64,16,48,0.25
20800974,1610612750,1610612752,94.0,102.0,0.425,0.391,0,2009-03-13,65,19,46,0.292,65,28,37,0.431
20800975,1610612749,1610612740,86.0,95.0,0.4379999999999999,0.466,0,2009-03-13,68,30,38,0.441,64,41,23,0.6409999999999999
20800976,1610612757,1610612751,109.0,100.0,0.451,0.462,1,2009-03-13,65,41,24,0.631,65,28,37,0.431
20800977,1610612758,1610612739,123.0,126.0,0.483,0.5,0,2009-03-13,65,14,51,0.215,65,52,13,0.8
20800978,1610612744,1610612742,119.0,110.0,0.4589999999999999,0.4270000000000001,1,2009-03-13,65,23,42,0.354,66,40,26,0.606
20800966,1610612759,1610612747,95.0,102.0,0.521,0.518,0,2009-03-12,64,43,21,0.672,65,52,13,0.8
20800967,1610612756,1610612739,111.0,119.0,0.5479999999999999,0.471,0,2009-03-12,65,34,31,0.523,64,51,13,0.797
20800955,1610612737,1610612762,100.0,93.0,0.507,0.4529999999999999,1,2009-03-11,65,37,28,0.569,65,41,24,0.631
20800956,1610612753,1610612741,107.0,79.0,0.476,0.314,1,2009-03-11,64,47,17,0.7340000000000001,65,29,36,0.446
20800957,1610612755,1610612761,115.0,106.0,0.564,0.524,1,2009-03-11,62,31,31,0.5,65,23,42,0.354
20800958,1610612764,1610612740,98.0,109.0,0.452,0.526,0,2009-03-11,65,15,50,0.231,63,40,23,0.635
20800959,1610612765,1610612752,111.0,116.0,0.469,0.434,0,2009-03-11,63,32,31,0.508,64,27,37,0.422
20800960,1610612748,1610612738,107.0,99.0,0.5,0.452,1,2009-03-11,64,35,29,0.547,65,49,16,0.754
20800961,1610612750,1610612763,104.0,79.0,0.487,0.4379999999999999,1,2009-03-11,64,19,45,0.297,63,16,47,0.254
20800962,1610612745,1610612747,96.0,102.0,0.513,0.5,0,2009-03-11,66,42,24,0.636,64,51,13,0.797
20800963,1610612743,1610612760,112.0,99.0,0.5,0.402,1,2009-03-11,66,41,25,0.621,65,18,47,0.2769999999999999
20800964,1610612757,1610612742,89.0,93.0,0.41,0.4629999999999999,0,2009-03-11,64,40,24,0.625,65,40,25,0.615
20800965,1610612744,1610612751,116.0,112.0,0.45,0.471,1,2009-03-11,64,22,42,0.344,64,28,36,0.4379999999999999
20800949,1610612754,1610612762,100.0,112.0,0.461,0.476,0,2009-03-10,66,28,38,0.424,64,41,23,0.6409999999999999
20800950,1610612749,1610612752,112.0,120.0,0.43,0.474,0,2009-03-10,67,30,37,0.4479999999999999,63,26,37,0.413
20800951,1610612759,1610612766,100.0,86.0,0.488,0.441,1,2009-03-10,63,43,20,0.6829999999999999,64,28,36,0.4379999999999999
20800952,1610612756,1610612742,117.0,122.0,0.552,0.534,0,2009-03-10,64,34,30,0.531,64,39,25,0.609
20800953,1610612758,1610612760,98.0,99.0,0.482,0.446,0,2009-03-10,64,14,50,0.2189999999999999,64,18,46,0.281
20800954,1610612746,1610612739,83.0,87.0,0.39,0.39,0,2009-03-10,64,15,49,0.2339999999999999,63,50,13,0.794
20800943,1610612737,1610612740,89.0,79.0,0.4029999999999999,0.4,1,2009-03-09,64,36,28,0.563,62,39,23,0.629
20800944,1610612765,1610612753,98.0,94.0,0.44,0.4529999999999999,1,2009-03-09,62,32,30,0.516,63,46,17,0.73
20800945,1610612748,1610612741,130.0,127.0,0.462,0.462,1,2009-03-09,63,34,29,0.54,64,29,35,0.4529999999999999
20800946,1610612750,1610612764,99.0,110.0,0.435,0.526,0,2009-03-09,63,18,45,0.286,64,15,49,0.2339999999999999
20800947,1610612743,1610612745,95.0,97.0,0.381,0.425,0,2009-03-09,65,40,25,0.615,65,42,23,0.6459999999999999
20800948,1610612757,1610612747,111.0,94.0,0.482,0.439,1,2009-03-09,63,40,23,0.635,63,50,13,0.794
20800937,1610612761,1610612762,101.0,109.0,0.487,0.472,0,2009-03-08,64,23,41,0.359,63,40,23,0.635
20800936,1610612738,1610612753,79.0,86.0,0.395,0.44,0,2009-03-08,64,49,15,0.7659999999999999,62,46,16,0.742
20800938,1610612759,1610612756,103.0,98.0,0.5,0.444,1,2009-03-08,62,42,20,0.677,63,34,29,0.54
20800939,1610612751,1610612752,106.0,101.0,0.5,0.513,1,2009-03-08,63,28,35,0.444,62,25,37,0.4029999999999999
20800940,1610612745,1610612763,93.0,83.0,0.474,0.381,1,2009-03-08,64,41,23,0.6409999999999999,62,16,46,0.258
20800941,1610612760,1610612755,89.0,74.0,0.479,0.3939999999999999,1,2009-03-08,63,17,46,0.27,61,30,31,0.4920000000000001
20800942,1610612758,1610612743,114.0,106.0,0.513,0.424,1,2009-03-08,63,14,49,0.222,64,40,24,0.625
20800927,1610612737,1610612765,87.0,83.0,0.429,0.405,1,2009-03-07,63,35,28,0.556,61,31,30,0.508
20800928,1610612739,1610612748,99.0,89.0,0.493,0.444,1,2009-03-07,62,49,13,0.79,62,33,29,0.532
20800929,1610612752,1610612766,105.0,114.0,0.442,0.5539999999999999,0,2009-03-07,61,25,36,0.41,63,28,35,0.444
20800930,1610612763,1610612755,105.0,110.0,0.564,0.5,0,2009-03-07,61,16,45,0.262,60,30,30,0.5
20800931,1610612740,1610612760,108.0,90.0,0.5379999999999999,0.3979999999999999,1,2009-03-07,61,39,22,0.639,62,16,46,0.258
20800932,1610612742,1610612764,119.0,103.0,0.544,0.527,1,2009-03-07,63,38,25,0.603,63,14,49,0.222
20800933,1610612749,1610612744,127.0,120.0,0.474,0.519,1,2009-03-07,66,30,36,0.455,63,21,42,0.3329999999999999
20800934,1610612757,1610612750,95.0,93.0,0.449,0.474,1,2009-03-07,62,39,23,0.629,62,18,44,0.29
20800935,1610612746,1610612754,105.0,106.0,0.494,0.461,0,2009-03-07,63,15,48,0.238,65,28,37,0.431
20800917,1610612766,1610612737,98.0,91.0,0.539,0.4629999999999999,1,2009-03-06,62,27,35,0.435,62,34,28,0.5479999999999999
20800918,1610612753,1610612751,105.0,102.0,0.4270000000000001,0.494,1,2009-03-06,61,45,16,0.738,62,27,35,0.435
20800919,1610612761,1610612748,102.0,108.0,0.506,0.506,0,2009-03-06,63,23,40,0.365,61,33,28,0.541
20800920,1610612738,1610612739,105.0,94.0,0.542,0.455,1,2009-03-06,63,49,14,0.778,61,48,13,0.787
20800921,1610612765,1610612744,108.0,91.0,0.473,0.384,1,2009-03-06,60,31,29,0.517,62,21,41,0.3389999999999999
20800922,1610612741,1610612749,117.0,102.0,0.487,0.447,1,2009-03-06,63,29,34,0.46,65,29,36,0.446
20800923,1610612745,1610612756,116.0,112.0,0.488,0.489,1,2009-03-06,63,40,23,0.635,62,34,28,0.5479999999999999
20800924,1610612759,1610612764,100.0,78.0,0.52,0.429,1,2009-03-06,61,41,20,0.672,62,14,48,0.226
20800925,1610612747,1610612750,110.0,90.0,0.488,0.33,1,2009-03-06,62,50,12,0.8059999999999999,61,18,43,0.295
20800926,1610612762,1610612743,97.0,91.0,0.4270000000000001,0.395,1,2009-03-06,62,39,23,0.629,63,40,23,0.635
20800915,1610612740,1610612742,104.0,88.0,0.56,0.395,1,2009-03-05,60,38,22,0.633,62,37,25,0.597
20800916,1610612743,1610612757,106.0,90.0,0.531,0.472,1,2009-03-05,62,40,22,0.645,61,38,23,0.623
20800905,1610612739,1610612749,91.0,73.0,0.419,0.373,1,2009-03-04,60,48,12,0.8,64,29,35,0.4529999999999999
20800906,1610612748,1610612756,135.0,129.0,0.5710000000000001,0.5579999999999999,1,2009-03-04,60,32,28,0.5329999999999999,61,34,27,0.557
20800907,1610612751,1610612738,111.0,115.0,0.494,0.612,0,2009-03-04,61,27,34,0.4429999999999999,62,48,14,0.774
20800908,1610612752,1610612737,109.0,105.0,0.465,0.518,1,2009-03-04,60,25,35,0.417,61,34,27,0.557
20800909,1610612760,1610612764,88.0,83.0,0.5,0.4,1,2009-03-04,61,16,45,0.262,61,14,47,0.23
20800910,1610612741,1610612744,110.0,88.0,0.4529999999999999,0.4,1,2009-03-04,62,28,34,0.452,61,21,40,0.344
20800911,1610612742,1610612759,107.0,102.0,0.536,0.4589999999999999,1,2009-03-04,61,37,24,0.607,60,40,20,0.667
20800912,1610612762,1610612745,101.0,94.0,0.5,0.425,1,2009-03-04,61,38,23,0.623,62,39,23,0.629
20800913,1610612757,1610612754,107.0,105.0,0.452,0.518,1,2009-03-04,60,38,22,0.633,64,27,37,0.422
20800914,1610612746,1610612763,95.0,118.0,0.479,0.561,0,2009-03-04,62,15,47,0.242,60,16,44,0.267
20800897,1610612766,1610612741,96.0,80.0,0.487,0.39,1,2009-03-03,61,26,35,0.426,61,27,34,0.4429999999999999
20800898,1610612753,1610612756,111.0,99.0,0.474,0.444,1,2009-03-03,60,44,16,0.733,60,34,26,0.5670000000000001
20800899,1610612765,1610612743,100.0,95.0,0.472,0.446,1,2009-03-03,59,30,29,0.508,61,39,22,0.639
20800900,1610612749,1610612751,95.0,99.0,0.385,0.429,0,2009-03-03,63,29,34,0.46,60,27,33,0.45
20800901,1610612750,1610612744,94.0,118.0,0.359,0.457,0,2009-03-03,60,18,42,0.3,60,21,39,0.35
20800902,1610612745,1610612761,107.0,97.0,0.506,0.4270000000000001,1,2009-03-03,61,39,22,0.639,62,23,39,0.371
20800903,1610612758,1610612754,109.0,117.0,0.4679999999999999,0.473,0,2009-03-03,62,13,49,0.21,63,27,36,0.429
20800904,1610612747,1610612763,99.0,89.0,0.444,0.41,1,2009-03-03,61,49,12,0.8029999999999999,59,15,44,0.254
20800892,1610612755,1610612740,91.0,98.0,0.45,0.4379999999999999,0,2009-03-02,59,29,30,0.4920000000000001,59,37,22,0.627
20800893,1610612764,1610612737,89.0,98.0,0.457,0.521,0,2009-03-02,60,14,46,0.233,60,34,26,0.5670000000000001
20800894,1610612748,1610612739,100.0,107.0,0.4639999999999999,0.487,0,2009-03-02,59,31,28,0.525,59,47,12,0.797
20800895,1610612760,1610612742,96.0,87.0,0.494,0.425,1,2009-03-02,60,15,45,0.25,60,36,24,0.6
20800896,1610612746,1610612759,78.0,106.0,0.368,0.478,0,2009-03-02,61,15,46,0.246,59,40,19,0.6779999999999999
20800883,1610612738,1610612765,95.0,105.0,0.467,0.485,0,2009-03-01,61,47,14,0.77,58,29,29,0.5
20800884,1610612756,1610612747,118.0,111.0,0.5579999999999999,0.447,1,2009-03-01,59,34,25,0.5760000000000001,60,48,12,0.8
20800886,1610612751,1610612740,96.0,99.0,0.446,0.4,0,2009-03-01,59,26,33,0.441,58,36,22,0.621
20800887,1610612754,1610612743,100.0,94.0,0.385,0.362,1,2009-03-01,62,26,36,0.419,60,39,21,0.65
20800888,1610612750,1610612745,94.0,105.0,0.482,0.5329999999999999,0,2009-03-01,59,18,41,0.305,60,38,22,0.633
20800885,1610612737,1610612739,87.0,88.0,0.419,0.446,0,2009-03-01,59,33,26,0.5589999999999999,58,46,12,0.7929999999999999
20800889,1610612757,1610612759,102.0,84.0,0.486,0.442,1,2009-03-01,59,37,22,0.627,58,39,19,0.672
20800890,1610612742,1610612761,109.0,98.0,0.441,0.374,1,2009-03-01,59,36,23,0.61,61,23,38,0.377
20800891,1610612744,1610612762,104.0,112.0,0.513,0.462,0,2009-03-01,59,20,39,0.3389999999999999,60,37,23,0.617
20800876,1610612755,1610612753,100.0,106.0,0.481,0.474,0,2009-02-28,58,29,29,0.5,59,43,16,0.7290000000000001
20800877,1610612748,1610612752,120.0,115.0,0.485,0.481,1,2009-02-28,58,31,27,0.534,59,24,35,0.407
20800878,1610612763,1610612760,92.0,99.0,0.479,0.407,0,2009-02-28,58,15,43,0.259,59,14,45,0.237
20800879,1610612741,1610612745,105.0,102.0,0.4679999999999999,0.476,1,2009-02-28,60,27,33,0.45,59,37,22,0.627
20800880,1610612749,1610612764,109.0,93.0,0.526,0.479,1,2009-02-28,62,29,33,0.4679999999999999,59,14,45,0.237
20800881,1610612762,1610612758,102.0,89.0,0.526,0.4379999999999999,1,2009-02-28,59,36,23,0.61,61,13,48,0.213
20800882,1610612746,1610612766,95.0,100.0,0.507,0.476,0,2009-02-28,60,15,45,0.25,60,25,35,0.417
20800864,1610612753,1610612765,85.0,93.0,0.471,0.493,0,2009-02-27,58,42,16,0.7240000000000001,57,28,29,0.491
20800865,1610612764,1610612741,113.0,90.0,0.506,0.395,1,2009-02-27,58,14,44,0.241,59,26,33,0.441
20800866,1610612737,1610612748,91.0,83.0,0.43,0.412,1,2009-02-27,58,33,25,0.569,57,30,27,0.526
20800867,1610612738,1610612754,104.0,99.0,0.527,0.4370000000000001,1,2009-02-27,60,47,13,0.7829999999999999,61,25,36,0.41
20800868,1610612752,1610612755,103.0,108.0,0.45,0.485,0,2009-02-27,58,24,34,0.414,57,29,28,0.509
20800863,1610612740,1610612749,95.0,94.0,0.476,0.386,1,2009-02-27,57,35,22,0.614,61,28,33,0.4589999999999999
20800869,1610612750,1610612757,82.0,102.0,0.433,0.5,0,2009-02-27,58,18,40,0.31,58,36,22,0.621
20800870,1610612742,1610612760,110.0,108.0,0.447,0.406,1,2009-02-27,58,35,23,0.603,58,13,45,0.2239999999999999
20800871,1610612743,1610612747,90.0,79.0,0.417,0.298,1,2009-02-27,59,39,20,0.6609999999999999,59,48,11,0.8140000000000001
20800872,1610612756,1610612761,133.0,113.0,0.561,0.466,1,2009-02-27,58,33,25,0.569,60,23,37,0.3829999999999999
20800873,1610612759,1610612739,86.0,97.0,0.418,0.434,0,2009-02-27,57,39,18,0.684,57,45,12,0.789
20800874,1610612758,1610612746,98.0,86.0,0.475,0.382,1,2009-02-27,60,13,47,0.217,59,15,44,0.254
20800875,1610612744,1610612766,109.0,112.0,0.494,0.541,0,2009-02-27,58,20,38,0.345,59,24,35,0.407
20800861,1610612745,1610612739,93.0,74.0,0.493,0.3379999999999999,1,2009-02-26,58,37,21,0.638,56,44,12,0.7859999999999999
20800862,1610612747,1610612756,132.0,106.0,0.574,0.429,1,2009-02-26,58,48,10,0.828,57,32,25,0.561
20800850,1610612754,1610612763,104.0,99.0,0.469,0.494,1,2009-02-25,60,25,35,0.417,57,15,42,0.263
20800851,1610612764,1610612755,98.0,106.0,0.475,0.5,0,2009-02-25,57,13,44,0.228,56,28,28,0.5
20800852,1610612751,1610612741,111.0,99.0,0.47,0.422,1,2009-02-25,58,26,32,0.4479999999999999,58,26,32,0.4479999999999999
20800853,1610612752,1610612753,109.0,114.0,0.414,0.513,0,2009-02-25,57,24,33,0.421,57,42,15,0.737
20800854,1610612750,1610612762,103.0,120.0,0.4629999999999999,0.532,0,2009-02-25,57,18,39,0.316,58,35,23,0.603
20800855,1610612740,1610612765,90.0,87.0,0.425,0.4270000000000001,1,2009-02-25,56,34,22,0.607,56,27,29,0.482
20800856,1610612742,1610612749,116.0,96.0,0.534,0.42,1,2009-02-25,57,34,23,0.596,60,28,32,0.467
20800857,1610612759,1610612757,99.0,84.0,0.5379999999999999,0.376,1,2009-02-25,56,39,17,0.696,57,35,22,0.614
20800858,1610612743,1610612737,110.0,109.0,0.506,0.5,1,2009-02-25,58,38,20,0.655,57,32,25,0.561
20800859,1610612758,1610612766,91.0,98.0,0.397,0.486,0,2009-02-25,59,12,47,0.203,58,23,35,0.397
20800860,1610612746,1610612738,93.0,91.0,0.446,0.47,1,2009-02-25,58,15,43,0.259,59,46,13,0.78
20800842,1610612739,1610612763,94.0,79.0,0.431,0.42,1,2009-02-24,55,44,11,0.8,56,15,41,0.268
20800843,1610612761,1610612750,118.0,110.0,0.535,0.5,1,2009-02-24,59,23,36,0.39,56,18,38,0.321
20800844,1610612748,1610612765,103.0,91.0,0.5,0.449,1,2009-02-24,56,30,26,0.536,55,27,28,0.491
20800845,1610612741,1610612753,120.0,102.0,0.565,0.449,1,2009-02-24,57,26,31,0.456,56,41,15,0.732
20800846,1610612760,1610612747,93.0,107.0,0.418,0.526,0,2009-02-24,57,13,44,0.228,57,47,10,0.825
20800847,1610612745,1610612757,98.0,94.0,0.439,0.44,1,2009-02-24,57,36,21,0.632,56,35,21,0.625
20800848,1610612759,1610612742,93.0,76.0,0.4629999999999999,0.342,1,2009-02-24,55,38,17,0.691,56,33,23,0.589
20800849,1610612756,1610612766,112.0,102.0,0.526,0.469,1,2009-02-24,56,32,24,0.5710000000000001,57,22,35,0.386
20800836,1610612751,1610612755,98.0,96.0,0.466,0.486,1,2009-02-23,57,25,32,0.439,55,27,28,0.491
20800837,1610612752,1610612754,123.0,119.0,0.4379999999999999,0.457,1,2009-02-23,56,24,32,0.429,59,24,35,0.407
20800838,1610612743,1610612738,76.0,114.0,0.347,0.494,0,2009-02-23,57,37,20,0.649,58,46,12,0.7929999999999999
20800839,1610612762,1610612737,108.0,89.0,0.5,0.5,1,2009-02-23,57,34,23,0.596,56,32,24,0.5710000000000001
20800840,1610612758,1610612740,105.0,112.0,0.481,0.506,0,2009-02-23,58,12,46,0.207,55,33,22,0.6
20800841,1610612746,1610612744,118.0,105.0,0.511,0.4429999999999999,1,2009-02-23,57,14,43,0.246,57,20,37,0.351
20800827,1610612754,1610612741,98.0,91.0,0.4,0.43,1,2009-02-22,58,24,34,0.414,56,25,31,0.446
20800828,1610612761,1610612752,111.0,100.0,0.512,0.429,1,2009-02-22,58,22,36,0.379,55,23,32,0.418
20800829,1610612756,1610612738,108.0,128.0,0.5,0.63,0,2009-02-22,55,31,24,0.564,57,45,12,0.789
20800830,1610612745,1610612766,99.0,78.0,0.5,0.36,1,2009-02-22,56,35,21,0.625,56,22,34,0.3929999999999999
20800831,1610612749,1610612743,120.0,117.0,0.4589999999999999,0.507,1,2009-02-22,59,28,31,0.475,56,37,19,0.6609999999999999
20800832,1610612753,1610612748,122.0,99.0,0.547,0.416,1,2009-02-22,55,41,14,0.745,55,29,26,0.527
20800833,1610612757,1610612746,116.0,87.0,0.522,0.3670000000000001,1,2009-02-22,55,35,20,0.636,56,13,43,0.2319999999999999
20800834,1610612750,1610612747,108.0,111.0,0.5,0.524,0,2009-02-22,55,18,37,0.327,56,46,10,0.821
20800835,1610612739,1610612765,99.0,78.0,0.455,0.3720000000000001,1,2009-02-22,54,43,11,0.7959999999999999,54,27,27,0.5
20800822,1610612748,1610612755,97.0,91.0,0.514,0.371,1,2009-02-21,54,29,25,0.537,54,27,27,0.5
20800823,1610612764,1610612759,67.0,98.0,0.3329999999999999,0.5,0,2009-02-21,56,13,43,0.2319999999999999,54,37,17,0.685
20800824,1610612742,1610612758,116.0,95.0,0.537,0.434,1,2009-02-21,55,33,22,0.6,57,12,45,0.211
20800825,1610612762,1610612740,102.0,88.0,0.494,0.457,1,2009-02-21,56,33,23,0.589,54,32,22,0.593
20800826,1610612744,1610612760,133.0,120.0,0.563,0.523,1,2009-02-21,56,20,36,0.357,56,13,43,0.2319999999999999
20800811,1610612766,1610612753,80.0,92.0,0.375,0.425,0,2009-02-20,55,22,33,0.4,54,40,14,0.741
20800812,1610612752,1610612761,127.0,97.0,0.495,0.409,1,2009-02-20,54,23,31,0.426,57,21,36,0.368
20800813,1610612763,1610612758,106.0,115.0,0.3829999999999999,0.466,0,2009-02-20,55,15,40,0.273,56,12,44,0.214
20800814,1610612750,1610612754,105.0,112.0,0.439,0.482,0,2009-02-20,54,18,36,0.3329999999999999,57,23,34,0.4039999999999999
20800815,1610612751,1610612764,96.0,107.0,0.379,0.471,0,2009-02-20,56,24,32,0.429,55,13,42,0.236
20800817,1610612745,1610612742,93.0,86.0,0.44,0.395,1,2009-02-20,55,34,21,0.618,54,32,22,0.593
20800816,1610612741,1610612743,116.0,99.0,0.506,0.4529999999999999,1,2009-02-20,55,25,30,0.455,55,37,18,0.6729999999999999
20800818,1610612749,1610612739,103.0,111.0,0.487,0.507,0,2009-02-20,58,27,31,0.466,53,42,11,0.792
20800819,1610612756,1610612760,140.0,118.0,0.5820000000000001,0.4579999999999999,1,2009-02-20,54,31,23,0.574,55,13,42,0.236
20800820,1610612757,1610612737,108.0,98.0,0.478,0.474,1,2009-02-20,54,34,20,0.63,55,32,23,0.5820000000000001
20800821,1610612747,1610612740,115.0,111.0,0.413,0.457,1,2009-02-20,55,45,10,0.818,53,32,21,0.604
20800809,1610612765,1610612759,79.0,83.0,0.402,0.408,0,2009-02-19,53,27,26,0.509,53,36,17,0.679
20800810,1610612762,1610612738,90.0,85.0,0.416,0.4370000000000001,1,2009-02-19,55,32,23,0.5820000000000001,56,44,12,0.7859999999999999
20800798,1610612766,1610612754,103.0,94.0,0.41,0.418,1,2009-02-18,54,22,32,0.407,56,22,34,0.3929999999999999
20800799,1610612761,1610612739,76.0,93.0,0.365,0.58,0,2009-02-18,56,21,35,0.375,52,41,11,0.7879999999999999
20800803,1610612755,1610612743,89.0,101.0,0.326,0.487,0,2009-02-18,53,27,26,0.509,54,37,17,0.685
20800800,1610612748,1610612750,104.0,111.0,0.469,0.536,0,2009-02-18,53,28,25,0.528,53,18,35,0.34
20800801,1610612749,1610612741,104.0,113.0,0.3929999999999999,0.462,0,2009-02-18,57,27,30,0.474,54,24,30,0.444
20800802,1610612740,1610612753,117.0,85.0,0.5820000000000001,0.371,1,2009-02-18,52,32,20,0.615,53,39,14,0.736
20800804,1610612742,1610612751,113.0,98.0,0.545,0.475,1,2009-02-18,53,32,21,0.604,55,24,31,0.436
20800805,1610612757,1610612763,94.0,90.0,0.456,0.435,1,2009-02-18,53,33,20,0.623,54,15,39,0.278
20800806,1610612758,1610612737,100.0,105.0,0.446,0.42,0,2009-02-18,55,11,44,0.2,54,32,22,0.593
20800807,1610612744,1610612747,121.0,129.0,0.516,0.5,0,2009-02-18,55,19,36,0.345,54,44,10,0.815
20800808,1610612746,1610612756,119.0,142.0,0.477,0.589,0,2009-02-18,55,13,42,0.236,53,30,23,0.5660000000000001
20800788,1610612754,1610612755,100.0,91.0,0.494,0.385,1,2009-02-17,55,22,33,0.4,52,27,25,0.519
20800789,1610612753,1610612766,107.0,102.0,0.4379999999999999,0.4629999999999999,1,2009-02-17,52,39,13,0.75,53,21,32,0.396
20800790,1610612764,1610612750,111.0,103.0,0.513,0.407,1,2009-02-17,54,12,42,0.222,52,17,35,0.327
20800791,1610612765,1610612749,86.0,92.0,0.436,0.405,0,2009-02-17,52,27,25,0.519,56,27,29,0.482
20800792,1610612752,1610612759,112.0,107.0,0.479,0.43,1,2009-02-17,53,22,31,0.415,52,35,17,0.6729999999999999
20800793,1610612760,1610612740,98.0,100.0,0.429,0.494,0,2009-02-17,54,13,41,0.241,51,31,20,0.608
20800794,1610612745,1610612751,114.0,88.0,0.455,0.4,1,2009-02-17,54,33,21,0.611,54,24,30,0.444
20800795,1610612756,1610612746,140.0,100.0,0.622,0.434,1,2009-02-17,52,29,23,0.5579999999999999,54,13,41,0.241
20800796,1610612762,1610612763,117.0,99.0,0.488,0.467,1,2009-02-17,54,31,23,0.574,53,15,38,0.283
20800797,1610612747,1610612737,96.0,83.0,0.4379999999999999,0.369,1,2009-02-17,53,43,10,0.8109999999999999,53,31,22,0.585
20800785,1610612741,1610612748,93.0,95.0,0.4429999999999999,0.487,0,2009-02-12,53,23,30,0.434,52,28,24,0.5379999999999999
20800786,1610612742,1610612738,92.0,99.0,0.395,0.486,0,2009-02-12,52,31,21,0.596,55,44,11,0.8
20800787,1610612744,1610612757,105.0,98.0,0.408,0.47,1,2009-02-12,54,19,35,0.352,52,32,20,0.615
20800773,1610612766,1610612764,101.0,89.0,0.5,0.417,1,2009-02-11,52,21,31,0.4039999999999999,53,11,42,0.208
20800774,1610612739,1610612756,109.0,92.0,0.461,0.486,1,2009-02-11,51,40,11,0.784,51,28,23,0.5489999999999999
20800775,1610612753,1610612743,73.0,82.0,0.304,0.409,0,2009-02-11,51,38,13,0.745,53,36,17,0.679
20800776,1610612755,1610612763,91.0,87.0,0.514,0.466,1,2009-02-11,51,27,24,0.529,52,15,37,0.288
20800777,1610612761,1610612759,91.0,89.0,0.449,0.419,1,2009-02-11,55,21,34,0.382,51,35,16,0.6859999999999999
20800778,1610612765,1610612737,95.0,99.0,0.494,0.514,0,2009-02-11,51,27,24,0.529,52,31,21,0.596
20800779,1610612749,1610612754,122.0,110.0,0.5379999999999999,0.43,1,2009-02-11,55,26,29,0.473,54,21,33,0.389
20800780,1610612740,1610612738,77.0,89.0,0.406,0.4429999999999999,0,2009-02-11,50,30,20,0.6,54,43,11,0.7959999999999999
20800781,1610612745,1610612758,94.0,82.0,0.447,0.471,1,2009-02-11,53,32,21,0.604,54,11,43,0.204
20800782,1610612762,1610612747,113.0,109.0,0.586,0.467,1,2009-02-11,53,30,23,0.5660000000000001,52,42,10,0.8079999999999999
20800783,1610612757,1610612760,106.0,92.0,0.488,0.39,1,2009-02-11,51,32,19,0.627,53,13,40,0.245
20800784,1610612746,1610612752,128.0,124.0,0.515,0.445,1,2009-02-11,53,13,40,0.245,52,21,31,0.4039999999999999
20800764,1610612737,1610612764,111.0,90.0,0.4589999999999999,0.446,1,2009-02-10,51,30,21,0.588,52,11,41,0.212
20800765,1610612754,1610612739,96.0,95.0,0.44,0.436,1,2009-02-10,53,21,32,0.396,50,39,11,0.78
20800766,1610612748,1610612743,82.0,99.0,0.4379999999999999,0.506,0,2009-02-10,51,27,24,0.529,52,35,17,0.6729999999999999
20800767,1610612751,1610612759,93.0,108.0,0.488,0.526,0,2009-02-10,53,24,29,0.4529999999999999,50,35,15,0.7
20800768,1610612750,1610612761,102.0,110.0,0.4270000000000001,0.531,0,2009-02-10,51,17,34,0.3329999999999999,54,20,34,0.37
20800769,1610612741,1610612765,107.0,102.0,0.474,0.494,1,2009-02-10,52,23,29,0.442,50,27,23,0.54
20800770,1610612742,1610612758,118.0,100.0,0.5529999999999999,0.4429999999999999,1,2009-02-10,51,31,20,0.608,53,11,42,0.208
20800771,1610612744,1610612752,144.0,127.0,0.5529999999999999,0.544,1,2009-02-10,53,18,35,0.34,51,21,30,0.412
20800772,1610612747,1610612760,105.0,98.0,0.455,0.3929999999999999,1,2009-02-10,51,42,9,0.8240000000000001,52,13,39,0.25
20800760,1610612766,1610612746,94.0,73.0,0.52,0.39,1,2009-02-09,51,20,31,0.392,52,12,40,0.231
20800761,1610612755,1610612756,108.0,91.0,0.43,0.424,1,2009-02-09,50,26,24,0.52,50,28,22,0.56
20800762,1610612763,1610612740,85.0,80.0,0.364,0.295,1,2009-02-09,51,15,36,0.294,49,30,19,0.612
20800763,1610612749,1610612745,124.0,112.0,0.528,0.425,1,2009-02-09,54,25,29,0.4629999999999999,52,31,21,0.596
20800750,1610612738,1610612759,99.0,105.0,0.506,0.487,0,2009-02-08,53,42,11,0.792,49,34,15,0.6940000000000001
20800751,1610612739,1610612747,91.0,101.0,0.391,0.489,0,2009-02-08,49,39,10,0.7959999999999999,50,41,9,0.82
20800752,1610612748,1610612766,96.0,92.0,0.56,0.475,1,2009-02-08,50,27,23,0.54,50,19,31,0.38
20800753,1610612753,1610612751,101.0,84.0,0.479,0.395,1,2009-02-08,50,38,12,0.76,52,24,28,0.462
20800754,1610612757,1610612752,109.0,108.0,0.537,0.506,1,2009-02-08,50,31,19,0.62,50,21,29,0.42
20800755,1610612764,1610612754,119.0,117.0,0.512,0.534,1,2009-02-08,51,11,40,0.216,52,20,32,0.385
20800756,1610612740,1610612750,101.0,97.0,0.485,0.44,1,2009-02-08,48,30,18,0.625,50,17,33,0.34
20800757,1610612760,1610612758,116.0,113.0,0.529,0.55,1,2009-02-08,51,13,38,0.255,52,11,41,0.212
20800758,1610612765,1610612756,97.0,107.0,0.424,0.494,0,2009-02-08,49,27,22,0.551,49,28,21,0.5710000000000001
20800759,1610612744,1610612762,116.0,96.0,0.519,0.418,1,2009-02-08,52,17,35,0.327,52,29,23,0.5579999999999999
20800743,1610612737,1610612746,97.0,121.0,0.452,0.57,0,2009-02-07,50,29,21,0.58,51,12,39,0.235
20800744,1610612755,1610612748,94.0,84.0,0.435,0.442,1,2009-02-07,49,25,24,0.51,49,26,23,0.531
20800745,1610612751,1610612743,114.0,70.0,0.4679999999999999,0.356,1,2009-02-07,51,24,27,0.471,51,34,17,0.667
20800746,1610612763,1610612761,78.0,70.0,0.385,0.291,1,2009-02-07,50,14,36,0.28,53,19,34,0.358
20800747,1610612742,1610612741,115.0,114.0,0.4639999999999999,0.457,1,2009-02-07,50,30,20,0.6,51,22,29,0.431
20800748,1610612745,1610612750,107.0,90.0,0.494,0.3979999999999999,1,2009-02-07,51,31,20,0.608,49,17,32,0.347
20800749,1610612749,1610612765,121.0,126.0,0.488,0.479,0,2009-02-07,53,24,29,0.4529999999999999,48,27,21,0.563
20800734,1610612766,1610612737,97.0,102.0,0.447,0.408,0,2009-02-06,49,19,30,0.3879999999999999,49,29,20,0.5920000000000001
20800735,1610612754,1610612753,107.0,102.0,0.4379999999999999,0.4379999999999999,1,2009-02-06,51,20,31,0.392,49,37,12,0.755
20800736,1610612752,1610612738,100.0,110.0,0.413,0.513,0,2009-02-06,49,21,28,0.429,52,42,10,0.8079999999999999
20800737,1610612763,1610612746,105.0,126.0,0.493,0.59,0,2009-02-06,49,13,36,0.265,50,11,39,0.22
20800738,1610612740,1610612761,101.0,92.0,0.48,0.507,1,2009-02-06,47,29,18,0.617,52,19,33,0.365
20800739,1610612760,1610612757,102.0,93.0,0.5,0.45,1,2009-02-06,50,12,38,0.24,49,30,19,0.612
20800740,1610612764,1610612743,103.0,124.0,0.4270000000000001,0.563,0,2009-02-06,50,10,40,0.2,50,34,16,0.68
20800741,1610612758,1610612762,107.0,111.0,0.434,0.527,0,2009-02-06,51,11,40,0.216,51,29,22,0.569
20800742,1610612756,1610612744,115.0,105.0,0.5,0.4529999999999999,1,2009-02-06,48,27,21,0.563,51,16,35,0.314
20800731,1610612755,1610612754,99.0,94.0,0.4,0.3929999999999999,1,2009-02-05,48,24,24,0.5,50,19,31,0.38
20800732,1610612738,1610612747,109.0,110.0,0.452,0.477,0,2009-02-05,51,41,10,0.804,49,40,9,0.816
20800733,1610612762,1610612742,115.0,87.0,0.5,0.4,1,2009-02-05,50,28,22,0.56,49,29,20,0.5920000000000001
20800720,1610612753,1610612746,125.0,96.0,0.5660000000000001,0.424,1,2009-02-04,48,37,11,0.7709999999999999,49,10,39,0.204
20800721,1610612761,1610612747,107.0,115.0,0.467,0.506,0,2009-02-04,51,19,32,0.373,48,39,9,0.813
20800722,1610612764,1610612751,88.0,115.0,0.424,0.613,0,2009-02-04,49,10,39,0.204,50,23,27,0.46
20800723,1610612765,1610612748,93.0,90.0,0.493,0.386,1,2009-02-04,47,26,21,0.5529999999999999,48,26,22,0.542
20800724,1610612752,1610612739,102.0,107.0,0.446,0.4629999999999999,0,2009-02-04,48,21,27,0.4379999999999999,48,39,9,0.813
20800725,1610612763,1610612745,104.0,93.0,0.5329999999999999,0.3979999999999999,1,2009-02-04,48,13,35,0.271,50,30,20,0.6
20800726,1610612750,1610612737,86.0,94.0,0.364,0.5,0,2009-02-04,48,17,31,0.354,48,28,20,0.583
20800727,1610612740,1610612741,93.0,107.0,0.362,0.562,0,2009-02-04,46,28,18,0.609,50,22,28,0.44
20800728,1610612760,1610612743,113.0,114.0,0.5,0.505,0,2009-02-04,49,11,38,0.2239999999999999,49,33,16,0.6729999999999999
20800729,1610612742,1610612757,104.0,99.0,0.551,0.481,1,2009-02-04,48,29,19,0.604,48,30,18,0.625
20800730,1610612744,1610612756,124.0,112.0,0.522,0.456,1,2009-02-04,50,16,34,0.32,47,26,21,0.5529999999999999
20800714,1610612739,1610612761,101.0,83.0,0.461,0.397,1,2009-02-03,47,38,9,0.809,50,19,31,0.38
20800715,1610612754,1610612750,111.0,116.0,0.476,0.488,0,2009-02-03,49,19,30,0.3879999999999999,47,17,30,0.362
20800716,1610612755,1610612738,99.0,100.0,0.446,0.539,0,2009-02-03,47,23,24,0.489,50,41,9,0.82
20800717,1610612751,1610612749,99.0,85.0,0.466,0.365,1,2009-02-03,49,22,27,0.449,52,24,28,0.462
20800718,1610612745,1610612741,107.0,100.0,0.44,0.424,1,2009-02-03,49,30,19,0.612,49,21,28,0.429
20800719,1610612743,1610612759,104.0,96.0,0.442,0.4429999999999999,1,2009-02-03,48,32,16,0.667,48,33,15,0.688
20800706,1610612753,1610612742,95.0,105.0,0.4270000000000001,0.534,0,2009-02-02,47,36,11,0.7659999999999999,47,28,19,0.596
20800707,1610612764,1610612763,97.0,113.0,0.457,0.494,0,2009-02-02,48,10,38,0.208,47,12,35,0.255
20800708,1610612748,1610612746,119.0,95.0,0.556,0.4320000000000001,1,2009-02-02,47,26,21,0.5529999999999999,48,10,38,0.208
20800709,1610612752,1610612747,117.0,126.0,0.441,0.524,0,2009-02-02,47,21,26,0.447,47,38,9,0.809
20800710,1610612740,1610612757,89.0,97.0,0.425,0.487,0,2009-02-02,45,28,17,0.622,47,30,17,0.638
20800711,1610612756,1610612758,129.0,81.0,0.511,0.369,1,2009-02-02,46,26,20,0.565,50,11,39,0.22
20800712,1610612762,1610612766,105.0,86.0,0.514,0.507,1,2009-02-02,49,27,22,0.551,48,19,29,0.396
20800713,1610612744,1610612759,105.0,110.0,0.4679999999999999,0.461,0,2009-02-02,49,15,34,0.306,47,33,14,0.7020000000000001
20800702,1610612738,1610612750,109.0,101.0,0.482,0.487,1,2009-02-01,49,40,9,0.816,46,16,30,0.348
20800703,1610612761,1610612753,90.0,113.0,0.402,0.4479999999999999,0,2009-02-01,49,19,30,0.3879999999999999,46,36,10,0.7829999999999999
20800704,1610612765,1610612739,80.0,90.0,0.421,0.473,0,2009-02-01,46,25,21,0.5429999999999999,46,37,9,0.804
20800705,1610612758,1610612760,122.0,118.0,0.4539999999999999,0.456,1,2009-02-01,49,11,38,0.2239999999999999,48,11,37,0.2289999999999999
20800692,1610612754,1610612752,113.0,122.0,0.42,0.489,0,2009-01-31,48,19,29,0.396,46,21,25,0.457
20800693,1610612755,1610612751,83.0,85.0,0.346,0.407,0,2009-01-31,46,23,23,0.5,48,21,27,0.4379999999999999
20800694,1610612748,1610612742,96.0,111.0,0.455,0.603,0,2009-01-31,46,25,21,0.5429999999999999,46,27,19,0.5870000000000001
20800695,1610612763,1610612747,98.0,115.0,0.513,0.537,0,2009-01-31,46,11,35,0.239,46,37,9,0.804
20800696,1610612764,1610612746,106.0,94.0,0.422,0.4589999999999999,1,2009-01-31,47,10,37,0.213,47,10,37,0.213
20800697,1610612745,1610612744,110.0,93.0,0.476,0.42,1,2009-01-31,48,29,19,0.604,48,15,33,0.313
20800698,1610612749,1610612737,110.0,107.0,0.521,0.44,1,2009-01-31,51,24,27,0.471,47,27,20,0.574
20800699,1610612759,1610612740,106.0,93.0,0.545,0.494,1,2009-01-31,46,32,14,0.696,44,28,16,0.636
20800700,1610612756,1610612741,111.0,122.0,0.529,0.5,0,2009-01-31,45,25,20,0.556,48,21,27,0.4379999999999999
20800701,1610612757,1610612762,122.0,108.0,0.5579999999999999,0.544,1,2009-01-31,46,29,17,0.63,48,26,22,0.542
20800681,1610612765,1610612738,78.0,86.0,0.405,0.456,0,2009-01-30,45,25,20,0.556,48,39,9,0.813
20800682,1610612754,1610612748,114.0,103.0,0.425,0.481,1,2009-01-30,47,19,28,0.4039999999999999,45,25,20,0.556
20800683,1610612755,1610612764,104.0,94.0,0.545,0.4379999999999999,1,2009-01-30,45,23,22,0.511,46,9,37,0.196
20800684,1610612761,1610612749,85.0,96.0,0.434,0.467,0,2009-01-30,48,19,29,0.396,50,23,27,0.46
20800685,1610612737,1610612751,105.0,88.0,0.514,0.4,1,2009-01-30,46,27,19,0.5870000000000001,47,20,27,0.426
20800686,1610612739,1610612746,112.0,95.0,0.494,0.402,1,2009-01-30,45,36,9,0.8,46,10,36,0.217
20800687,1610612750,1610612747,119.0,132.0,0.4270000000000001,0.505,0,2009-01-30,45,16,29,0.356,45,36,9,0.8
20800688,1610612743,1610612766,110.0,99.0,0.5479999999999999,0.455,1,2009-01-30,47,31,16,0.66,47,19,28,0.4039999999999999
20800689,1610612762,1610612760,110.0,90.0,0.512,0.479,1,2009-01-30,47,26,21,0.5529999999999999,47,11,36,0.2339999999999999
20800690,1610612740,1610612744,87.0,91.0,0.359,0.41,0,2009-01-30,43,28,15,0.6509999999999999,47,15,32,0.319
20800691,1610612758,1610612741,88.0,109.0,0.368,0.556,0,2009-01-30,48,10,38,0.208,47,20,27,0.426
20800679,1610612753,1610612739,99.0,88.0,0.45,0.415,1,2009-01-29,45,35,10,0.778,44,35,9,0.795
20800680,1610612756,1610612759,104.0,114.0,0.494,0.461,0,2009-01-29,44,25,19,0.568,45,31,14,0.6890000000000001
20800667,1610612754,1610612749,107.0,99.0,0.519,0.4639999999999999,1,2009-01-28,46,18,28,0.391,49,22,27,0.449
20800668,1610612738,1610612758,119.0,100.0,0.55,0.44,1,2009-01-28,47,38,9,0.809,47,10,37,0.213
20800669,1610612748,1610612764,93.0,71.0,0.39,0.37,1,2009-01-28,44,25,19,0.568,45,9,36,0.2
20800670,1610612751,1610612761,106.0,107.0,0.4629999999999999,0.557,0,2009-01-28,46,20,26,0.435,47,19,28,0.4039999999999999
20800671,1610612752,1610612737,112.0,104.0,0.5,0.482,1,2009-01-28,45,20,25,0.444,45,26,19,0.578
20800672,1610612750,1610612765,89.0,98.0,0.481,0.486,0,2009-01-28,44,16,28,0.364,44,25,19,0.568
20800673,1610612740,1610612743,94.0,81.0,0.486,0.446,1,2009-01-28,42,28,14,0.667,46,30,16,0.652
20800674,1610612760,1610612763,114.0,102.0,0.512,0.435,1,2009-01-28,46,11,35,0.239,45,11,34,0.244
20800675,1610612745,1610612755,93.0,95.0,0.411,0.457,0,2009-01-28,47,28,19,0.596,44,22,22,0.5
20800676,1610612742,1610612744,117.0,93.0,0.494,0.386,1,2009-01-28,45,26,19,0.578,46,14,32,0.304
20800677,1610612757,1610612766,88.0,74.0,0.452,0.414,1,2009-01-28,45,28,17,0.622,46,19,27,0.413
20800678,1610612746,1610612741,75.0,95.0,0.36,0.474,0,2009-01-28,45,10,35,0.222,46,19,27,0.413
20800662,1610612739,1610612758,117.0,110.0,0.474,0.5,1,2009-01-27,43,35,8,0.8140000000000001,46,10,36,0.217
20800663,1610612753,1610612754,135.0,111.0,0.5489999999999999,0.506,1,2009-01-27,44,34,10,0.773,45,17,28,0.3779999999999999
20800664,1610612763,1610612743,85.0,100.0,0.375,0.444,0,2009-01-27,44,11,33,0.25,45,30,15,0.667
20800665,1610612762,1610612759,100.0,106.0,0.481,0.514,0,2009-01-27,46,25,21,0.5429999999999999,44,30,14,0.682
20800666,1610612747,1610612766,110.0,117.0,0.434,0.469,0,2009-01-27,44,35,9,0.795,45,19,26,0.422
20800655,1610612764,1610612756,87.0,103.0,0.395,0.476,0,2009-01-26,44,9,35,0.205,43,25,18,0.581
20800656,1610612748,1610612737,95.0,79.0,0.461,0.382,1,2009-01-26,43,24,19,0.5579999999999999,44,26,18,0.591
20800657,1610612752,1610612745,104.0,98.0,0.474,0.389,1,2009-01-26,44,19,25,0.4320000000000001,46,28,18,0.609
20800658,1610612749,1610612750,83.0,90.0,0.4,0.4,0,2009-01-26,48,22,26,0.4579999999999999,43,16,27,0.3720000000000001
20800659,1610612740,1610612755,101.0,86.0,0.4529999999999999,0.537,1,2009-01-26,41,27,14,0.659,43,21,22,0.488
20800660,1610612760,1610612751,94.0,85.0,0.411,0.4,1,2009-01-26,45,10,35,0.222,45,20,25,0.444
20800661,1610612746,1610612757,88.0,113.0,0.4479999999999999,0.58,0,2009-01-26,44,10,34,0.2269999999999999,44,27,17,0.614
20800646,1610612738,1610612742,124.0,100.0,0.5379999999999999,0.421,1,2009-01-25,46,37,9,0.804,44,25,19,0.568
20800647,1610612747,1610612759,99.0,85.0,0.4639999999999999,0.375,1,2009-01-25,43,35,8,0.8140000000000001,43,29,14,0.674
20800648,1610612737,1610612756,99.0,104.0,0.417,0.5539999999999999,0,2009-01-25,43,26,17,0.605,42,24,18,0.5710000000000001
20800649,1610612761,1610612758,113.0,97.0,0.526,0.434,1,2009-01-25,46,18,28,0.391,45,10,35,0.222
20800650,1610612765,1610612745,105.0,108.0,0.564,0.527,0,2009-01-25,43,24,19,0.5579999999999999,45,28,17,0.622
20800651,1610612754,1610612766,98.0,93.0,0.43,0.436,1,2009-01-25,44,17,27,0.386,44,18,26,0.409
20800652,1610612750,1610612741,109.0,108.0,0.446,0.477,1,2009-01-25,42,15,27,0.357,45,18,27,0.4
20800653,1610612743,1610612762,117.0,97.0,0.457,0.405,1,2009-01-25,44,29,15,0.659,45,25,20,0.556
20800654,1610612744,1610612746,107.0,92.0,0.488,0.379,1,2009-01-25,45,14,31,0.311,43,10,33,0.233
20800640,1610612755,1610612752,116.0,110.0,0.5379999999999999,0.487,1,2009-01-24,42,21,21,0.5,43,18,25,0.419
20800641,1610612748,1610612753,103.0,97.0,0.474,0.478,1,2009-01-24,42,23,19,0.5479999999999999,43,33,10,0.767
20800642,1610612763,1610612751,88.0,99.0,0.429,0.4579999999999999,0,2009-01-24,43,11,32,0.256,44,20,24,0.455
20800643,1610612749,1610612758,106.0,104.0,0.46,0.455,1,2009-01-24,47,22,25,0.4679999999999999,44,10,34,0.2269999999999999
20800644,1610612762,1610612739,97.0,102.0,0.476,0.506,0,2009-01-24,44,25,19,0.568,42,34,8,0.81
20800645,1610612757,1610612764,100.0,87.0,0.4379999999999999,0.478,1,2009-01-24,43,26,17,0.605,43,9,34,0.209
20800630,1610612766,1610612756,98.0,76.0,0.513,0.36,1,2009-01-23,43,18,25,0.419,41,23,18,0.561
20800631,1610612765,1610612742,91.0,112.0,0.425,0.5489999999999999,0,2009-01-23,42,24,18,0.5710000000000001,43,25,18,0.581
20800632,1610612754,1610612745,107.0,102.0,0.3929999999999999,0.43,1,2009-01-23,43,16,27,0.3720000000000001,44,27,17,0.614
20800633,1610612737,1610612749,117.0,87.0,0.5579999999999999,0.38,1,2009-01-23,42,26,16,0.619,46,21,25,0.457
20800634,1610612752,1610612763,108.0,88.0,0.5,0.39,1,2009-01-23,42,18,24,0.429,42,11,31,0.262
20800635,1610612750,1610612740,116.0,108.0,0.513,0.532,1,2009-01-23,41,14,27,0.341,40,26,14,0.65
20800636,1610612741,1610612761,94.0,114.0,0.4639999999999999,0.5660000000000001,0,2009-01-23,44,18,26,0.409,45,17,28,0.3779999999999999
20800637,1610612759,1610612751,94.0,91.0,0.467,0.425,1,2009-01-23,42,29,13,0.69,43,19,24,0.442
20800638,1610612744,1610612739,105.0,106.0,0.4379999999999999,0.424,0,2009-01-23,44,13,31,0.295,41,33,8,0.805
20800639,1610612746,1610612760,107.0,104.0,0.481,0.4270000000000001,1,2009-01-23,42,10,32,0.238,44,9,35,0.205
20800628,1610612753,1610612738,80.0,90.0,0.382,0.467,0,2009-01-22,42,33,9,0.7859999999999999,45,36,9,0.8
20800629,1610612747,1610612764,117.0,97.0,0.536,0.446,1,2009-01-22,42,34,8,0.81,42,9,33,0.214
20800617,1610612766,1610612763,101.0,86.0,0.5,0.475,1,2009-01-21,42,17,25,0.405,41,11,30,0.268
20800618,1610612765,1610612761,95.0,76.0,0.506,0.425,1,2009-01-21,41,24,17,0.585,44,16,28,0.364
20800619,1610612748,1610612738,83.0,98.0,0.4,0.514,0,2009-01-21,41,22,19,0.537,44,35,9,0.795
20800620,1610612752,1610612756,114.0,109.0,0.461,0.471,1,2009-01-21,41,17,24,0.415,40,23,17,0.575
20800621,1610612749,1610612742,133.0,99.0,0.578,0.366,1,2009-01-21,45,21,24,0.467,42,24,18,0.5710000000000001
20800622,1610612740,1610612751,102.0,92.0,0.506,0.474,1,2009-01-21,39,26,13,0.667,42,19,23,0.452
20800623,1610612745,1610612762,108.0,99.0,0.461,0.435,1,2009-01-21,43,27,16,0.628,43,25,18,0.581
20800624,1610612757,1610612739,98.0,104.0,0.407,0.526,0,2009-01-21,42,25,17,0.595,40,32,8,0.8
20800625,1610612758,1610612764,107.0,110.0,0.4379999999999999,0.518,0,2009-01-21,43,10,33,0.233,41,9,32,0.22
20800626,1610612744,1610612760,121.0,122.0,0.52,0.494,0,2009-01-21,43,13,30,0.302,43,9,34,0.209
20800627,1610612746,1610612747,97.0,108.0,0.487,0.5,0,2009-01-21,41,9,32,0.22,41,33,8,0.805
20800613,1610612741,1610612737,102.0,105.0,0.482,0.435,0,2009-01-20,43,18,25,0.419,41,25,16,0.61
20800614,1610612759,1610612754,99.0,81.0,0.435,0.37,1,2009-01-20,41,28,13,0.6829999999999999,42,15,27,0.357
20800615,1610612743,1610612758,118.0,99.0,0.563,0.4270000000000001,1,2009-01-20,43,28,15,0.6509999999999999,42,10,32,0.238
20800616,1610612762,1610612750,112.0,107.0,0.455,0.512,1,2009-01-20,42,25,17,0.595,40,13,27,0.325
20800601,1610612752,1610612741,102.0,98.0,0.434,0.426,1,2009-01-19,40,16,24,0.4,42,18,24,0.429
20800602,1610612755,1610612742,93.0,95.0,0.4270000000000001,0.461,0,2009-01-19,41,20,21,0.488,41,24,17,0.585
20800603,1610612737,1610612761,87.0,84.0,0.418,0.417,1,2009-01-19,40,24,16,0.6,43,16,27,0.3720000000000001
20800604,1610612766,1610612759,84.0,86.0,0.362,0.408,0,2009-01-19,41,16,25,0.39,40,27,13,0.675
20800605,1610612745,1610612743,115.0,113.0,0.511,0.545,1,2009-01-19,42,26,16,0.619,42,27,15,0.643
20800606,1610612746,1610612750,86.0,94.0,0.415,0.419,0,2009-01-19,40,9,31,0.225,39,13,26,0.3329999999999999
20800607,1610612740,1610612754,103.0,100.0,0.451,0.43,1,2009-01-19,38,25,13,0.6579999999999999,41,15,26,0.366
20800608,1610612744,1610612764,119.0,98.0,0.53,0.444,1,2009-01-19,42,13,29,0.31,40,8,32,0.2
20800609,1610612763,1610612765,79.0,87.0,0.41,0.48,0,2009-01-19,40,11,29,0.275,40,23,17,0.575
20800610,1610612738,1610612756,104.0,87.0,0.479,0.472,1,2009-01-19,43,34,9,0.7909999999999999,39,23,16,0.59
20800611,1610612757,1610612749,102.0,85.0,0.4629999999999999,0.418,1,2009-01-19,41,25,16,0.61,44,20,24,0.455
20800612,1610612747,1610612739,105.0,88.0,0.524,0.425,1,2009-01-19,40,32,8,0.8,39,31,8,0.795
20800599,1610612761,1610612756,113.0,117.0,0.537,0.544,0,2009-01-18,42,16,26,0.381,38,23,15,0.605
20800600,1610612760,1610612748,94.0,104.0,0.472,0.482,0,2009-01-18,42,8,34,0.19,40,22,18,0.55
20800590,1610612751,1610612738,85.0,105.0,0.405,0.522,0,2009-01-17,41,19,22,0.4629999999999999,42,33,9,0.7859999999999999
20800591,1610612766,1610612757,102.0,97.0,0.4579999999999999,0.442,1,2009-01-17,40,16,24,0.4,40,24,16,0.6
20800592,1610612765,1610612740,85.0,91.0,0.424,0.486,0,2009-01-17,39,22,17,0.564,37,24,13,0.649
20800593,1610612752,1610612755,97.0,107.0,0.461,0.506,0,2009-01-17,39,15,24,0.385,40,20,20,0.5
20800594,1610612741,1610612759,87.0,92.0,0.447,0.412,0,2009-01-17,41,18,23,0.439,39,26,13,0.667
20800595,1610612745,1610612748,93.0,86.0,0.565,0.4,1,2009-01-17,41,25,16,0.61,39,21,18,0.5379999999999999
20800596,1610612742,1610612762,115.0,108.0,0.506,0.513,1,2009-01-17,40,23,17,0.575,41,24,17,0.585
20800597,1610612743,1610612753,88.0,106.0,0.365,0.4629999999999999,0,2009-01-17,41,27,14,0.659,41,33,8,0.805
20800598,1610612746,1610612749,101.0,92.0,0.545,0.3879999999999999,1,2009-01-17,39,9,30,0.231,43,20,23,0.465
20800580,1610612754,1610612761,111.0,104.0,0.452,0.41,1,2009-01-16,40,15,25,0.375,41,16,25,0.39
20800581,1610612755,1610612759,109.0,87.0,0.5,0.365,1,2009-01-16,39,19,20,0.487,38,25,13,0.6579999999999999
20800582,1610612764,1610612752,96.0,89.0,0.446,0.3720000000000001,1,2009-01-16,39,8,31,0.205,38,15,23,0.395
20800583,1610612739,1610612740,92.0,78.0,0.4270000000000001,0.373,1,2009-01-16,38,31,7,0.816,36,23,13,0.639
20800584,1610612763,1610612762,91.0,101.0,0.4270000000000001,0.521,0,2009-01-16,39,11,28,0.282,40,24,16,0.6
20800585,1610612760,1610612765,89.0,79.0,0.4270000000000001,0.4629999999999999,1,2009-01-16,41,8,33,0.195,38,22,16,0.579
20800586,1610612756,1610612750,103.0,105.0,0.5,0.433,0,2009-01-16,37,22,15,0.595,38,12,26,0.316
20800587,1610612758,1610612749,122.0,129.0,0.515,0.5,0,2009-01-16,41,10,31,0.244,42,20,22,0.476
20800588,1610612744,1610612737,119.0,114.0,0.506,0.451,1,2009-01-16,41,12,29,0.293,39,23,16,0.59
20800589,1610612747,1610612753,103.0,109.0,0.3979999999999999,0.446,0,2009-01-16,39,31,8,0.795,40,32,8,0.8
20800577,1610612751,1610612757,99.0,105.0,0.513,0.481,0,2009-01-15,40,19,21,0.475,39,24,15,0.615
20800578,1610612741,1610612739,102.0,93.0,0.447,0.418,1,2009-01-15,40,18,22,0.45,37,30,7,0.8109999999999999
20800579,1610612743,1610612756,119.0,113.0,0.436,0.4429999999999999,1,2009-01-15,40,27,13,0.675,36,22,14,0.611
20800566,1610612754,1610612765,110.0,106.0,0.4320000000000001,0.43,1,2009-01-14,39,14,25,0.359,37,22,15,0.595
20800567,1610612755,1610612757,100.0,79.0,0.461,0.3939999999999999,1,2009-01-14,38,18,20,0.474,38,23,15,0.605
20800568,1610612761,1610612741,98.0,102.0,0.473,0.488,0,2009-01-14,40,16,24,0.4,39,17,22,0.436
20800569,1610612738,1610612751,118.0,86.0,0.564,0.3879999999999999,1,2009-01-14,41,32,9,0.78,39,19,20,0.487
20800570,1610612752,1610612764,128.0,122.0,0.537,0.597,1,2009-01-14,37,15,22,0.405,38,7,31,0.184
20800571,1610612749,1610612748,99.0,102.0,0.494,0.481,0,2009-01-14,41,19,22,0.4629999999999999,38,21,17,0.5529999999999999
20800572,1610612760,1610612762,114.0,93.0,0.5489999999999999,0.422,1,2009-01-14,40,7,33,0.175,39,23,16,0.59
20800573,1610612742,1610612740,97.0,104.0,0.5,0.494,0,2009-01-14,39,22,17,0.564,35,23,12,0.657
20800574,1610612759,1610612747,112.0,111.0,0.5710000000000001,0.5660000000000001,1,2009-01-14,37,25,12,0.6759999999999999,38,31,7,0.816
20800575,1610612744,1610612758,133.0,135.0,0.4429999999999999,0.409,0,2009-01-14,40,11,29,0.275,40,10,30,0.25
20800576,1610612746,1610612737,80.0,97.0,0.425,0.493,0,2009-01-14,38,8,30,0.211,38,23,15,0.605
20800559,1610612765,1610612766,78.0,80.0,0.419,0.4270000000000001,0,2009-01-13,36,22,14,0.611,39,15,24,0.385
20800560,1610612763,1610612739,87.0,102.0,0.42,0.529,0,2009-01-13,38,11,27,0.289,36,30,6,0.833
20800561,1610612750,1610612748,96.0,99.0,0.4629999999999999,0.4579999999999999,0,2009-01-13,37,11,26,0.297,37,20,17,0.541
20800562,1610612745,1610612747,100.0,105.0,0.53,0.506,0,2009-01-13,40,24,16,0.6,37,31,6,0.838
20800563,1610612743,1610612742,99.0,97.0,0.423,0.412,1,2009-01-13,39,26,13,0.667,38,22,16,0.579
20800564,1610612756,1610612737,107.0,102.0,0.514,0.416,1,2009-01-13,35,22,13,0.629,37,22,15,0.595
20800565,1610612758,1610612753,107.0,139.0,0.451,0.605,0,2009-01-13,39,9,30,0.231,39,31,8,0.795
20800553,1610612764,1610612749,91.0,97.0,0.4379999999999999,0.475,0,2009-01-12,37,7,30,0.1889999999999999,40,19,21,0.475
20800554,1610612738,1610612761,115.0,109.0,0.477,0.476,1,2009-01-12,40,31,9,0.775,39,16,23,0.41
20800555,1610612751,1610612760,103.0,99.0,0.3979999999999999,0.439,1,2009-01-12,38,19,19,0.5,39,6,33,0.154
20800556,1610612740,1610612752,95.0,101.0,0.384,0.4379999999999999,0,2009-01-12,34,22,12,0.647,36,14,22,0.389
20800557,1610612741,1610612757,95.0,109.0,0.434,0.466,0,2009-01-12,38,16,22,0.421,37,23,14,0.622
20800558,1610612762,1610612754,120.0,113.0,0.4589999999999999,0.5,1,2009-01-12,38,23,15,0.605,38,13,25,0.342
20800546,1610612761,1610612738,88.0,94.0,0.3779999999999999,0.41,0,2009-01-11,38,16,22,0.421,39,30,9,0.769
20800547,1610612737,1610612755,94.0,109.0,0.471,0.547,0,2009-01-11,36,22,14,0.611,37,17,20,0.4589999999999999
20800548,1610612746,1610612756,103.0,109.0,0.43,0.4529999999999999,0,2009-01-11,37,8,29,0.216,34,21,13,0.618
20800549,1610612759,1610612753,98.0,105.0,0.506,0.486,0,2009-01-11,36,24,12,0.667,38,30,8,0.789
20800550,1610612744,1610612754,120.0,117.0,0.481,0.441,1,2009-01-11,39,11,28,0.282,37,13,24,0.351
20800551,1610612758,1610612742,102.0,95.0,0.506,0.4529999999999999,1,2009-01-11,38,9,29,0.237,37,22,15,0.595
20800552,1610612747,1610612748,108.0,105.0,0.446,0.462,1,2009-01-11,36,30,6,0.833,36,19,17,0.528
20800540,1610612764,1610612766,89.0,92.0,0.523,0.507,0,2009-01-10,36,7,29,0.1939999999999999,38,14,24,0.368
20800541,1610612750,1610612749,106.0,104.0,0.4429999999999999,0.526,1,2009-01-10,36,11,25,0.306,39,18,21,0.462
20800542,1610612741,1610612760,98.0,109.0,0.435,0.408,0,2009-01-10,37,16,21,0.4320000000000001,38,6,32,0.158
20800543,1610612745,1610612752,96.0,76.0,0.424,0.354,1,2009-01-10,39,24,15,0.615,35,13,22,0.371
20800544,1610612762,1610612765,99.0,82.0,0.535,0.359,1,2009-01-10,37,22,15,0.595,35,22,13,0.629
20800545,1610612757,1610612744,113.0,100.0,0.482,0.507,1,2009-01-10,36,22,14,0.611,38,10,28,0.263
20800528,1610612753,1610612737,121.0,87.0,0.488,0.35,1,2009-01-09,37,29,8,0.784,35,22,13,0.629
20800529,1610612755,1610612766,93.0,87.0,0.481,0.486,1,2009-01-09,36,16,20,0.444,37,13,24,0.351
20800530,1610612761,1610612763,103.0,82.0,0.556,0.425,1,2009-01-09,37,16,21,0.4320000000000001,37,11,26,0.297
20800531,1610612739,1610612738,98.0,83.0,0.508,0.412,1,2009-01-09,35,29,6,0.8290000000000001,38,29,9,0.763
20800532,1610612740,1610612746,107.0,80.0,0.513,0.471,1,2009-01-09,33,22,11,0.667,36,8,28,0.222
20800533,1610612760,1610612745,96.0,98.0,0.481,0.4589999999999999,0,2009-01-09,37,5,32,0.135,38,23,15,0.605
20800534,1610612741,1610612764,98.0,86.0,0.487,0.461,1,2009-01-09,36,16,20,0.444,35,7,28,0.2
20800535,1610612749,1610612751,104.0,102.0,0.494,0.528,1,2009-01-09,38,18,20,0.474,37,18,19,0.486
20800536,1610612743,1610612765,90.0,93.0,0.417,0.425,0,2009-01-09,38,25,13,0.6579999999999999,34,22,12,0.647
20800537,1610612758,1610612748,115.0,119.0,0.416,0.449,0,2009-01-09,37,8,29,0.216,35,19,16,0.5429999999999999
20800538,1610612747,1610612754,121.0,119.0,0.564,0.488,1,2009-01-09,35,29,6,0.8290000000000001,36,13,23,0.361
20800539,1610612756,1610612742,128.0,100.0,0.627,0.435,1,2009-01-09,33,20,13,0.606,36,22,14,0.611
20800526,1610612742,1610612752,99.0,94.0,0.469,0.416,1,2009-01-08,35,22,13,0.629,34,13,21,0.382
20800527,1610612759,1610612746,106.0,84.0,0.512,0.4429999999999999,1,2009-01-08,35,24,11,0.6859999999999999,35,8,27,0.2289999999999999
20800514,1610612737,1610612753,102.0,106.0,0.476,0.5,0,2009-01-07,34,22,12,0.647,36,28,8,0.778
20800515,1610612739,1610612766,111.0,81.0,0.6,0.392,1,2009-01-07,34,28,6,0.8240000000000001,36,13,23,0.361
20800516,1610612764,1610612761,93.0,99.0,0.4639999999999999,0.544,0,2009-01-07,34,7,27,0.206,36,15,21,0.417
20800517,1610612738,1610612745,85.0,89.0,0.429,0.486,0,2009-01-07,37,29,8,0.784,37,22,15,0.595
20800518,1610612751,1610612763,100.0,89.0,0.544,0.473,1,2009-01-07,36,18,18,0.5,36,11,25,0.306
20800519,1610612749,1610612755,105.0,110.0,0.471,0.515,0,2009-01-07,37,17,20,0.4589999999999999,35,15,20,0.429
20800520,1610612750,1610612760,129.0,87.0,0.522,0.3979999999999999,1,2009-01-07,35,10,25,0.286,36,5,31,0.139
20800521,1610612743,1610612748,108.0,97.0,0.486,0.481,1,2009-01-07,37,25,12,0.6759999999999999,34,18,16,0.529
20800522,1610612756,1610612754,110.0,113.0,0.425,0.495,0,2009-01-07,32,19,13,0.594,35,13,22,0.371
20800523,1610612762,1610612740,116.0,90.0,0.519,0.4379999999999999,1,2009-01-07,36,21,15,0.583,32,21,11,0.6559999999999999
20800524,1610612757,1610612765,84.0,83.0,0.485,0.5,1,2009-01-07,35,21,14,0.6,33,21,12,0.636
20800525,1610612744,1610612747,106.0,114.0,0.484,0.451,0,2009-01-07,37,10,27,0.27,34,28,6,0.8240000000000001
20800506,1610612766,1610612738,114.0,106.0,0.481,0.4429999999999999,1,2009-01-06,35,13,22,0.371,36,29,7,0.8059999999999999
20800507,1610612753,1610612764,89.0,80.0,0.413,0.395,1,2009-01-06,35,27,8,0.7709999999999999,33,7,26,0.212
20800508,1610612755,1610612745,104.0,96.0,0.562,0.425,1,2009-01-06,34,14,20,0.412,36,21,15,0.583
20800509,1610612763,1610612750,87.0,94.0,0.416,0.473,0,2009-01-06,35,11,24,0.314,34,9,25,0.265
20800510,1610612760,1610612752,107.0,99.0,0.527,0.3979999999999999,1,2009-01-06,35,5,30,0.143,33,13,20,0.3939999999999999
20800511,1610612741,1610612758,99.0,94.0,0.386,0.507,1,2009-01-06,35,15,20,0.429,36,8,28,0.222
20800512,1610612742,1610612746,107.0,102.0,0.471,0.4320000000000001,1,2009-01-06,34,21,13,0.618,34,8,26,0.235
20800513,1610612747,1610612740,105.0,116.0,0.419,0.506,0,2009-01-06,33,27,6,0.818,31,21,10,0.677
20800501,1610612748,1610612759,84.0,91.0,0.444,0.467,0,2009-01-05,33,18,15,0.545,34,23,11,0.6759999999999999
20800502,1610612751,1610612758,98.0,90.0,0.466,0.422,1,2009-01-05,35,17,18,0.486,35,8,27,0.2289999999999999
20800503,1610612749,1610612761,107.0,97.0,0.481,0.542,1,2009-01-05,36,17,19,0.472,35,14,21,0.4
20800504,1610612743,1610612754,135.0,115.0,0.581,0.436,1,2009-01-05,36,24,12,0.667,34,12,22,0.353
20800505,1610612762,1610612744,119.0,114.0,0.489,0.5,1,2009-01-05,35,20,15,0.5710000000000001,36,10,26,0.278
20800495,1610612761,1610612753,108.0,102.0,0.539,0.461,1,2009-01-04,34,14,20,0.412,34,26,8,0.765
20800496,1610612764,1610612739,80.0,77.0,0.41,0.3939999999999999,1,2009-01-04,32,7,25,0.2189999999999999,33,27,6,0.818
20800497,1610612746,1610612765,87.0,88.0,0.412,0.3929999999999999,0,2009-01-04,33,8,25,0.242,32,21,11,0.6559999999999999
20800498,1610612763,1610612742,102.0,82.0,0.476,0.421,1,2009-01-04,34,11,23,0.324,33,20,13,0.606
20800499,1610612752,1610612738,100.0,88.0,0.415,0.4,1,2009-01-04,32,13,19,0.406,35,29,6,0.8290000000000001
20800500,1610612747,1610612757,100.0,86.0,0.493,0.39,1,2009-01-04,32,27,5,0.8440000000000001,34,20,14,0.588
20800488,1610612737,1610612745,103.0,100.0,0.589,0.481,1,2009-01-03,33,22,11,0.667,35,21,14,0.6
20800489,1610612766,1610612749,102.0,92.0,0.471,0.5,1,2009-01-03,34,12,22,0.353,35,16,19,0.457
20800490,1610612754,1610612758,122.0,117.0,0.5,0.471,1,2009-01-03,33,12,21,0.364,34,8,26,0.235
20800491,1610612748,1610612751,101.0,96.0,0.408,0.3979999999999999,1,2009-01-03,32,18,14,0.563,34,16,18,0.471
20800492,1610612741,1610612750,92.0,102.0,0.3929999999999999,0.416,0,2009-01-03,34,14,20,0.412,33,8,25,0.242
20800493,1610612759,1610612755,108.0,106.0,0.532,0.544,1,2009-01-03,33,22,11,0.667,33,13,20,0.3939999999999999
20800494,1610612743,1610612740,105.0,100.0,0.5,0.5,1,2009-01-03,35,23,12,0.657,30,20,10,0.667
20800473,1610612753,1610612748,86.0,76.0,0.382,0.405,1,2009-01-02,33,26,7,0.7879999999999999,31,17,14,0.5479999999999999
20800474,1610612761,1610612745,94.0,73.0,0.482,0.341,1,2009-01-02,33,13,20,0.3939999999999999,34,21,13,0.618
20800475,1610612738,1610612764,108.0,83.0,0.5539999999999999,0.3829999999999999,1,2009-01-02,34,29,5,0.853,31,6,25,0.1939999999999999
20800476,1610612739,1610612741,117.0,92.0,0.506,0.366,1,2009-01-02,32,27,5,0.8440000000000001,33,14,19,0.424
20800477,1610612751,1610612737,93.0,91.0,0.38,0.444,1,2009-01-02,33,16,17,0.485,32,21,11,0.6559999999999999
20800478,1610612752,1610612754,103.0,105.0,0.4320000000000001,0.446,0,2009-01-02,31,12,19,0.387,32,11,21,0.344
20800479,1610612765,1610612758,98.0,92.0,0.488,0.337,1,2009-01-02,31,20,11,0.645,33,8,25,0.242
20800480,1610612763,1610612759,80.0,91.0,0.397,0.479,0,2009-01-02,33,10,23,0.303,32,21,11,0.6559999999999999
20800481,1610612750,1610612744,115.0,108.0,0.451,0.475,1,2009-01-02,32,7,25,0.2189999999999999,35,10,25,0.286
20800482,1610612760,1610612743,120.0,122.0,0.584,0.547,0,2009-01-02,34,4,30,0.118,34,22,12,0.647
20800483,1610612742,1610612755,96.0,86.0,0.456,0.449,1,2009-01-02,32,20,12,0.625,32,13,19,0.406
20800484,1610612749,1610612766,103.0,75.0,0.474,0.377,1,2009-01-02,34,16,18,0.471,33,11,22,0.3329999999999999
20800485,1610612756,1610612746,106.0,98.0,0.5539999999999999,0.417,1,2009-01-02,31,19,12,0.613,32,8,24,0.25
20800486,1610612757,1610612740,77.0,92.0,0.397,0.513,0,2009-01-02,33,20,13,0.606,29,20,9,0.69
20800487,1610612747,1610612762,113.0,100.0,0.4589999999999999,0.424,1,2009-01-02,31,26,5,0.8390000000000001,34,19,15,0.5589999999999999
20800467,1610612741,1610612753,94.0,113.0,0.42,0.494,0,2008-12-31,32,14,18,0.4379999999999999,32,25,7,0.7809999999999999
20800468,1610612765,1610612751,83.0,75.0,0.471,0.373,1,2008-12-31,30,19,11,0.633,32,15,17,0.469
20800469,1610612745,1610612749,85.0,81.0,0.411,0.451,1,2008-12-31,33,21,12,0.636,33,15,18,0.455
20800470,1610612761,1610612743,107.0,114.0,0.469,0.512,0,2008-12-31,32,12,20,0.375,33,21,12,0.636
20800471,1610612760,1610612744,107.0,100.0,0.482,0.461,1,2008-12-31,33,4,29,0.121,34,10,24,0.294
20800472,1610612746,1610612755,92.0,100.0,0.405,0.4629999999999999,0,2008-12-31,31,8,23,0.258,31,13,18,0.419
20800458,1610612766,1610612752,89.0,93.0,0.4270000000000001,0.424,0,2008-12-30,32,11,21,0.344,30,12,18,0.4
20800459,1610612754,1610612737,104.0,110.0,0.425,0.4629999999999999,0,2008-12-30,31,10,21,0.3229999999999999,31,21,10,0.677
20800460,1610612748,1610612739,104.0,95.0,0.447,0.465,1,2008-12-30,30,17,13,0.5670000000000001,31,26,5,0.8390000000000001
20800461,1610612763,1610612756,89.0,101.0,0.387,0.467,0,2008-12-30,32,10,22,0.313,30,18,12,0.6
20800462,1610612740,1610612764,97.0,85.0,0.4579999999999999,0.456,1,2008-12-30,28,19,9,0.679,30,6,24,0.2
20800463,1610612742,1610612750,107.0,100.0,0.471,0.494,1,2008-12-30,31,19,12,0.613,31,6,25,0.1939999999999999
20800464,1610612759,1610612749,98.0,100.0,0.48,0.512,0,2008-12-30,31,20,11,0.645,32,15,17,0.469
20800465,1610612757,1610612738,91.0,86.0,0.452,0.4029999999999999,1,2008-12-30,32,20,12,0.625,33,28,5,0.848
20800466,1610612758,1610612746,92.0,90.0,0.381,0.357,1,2008-12-30,32,8,24,0.25,30,8,22,0.267
20800450,1610612737,1610612743,109.0,91.0,0.487,0.455,1,2008-12-29,30,20,10,0.667,32,20,12,0.625
20800451,1610612765,1610612753,88.0,82.0,0.421,0.4029999999999999,1,2008-12-29,29,18,11,0.621,31,24,7,0.774
20800452,1610612751,1610612741,87.0,100.0,0.4,0.475,0,2008-12-29,31,15,16,0.484,31,14,17,0.452
20800453,1610612750,1610612763,108.0,98.0,0.494,0.429,1,2008-12-29,30,6,24,0.2,31,10,21,0.3229999999999999
20800454,1610612760,1610612756,102.0,110.0,0.528,0.5,0,2008-12-29,32,3,29,0.094,29,17,12,0.586
20800455,1610612745,1610612764,87.0,89.0,0.4,0.462,0,2008-12-29,32,20,12,0.625,29,6,23,0.207
20800456,1610612762,1610612755,112.0,95.0,0.512,0.487,1,2008-12-29,33,19,14,0.5760000000000001,30,12,18,0.4
20800457,1610612744,1610612761,117.0,111.0,0.5,0.441,1,2008-12-29,33,10,23,0.303,31,12,19,0.387
20800444,1610612752,1610612743,110.0,117.0,0.447,0.57,0,2008-12-28,29,11,18,0.379,31,20,11,0.645
20800445,1610612746,1610612742,76.0,98.0,0.38,0.417,0,2008-12-28,29,8,21,0.276,30,18,12,0.6
20800446,1610612739,1610612748,93.0,86.0,0.408,0.4320000000000001,1,2008-12-28,30,26,4,0.867,29,16,13,0.552
20800447,1610612754,1610612740,103.0,105.0,0.5,0.4639999999999999,0,2008-12-28,30,10,20,0.3329999999999999,27,18,9,0.667
20800448,1610612758,1610612738,63.0,108.0,0.2789999999999999,0.519,0,2008-12-28,31,7,24,0.226,32,28,4,0.875
20800449,1610612747,1610612744,130.0,113.0,0.516,0.494,1,2008-12-28,30,25,5,0.833,32,9,23,0.281
20800436,1610612737,1610612741,129.0,117.0,0.557,0.544,1,2008-12-27,29,19,10,0.655,30,13,17,0.433
20800437,1610612766,1610612751,103.0,114.0,0.481,0.487,0,2008-12-27,31,11,20,0.355,30,15,15,0.5
20800438,1610612764,1610612760,104.0,95.0,0.45,0.481,1,2008-12-27,28,5,23,0.179,31,3,28,0.0969999999999999
20800439,1610612750,1610612753,94.0,118.0,0.412,0.537,0,2008-12-27,29,5,24,0.172,30,24,6,0.8
20800440,1610612745,1610612762,120.0,115.0,0.392,0.49,1,2008-12-27,31,20,11,0.645,32,18,14,0.563
20800441,1610612749,1610612765,76.0,87.0,0.304,0.43,0,2008-12-27,31,14,17,0.452,28,17,11,0.607
20800442,1610612759,1610612763,106.0,103.0,0.461,0.466,1,2008-12-27,30,20,10,0.667,30,10,20,0.3329999999999999
20800443,1610612757,1610612761,102.0,89.0,0.506,0.449,1,2008-12-27,31,19,12,0.613,30,12,18,0.4
20800426,1610612748,1610612741,90.0,77.0,0.424,0.369,1,2008-12-26,28,16,12,0.5710000000000001,29,13,16,0.4479999999999999
20800427,1610612751,1610612766,87.0,95.0,0.4,0.5,0,2008-12-26,29,14,15,0.483,30,11,19,0.3670000000000001
20800428,1610612752,1610612750,107.0,120.0,0.389,0.514,0,2008-12-26,28,11,17,0.3929999999999999,28,5,23,0.179
20800429,1610612765,1610612760,90.0,88.0,0.4479999999999999,0.451,1,2008-12-26,27,16,11,0.593,30,3,27,0.1
20800430,1610612763,1610612754,108.0,105.0,0.526,0.537,1,2008-12-26,29,10,19,0.345,29,10,19,0.345
20800431,1610612740,1610612745,88.0,79.0,0.446,0.361,1,2008-12-26,26,17,9,0.654,30,19,11,0.633
20800432,1610612743,1610612755,105.0,101.0,0.434,0.494,1,2008-12-26,30,19,11,0.633,29,12,17,0.414
20800433,1610612762,1610612742,97.0,88.0,0.45,0.407,1,2008-12-26,31,18,13,0.581,29,17,12,0.586
20800434,1610612758,1610612761,101.0,107.0,0.45,0.551,0,2008-12-26,30,7,23,0.233,29,12,17,0.414
20800435,1610612744,1610612738,99.0,89.0,0.4579999999999999,0.471,1,2008-12-26,31,9,22,0.29,31,27,4,0.871
20800421,1610612753,1610612740,88.0,68.0,0.405,0.3329999999999999,1,2008-12-25,29,23,6,0.7929999999999999,25,16,9,0.64
20800422,1610612756,1610612759,90.0,91.0,0.4529999999999999,0.418,0,2008-12-25,28,16,12,0.5710000000000001,29,19,10,0.655
20800423,1610612747,1610612738,92.0,83.0,0.462,0.4679999999999999,1,2008-12-25,29,24,5,0.828,30,27,3,0.9
20800424,1610612739,1610612764,93.0,89.0,0.419,0.4370000000000001,1,2008-12-25,29,25,4,0.862,27,4,23,0.148
20800425,1610612757,1610612742,94.0,102.0,0.5,0.488,0,2008-12-25,30,18,12,0.6,28,17,11,0.607
20800409,1610612737,1610612760,99.0,88.0,0.4679999999999999,0.374,1,2008-12-23,28,18,10,0.643,29,3,26,0.103
20800410,1610612766,1610612764,80.0,72.0,0.417,0.322,1,2008-12-23,29,10,19,0.345,26,4,22,0.154
20800411,1610612739,1610612745,99.0,90.0,0.487,0.431,1,2008-12-23,28,24,4,0.857,29,19,10,0.655
20800412,1610612754,1610612751,107.0,108.0,0.494,0.48,0,2008-12-23,28,10,18,0.357,28,14,14,0.5
20800413,1610612738,1610612755,110.0,91.0,0.457,0.481,1,2008-12-23,29,27,2,0.931,28,12,16,0.429
20800414,1610612748,1610612744,96.0,88.0,0.514,0.371,1,2008-12-23,27,15,12,0.556,30,8,22,0.267
20800415,1610612765,1610612741,104.0,98.0,0.424,0.474,1,2008-12-23,26,15,11,0.5770000000000001,28,13,15,0.4639999999999999
20800416,1610612749,1610612762,94.0,86.0,0.3879999999999999,0.38,1,2008-12-23,30,14,16,0.467,30,17,13,0.5670000000000001
20800417,1610612740,1610612747,87.0,100.0,0.416,0.44,0,2008-12-23,24,16,8,0.667,28,23,5,0.821
20800418,1610612742,1610612763,100.0,82.0,0.5,0.3829999999999999,1,2008-12-23,27,16,11,0.593,28,9,19,0.321
20800419,1610612759,1610612750,99.0,93.0,0.487,0.4270000000000001,1,2008-12-23,28,18,10,0.643,27,4,23,0.148
20800420,1610612757,1610612743,101.0,92.0,0.4589999999999999,0.429,1,2008-12-23,29,18,11,0.621,29,18,11,0.621
20800403,1610612753,1610612744,113.0,81.0,0.482,0.319,1,2008-12-22,28,22,6,0.7859999999999999,29,8,21,0.276
20800404,1610612751,1610612745,91.0,114.0,0.414,0.581,0,2008-12-22,27,13,14,0.481,28,19,9,0.679
20800405,1610612763,1610612747,96.0,105.0,0.455,0.541,0,2008-12-22,27,9,18,0.3329999999999999,27,22,5,0.815
20800406,1610612759,1610612758,101.0,85.0,0.521,0.397,1,2008-12-22,27,17,10,0.63,29,7,22,0.241
20800407,1610612743,1610612757,97.0,89.0,0.4579999999999999,0.418,1,2008-12-22,28,18,10,0.643,28,17,11,0.607
20800408,1610612746,1610612761,75.0,97.0,0.3289999999999999,0.45,0,2008-12-22,28,8,20,0.286,28,11,17,0.3929999999999999
20800399,1610612737,1610612765,85.0,78.0,0.419,0.467,1,2008-12-21,27,17,10,0.63,25,14,11,0.56
20800400,1610612738,1610612752,124.0,105.0,0.6579999999999999,0.434,1,2008-12-21,28,26,2,0.929,27,11,16,0.407
20800401,1610612764,1610612742,86.0,97.0,0.395,0.46,0,2008-12-21,25,4,21,0.16,26,15,11,0.5770000000000001
20800402,1610612760,1610612739,91.0,102.0,0.4429999999999999,0.5529999999999999,0,2008-12-21,28,3,25,0.107,27,23,4,0.852
20800389,1610612766,1610612744,103.0,110.0,0.469,0.455,0,2008-12-20,28,9,19,0.321,28,8,20,0.286
20800390,1610612753,1610612747,106.0,103.0,0.486,0.414,1,2008-12-20,27,21,6,0.778,26,21,5,0.8079999999999999
20800391,1610612755,1610612754,94.0,95.0,0.4379999999999999,0.434,0,2008-12-20,27,12,15,0.444,27,10,17,0.37
20800392,1610612750,1610612745,102.0,109.0,0.449,0.527,0,2008-12-20,26,4,22,0.154,27,18,9,0.667
20800393,1610612751,1610612748,103.0,106.0,0.473,0.513,0,2008-12-20,26,13,13,0.5,26,14,12,0.5379999999999999
20800394,1610612740,1610612758,99.0,90.0,0.456,0.471,1,2008-12-20,23,16,7,0.696,28,7,21,0.25
20800395,1610612741,1610612762,106.0,98.0,0.461,0.481,1,2008-12-20,27,13,14,0.481,29,17,12,0.586
20800396,1610612749,1610612746,119.0,85.0,0.517,0.346,1,2008-12-20,29,13,16,0.4479999999999999,27,8,19,0.296
20800397,1610612759,1610612761,107.0,97.0,0.488,0.455,1,2008-12-20,26,16,10,0.615,27,10,17,0.37
20800398,1610612756,1610612743,108.0,101.0,0.494,0.4629999999999999,1,2008-12-20,27,16,11,0.593,27,17,10,0.63
20800377,1610612754,1610612746,109.0,117.0,0.4429999999999999,0.4320000000000001,0,2008-12-19,26,9,17,0.346,26,8,18,0.308
20800378,1610612764,1610612755,103.0,109.0,0.476,0.493,0,2008-12-19,24,4,20,0.1669999999999999,26,12,14,0.462
20800379,1610612737,1610612744,115.0,99.0,0.518,0.451,1,2008-12-19,26,16,10,0.615,27,7,20,0.259
20800380,1610612738,1610612741,126.0,108.0,0.595,0.506,1,2008-12-19,27,25,2,0.926,26,12,14,0.462
20800381,1610612751,1610612742,121.0,97.0,0.484,0.416,1,2008-12-19,25,13,12,0.52,25,14,11,0.56
20800382,1610612752,1610612749,81.0,105.0,0.387,0.467,0,2008-12-19,26,11,15,0.423,28,12,16,0.429
20800383,1610612765,1610612762,114.0,120.0,0.478,0.4629999999999999,0,2008-12-19,24,14,10,0.583,28,17,11,0.607
20800384,1610612763,1610612766,83.0,112.0,0.431,0.6579999999999999,0,2008-12-19,26,9,17,0.346,27,9,18,0.3329999999999999
20800385,1610612748,1610612747,89.0,87.0,0.4379999999999999,0.473,1,2008-12-19,25,13,12,0.52,25,21,4,0.84
20800386,1610612760,1610612761,91.0,83.0,0.444,0.364,1,2008-12-19,27,3,24,0.111,26,10,16,0.385
20800387,1610612745,1610612758,107.0,96.0,0.488,0.461,1,2008-12-19,26,17,9,0.654,27,7,20,0.259
20800388,1610612743,1610612739,88.0,105.0,0.43,0.476,0,2008-12-19,26,17,9,0.654,26,22,4,0.846
20800375,1610612753,1610612759,90.0,78.0,0.447,0.375,1,2008-12-18,26,20,6,0.769,25,15,10,0.6
20800376,1610612757,1610612756,124.0,119.0,0.517,0.569,1,2008-12-18,27,17,10,0.63,26,15,11,0.5770000000000001
20800366,1610612737,1610612738,85.0,88.0,0.3670000000000001,0.442,0,2008-12-17,25,15,10,0.6,26,24,2,0.923
20800367,1610612754,1610612744,127.0,120.0,0.4429999999999999,0.45,1,2008-12-17,25,9,16,0.36,26,7,19,0.2689999999999999
20800368,1610612755,1610612749,93.0,88.0,0.462,0.4320000000000001,1,2008-12-17,25,11,14,0.44,27,11,16,0.407
20800369,1610612761,1610612742,86.0,96.0,0.429,0.5,0,2008-12-17,25,10,15,0.4,24,14,10,0.583
20800370,1610612765,1610612764,88.0,74.0,0.479,0.3329999999999999,1,2008-12-17,23,14,9,0.609,23,4,19,0.174
20800371,1610612751,1610612762,92.0,103.0,0.412,0.449,0,2008-12-17,24,12,12,0.5,27,16,11,0.593
20800372,1610612750,1610612739,70.0,93.0,0.408,0.5329999999999999,0,2008-12-17,25,4,21,0.16,25,21,4,0.84
20800373,1610612741,1610612746,115.0,109.0,0.451,0.4270000000000001,1,2008-12-17,25,12,13,0.48,25,7,18,0.28
20800374,1610612740,1610612759,90.0,83.0,0.4320000000000001,0.3879999999999999,1,2008-12-17,22,15,7,0.682,24,15,9,0.625
20800360,1610612766,1610612741,110.0,101.0,0.444,0.451,1,2008-12-16,26,8,18,0.308,24,11,13,0.4579999999999999
20800361,1610612763,1610612740,84.0,91.0,0.478,0.419,0,2008-12-16,25,9,16,0.36,21,14,7,0.667
20800362,1610612760,1610612746,88.0,98.0,0.456,0.4589999999999999,0,2008-12-16,26,2,24,0.077,24,7,17,0.292
20800363,1610612745,1610612743,108.0,96.0,0.5529999999999999,0.451,1,2008-12-16,25,16,9,0.64,25,17,8,0.68
20800364,1610612757,1610612758,109.0,77.0,0.414,0.316,1,2008-12-16,26,16,10,0.615,26,7,19,0.2689999999999999
20800365,1610612747,1610612752,116.0,114.0,0.474,0.457,1,2008-12-16,24,21,3,0.875,25,11,14,0.44
20800351,1610612737,1610612766,83.0,79.0,0.455,0.3879999999999999,1,2008-12-15,24,15,9,0.625,25,7,18,0.28
20800352,1610612761,1610612751,87.0,94.0,0.4,0.381,0,2008-12-15,24,10,14,0.417,23,12,11,0.522
20800353,1610612764,1610612754,98.0,118.0,0.42,0.474,0,2008-12-15,22,4,18,0.182,24,8,16,0.3329999999999999
20800354,1610612738,1610612762,100.0,91.0,0.493,0.4589999999999999,1,2008-12-15,25,23,2,0.92,26,15,11,0.5770000000000001
20800355,1610612748,1610612749,83.0,98.0,0.4429999999999999,0.45,0,2008-12-15,24,12,12,0.5,26,11,15,0.423
20800356,1610612742,1610612743,88.0,98.0,0.349,0.462,0,2008-12-15,23,13,10,0.565,24,17,7,0.708
20800357,1610612756,1610612752,111.0,103.0,0.4479999999999999,0.412,1,2008-12-15,25,15,10,0.6,24,11,13,0.4579999999999999
20800358,1610612758,1610612750,118.0,103.0,0.506,0.419,1,2008-12-15,25,7,18,0.28,24,4,20,0.1669999999999999
20800359,1610612744,1610612753,98.0,109.0,0.418,0.479,0,2008-12-15,25,7,18,0.28,25,19,6,0.76
20800347,1610612761,1610612740,91.0,99.0,0.4029999999999999,0.48,0,2008-12-14,23,10,13,0.435,20,13,7,0.65
20800348,1610612763,1610612748,102.0,86.0,0.466,0.364,1,2008-12-14,24,9,15,0.375,23,12,11,0.522
20800349,1610612759,1610612760,109.0,104.0,0.512,0.518,1,2008-12-14,23,15,8,0.652,25,2,23,0.08
20800350,1610612747,1610612750,98.0,86.0,0.447,0.361,1,2008-12-14,23,20,3,0.87,23,4,19,0.174
20800337,1610612737,1610612739,97.0,92.0,0.476,0.415,1,2008-12-13,23,14,9,0.609,24,20,4,0.833
20800338,1610612766,1610612765,86.0,90.0,0.412,0.4529999999999999,0,2008-12-13,24,7,17,0.292,22,13,9,0.591
20800339,1610612755,1610612764,104.0,89.0,0.514,0.41,1,2008-12-13,24,10,14,0.417,21,4,17,0.19
20800340,1610612741,1610612751,113.0,104.0,0.467,0.387,1,2008-12-13,23,11,12,0.478,22,11,11,0.5
20800341,1610612742,1610612760,103.0,99.0,0.506,0.46,1,2008-12-13,22,13,9,0.591,24,2,22,0.083
20800342,1610612749,1610612754,121.0,103.0,0.512,0.446,1,2008-12-13,25,10,15,0.4,23,7,16,0.304
20800343,1610612743,1610612744,123.0,105.0,0.532,0.412,1,2008-12-13,23,16,7,0.696,24,7,17,0.292
20800344,1610612762,1610612753,94.0,103.0,0.429,0.48,0,2008-12-13,25,15,10,0.6,24,18,6,0.75
20800345,1610612758,1610612752,90.0,114.0,0.3670000000000001,0.494,0,2008-12-13,24,6,18,0.25,23,11,12,0.478
20800346,1610612746,1610612745,95.0,82.0,0.47,0.356,1,2008-12-13,23,6,17,0.261,24,15,9,0.625
20800326,1610612739,1610612755,88.0,72.0,0.41,0.435,1,2008-12-12,23,20,3,0.87,23,9,14,0.391
20800327,1610612748,1610612737,73.0,87.0,0.386,0.3779999999999999,0,2008-12-12,22,12,10,0.545,22,13,9,0.591
20800328,1610612751,1610612761,79.0,101.0,0.313,0.4379999999999999,0,2008-12-12,21,11,10,0.524,22,10,12,0.455
20800329,1610612738,1610612740,94.0,82.0,0.471,0.354,1,2008-12-12,24,22,2,0.917,19,12,7,0.632
20800330,1610612765,1610612754,114.0,110.0,0.5579999999999999,0.565,1,2008-12-12,21,12,9,0.5710000000000001,22,7,15,0.318
20800331,1610612763,1610612741,103.0,96.0,0.471,0.444,1,2008-12-12,23,8,15,0.348,22,10,12,0.455
20800332,1610612750,1610612759,86.0,98.0,0.409,0.4679999999999999,0,2008-12-12,22,4,18,0.182,22,14,8,0.636
20800333,1610612756,1610612753,113.0,112.0,0.506,0.4529999999999999,1,2008-12-12,24,14,10,0.583,23,17,6,0.7390000000000001
20800334,1610612757,1610612746,112.0,120.0,0.422,0.47,0,2008-12-12,25,15,10,0.6,22,5,17,0.2269999999999999
20800335,1610612744,1610612745,108.0,119.0,0.402,0.466,0,2008-12-12,23,7,16,0.304,23,15,8,0.652
20800336,1610612747,1610612758,112.0,103.0,0.5,0.4679999999999999,1,2008-12-12,22,19,3,0.8640000000000001,23,6,17,0.261
20800323,1610612764,1610612738,88.0,122.0,0.431,0.557,0,2008-12-11,20,4,16,0.2,23,21,2,0.913
20800324,1610612742,1610612766,95.0,90.0,0.45,0.487,1,2008-12-11,21,12,9,0.5710000000000001,23,7,16,0.304
20800325,1610612762,1610612757,97.0,88.0,0.486,0.442,1,2008-12-11,24,15,9,0.625,24,15,9,0.625
20800314,1610612761,1610612754,101.0,88.0,0.494,0.347,1,2008-12-10,21,9,12,0.429,21,7,14,0.3329999999999999
20800315,1610612751,1610612752,109.0,121.0,0.537,0.506,0,2008-12-10,20,11,9,0.55,22,10,12,0.455
20800316,1610612740,1610612766,105.0,89.0,0.488,0.415,1,2008-12-10,18,12,6,0.667,22,7,15,0.318
20800317,1610612760,1610612763,102.0,108.0,0.514,0.481,0,2008-12-10,23,2,21,0.087,22,7,15,0.318
20800318,1610612755,1610612739,93.0,101.0,0.423,0.46,0,2008-12-10,22,9,13,0.409,22,19,3,0.8640000000000001
20800319,1610612759,1610612737,95.0,89.0,0.4429999999999999,0.4679999999999999,1,2008-12-10,21,13,8,0.619,21,12,9,0.5710000000000001
20800320,1610612743,1610612750,116.0,105.0,0.481,0.4429999999999999,1,2008-12-10,22,15,7,0.682,21,4,17,0.19
20800321,1610612744,1610612749,119.0,96.0,0.489,0.43,1,2008-12-10,22,7,15,0.318,24,9,15,0.375
20800322,1610612747,1610612756,115.0,110.0,0.488,0.506,1,2008-12-10,21,18,3,0.857,23,13,10,0.565
20800305,1610612739,1610612761,114.0,94.0,0.494,0.451,1,2008-12-09,21,18,3,0.857,20,8,12,0.4
20800306,1610612764,1610612765,107.0,94.0,0.494,0.514,1,2008-12-09,19,4,15,0.211,20,11,9,0.55
20800307,1610612750,1610612762,96.0,99.0,0.402,0.4639999999999999,0,2008-12-09,20,4,16,0.2,23,14,9,0.609
20800308,1610612741,1610612752,105.0,100.0,0.472,0.421,1,2008-12-09,21,10,11,0.476,21,9,12,0.429
20800309,1610612742,1610612759,126.0,133.0,0.516,0.49,0,2008-12-09,20,11,9,0.55,20,12,8,0.6
20800310,1610612745,1610612737,92.0,84.0,0.4320000000000001,0.391,1,2008-12-09,22,14,8,0.636,20,12,8,0.6
20800311,1610612756,1610612749,125.0,110.0,0.5870000000000001,0.4679999999999999,1,2008-12-09,22,13,9,0.591,23,9,14,0.391
20800312,1610612757,1610612753,108.0,109.0,0.519,0.506,0,2008-12-09,23,15,8,0.652,22,17,5,0.773
20800313,1610612758,1610612747,113.0,101.0,0.494,0.402,1,2008-12-09,22,6,16,0.273,20,17,3,0.85
20800301,1610612748,1610612766,100.0,96.0,0.4270000000000001,0.436,1,2008-12-08,21,12,9,0.5710000000000001,21,7,14,0.3329999999999999
20800302,1610612763,1610612745,109.0,97.0,0.513,0.486,1,2008-12-08,21,6,15,0.286,21,13,8,0.619
20800303,1610612760,1610612744,102.0,112.0,0.4270000000000001,0.506,0,2008-12-08,22,2,20,0.091,21,6,15,0.286
20800304,1610612746,1610612753,88.0,95.0,0.385,0.44,0,2008-12-08,21,4,17,0.19,21,16,5,0.762
20800297,1610612752,1610612765,104.0,92.0,0.467,0.4379999999999999,1,2008-12-07,20,9,11,0.45,19,11,8,0.579
20800298,1610612761,1610612757,97.0,98.0,0.494,0.439,0,2008-12-07,19,8,11,0.421,22,15,7,0.682
20800299,1610612754,1610612738,117.0,122.0,0.506,0.5,0,2008-12-07,20,7,13,0.35,22,20,2,0.909
20800300,1610612747,1610612749,105.0,92.0,0.486,0.38,1,2008-12-07,19,17,2,0.895,22,9,13,0.409
20800287,1610612766,1610612739,74.0,94.0,0.362,0.4639999999999999,0,2008-12-06,20,7,13,0.35,20,17,3,0.85
20800288,1610612748,1610612760,105.0,99.0,0.482,0.4320000000000001,1,2008-12-06,20,11,9,0.55,21,2,19,0.095
20800289,1610612755,1610612751,84.0,95.0,0.364,0.493,0,2008-12-06,21,9,12,0.429,19,11,8,0.579
20800290,1610612750,1610612746,84.0,107.0,0.39,0.469,0,2008-12-06,19,4,15,0.211,20,4,16,0.2
20800291,1610612740,1610612763,106.0,87.0,0.521,0.452,1,2008-12-06,17,11,6,0.647,20,5,15,0.25
20800292,1610612741,1610612764,117.0,110.0,0.524,0.542,1,2008-12-06,20,9,11,0.45,18,3,15,0.1669999999999999
20800293,1610612742,1610612737,100.0,98.0,0.476,0.4529999999999999,1,2008-12-06,19,11,8,0.579,19,12,7,0.632
20800294,1610612759,1610612744,123.0,88.0,0.5529999999999999,0.373,1,2008-12-06,19,11,8,0.579,20,5,15,0.25
20800295,1610612756,1610612762,106.0,104.0,0.45,0.4529999999999999,1,2008-12-06,21,12,9,0.5710000000000001,22,13,9,0.591
20800296,1610612758,1610612743,85.0,118.0,0.293,0.525,0,2008-12-06,21,5,16,0.238,21,14,7,0.667
20800276,1610612753,1610612760,98.0,89.0,0.452,0.434,1,2008-12-05,20,15,5,0.75,20,2,18,0.1
20800277,1610612764,1610612747,104.0,106.0,0.4529999999999999,0.5,0,2008-12-05,17,3,14,0.176,18,16,2,0.889
20800278,1610612737,1610612752,98.0,95.0,0.487,0.4379999999999999,1,2008-12-05,18,12,6,0.667,19,8,11,0.421
20800279,1610612739,1610612754,97.0,73.0,0.514,0.4029999999999999,1,2008-12-05,19,16,3,0.8420000000000001,19,7,12,0.368
20800280,1610612751,1610612750,113.0,84.0,0.527,0.426,1,2008-12-05,18,10,8,0.556,18,4,14,0.222
20800281,1610612738,1610612757,93.0,78.0,0.466,0.426,1,2008-12-05,21,19,2,0.905,21,14,7,0.667
20800282,1610612765,1610612755,91.0,96.0,0.48,0.4589999999999999,0,2008-12-05,18,11,7,0.611,20,9,11,0.45
20800283,1610612763,1610612746,93.0,81.0,0.494,0.457,1,2008-12-05,19,5,14,0.263,19,3,16,0.158
20800284,1610612745,1610612744,131.0,112.0,0.488,0.542,1,2008-12-05,20,13,7,0.65,19,5,14,0.263
20800285,1610612749,1610612766,101.0,96.0,0.479,0.514,1,2008-12-05,21,9,12,0.429,19,7,12,0.368
20800286,1610612762,1610612761,114.0,87.0,0.516,0.439,1,2008-12-05,21,13,8,0.619,18,8,10,0.444
20800274,1610612742,1610612756,112.0,97.0,0.511,0.444,1,2008-12-04,18,10,8,0.556,20,11,9,0.55
20800275,1610612743,1610612759,91.0,108.0,0.4429999999999999,0.5,0,2008-12-04,20,13,7,0.65,18,10,8,0.556
20800263,1610612737,1610612763,105.0,95.0,0.563,0.455,1,2008-12-03,17,11,6,0.647,18,4,14,0.222
20800264,1610612766,1610612760,103.0,97.0,0.474,0.545,1,2008-12-03,18,7,11,0.389,19,2,17,0.105
20800265,1610612739,1610612752,118.0,82.0,0.506,0.386,1,2008-12-03,18,15,3,0.833,18,8,10,0.444
20800266,1610612753,1610612750,100.0,89.0,0.569,0.414,1,2008-12-03,19,14,5,0.737,17,4,13,0.235
20800267,1610612755,1610612747,102.0,114.0,0.488,0.581,0,2008-12-03,19,8,11,0.421,17,15,2,0.882
20800268,1610612764,1610612757,92.0,98.0,0.507,0.481,0,2008-12-03,16,3,13,0.188,20,14,6,0.7
20800269,1610612738,1610612754,114.0,96.0,0.5,0.44,1,2008-12-03,20,18,2,0.9,18,7,11,0.389
20800270,1610612749,1610612741,97.0,90.0,0.47,0.4320000000000001,1,2008-12-03,20,8,12,0.4,19,8,11,0.421
20800271,1610612740,1610612756,104.0,91.0,0.452,0.474,1,2008-12-03,16,10,6,0.625,19,11,8,0.579
20800272,1610612745,1610612746,103.0,96.0,0.408,0.44,1,2008-12-03,19,12,7,0.632,18,3,15,0.1669999999999999
20800273,1610612762,1610612748,89.0,93.0,0.397,0.444,0,2008-12-03,20,12,8,0.6,19,10,9,0.526
20800255,1610612754,1610612747,118.0,117.0,0.455,0.513,1,2008-12-02,17,7,10,0.412,16,14,2,0.875
20800256,1610612751,1610612764,88.0,108.0,0.4029999999999999,0.518,0,2008-12-02,17,9,8,0.529,15,3,12,0.2
20800257,1610612752,1610612757,97.0,104.0,0.41,0.444,0,2008-12-02,17,8,9,0.471,19,13,6,0.684
20800258,1610612741,1610612755,95.0,103.0,0.402,0.396,0,2008-12-02,18,8,10,0.444,18,8,10,0.444
20800259,1610612742,1610612746,100.0,98.0,0.4479999999999999,0.494,1,2008-12-02,17,9,8,0.529,17,3,14,0.176
20800260,1610612759,1610612765,77.0,89.0,0.3939999999999999,0.5,0,2008-12-02,17,9,8,0.529,17,11,6,0.647
20800261,1610612743,1610612761,132.0,93.0,0.598,0.366,1,2008-12-02,19,13,6,0.684,17,8,9,0.471
20800262,1610612758,1610612762,94.0,99.0,0.405,0.514,0,2008-12-02,20,5,15,0.25,19,12,7,0.632
20800252,1610612766,1610612750,100.0,90.0,0.4629999999999999,0.4,1,2008-12-01,17,6,11,0.353,16,4,12,0.25
20800253,1610612738,1610612753,107.0,88.0,0.541,0.42,1,2008-12-01,19,17,2,0.895,18,13,5,0.722
20800254,1610612744,1610612748,129.0,130.0,0.4639999999999999,0.475,0,2008-12-01,18,5,13,0.278,18,9,9,0.5
20800247,1610612765,1610612757,85.0,96.0,0.435,0.522,0,2008-11-30,16,10,6,0.625,18,12,6,0.667
20800248,1610612755,1610612741,92.0,103.0,0.434,0.521,0,2008-11-30,17,7,10,0.412,17,8,9,0.471
20800249,1610612743,1610612745,104.0,94.0,0.481,0.408,1,2008-11-30,18,12,6,0.667,18,11,7,0.611
20800250,1610612756,1610612751,109.0,117.0,0.5479999999999999,0.5,0,2008-11-30,18,11,7,0.611,16,9,7,0.563
20800251,1610612747,1610612761,112.0,99.0,0.511,0.386,1,2008-11-30,15,14,1,0.933,16,8,8,0.5
20800236,1610612766,1610612738,84.0,89.0,0.478,0.4379999999999999,0,2008-11-29,16,5,11,0.313,18,16,2,0.889
20800237,1610612753,1610612754,110.0,96.0,0.507,0.43,1,2008-11-29,17,13,4,0.765,16,6,10,0.375
20800238,1610612764,1610612737,98.0,102.0,0.425,0.5,0,2008-11-29,14,2,12,0.143,16,10,6,0.625
20800239,1610612752,1610612744,138.0,125.0,0.514,0.455,1,2008-11-29,16,8,8,0.5,17,5,12,0.294
20800240,1610612763,1610612760,103.0,111.0,0.5770000000000001,0.521,0,2008-11-29,17,4,13,0.235,18,2,16,0.111
20800241,1610612750,1610612743,97.0,106.0,0.456,0.4629999999999999,0,2008-11-29,15,4,11,0.267,17,11,6,0.647
20800242,1610612745,1610612759,103.0,84.0,0.481,0.377,1,2008-11-29,17,11,6,0.647,16,9,7,0.563
20800243,1610612749,1610612739,85.0,97.0,0.392,0.415,0,2008-11-29,19,7,12,0.368,17,14,3,0.8240000000000001
20800244,1610612762,1610612751,88.0,105.0,0.434,0.519,0,2008-11-29,18,11,7,0.611,15,8,7,0.5329999999999999
20800245,1610612758,1610612742,78.0,101.0,0.348,0.434,0,2008-11-29,19,5,14,0.263,16,8,8,0.5
20800246,1610612746,1610612748,97.0,96.0,0.4270000000000001,0.4529999999999999,1,2008-11-29,16,3,13,0.188,17,8,9,0.471
20800225,1610612761,1610612737,93.0,88.0,0.46,0.422,1,2008-11-28,15,8,7,0.5329999999999999,15,9,6,0.6
20800226,1610612738,1610612755,102.0,78.0,0.513,0.416,1,2008-11-28,17,15,2,0.882,16,7,9,0.4379999999999999
20800227,1610612739,1610612744,112.0,97.0,0.467,0.3979999999999999,1,2008-11-28,16,13,3,0.813,16,5,11,0.313
20800228,1610612765,1610612749,107.0,97.0,0.48,0.405,1,2008-11-28,15,10,5,0.667,18,7,11,0.389
20800229,1610612754,1610612766,108.0,115.0,0.417,0.407,0,2008-11-28,15,6,9,0.4,15,5,10,0.3329999999999999
20800230,1610612760,1610612750,103.0,105.0,0.5,0.4679999999999999,0,2008-11-28,17,1,16,0.059,14,4,10,0.286
20800231,1610612756,1610612748,92.0,107.0,0.487,0.494,0,2008-11-28,17,11,6,0.647,16,8,8,0.5
20800232,1610612759,1610612763,109.0,98.0,0.5660000000000001,0.545,1,2008-11-28,15,9,6,0.6,16,4,12,0.25
20800233,1610612762,1610612758,120.0,94.0,0.53,0.488,1,2008-11-28,17,11,6,0.647,18,5,13,0.278
20800234,1610612757,1610612740,101.0,86.0,0.536,0.4429999999999999,1,2008-11-28,17,11,6,0.647,15,9,6,0.6
20800235,1610612747,1610612742,114.0,107.0,0.49,0.512,1,2008-11-28,14,13,1,0.929,15,7,8,0.467
20800223,1610612764,1610612753,90.0,105.0,0.422,0.469,0,2008-11-27,13,2,11,0.154,16,12,4,0.75
20800224,1610612743,1610612740,101.0,105.0,0.507,0.452,0,2008-11-27,16,10,6,0.625,14,9,5,0.643
20800210,1610612737,1610612749,102.0,96.0,0.5,0.487,1,2008-11-26,14,9,5,0.643,17,7,10,0.412
20800211,1610612739,1610612760,117.0,82.0,0.608,0.354,1,2008-11-26,15,12,3,0.8,16,1,15,0.063
20800212,1610612761,1610612766,93.0,86.0,0.5,0.43,1,2008-11-26,14,7,7,0.5,14,4,10,0.286
20800213,1610612738,1610612744,119.0,111.0,0.471,0.494,1,2008-11-26,16,14,2,0.875,15,5,10,0.3329999999999999
20800214,1610612755,1610612753,94.0,96.0,0.444,0.471,0,2008-11-26,15,7,8,0.467,15,11,4,0.733
20800215,1610612765,1610612752,110.0,96.0,0.516,0.3879999999999999,1,2008-11-26,14,9,5,0.643,15,7,8,0.467
20800216,1610612750,1610612756,102.0,110.0,0.424,0.536,0,2008-11-26,13,3,10,0.231,16,11,5,0.688
20800217,1610612745,1610612754,90.0,91.0,0.348,0.417,0,2008-11-26,16,10,6,0.625,14,6,8,0.429
20800218,1610612759,1610612741,98.0,88.0,0.447,0.457,1,2008-11-26,14,8,6,0.5710000000000001,16,7,9,0.4379999999999999
20800219,1610612762,1610612763,117.0,100.0,0.537,0.532,1,2008-11-26,16,10,6,0.625,15,4,11,0.267
20800220,1610612757,1610612748,106.0,68.0,0.494,0.345,1,2008-11-26,16,10,6,0.625,15,7,8,0.467
20800221,1610612758,1610612751,114.0,116.0,0.429,0.452,0,2008-11-26,17,5,12,0.294,14,7,7,0.5
20800222,1610612746,1610612743,105.0,106.0,0.481,0.452,0,2008-11-26,15,2,13,0.133,15,10,5,0.667
20800205,1610612764,1610612744,124.0,100.0,0.505,0.4589999999999999,1,2008-11-25,12,2,10,0.1669999999999999,14,5,9,0.357
20800206,1610612752,1610612739,101.0,119.0,0.414,0.527,0,2008-11-25,14,7,7,0.5,14,11,3,0.7859999999999999
20800207,1610612760,1610612756,98.0,99.0,0.419,0.534,0,2008-11-25,15,1,14,0.067,15,10,5,0.667
20800208,1610612742,1610612754,109.0,106.0,0.482,0.467,1,2008-11-25,14,7,7,0.5,13,5,8,0.385
20800209,1610612747,1610612751,120.0,93.0,0.506,0.345,1,2008-11-25,13,12,1,0.923,13,6,7,0.462
20800198,1610612766,1610612755,93.0,84.0,0.5479999999999999,0.395,1,2008-11-24,13,4,9,0.308,14,7,7,0.5
20800199,1610612753,1610612749,108.0,101.0,0.477,0.46,1,2008-11-24,14,10,4,0.7140000000000001,16,7,9,0.4379999999999999
20800200,1610612748,1610612745,98.0,107.0,0.429,0.456,0,2008-11-24,14,7,7,0.5,15,10,5,0.667
20800201,1610612763,1610612759,81.0,94.0,0.39,0.472,0,2008-11-24,14,4,10,0.286,13,7,6,0.5379999999999999
20800202,1610612762,1610612741,100.0,101.0,0.512,0.512,0,2008-11-24,15,9,6,0.6,15,7,8,0.467
20800203,1610612757,1610612758,91.0,90.0,0.405,0.465,1,2008-11-24,15,9,6,0.6,16,5,11,0.313
20800204,1610612746,1610612740,87.0,99.0,0.384,0.494,0,2008-11-24,14,2,12,0.143,13,8,5,0.615
20800193,1610612761,1610612738,103.0,118.0,0.4429999999999999,0.616,0,2008-11-23,13,6,7,0.462,15,13,2,0.867
20800194,1610612755,1610612744,89.0,81.0,0.3979999999999999,0.436,1,2008-11-23,13,7,6,0.5379999999999999,13,5,8,0.385
20800195,1610612765,1610612750,80.0,106.0,0.37,0.53,0,2008-11-23,13,8,5,0.615,12,3,9,0.25
20800196,1610612743,1610612741,114.0,101.0,0.541,0.416,1,2008-11-23,14,9,5,0.643,14,6,8,0.429
20800197,1610612747,1610612758,118.0,108.0,0.517,0.534,1,2008-11-23,12,11,1,0.917,15,5,10,0.3329999999999999
20800184,1610612766,1610612749,74.0,79.0,0.3720000000000001,0.368,0,2008-11-22,12,3,9,0.25,15,7,8,0.467
20800185,1610612753,1610612745,95.0,100.0,0.407,0.482,0,2008-11-22,13,9,4,0.6920000000000001,14,9,5,0.643
20800186,1610612739,1610612737,110.0,96.0,0.506,0.444,1,2008-11-22,13,10,3,0.769,13,8,5,0.615
20800187,1610612748,1610612754,109.0,100.0,0.519,0.4629999999999999,1,2008-11-22,13,7,6,0.5379999999999999,12,5,7,0.417
20800188,1610612751,1610612746,112.0,95.0,0.507,0.4679999999999999,1,2008-11-22,12,6,6,0.5,13,2,11,0.154
20800189,1610612752,1610612764,122.0,117.0,0.478,0.4629999999999999,1,2008-11-22,13,7,6,0.5379999999999999,11,1,10,0.091
20800190,1610612763,1610612762,94.0,103.0,0.467,0.547,0,2008-11-22,13,4,9,0.308,14,9,5,0.643
20800191,1610612740,1610612760,109.0,97.0,0.541,0.528,1,2008-11-22,12,7,5,0.583,14,1,13,0.071
20800192,1610612756,1610612757,102.0,92.0,0.5329999999999999,0.389,1,2008-11-22,14,9,5,0.643,14,8,6,0.5710000000000001
20800171,1610612754,1610612753,98.0,100.0,0.384,0.43,0,2008-11-21,11,5,6,0.455,12,9,3,0.75
20800172,1610612755,1610612746,89.0,88.0,0.425,0.442,1,2008-11-21,12,6,6,0.5,12,2,10,0.1669999999999999
20800173,1610612761,1610612751,127.0,129.0,0.483,0.515,0,2008-11-21,12,6,6,0.5,11,5,6,0.455
20800174,1610612764,1610612745,91.0,103.0,0.4270000000000001,0.479,0,2008-11-21,10,1,9,0.1,13,8,5,0.615
20800175,1610612737,1610612766,88.0,83.0,0.446,0.423,1,2008-11-21,12,8,4,0.667,11,3,8,0.273
20800176,1610612750,1610612738,78.0,95.0,0.313,0.493,0,2008-11-21,11,2,9,0.182,14,12,2,0.857
20800177,1610612742,1610612763,91.0,76.0,0.4,0.373,1,2008-11-21,13,6,7,0.462,12,4,8,0.3329999999999999
20800178,1610612749,1610612752,104.0,87.0,0.442,0.344,1,2008-11-21,14,6,8,0.429,12,6,6,0.5
20800179,1610612759,1610612762,119.0,94.0,0.519,0.493,1,2008-11-21,12,6,6,0.5,13,8,5,0.615
20800180,1610612760,1610612740,80.0,105.0,0.366,0.494,0,2008-11-21,13,1,12,0.077,11,6,5,0.545
20800181,1610612758,1610612757,96.0,117.0,0.5,0.556,0,2008-11-21,14,5,9,0.357,13,8,5,0.615
20800182,1610612744,1610612741,110.0,115.0,0.494,0.511,0,2008-11-21,12,5,7,0.417,13,6,7,0.462
20800183,1610612747,1610612743,104.0,90.0,0.488,0.429,1,2008-11-21,11,10,1,0.909,13,8,5,0.615
20800169,1610612738,1610612765,98.0,80.0,0.493,0.426,1,2008-11-20,13,11,2,0.846,12,8,4,0.667
20800170,1610612756,1610612747,92.0,105.0,0.442,0.467,0,2008-11-20,13,8,5,0.615,10,9,1,0.9
20800159,1610612737,1610612764,91.0,87.0,0.3929999999999999,0.412,1,2008-11-19,11,7,4,0.636,9,1,8,0.111
20800160,1610612765,1610612739,96.0,89.0,0.507,0.425,1,2008-11-19,11,8,3,0.727,12,9,3,0.75
20800161,1610612748,1610612761,95.0,101.0,0.4429999999999999,0.4629999999999999,0,2008-11-19,12,6,6,0.5,11,6,5,0.545
20800162,1610612745,1610612742,86.0,96.0,0.3720000000000001,0.455,0,2008-11-19,12,7,5,0.583,12,5,7,0.417
20800163,1610612750,1610612755,102.0,96.0,0.514,0.471,1,2008-11-19,10,2,8,0.2,11,5,6,0.455
20800164,1610612740,1610612758,96.0,105.0,0.519,0.547,0,2008-11-19,10,5,5,0.5,13,5,8,0.385
20800165,1610612760,1610612746,88.0,108.0,0.4,0.474,0,2008-11-19,12,1,11,0.083,11,2,9,0.182
20800166,1610612759,1610612743,81.0,91.0,0.387,0.462,0,2008-11-19,11,5,6,0.455,12,8,4,0.667
20800167,1610612762,1610612749,105.0,94.0,0.514,0.444,1,2008-11-19,12,8,4,0.667,13,5,8,0.385
20800168,1610612757,1610612741,116.0,74.0,0.506,0.346,1,2008-11-19,12,7,5,0.583,12,5,7,0.417
20800149,1610612766,1610612742,83.0,100.0,0.3879999999999999,0.5,0,2008-11-18,10,3,7,0.3,11,4,7,0.364
20800150,1610612754,1610612737,113.0,96.0,0.55,0.424,1,2008-11-18,10,5,5,0.5,10,6,4,0.6
20800151,1610612753,1610612761,103.0,90.0,0.457,0.4379999999999999,1,2008-11-18,11,8,3,0.727,10,5,5,0.5
20800152,1610612764,1610612748,87.0,94.0,0.413,0.45,0,2008-11-18,8,1,7,0.125,11,6,5,0.545
20800153,1610612738,1610612752,110.0,101.0,0.532,0.435,1,2008-11-18,12,10,2,0.833,11,6,5,0.545
20800154,1610612751,1610612739,82.0,106.0,0.3670000000000001,0.44,0,2008-11-18,10,4,6,0.4,11,9,2,0.818
20800155,1610612763,1610612758,109.0,94.0,0.542,0.45,1,2008-11-18,11,4,7,0.364,12,4,8,0.3329999999999999
20800156,1610612743,1610612749,114.0,105.0,0.507,0.4579999999999999,1,2008-11-18,11,7,4,0.636,12,5,7,0.417
20800157,1610612744,1610612757,111.0,106.0,0.45,0.4679999999999999,1,2008-11-18,11,5,6,0.455,11,6,5,0.545
20800158,1610612747,1610612741,116.0,109.0,0.469,0.43,1,2008-11-18,9,8,1,0.889,11,5,6,0.455
20800146,1610612760,1610612745,89.0,100.0,0.405,0.506,0,2008-11-17,11,1,10,0.091,11,7,4,0.636
20800147,1610612762,1610612756,109.0,97.0,0.471,0.486,1,2008-11-17,11,7,4,0.636,12,8,4,0.667
20800148,1610612746,1610612759,83.0,86.0,0.414,0.444,0,2008-11-17,10,1,9,0.1,10,5,5,0.5
20800140,1610612761,1610612748,107.0,96.0,0.474,0.402,1,2008-11-16,9,5,4,0.556,10,5,5,0.5
20800141,1610612766,1610612753,85.0,90.0,0.4320000000000001,0.4379999999999999,0,2008-11-16,9,3,6,0.3329999999999999,10,7,3,0.7
20800142,1610612752,1610612742,114.0,124.0,0.433,0.439,0,2008-11-16,10,6,4,0.6,10,3,7,0.3
20800143,1610612743,1610612750,90.0,84.0,0.337,0.397,1,2008-11-16,10,6,4,0.6,9,1,8,0.111
20800144,1610612756,1610612765,104.0,86.0,0.569,0.3979999999999999,1,2008-11-16,11,8,3,0.727,10,7,3,0.7
20800145,1610612758,1610612759,88.0,90.0,0.446,0.4589999999999999,0,2008-11-16,11,4,7,0.364,9,4,5,0.444
20800132,1610612746,1610612744,103.0,121.0,0.396,0.511,0,2008-11-15,9,1,8,0.111,10,4,6,0.4
20800133,1610612737,1610612751,107.0,119.0,0.461,0.551,0,2008-11-15,9,6,3,0.667,9,4,5,0.444
20800134,1610612755,1610612760,110.0,85.0,0.469,0.395,1,2008-11-15,10,5,5,0.5,10,1,9,0.1
20800135,1610612739,1610612762,105.0,93.0,0.456,0.4579999999999999,1,2008-11-15,10,8,2,0.8,10,6,4,0.6
20800136,1610612750,1610612757,83.0,88.0,0.442,0.44,0,2008-11-15,8,1,7,0.125,10,6,4,0.6
20800137,1610612741,1610612754,104.0,91.0,0.3979999999999999,0.3720000000000001,1,2008-11-15,10,5,5,0.5,9,4,5,0.444
20800138,1610612745,1610612740,91.0,82.0,0.455,0.408,1,2008-11-15,10,6,4,0.6,9,5,4,0.556
20800139,1610612749,1610612738,97.0,102.0,0.365,0.4629999999999999,0,2008-11-15,11,5,6,0.455,11,9,2,0.818
20800120,1610612766,1610612762,104.0,96.0,0.466,0.439,1,2008-11-14,8,3,5,0.375,9,6,3,0.667
20800121,1610612754,1610612755,92.0,94.0,0.44,0.368,0,2008-11-14,8,4,4,0.5,9,4,5,0.444
20800122,1610612748,1610612764,97.0,77.0,0.471,0.408,1,2008-11-14,9,5,4,0.556,7,1,6,0.143
20800123,1610612751,1610612737,115.0,108.0,0.475,0.475,1,2008-11-14,8,3,5,0.375,8,6,2,0.75
20800124,1610612752,1610612760,116.0,106.0,0.449,0.473,1,2008-11-14,9,6,3,0.667,9,1,8,0.111
20800125,1610612738,1610612743,85.0,94.0,0.397,0.487,0,2008-11-14,10,8,2,0.8,9,5,4,0.556
20800126,1610612763,1610612749,96.0,101.0,0.395,0.385,0,2008-11-14,10,3,7,0.3,10,5,5,0.5
20800127,1610612740,1610612757,87.0,82.0,0.423,0.435,1,2008-11-14,8,5,3,0.625,9,5,4,0.556
20800128,1610612742,1610612753,100.0,102.0,0.4370000000000001,0.3879999999999999,0,2008-11-14,9,2,7,0.222,9,6,3,0.667
20800129,1610612759,1610612745,77.0,75.0,0.4479999999999999,0.4,1,2008-11-14,8,3,5,0.375,9,5,4,0.556
20800130,1610612758,1610612756,95.0,97.0,0.425,0.462,0,2008-11-14,10,4,6,0.4,10,7,3,0.7
20800131,1610612747,1610612765,95.0,106.0,0.421,0.507,0,2008-11-14,8,7,1,0.875,9,7,2,0.778
20800117,1610612739,1610612743,110.0,99.0,0.573,0.479,1,2008-11-13,9,7,2,0.778,8,4,4,0.5
20800118,1610612741,1610612742,98.0,91.0,0.412,0.368,1,2008-11-13,9,4,5,0.444,8,2,6,0.25
20800119,1610612744,1610612765,102.0,107.0,0.411,0.4529999999999999,0,2008-11-13,9,3,6,0.3329999999999999,8,6,2,0.75
20800106,1610612761,1610612755,96.0,106.0,0.425,0.537,0,2008-11-12,8,4,4,0.5,8,3,5,0.375
20800107,1610612738,1610612737,103.0,102.0,0.421,0.456,1,2008-11-12,9,8,1,0.889,7,6,1,0.857
20800109,1610612751,1610612754,87.0,98.0,0.425,0.473,0,2008-11-12,7,2,5,0.286,7,4,3,0.5710000000000001
20800108,1610612748,1610612757,96.0,104.0,0.472,0.474,0,2008-11-12,8,4,4,0.5,8,5,3,0.625
20800110,1610612763,1610612752,103.0,132.0,0.488,0.591,0,2008-11-12,9,3,6,0.3329999999999999,8,5,3,0.625
20800111,1610612749,1610612759,82.0,78.0,0.413,0.4320000000000001,1,2008-11-12,9,4,5,0.444,7,2,5,0.286
20800112,1610612740,1610612747,86.0,93.0,0.447,0.41,0,2008-11-12,7,4,3,0.5710000000000001,7,7,0,1.0
20800113,1610612760,1610612753,92.0,109.0,0.374,0.451,0,2008-11-12,8,1,7,0.125,8,5,3,0.625
20800114,1610612764,1610612762,95.0,87.0,0.408,0.434,1,2008-11-12,6,1,5,0.1669999999999999,8,6,2,0.75
20800115,1610612746,1610612758,98.0,103.0,0.442,0.525,0,2008-11-12,8,1,7,0.125,9,4,5,0.444
20800116,1610612756,1610612745,82.0,94.0,0.376,0.4529999999999999,0,2008-11-12,9,6,3,0.667,8,5,3,0.625
20800098,1610612766,1610612743,80.0,88.0,0.4029999999999999,0.4379999999999999,0,2008-11-11,7,2,5,0.286,7,4,3,0.5710000000000001
20800099,1610612739,1610612749,99.0,93.0,0.486,0.38,1,2008-11-11,8,6,2,0.75,8,3,5,0.375
20800100,1610612755,1610612762,80.0,93.0,0.382,0.4370000000000001,0,2008-11-11,7,2,5,0.286,7,6,1,0.857
20800101,1610612741,1610612737,108.0,113.0,0.447,0.47,0,2008-11-11,8,3,5,0.375,6,6,0,1.0
20800102,1610612742,1610612747,99.0,106.0,0.419,0.442,0,2008-11-11,7,2,5,0.286,6,6,0,1.0
20800103,1610612759,1610612752,92.0,80.0,0.444,0.38,1,2008-11-11,6,2,4,0.3329999999999999,7,4,3,0.5710000000000001
20800104,1610612758,1610612765,92.0,100.0,0.487,0.416,0,2008-11-11,8,3,5,0.375,7,5,2,0.7140000000000001
20800105,1610612744,1610612750,113.0,110.0,0.475,0.4270000000000001,1,2008-11-11,8,3,5,0.375,7,1,6,0.143
20800093,1610612754,1610612760,107.0,99.0,0.482,0.387,1,2008-11-10,6,3,3,0.5,7,1,6,0.143
20800094,1610612753,1610612757,99.0,106.0,0.451,0.4379999999999999,0,2008-11-10,7,4,3,0.5710000000000001,7,4,3,0.5710000000000001
20800095,1610612738,1610612761,94.0,87.0,0.4379999999999999,0.429,1,2008-11-10,8,7,1,0.875,7,4,3,0.5710000000000001
20800096,1610612748,1610612751,99.0,94.0,0.4429999999999999,0.465,1,2008-11-10,7,4,3,0.5710000000000001,6,2,4,0.3329999999999999
20800097,1610612756,1610612763,107.0,102.0,0.487,0.442,1,2008-11-10,8,6,2,0.75,8,3,5,0.375
20800085,1610612766,1610612761,79.0,89.0,0.37,0.493,0,2008-11-09,6,2,4,0.3329999999999999,6,4,2,0.667
20800086,1610612752,1610612762,107.0,99.0,0.424,0.506,1,2008-11-09,6,4,2,0.667,6,5,1,0.833
20800087,1610612746,1610612742,103.0,92.0,0.487,0.414,1,2008-11-09,7,1,6,0.143,6,2,4,0.3329999999999999
20800088,1610612765,1610612738,76.0,88.0,0.347,0.446,0,2008-11-09,6,4,2,0.667,7,6,1,0.857
20800089,1610612760,1610612737,85.0,89.0,0.391,0.3720000000000001,0,2008-11-09,6,1,5,0.1669999999999999,5,5,0,1.0
20800090,1610612743,1610612763,100.0,90.0,0.423,0.38,1,2008-11-09,6,3,3,0.5,7,3,4,0.429
20800091,1610612758,1610612744,115.0,98.0,0.477,0.411,1,2008-11-09,7,3,4,0.429,7,2,5,0.286
20800092,1610612747,1610612745,111.0,82.0,0.532,0.3779999999999999,1,2008-11-09,5,5,0,1.0,7,4,3,0.5710000000000001
20800079,1610612754,1610612751,98.0,80.0,0.439,0.387,1,2008-11-08,5,2,3,0.4,5,2,3,0.4
20800080,1610612753,1610612764,106.0,81.0,0.5,0.392,1,2008-11-08,6,4,2,0.667,5,0,5,0.0
20800081,1610612740,1610612748,100.0,89.0,0.447,0.431,1,2008-11-08,6,4,2,0.667,6,3,3,0.5
20800082,1610612741,1610612739,97.0,106.0,0.424,0.4629999999999999,0,2008-11-08,7,3,4,0.429,7,5,2,0.7140000000000001
20800083,1610612749,1610612756,96.0,104.0,0.43,0.4429999999999999,0,2008-11-08,7,3,4,0.429,7,5,2,0.7140000000000001
20800084,1610612757,1610612750,97.0,93.0,0.466,0.417,1,2008-11-08,6,3,3,0.5,6,1,5,0.1669999999999999
20800066,1610612766,1610612740,92.0,89.0,0.418,0.421,1,2008-11-07,5,2,3,0.4,5,3,2,0.6
20800067,1610612764,1610612752,108.0,114.0,0.517,0.511,0,2008-11-07,4,0,4,0.0,5,3,2,0.6
20800068,1610612737,1610612761,110.0,92.0,0.5429999999999999,0.4320000000000001,1,2008-11-07,4,4,0,1.0,5,3,2,0.6
20800069,1610612738,1610612749,101.0,89.0,0.481,0.397,1,2008-11-07,6,5,1,0.833,6,3,3,0.5
20800070,1610612739,1610612754,111.0,107.0,0.519,0.478,1,2008-11-07,6,4,2,0.667,4,1,3,0.25
20800071,1610612751,1610612765,103.0,96.0,0.4270000000000001,0.373,1,2008-11-07,4,2,2,0.5,5,4,1,0.8
20800072,1610612759,1610612748,83.0,99.0,0.376,0.4679999999999999,0,2008-11-07,5,1,4,0.2,5,3,2,0.6
20800073,1610612741,1610612756,100.0,83.0,0.519,0.406,1,2008-11-07,6,3,3,0.5,6,4,2,0.667
20800074,1610612762,1610612760,104.0,97.0,0.5,0.4320000000000001,1,2008-11-07,5,5,0,1.0,5,1,4,0.2
20800075,1610612758,1610612750,121.0,109.0,0.5479999999999999,0.429,1,2008-11-07,6,2,4,0.3329999999999999,5,1,4,0.2
20800076,1610612743,1610612742,108.0,105.0,0.386,0.406,1,2008-11-07,5,2,3,0.4,5,2,3,0.4
20800077,1610612744,1610612763,104.0,109.0,0.429,0.461,0,2008-11-07,6,2,4,0.3329999999999999,6,3,3,0.5
20800078,1610612746,1610612745,83.0,92.0,0.434,0.43,0,2008-11-07,6,0,6,0.0,6,4,2,0.667
20800064,1610612753,1610612755,98.0,88.0,0.451,0.379,1,2008-11-06,5,3,2,0.6,6,2,4,0.3329999999999999
20800065,1610612757,1610612745,101.0,99.0,0.461,0.474,1,2008-11-06,5,2,3,0.4,5,3,2,0.6
20800051,1610612754,1610612756,103.0,113.0,0.446,0.5579999999999999,0,2008-11-05,3,1,2,0.3329999999999999,5,4,1,0.8
20800052,1610612761,1610612765,93.0,100.0,0.4529999999999999,0.4589999999999999,0,2008-11-05,4,3,1,0.75,4,4,0,1.0
20800053,1610612748,1610612755,106.0,83.0,0.47,0.375,1,2008-11-05,4,2,2,0.5,5,2,3,0.4
20800054,1610612752,1610612766,101.0,98.0,0.494,0.488,1,2008-11-05,4,2,2,0.5,4,1,3,0.25
20800055,1610612739,1610612741,107.0,93.0,0.451,0.392,1,2008-11-05,5,3,2,0.6,5,2,3,0.4
20800056,1610612749,1610612764,112.0,104.0,0.495,0.436,1,2008-11-05,5,3,2,0.6,3,0,3,0.0
20800057,1610612750,1610612759,125.0,129.0,0.4429999999999999,0.515,0,2008-11-05,4,1,3,0.25,4,1,3,0.25
20800058,1610612740,1610612737,79.0,87.0,0.423,0.43,0,2008-11-05,4,3,1,0.75,3,3,0,1.0
20800059,1610612760,1610612738,83.0,96.0,0.369,0.434,0,2008-11-05,4,1,3,0.25,5,4,1,0.8
20800060,1610612762,1610612757,103.0,96.0,0.527,0.4379999999999999,1,2008-11-05,4,4,0,1.0,4,1,3,0.25
20800061,1610612758,1610612763,100.0,95.0,0.527,0.4370000000000001,1,2008-11-05,5,1,4,0.2,5,2,3,0.4
20800062,1610612744,1610612743,111.0,101.0,0.467,0.4429999999999999,1,2008-11-05,5,2,3,0.4,4,1,3,0.25
20800063,1610612747,1610612746,106.0,88.0,0.3879999999999999,0.389,1,2008-11-05,4,4,0,1.0,5,0,5,0.0
20800048,1610612751,1610612756,86.0,114.0,0.337,0.632,0,2008-11-04,3,1,2,0.3329999999999999,4,3,1,0.75
20800049,1610612745,1610612738,99.0,103.0,0.391,0.519,0,2008-11-04,4,3,1,0.75,4,3,1,0.75
20800050,1610612759,1610612742,81.0,98.0,0.417,0.531,0,2008-11-04,3,0,3,0.0,4,2,2,0.5
20800042,1610612766,1610612765,83.0,101.0,0.441,0.5,0,2008-11-03,3,1,2,0.3329999999999999,3,3,0,1.0
20800043,1610612753,1610612741,96.0,93.0,0.412,0.442,1,2008-11-03,4,2,2,0.5,4,2,2,0.5
20800044,1610612755,1610612758,125.0,91.0,0.5920000000000001,0.474,1,2008-11-03,4,2,2,0.5,4,0,4,0.0
20800045,1610612763,1610612744,90.0,79.0,0.462,0.344,1,2008-11-03,4,2,2,0.5,4,1,3,0.25
20800046,1610612742,1610612739,81.0,100.0,0.408,0.4429999999999999,0,2008-11-03,3,1,2,0.3329999999999999,4,2,2,0.5
20800047,1610612746,1610612762,73.0,89.0,0.4029999999999999,0.416,0,2008-11-03,4,0,4,0.0,3,3,0,1.0
20800040,1610612752,1610612749,86.0,94.0,0.37,0.444,0,2008-11-02,3,1,2,0.3329999999999999,4,2,2,0.5
20800041,1610612760,1610612750,88.0,85.0,0.42,0.429,1,2008-11-02,3,1,2,0.3329999999999999,3,1,2,0.3329999999999999
20800026,1610612737,1610612755,95.0,88.0,0.429,0.412,1,2008-11-01,2,2,0,1.0,3,1,2,0.3329999999999999
20800027,1610612766,1610612748,100.0,87.0,0.536,0.444,1,2008-11-01,2,1,1,0.5,3,1,2,0.3329999999999999
20800028,1610612754,1610612738,95.0,79.0,0.407,0.346,1,2008-11-01,2,1,1,0.5,3,2,1,0.667
20800029,1610612753,1610612758,121.0,103.0,0.55,0.527,1,2008-11-01,3,1,2,0.3329999999999999,3,0,3,0.0
20800030,1610612765,1610612764,117.0,109.0,0.532,0.519,1,2008-11-01,2,2,0,1.0,2,0,2,0.0
20800031,1610612751,1610612744,97.0,105.0,0.422,0.421,0,2008-11-01,2,1,1,0.5,3,1,2,0.3329999999999999
20800032,1610612750,1610612742,85.0,95.0,0.392,0.446,0,2008-11-01,2,1,1,0.5,2,1,1,0.5
20800033,1610612740,1610612739,104.0,92.0,0.474,0.48,1,2008-11-01,3,3,0,1.0,3,1,2,0.3329999999999999
20800034,1610612741,1610612763,96.0,86.0,0.381,0.4270000000000001,1,2008-11-01,3,2,1,0.667,3,1,2,0.3329999999999999
20800035,1610612745,1610612760,89.0,77.0,0.364,0.4,1,2008-11-01,3,3,0,1.0,2,0,2,0.0
20800036,1610612749,1610612761,87.0,91.0,0.444,0.476,0,2008-11-01,3,1,2,0.3329999999999999,3,3,0,1.0
20800037,1610612743,1610612747,97.0,104.0,0.4589999999999999,0.379,0,2008-11-01,3,1,2,0.3329999999999999,3,3,0,1.0
20800038,1610612762,1610612746,101.0,79.0,0.489,0.397,1,2008-11-01,2,2,0,1.0,3,0,3,0.0
20800039,1610612756,1610612757,107.0,96.0,0.551,0.457,1,2008-11-01,3,2,1,0.667,3,1,2,0.3329999999999999
20800019,1610612755,1610612752,116.0,87.0,0.584,0.327,1,2008-10-31,2,1,1,0.5,2,1,1,0.5
20800020,1610612761,1610612744,112.0,108.0,0.513,0.447,1,2008-10-31,2,2,0,1.0,2,0,2,0.0
20800021,1610612748,1610612758,103.0,77.0,0.469,0.382,1,2008-10-31,2,1,1,0.5,2,0,2,0.0
20800022,1610612738,1610612741,96.0,80.0,0.4379999999999999,0.298,1,2008-10-31,2,2,0,1.0,2,1,1,0.5
20800023,1610612763,1610612753,86.0,84.0,0.395,0.42,1,2008-10-31,2,1,1,0.5,2,0,2,0.0
20800024,1610612746,1610612743,103.0,113.0,0.381,0.447,0,2008-10-31,2,0,2,0.0,2,1,1,0.5
20800025,1610612757,1610612759,100.0,99.0,0.4629999999999999,0.5589999999999999,1,2008-10-31,2,1,1,0.5,2,0,2,0.0
20800016,1610612739,1610612766,96.0,79.0,0.486,0.3379999999999999,1,2008-10-30,2,1,1,0.5,1,0,1,0.0
20800017,1610612742,1610612745,102.0,112.0,0.417,0.481,0,2008-10-30,1,0,1,0.0,2,2,0,1.0
20800018,1610612756,1610612740,95.0,108.0,0.544,0.474,0,2008-10-30,2,1,1,0.5,2,2,0,1.0
20800005,1610612755,1610612761,84.0,95.0,0.345,0.444,0,2008-10-29,1,0,1,0.0,1,1,0,1.0
20800004,1610612753,1610612737,85.0,99.0,0.368,0.442,0,2008-10-29,1,0,1,0.0,1,1,0,1.0
20800006,1610612764,1610612751,85.0,95.0,0.37,0.474,0,2008-10-29,1,0,1,0.0,1,1,0,1.0
20800007,1610612752,1610612748,120.0,115.0,0.483,0.457,1,2008-10-29,1,1,0,1.0,1,0,1,0.0
20800008,1610612765,1610612754,100.0,94.0,0.44,0.493,1,2008-10-29,1,1,0,1.0,1,0,1,0.0
20800009,1610612750,1610612758,98.0,96.0,0.483,0.45,1,2008-10-29,1,1,0,1.0,1,0,1,0.0
20800010,1610612760,1610612749,87.0,98.0,0.4379999999999999,0.461,0,2008-10-29,1,0,1,0.0,2,1,1,0.5
20800011,1610612759,1610612756,98.0,103.0,0.5,0.494,0,2008-10-29,1,0,1,0.0,1,1,0,1.0
20800012,1610612745,1610612763,82.0,71.0,0.368,0.3829999999999999,1,2008-10-29,1,1,0,1.0,1,0,1,0.0
20800013,1610612762,1610612743,98.0,94.0,0.4679999999999999,0.4679999999999999,1,2008-10-29,1,1,0,1.0,1,0,1,0.0
20800014,1610612744,1610612740,103.0,108.0,0.439,0.5,0,2008-10-29,1,0,1,0.0,1,1,0,1.0
20800015,1610612746,1610612747,79.0,117.0,0.385,0.512,0,2008-10-29,1,0,1,0.0,2,2,0,1.0
20800001,1610612738,1610612739,90.0,85.0,0.446,0.426,1,2008-10-28,1,1,0,1.0,1,0,1,0.0
20800002,1610612741,1610612749,108.0,95.0,0.507,0.474,1,2008-10-28,1,1,0,1.0,1,0,1,0.0
20800003,1610612747,1610612757,96.0,76.0,0.4679999999999999,0.345,1,2008-10-28,1,1,0,1.0,1,0,1,0.0
10800111,1610612752,1610612751,110.0,111.0,0.4679999999999999,0.519,0,2008-10-24,7,3,4,0.429,7,3,4,0.429
10800112,1610612739,1610612764,107.0,80.0,0.5,0.386,1,2008-10-24,8,3,5,0.375,7,2,5,0.286
10800113,1610612741,1610612749,112.0,104.0,0.481,0.385,1,2008-10-24,8,4,4,0.5,8,1,7,0.125
10800114,1610612759,1610612748,93.0,96.0,0.521,0.542,0,2008-10-24,7,3,4,0.429,7,2,5,0.286
10800110,1610612747,1610612760,105.0,94.0,0.551,0.38,1,2008-10-24,8,6,2,0.75,7,1,6,0.143
10800115,1610612746,1610612743,92.0,106.0,0.405,0.405,0,2008-10-24,8,4,4,0.5,6,5,1,0.833
10800107,1610612765,1610612737,87.0,88.0,0.391,0.461,0,2008-10-23,8,6,2,0.75,8,5,3,0.625
10800102,1610612750,1610612749,95.0,76.0,0.4270000000000001,0.362,1,2008-10-23,8,6,2,0.75,7,1,6,0.143
10800108,1610612740,1610612748,100.0,80.0,0.522,0.4270000000000001,1,2008-10-23,7,7,0,1.0,6,1,5,0.1669999999999999
10800109,1610612742,1610612754,91.0,114.0,0.384,0.416,0,2008-10-23,8,4,4,0.5,8,4,4,0.5
10800103,1610612762,1610612757,100.0,89.0,0.529,0.457,1,2008-10-23,7,4,3,0.5710000000000001,7,4,3,0.5710000000000001
10800104,1610612756,1610612760,102.0,93.0,0.507,0.479,1,2008-10-23,7,5,2,0.7140000000000001,6,1,5,0.1669999999999999
10800105,1610612758,1610612745,97.0,110.0,0.42,0.56,0,2008-10-23,8,1,7,0.125,7,5,2,0.7140000000000001
10800106,1610612747,1610612766,88.0,77.0,0.423,0.3289999999999999,1,2008-10-23,7,5,2,0.7140000000000001,8,0,8,0.0
10800096,1610612753,1610612763,101.0,90.0,0.4679999999999999,0.431,1,2008-10-22,7,6,1,0.857,8,2,6,0.25
10800098,1610612751,1610612755,100.0,118.0,0.4629999999999999,0.481,0,2008-10-22,6,2,4,0.3329999999999999,7,4,3,0.5710000000000001
10800099,1610612765,1610612739,97.0,79.0,0.541,0.392,1,2008-10-22,7,6,1,0.857,7,2,5,0.286
10800097,1610612750,1610612741,75.0,85.0,0.325,0.4320000000000001,0,2008-10-22,7,5,2,0.7140000000000001,7,3,4,0.429
10800100,1610612759,1610612764,95.0,100.0,0.4379999999999999,0.481,0,2008-10-22,6,3,3,0.5,6,2,4,0.3329999999999999
10800101,1610612746,1610612757,75.0,87.0,0.434,0.446,0,2008-10-22,7,4,3,0.5710000000000001,6,4,2,0.667
10800087,1610612755,1610612739,83.0,91.0,0.359,0.43,0,2008-10-21,6,3,3,0.5,6,2,4,0.3329999999999999
10800091,1610612752,1610612738,90.0,101.0,0.4029999999999999,0.442,0,2008-10-21,6,3,3,0.5,8,6,2,0.75
10800092,1610612748,1610612763,102.0,85.0,0.526,0.4429999999999999,1,2008-10-21,5,1,4,0.2,7,2,5,0.286
10800089,1610612740,1610612754,101.0,96.0,0.461,0.479,1,2008-10-21,6,6,0,1.0,7,3,4,0.429
10800093,1610612742,1610612741,105.0,109.0,0.536,0.446,0,2008-10-21,7,4,3,0.5710000000000001,6,2,4,0.3329999999999999
10800088,1610612761,1610612743,94.0,105.0,0.4579999999999999,0.5329999999999999,0,2008-10-21,8,4,4,0.5,5,4,1,0.8
10800090,1610612747,1610612766,102.0,98.0,0.4579999999999999,0.4320000000000001,1,2008-10-21,6,4,2,0.667,7,0,7,0.0
10800095,1610612746,1610612756,69.0,86.0,0.3379999999999999,0.446,0,2008-10-21,6,4,2,0.667,6,4,2,0.667
10800083,1610612737,1610612753,103.0,109.0,0.474,0.473,0,2008-10-20,7,4,3,0.5710000000000001,6,5,1,0.833
10800086,1610612751,1610612752,106.0,114.0,0.5,0.5,0,2008-10-20,5,2,3,0.4,5,3,2,0.6
10800084,1610612756,1610612766,111.0,108.0,0.455,0.411,1,2008-10-20,5,3,2,0.6,6,0,6,0.0
10800085,1610612758,1610612757,98.0,112.0,0.515,0.506,0,2008-10-20,7,1,6,0.143,5,3,2,0.6
10800079,1610612738,1610612751,83.0,66.0,0.415,0.319,1,2008-10-19,7,5,2,0.7140000000000001,4,2,2,0.5
10800081,1610612750,1610612743,111.0,107.0,0.526,0.481,1,2008-10-19,6,5,1,0.833,4,3,1,0.75
10800082,1610612747,1610612761,112.0,89.0,0.518,0.421,1,2008-10-19,5,3,2,0.6,7,4,3,0.5710000000000001
10800072,1610612766,1610612737,96.0,102.0,0.3929999999999999,0.444,0,2008-10-18,5,0,5,0.0,6,4,2,0.667
10800071,1610612746,1610612761,89.0,93.0,0.444,0.3879999999999999,0,2008-10-18,4,3,1,0.75,6,4,2,0.667
10800073,1610612748,1610612753,92.0,100.0,0.41,0.446,0,2008-10-18,4,0,4,0.0,5,4,1,0.8
10800074,1610612739,1610612755,100.0,93.0,0.456,0.4,1,2008-10-18,5,1,4,0.2,5,3,2,0.6
10800075,1610612741,1610612762,80.0,88.0,0.3379999999999999,0.364,0,2008-10-18,5,1,4,0.2,6,3,3,0.5
10800076,1610612759,1610612754,106.0,98.0,0.424,0.4270000000000001,1,2008-10-18,5,3,2,0.6,6,3,3,0.5
10800078,1610612742,1610612758,124.0,109.0,0.551,0.422,1,2008-10-18,6,4,2,0.667,6,1,5,0.1669999999999999
10800069,1610612764,1610612740,80.0,102.0,0.369,0.449,0,2008-10-17,5,1,4,0.2,5,5,0,1.0
10800064,1610612754,1610612763,112.0,86.0,0.494,0.341,1,2008-10-17,5,3,2,0.6,6,2,4,0.3329999999999999
10800065,1610612738,1610612752,97.0,104.0,0.42,0.3829999999999999,0,2008-10-17,6,4,2,0.667,4,2,2,0.5
10800068,1610612743,1610612756,94.0,91.0,0.429,0.434,1,2008-10-17,3,3,0,1.0,4,2,2,0.5
10800066,1610612741,1610612762,108.0,105.0,0.442,0.506,1,2008-10-17,4,1,3,0.25,5,2,3,0.4
10800067,1610612745,1610612758,95.0,90.0,0.4,0.375,1,2008-10-17,6,4,2,0.667,5,1,4,0.2
10800070,1610612744,1610612749,109.0,108.0,0.527,0.465,1,2008-10-17,5,3,2,0.6,6,1,5,0.1669999999999999
10800059,1610612766,1610612753,84.0,94.0,0.3779999999999999,0.43,0,2008-10-16,4,0,4,0.0,4,3,1,0.75
10800060,1610612761,1610612750,86.0,90.0,0.392,0.4589999999999999,0,2008-10-16,5,3,2,0.6,5,4,1,0.8
10800061,1610612739,1610612759,70.0,91.0,0.3379999999999999,0.452,0,2008-10-16,4,0,4,0.0,4,2,2,0.5
10800062,1610612751,1610612738,108.0,111.0,0.536,0.455,0,2008-10-16,3,2,1,0.667,5,4,1,0.8
10800063,1610612765,1610612742,85.0,81.0,0.317,0.382,1,2008-10-16,6,5,1,0.833,5,3,2,0.6
10800058,1610612749,1610612744,98.0,94.0,0.417,0.421,1,2008-10-15,5,1,4,0.2,4,2,2,0.5
10800053,1610612737,1610612756,100.0,102.0,0.478,0.46,0,2008-10-15,5,3,2,0.6,3,2,1,0.667
10800054,1610612754,1610612742,100.0,93.0,0.416,0.3929999999999999,1,2008-10-15,4,2,2,0.5,4,3,1,0.75
10800055,1610612763,1610612745,97.0,101.0,0.486,0.447,0,2008-10-15,5,2,3,0.4,5,3,2,0.6
10800056,1610612743,1610612762,120.0,119.0,0.481,0.487,1,2008-10-15,2,2,0,1.0,4,2,2,0.5
10800057,1610612758,1610612746,112.0,116.0,0.612,0.467,0,2008-10-15,4,1,3,0.25,3,3,0,1.0
10800052,1610612740,1610612764,96.0,80.0,0.442,0.3670000000000001,1,2008-10-14,4,4,0,1.0,4,1,3,0.25
10800047,1610612765,1610612759,64.0,86.0,0.278,0.424,0,2008-10-14,5,4,1,0.8,3,1,2,0.3329999999999999
10800049,1610612752,1610612755,109.0,116.0,0.471,0.506,0,2008-10-14,3,1,2,0.3329999999999999,4,3,1,0.75
10800050,1610612739,1610612738,86.0,90.0,0.441,0.439,0,2008-10-14,3,0,3,0.0,4,3,1,0.75
10800048,1610612760,1610612746,88.0,90.0,0.405,0.405,0,2008-10-14,5,1,4,0.2,2,2,0,1.0
10800051,1610612741,1610612750,86.0,96.0,0.465,0.4629999999999999,0,2008-10-14,3,0,3,0.0,4,3,1,0.75
10800043,1610612737,1610612766,88.0,87.0,0.5,0.423,1,2008-10-13,4,3,1,0.75,3,0,3,0.0
10800044,1610612763,1610612754,103.0,95.0,0.4529999999999999,0.405,1,2008-10-13,4,2,2,0.5,3,1,2,0.3329999999999999
10800045,1610612745,1610612760,104.0,110.0,0.446,0.482,0,2008-10-13,4,2,2,0.5,4,1,3,0.25
10800039,1610612761,1610612755,79.0,85.0,0.3779999999999999,0.4,0,2008-10-12,3,2,1,0.667,3,2,1,0.667
10800042,1610612751,1610612748,94.0,92.0,0.4029999999999999,0.4579999999999999,1,2008-10-12,2,2,0,1.0,3,0,3,0.0
10800040,1610612757,1610612762,80.0,93.0,0.439,0.446,0,2008-10-12,4,2,2,0.5,3,2,1,0.667
10800041,1610612747,1610612758,94.0,89.0,0.462,0.3720000000000001,1,2008-10-12,3,1,2,0.3329999999999999,3,1,2,0.3329999999999999
10800036,1610612738,1610612745,90.0,89.0,0.493,0.375,1,2008-10-11,3,2,1,0.667,3,2,1,0.667
10800037,1610612749,1610612765,99.0,111.0,0.479,0.522,0,2008-10-11,4,0,4,0.0,4,4,0,1.0
10800035,1610612756,1610612743,72.0,77.0,0.316,0.362,0,2008-10-11,2,1,1,0.5,1,1,0,1.0
10800038,1610612744,1610612760,122.0,102.0,0.485,0.386,1,2008-10-11,3,2,1,0.667,3,0,3,0.0
10800024,1610612755,1610612752,104.0,110.0,0.476,0.506,0,2008-10-10,2,1,1,0.5,2,1,1,0.5
10800025,1610612764,1610612765,62.0,73.0,0.324,0.4029999999999999,0,2008-10-10,3,1,2,0.3329999999999999,3,3,0,1.0
10800027,1610612754,1610612741,102.0,95.0,0.4679999999999999,0.407,1,2008-10-10,2,1,1,0.5,2,0,2,0.0
10800032,1610612738,1610612739,96.0,94.0,0.545,0.4579999999999999,1,2008-10-10,2,1,1,0.5,2,0,2,0.0
10800028,1610612763,1610612766,92.0,79.0,0.436,0.4,1,2008-10-10,3,1,2,0.3329999999999999,2,0,2,0.0
10800031,1610612757,1610612737,102.0,80.0,0.581,0.377,1,2008-10-10,3,2,1,0.667,3,2,1,0.667
10800033,1610612749,1610612742,79.0,105.0,0.382,0.479,0,2008-10-10,3,0,3,0.0,3,3,0,1.0
10800034,1610612759,1610612740,84.0,89.0,0.421,0.493,0,2008-10-10,2,0,2,0.0,3,3,0,1.0
10800029,1610612743,1610612750,118.0,95.0,0.506,0.425,1,2008-10-10,1,1,0,1.0,3,2,1,0.667
10800030,1610612758,1610612760,94.0,85.0,0.4379999999999999,0.371,1,2008-10-10,2,1,1,0.5,2,0,2,0.0
10800023,1610612748,1610612751,98.0,100.0,0.414,0.444,0,2008-10-09,2,0,2,0.0,1,1,0,1.0
10800021,1610612741,1610612742,102.0,110.0,0.466,0.462,0,2008-10-09,1,0,1,0.0,2,2,0,1.0
10800022,1610612745,1610612759,85.0,78.0,0.447,0.416,1,2008-10-09,2,2,0,1.0,1,0,1,0.0
10800019,1610612762,1610612756,89.0,96.0,0.425,0.486,0,2008-10-09,2,1,1,0.5,2,1,1,0.5
10800020,1610612747,1610612746,80.0,107.0,0.38,0.488,0,2008-10-09,2,0,2,0.0,1,1,0,1.0
10800016,1610612756,1610612737,96.0,100.0,0.4589999999999999,0.48,0,2008-10-08,1,0,1,0.0,2,2,0,1.0
10800015,1610612750,1610612760,88.0,82.0,0.37,0.417,1,2008-10-08,2,2,0,1.0,1,0,1,0.0
10800010,1610612761,1610612752,113.0,111.0,0.494,0.4429999999999999,1,2008-10-08,2,2,0,1.0,1,0,1,0.0
10800011,1610612755,1610612738,98.0,92.0,0.447,0.479,1,2008-10-08,1,1,0,1.0,1,0,1,0.0
10800012,1610612753,1610612766,118.0,80.0,0.471,0.284,1,2008-10-08,2,1,1,0.5,1,0,1,0.0
10800013,1610612754,1610612740,71.0,105.0,0.311,0.424,0,2008-10-08,1,0,1,0.0,2,2,0,1.0
10800014,1610612763,1610612764,80.0,89.0,0.347,0.436,0,2008-10-08,2,0,2,0.0,2,1,1,0.5
10800018,1610612765,1610612749,85.0,71.0,0.456,0.38,1,2008-10-08,2,2,0,1.0,2,0,2,0.0
10800017,1610612757,1610612744,95.0,110.0,0.369,0.481,0,2008-10-08,2,1,1,0.5,2,1,1,0.5
10800007,1610612747,1610612762,90.0,99.0,0.508,0.481,0,2008-10-07,1,0,1,0.0,1,1,0,1.0
10800005,1610612739,1610612761,84.0,104.0,0.402,0.52,0,2008-10-07,1,0,1,0.0,1,1,0,1.0
10800008,1610612742,1610612764,108.0,82.0,0.53,0.356,1,2008-10-07,1,1,0,1.0,1,0,1,0.0
10800009,1610612745,1610612763,96.0,93.0,0.419,0.422,1,2008-10-07,1,1,0,1.0,1,0,1,0.0
10800006,1610612757,1610612758,110.0,81.0,0.506,0.289,1,2008-10-07,1,1,0,1.0,1,0,1,0.0
10800003,1610612753,1610612737,101.0,118.0,0.494,0.505,0,2008-10-06,1,0,1,0.0,1,1,0,1.0
10800004,1610612749,1610612750,79.0,117.0,0.3379999999999999,0.5820000000000001,0,2008-10-06,1,0,1,0.0,1,1,0,1.0
10800001,1610612748,1610612765,91.0,95.0,0.4029999999999999,0.4379999999999999,0,2008-10-05,1,0,1,0.0,1,1,0,1.0
10800002,1610612740,1610612744,106.0,103.0,0.479,0.482,1,2008-10-05,1,1,0,1.0,1,0,1,0.0
40700406,1610612738,1610612747,131.0,92.0,0.494,0.422,1,2008-06-17,82,66,16,0.805,82,57,25,0.695
40700405,1610612747,1610612738,103.0,98.0,0.456,0.429,1,2008-06-15,82,57,25,0.695,82,66,16,0.805
40700404,1610612747,1610612738,91.0,97.0,0.416,0.452,0,2008-06-12,82,57,25,0.695,82,66,16,0.805
40700403,1610612747,1610612738,87.0,81.0,0.435,0.349,1,2008-06-10,82,57,25,0.695,82,66,16,0.805
40700402,1610612738,1610612747,108.0,102.0,0.529,0.494,1,2008-06-08,82,66,16,0.805,82,57,25,0.695
40700401,1610612738,1610612747,98.0,88.0,0.421,0.416,1,2008-06-05,82,66,16,0.805,82,57,25,0.695
40700306,1610612765,1610612738,81.0,89.0,0.42,0.444,0,2008-05-30,82,59,23,0.72,82,66,16,0.805
40700315,1610612747,1610612759,100.0,92.0,0.447,0.486,1,2008-05-29,82,57,25,0.695,82,56,26,0.6829999999999999
40700305,1610612738,1610612765,106.0,102.0,0.507,0.4629999999999999,1,2008-05-28,82,66,16,0.805,82,59,23,0.72
40700314,1610612759,1610612747,91.0,93.0,0.4,0.447,0,2008-05-27,82,56,26,0.6829999999999999,82,57,25,0.695
40700304,1610612765,1610612738,94.0,75.0,0.514,0.318,1,2008-05-26,82,59,23,0.72,82,66,16,0.805
40700313,1610612759,1610612747,103.0,84.0,0.514,0.4270000000000001,1,2008-05-25,82,56,26,0.6829999999999999,82,57,25,0.695
40700303,1610612765,1610612738,80.0,94.0,0.384,0.4639999999999999,0,2008-05-24,82,59,23,0.72,82,66,16,0.805
40700312,1610612747,1610612759,101.0,71.0,0.5489999999999999,0.345,1,2008-05-23,82,57,25,0.695,82,56,26,0.6829999999999999
40700302,1610612738,1610612765,97.0,103.0,0.486,0.493,0,2008-05-22,82,66,16,0.805,82,59,23,0.72
40700311,1610612747,1610612759,89.0,85.0,0.4320000000000001,0.405,1,2008-05-21,82,57,25,0.695,82,56,26,0.6829999999999999
40700301,1610612738,1610612765,88.0,79.0,0.522,0.424,1,2008-05-20,82,66,16,0.805,82,59,23,0.72
40700237,1610612740,1610612759,82.0,91.0,0.402,0.395,0,2008-05-19,82,56,26,0.6829999999999999,82,56,26,0.6829999999999999
40700207,1610612738,1610612739,97.0,92.0,0.478,0.4479999999999999,1,2008-05-18,82,66,16,0.805,82,45,37,0.5489999999999999
40700206,1610612739,1610612738,74.0,69.0,0.3289999999999999,0.397,1,2008-05-16,82,45,37,0.5489999999999999,82,66,16,0.805
40700226,1610612762,1610612747,105.0,108.0,0.381,0.5,0,2008-05-16,82,54,28,0.659,82,57,25,0.695
40700236,1610612759,1610612740,99.0,80.0,0.494,0.412,1,2008-05-15,82,56,26,0.6829999999999999,82,56,26,0.6829999999999999
40700225,1610612747,1610612762,111.0,104.0,0.473,0.457,1,2008-05-14,82,57,25,0.695,82,54,28,0.659
40700205,1610612738,1610612739,96.0,89.0,0.481,0.446,1,2008-05-14,82,66,16,0.805,82,45,37,0.5489999999999999
40700215,1610612765,1610612753,91.0,86.0,0.361,0.484,1,2008-05-13,82,59,23,0.72,82,52,30,0.634
40700235,1610612740,1610612759,101.0,79.0,0.447,0.377,1,2008-05-13,82,56,26,0.6829999999999999,82,56,26,0.6829999999999999
40700204,1610612739,1610612738,88.0,77.0,0.455,0.386,1,2008-05-12,82,45,37,0.5489999999999999,82,66,16,0.805
40700224,1610612762,1610612747,123.0,115.0,0.526,0.474,1,2008-05-11,82,54,28,0.659,82,57,25,0.695
40700234,1610612759,1610612740,100.0,80.0,0.513,0.402,1,2008-05-11,82,56,26,0.6829999999999999,82,56,26,0.6829999999999999
40700203,1610612739,1610612738,108.0,84.0,0.536,0.405,1,2008-05-10,82,45,37,0.5489999999999999,82,66,16,0.805
40700214,1610612753,1610612765,89.0,90.0,0.466,0.456,0,2008-05-10,82,52,30,0.634,82,59,23,0.72
40700223,1610612762,1610612747,104.0,99.0,0.5,0.485,1,2008-05-09,82,54,28,0.659,82,57,25,0.695
40700233,1610612759,1610612740,110.0,99.0,0.482,0.494,1,2008-05-08,82,56,26,0.6829999999999999,82,56,26,0.6829999999999999
40700202,1610612738,1610612739,89.0,73.0,0.4029999999999999,0.356,1,2008-05-08,82,66,16,0.805,82,45,37,0.5489999999999999
40700222,1610612747,1610612762,120.0,110.0,0.574,0.446,1,2008-05-07,82,57,25,0.695,82,54,28,0.659
40700213,1610612753,1610612765,111.0,86.0,0.5379999999999999,0.4029999999999999,1,2008-05-07,82,52,30,0.634,82,59,23,0.72
40700201,1610612738,1610612739,76.0,72.0,0.426,0.307,1,2008-05-06,82,66,16,0.805,82,45,37,0.5489999999999999
40700232,1610612740,1610612759,102.0,84.0,0.48,0.425,1,2008-05-05,82,56,26,0.6829999999999999,82,56,26,0.6829999999999999
40700212,1610612765,1610612753,100.0,93.0,0.474,0.4379999999999999,1,2008-05-05,82,59,23,0.72,82,52,30,0.634
40700107,1610612738,1610612737,99.0,65.0,0.476,0.293,1,2008-05-04,82,66,16,0.805,82,37,45,0.451
40700221,1610612747,1610612762,109.0,98.0,0.452,0.379,1,2008-05-04,82,57,25,0.695,82,54,28,0.659
40700211,1610612765,1610612753,91.0,72.0,0.429,0.405,1,2008-05-03,82,59,23,0.72,82,52,30,0.634
40700231,1610612740,1610612759,101.0,82.0,0.5,0.408,1,2008-05-03,82,56,26,0.6829999999999999,82,56,26,0.6829999999999999
40700176,1610612762,1610612745,113.0,91.0,0.466,0.39,1,2008-05-02,82,54,28,0.659,82,55,27,0.6709999999999999
40700106,1610612737,1610612738,103.0,100.0,0.478,0.4629999999999999,1,2008-05-02,82,37,45,0.451,82,66,16,0.805
40700136,1610612764,1610612739,88.0,105.0,0.397,0.494,0,2008-05-02,82,43,39,0.524,82,45,37,0.5489999999999999
40700116,1610612755,1610612765,77.0,100.0,0.3379999999999999,0.5820000000000001,0,2008-05-01,82,40,42,0.488,82,59,23,0.72
40700105,1610612738,1610612737,110.0,85.0,0.536,0.406,1,2008-04-30,82,66,16,0.805,82,37,45,0.451
40700135,1610612739,1610612764,87.0,88.0,0.36,0.408,0,2008-04-30,82,45,37,0.5489999999999999,82,43,39,0.524
40700165,1610612759,1610612756,92.0,87.0,0.3929999999999999,0.419,1,2008-04-29,82,56,26,0.6829999999999999,82,55,27,0.6709999999999999
40700115,1610612765,1610612755,98.0,81.0,0.581,0.423,1,2008-04-29,82,59,23,0.72,82,40,42,0.488
40700155,1610612740,1610612742,99.0,94.0,0.487,0.4270000000000001,1,2008-04-29,82,56,26,0.6829999999999999,82,51,31,0.622
40700175,1610612745,1610612762,95.0,69.0,0.4679999999999999,0.365,1,2008-04-29,82,55,27,0.6709999999999999,82,54,28,0.659
40700144,1610612743,1610612747,101.0,107.0,0.4429999999999999,0.46,0,2008-04-28,82,50,32,0.61,82,57,25,0.695
40700104,1610612737,1610612738,97.0,92.0,0.478,0.412,1,2008-04-28,82,37,45,0.451,82,66,16,0.805
40700125,1610612753,1610612761,102.0,92.0,0.449,0.412,1,2008-04-28,82,52,30,0.634,82,41,41,0.5
40700154,1610612742,1610612740,84.0,97.0,0.36,0.5,0,2008-04-27,82,51,31,0.622,82,56,26,0.6829999999999999
40700114,1610612755,1610612765,84.0,93.0,0.4629999999999999,0.425,0,2008-04-27,82,40,42,0.488,82,59,23,0.72
40700134,1610612764,1610612739,97.0,100.0,0.457,0.41,0,2008-04-27,82,43,39,0.524,82,45,37,0.5489999999999999
40700164,1610612756,1610612759,105.0,86.0,0.4270000000000001,0.39,1,2008-04-27,82,55,27,0.6709999999999999,82,56,26,0.6829999999999999
40700174,1610612762,1610612745,86.0,82.0,0.431,0.3670000000000001,1,2008-04-26,82,54,28,0.659,82,55,27,0.6709999999999999
40700103,1610612737,1610612738,102.0,93.0,0.474,0.444,1,2008-04-26,82,37,45,0.451,82,66,16,0.805
40700124,1610612761,1610612753,94.0,106.0,0.435,0.493,0,2008-04-26,82,41,41,0.5,82,52,30,0.634
40700143,1610612743,1610612747,84.0,102.0,0.3720000000000001,0.4629999999999999,0,2008-04-26,82,50,32,0.61,82,57,25,0.695
40700163,1610612756,1610612759,99.0,115.0,0.494,0.561,0,2008-04-25,82,55,27,0.6709999999999999,82,56,26,0.6829999999999999
40700113,1610612755,1610612765,95.0,75.0,0.4589999999999999,0.409,1,2008-04-25,82,40,42,0.488,82,59,23,0.72
40700153,1610612742,1610612740,97.0,87.0,0.4270000000000001,0.379,1,2008-04-25,82,51,31,0.622,82,56,26,0.6829999999999999
40700173,1610612762,1610612745,92.0,94.0,0.457,0.444,0,2008-04-24,82,54,28,0.659,82,55,27,0.6709999999999999
40700123,1610612761,1610612753,108.0,94.0,0.494,0.466,1,2008-04-24,82,41,41,0.5,82,52,30,0.634
40700133,1610612764,1610612739,108.0,72.0,0.521,0.397,1,2008-04-24,82,43,39,0.524,82,45,37,0.5489999999999999
40700142,1610612747,1610612743,122.0,107.0,0.505,0.44,1,2008-04-23,82,57,25,0.695,82,50,32,0.61
40700102,1610612738,1610612737,96.0,77.0,0.417,0.3829999999999999,1,2008-04-23,82,66,16,0.805,82,37,45,0.451
40700112,1610612765,1610612755,105.0,88.0,0.5489999999999999,0.395,1,2008-04-23,82,59,23,0.72,82,40,42,0.488
40700162,1610612759,1610612756,102.0,96.0,0.482,0.4629999999999999,1,2008-04-22,82,56,26,0.6829999999999999,82,55,27,0.6709999999999999
40700122,1610612753,1610612761,104.0,103.0,0.4270000000000001,0.457,1,2008-04-22,82,52,30,0.634,82,41,41,0.5
40700152,1610612740,1610612742,127.0,103.0,0.608,0.471,1,2008-04-22,82,56,26,0.6829999999999999,82,51,31,0.622
40700172,1610612745,1610612762,84.0,90.0,0.416,0.442,0,2008-04-21,82,55,27,0.6709999999999999,82,54,28,0.659
40700132,1610612739,1610612764,116.0,86.0,0.519,0.375,1,2008-04-21,82,45,37,0.5489999999999999,82,43,39,0.524
40700101,1610612738,1610612737,104.0,81.0,0.469,0.382,1,2008-04-20,82,66,16,0.805,82,37,45,0.451
40700111,1610612765,1610612755,86.0,90.0,0.39,0.4320000000000001,0,2008-04-20,82,59,23,0.72,82,40,42,0.488
40700121,1610612753,1610612761,114.0,100.0,0.532,0.376,1,2008-04-20,82,52,30,0.634,82,41,41,0.5
40700141,1610612747,1610612743,128.0,114.0,0.5,0.4479999999999999,1,2008-04-20,82,57,25,0.695,82,50,32,0.61
40700171,1610612745,1610612762,82.0,93.0,0.3670000000000001,0.521,0,2008-04-19,82,55,27,0.6709999999999999,82,54,28,0.659
40700131,1610612739,1610612764,93.0,86.0,0.395,0.402,1,2008-04-19,82,45,37,0.5489999999999999,82,43,39,0.524
40700151,1610612740,1610612742,104.0,92.0,0.466,0.3329999999999999,1,2008-04-19,82,56,26,0.6829999999999999,82,51,31,0.622
40700161,1610612759,1610612756,117.0,115.0,0.505,0.5,1,2008-04-19,82,56,26,0.6829999999999999,82,55,27,0.6709999999999999
20701230,1610612744,1610612760,121.0,126.0,0.4270000000000001,0.5529999999999999,0,2008-04-16,82,48,34,0.585,82,20,62,0.244
20701223,1610612759,1610612762,109.0,80.0,0.594,0.3829999999999999,1,2008-04-16,82,56,26,0.6829999999999999,82,54,28,0.659
20701229,1610612756,1610612757,100.0,91.0,0.474,0.4,1,2008-04-16,82,55,27,0.6709999999999999,82,41,41,0.5
20701217,1610612766,1610612755,115.0,109.0,0.57,0.474,1,2008-04-16,82,32,50,0.39,82,40,42,0.488
20701218,1610612753,1610612764,103.0,83.0,0.466,0.474,1,2008-04-16,82,52,30,0.634,82,43,39,0.524
20701219,1610612739,1610612765,74.0,84.0,0.3289999999999999,0.386,0,2008-04-16,82,45,37,0.5489999999999999,82,59,23,0.72
20701220,1610612754,1610612752,132.0,123.0,0.506,0.408,1,2008-04-16,82,36,46,0.439,82,23,59,0.28
20701221,1610612738,1610612751,105.0,94.0,0.451,0.4370000000000001,1,2008-04-16,82,66,16,0.805,82,34,48,0.415
20701222,1610612748,1610612737,113.0,99.0,0.478,0.474,1,2008-04-16,82,15,67,0.183,82,37,45,0.451
20701224,1610612750,1610612749,110.0,101.0,0.414,0.447,1,2008-04-16,82,22,60,0.268,82,26,56,0.317
20701225,1610612741,1610612761,107.0,97.0,0.481,0.433,1,2008-04-16,82,33,49,0.402,82,41,41,0.5
20701226,1610612745,1610612746,93.0,75.0,0.413,0.373,1,2008-04-16,82,55,27,0.6709999999999999,82,23,59,0.28
20701227,1610612742,1610612740,111.0,98.0,0.4379999999999999,0.4579999999999999,1,2008-04-16,82,51,31,0.622,82,56,26,0.6829999999999999
20701228,1610612743,1610612763,120.0,111.0,0.4629999999999999,0.417,1,2008-04-16,82,50,32,0.61,82,22,60,0.268
20701215,1610612757,1610612763,113.0,91.0,0.506,0.422,1,2008-04-15,81,41,40,0.506,81,22,59,0.272
20701211,1610612737,1610612753,105.0,121.0,0.466,0.573,0,2008-04-15,81,37,44,0.457,81,51,30,0.63
20701212,1610612751,1610612766,112.0,108.0,0.451,0.429,1,2008-04-15,81,34,47,0.42,81,31,50,0.3829999999999999
20701213,1610612765,1610612750,115.0,103.0,0.506,0.482,1,2008-04-15,81,58,23,0.716,81,21,60,0.259
20701214,1610612740,1610612746,114.0,92.0,0.506,0.472,1,2008-04-15,81,56,25,0.691,81,23,58,0.284
20701216,1610612747,1610612758,124.0,101.0,0.5,0.442,1,2008-04-15,82,57,25,0.695,82,38,44,0.4629999999999999
20701209,1610612756,1610612744,122.0,116.0,0.524,0.442,1,2008-04-14,81,54,27,0.667,81,48,33,0.593
20701210,1610612758,1610612759,98.0,101.0,0.5,0.52,0,2008-04-14,81,38,43,0.469,81,55,26,0.679
20701203,1610612761,1610612748,91.0,75.0,0.461,0.37,1,2008-04-14,81,41,40,0.506,81,14,67,0.173
20701204,1610612755,1610612739,90.0,91.0,0.469,0.487,0,2008-04-14,81,40,41,0.494,81,45,36,0.556
20701205,1610612764,1610612754,117.0,110.0,0.4529999999999999,0.4679999999999999,1,2008-04-14,81,43,38,0.531,81,35,46,0.4320000000000001
20701206,1610612752,1610612738,93.0,99.0,0.4,0.481,0,2008-04-14,81,23,58,0.284,81,65,16,0.802
20701207,1610612749,1610612741,135.0,151.0,0.575,0.67,0,2008-04-14,81,26,55,0.321,81,32,49,0.395
20701208,1610612762,1610612745,105.0,96.0,0.481,0.4,1,2008-04-14,81,54,27,0.667,81,54,27,0.667
20701197,1610612739,1610612748,84.0,76.0,0.3779999999999999,0.3939999999999999,1,2008-04-13,80,44,36,0.55,80,14,66,0.175
20701198,1610612747,1610612759,106.0,85.0,0.5,0.418,1,2008-04-13,81,56,25,0.691,80,54,26,0.675
20701199,1610612765,1610612761,91.0,84.0,0.487,0.434,1,2008-04-13,80,57,23,0.713,80,40,40,0.5
20701200,1610612741,1610612753,84.0,104.0,0.4,0.493,0,2008-04-13,80,31,49,0.3879999999999999,80,50,30,0.625
20701201,1610612743,1610612745,111.0,94.0,0.482,0.348,1,2008-04-13,81,49,32,0.605,80,54,26,0.675
20701202,1610612760,1610612742,99.0,95.0,0.409,0.4039999999999999,1,2008-04-13,81,19,62,0.235,81,50,31,0.617
20701194,1610612758,1610612740,94.0,91.0,0.487,0.384,1,2008-04-12,80,38,42,0.475,80,55,25,0.688
20701196,1610612744,1610612746,122.0,116.0,0.473,0.4479999999999999,1,2008-04-12,80,48,32,0.6,80,23,57,0.288
20701195,1610612757,1610612742,108.0,105.0,0.5870000000000001,0.5,1,2008-04-12,80,40,40,0.5,80,50,30,0.625
20701188,1610612764,1610612755,109.0,93.0,0.476,0.4679999999999999,1,2008-04-12,80,42,38,0.525,80,40,40,0.5
20701189,1610612737,1610612738,89.0,99.0,0.4320000000000001,0.472,0,2008-04-12,80,37,43,0.4629999999999999,80,64,16,0.8
20701190,1610612754,1610612766,103.0,107.0,0.407,0.417,0,2008-04-12,80,35,45,0.4379999999999999,80,31,49,0.3879999999999999
20701191,1610612763,1610612750,105.0,114.0,0.4039999999999999,0.495,0,2008-04-12,80,22,58,0.275,80,21,59,0.263
20701192,1610612749,1610612751,98.0,111.0,0.544,0.563,0,2008-04-12,80,26,54,0.325,80,33,47,0.413
20701193,1610612762,1610612743,124.0,97.0,0.575,0.479,1,2008-04-12,80,53,27,0.6629999999999999,80,48,32,0.6
20701186,1610612758,1610612757,103.0,86.0,0.5579999999999999,0.419,1,2008-04-11,79,37,42,0.4679999999999999,79,39,40,0.494
20701176,1610612761,1610612751,113.0,85.0,0.487,0.42,1,2008-04-11,79,40,39,0.506,79,32,47,0.405
20701177,1610612755,1610612754,76.0,85.0,0.347,0.446,0,2008-04-11,79,40,39,0.506,79,35,44,0.4429999999999999
20701178,1610612753,1610612750,101.0,102.0,0.513,0.447,0,2008-04-11,79,49,30,0.62,79,20,59,0.253
20701179,1610612741,1610612739,100.0,95.0,0.455,0.4270000000000001,1,2008-04-11,79,31,48,0.392,79,43,36,0.544
20701180,1610612738,1610612749,102.0,86.0,0.506,0.3829999999999999,1,2008-04-11,79,63,16,0.797,79,26,53,0.3289999999999999
20701181,1610612752,1610612737,104.0,116.0,0.474,0.5529999999999999,0,2008-04-11,80,23,57,0.288,79,37,42,0.4679999999999999
20701182,1610612748,1610612763,91.0,96.0,0.375,0.423,0,2008-04-11,79,14,65,0.177,79,22,57,0.278
20701183,1610612765,1610612764,102.0,74.0,0.5,0.271,1,2008-04-11,79,56,23,0.7090000000000001,79,41,38,0.519
20701184,1610612745,1610612756,101.0,90.0,0.511,0.461,1,2008-04-11,79,54,25,0.684,80,53,27,0.6629999999999999
20701185,1610612759,1610612760,95.0,74.0,0.461,0.386,1,2008-04-11,79,54,25,0.684,80,18,62,0.225
20701187,1610612747,1610612740,107.0,104.0,0.45,0.512,1,2008-04-11,80,55,25,0.688,79,55,24,0.696
20701175,1610612746,1610612747,78.0,106.0,0.361,0.488,0,2008-04-10,79,23,56,0.291,79,54,25,0.684
20701173,1610612744,1610612743,105.0,114.0,0.42,0.506,0,2008-04-10,79,47,32,0.595,79,48,31,0.608
20701174,1610612742,1610612762,97.0,94.0,0.446,0.4629999999999999,1,2008-04-10,79,50,29,0.633,79,52,27,0.6579999999999999
20701164,1610612761,1610612749,111.0,93.0,0.542,0.42,1,2008-04-09,78,39,39,0.5,78,26,52,0.3329999999999999
20701165,1610612755,1610612765,101.0,94.0,0.507,0.4320000000000001,1,2008-04-09,78,40,38,0.513,78,55,23,0.705
20701166,1610612764,1610612738,109.0,95.0,0.513,0.447,1,2008-04-09,78,41,37,0.526,78,62,16,0.795
20701167,1610612753,1610612741,115.0,83.0,0.506,0.41,1,2008-04-09,78,49,29,0.628,78,30,48,0.385
20701168,1610612739,1610612751,104.0,83.0,0.45,0.3329999999999999,1,2008-04-09,78,43,35,0.551,78,32,46,0.41
20701169,1610612752,1610612766,109.0,107.0,0.474,0.488,1,2008-04-09,79,23,56,0.291,79,30,49,0.38
20701170,1610612750,1610612740,90.0,122.0,0.486,0.56,0,2008-04-09,78,19,59,0.244,78,55,23,0.705
20701171,1610612745,1610612760,103.0,80.0,0.527,0.364,1,2008-04-09,78,53,25,0.679,79,18,61,0.228
20701172,1610612759,1610612756,79.0,96.0,0.42,0.519,0,2008-04-09,78,53,25,0.679,79,53,26,0.6709999999999999
20701161,1610612757,1610612747,112.0,103.0,0.506,0.449,1,2008-04-08,78,39,39,0.5,78,53,25,0.679
20701153,1610612766,1610612750,121.0,119.0,0.623,0.515,1,2008-04-08,78,30,48,0.385,77,19,58,0.247
20701154,1610612754,1610612737,112.0,98.0,0.512,0.3720000000000001,1,2008-04-08,78,34,44,0.436,78,36,42,0.462
20701155,1610612748,1610612741,95.0,88.0,0.48,0.452,1,2008-04-08,78,14,64,0.179,77,30,47,0.39
20701156,1610612765,1610612752,94.0,98.0,0.356,0.539,0,2008-04-08,77,55,22,0.7140000000000001,78,22,56,0.282
20701157,1610612749,1610612738,104.0,107.0,0.4,0.493,0,2008-04-08,77,26,51,0.3379999999999999,77,62,15,0.805
20701158,1610612763,1610612756,113.0,127.0,0.556,0.565,0,2008-04-08,78,21,57,0.2689999999999999,78,52,26,0.667
20701159,1610612740,1610612762,66.0,77.0,0.365,0.4379999999999999,0,2008-04-08,77,54,23,0.701,78,52,26,0.667
20701160,1610612742,1610612760,99.0,83.0,0.506,0.381,1,2008-04-08,78,49,29,0.628,78,18,60,0.231
20701162,1610612746,1610612743,99.0,117.0,0.442,0.512,0,2008-04-08,78,23,55,0.295,78,47,31,0.603
20701163,1610612744,1610612758,140.0,132.0,0.523,0.529,1,2008-04-08,78,47,31,0.603,78,36,42,0.462
20701150,1610612758,1610612747,92.0,114.0,0.418,0.526,0,2008-04-06,77,36,41,0.4679999999999999,77,53,24,0.688
20701151,1610612760,1610612743,151.0,147.0,0.526,0.505,1,2008-04-06,77,18,59,0.2339999999999999,77,46,31,0.597
20701152,1610612746,1610612745,79.0,105.0,0.4320000000000001,0.481,0,2008-04-06,77,23,54,0.299,77,52,25,0.675
20701143,1610612748,1610612765,75.0,91.0,0.352,0.5,0,2008-04-06,77,13,64,0.1689999999999999,76,55,21,0.7240000000000001
20701144,1610612756,1610612742,98.0,105.0,0.425,0.471,0,2008-04-06,77,51,26,0.662,77,48,29,0.623
20701145,1610612752,1610612753,100.0,90.0,0.359,0.4,1,2008-04-06,77,21,56,0.273,77,48,29,0.623
20701146,1610612754,1610612749,105.0,97.0,0.418,0.47,1,2008-04-06,77,33,44,0.429,76,26,50,0.342
20701147,1610612757,1610612759,65.0,72.0,0.342,0.389,0,2008-04-06,77,38,39,0.494,77,53,24,0.688
20701148,1610612750,1610612763,101.0,113.0,0.518,0.442,0,2008-04-06,76,19,57,0.25,77,21,56,0.273
20701149,1610612740,1610612744,108.0,96.0,0.506,0.4529999999999999,1,2008-04-06,76,54,22,0.711,77,46,31,0.597
20701142,1610612743,1610612758,115.0,118.0,0.456,0.466,0,2008-04-05,76,46,30,0.605,76,36,40,0.474
20701137,1610612739,1610612753,86.0,101.0,0.386,0.4679999999999999,0,2008-04-05,77,42,35,0.545,76,48,28,0.632
20701138,1610612755,1610612737,85.0,92.0,0.419,0.479,0,2008-04-05,77,39,38,0.506,77,36,41,0.4679999999999999
20701139,1610612766,1610612738,78.0,101.0,0.423,0.436,0,2008-04-05,77,29,48,0.377,76,61,15,0.8029999999999999
20701140,1610612751,1610612761,99.0,90.0,0.475,0.42,1,2008-04-05,77,32,45,0.416,77,38,39,0.494
20701141,1610612741,1610612764,87.0,99.0,0.429,0.476,0,2008-04-05,76,30,46,0.395,77,40,37,0.519
20701134,1610612756,1610612750,117.0,88.0,0.5660000000000001,0.382,1,2008-04-04,76,51,25,0.6709999999999999,75,19,56,0.253
20701126,1610612761,1610612766,100.0,105.0,0.456,0.47,0,2008-04-04,76,38,38,0.5,76,29,47,0.382
20701127,1610612737,1610612755,104.0,109.0,0.519,0.513,0,2008-04-04,76,35,41,0.461,76,39,37,0.513
20701128,1610612764,1610612748,109.0,95.0,0.521,0.4579999999999999,1,2008-04-04,76,39,37,0.513,76,13,63,0.171
20701129,1610612765,1610612751,106.0,87.0,0.525,0.4529999999999999,1,2008-04-04,75,54,21,0.72,76,31,45,0.408
20701130,1610612763,1610612744,86.0,117.0,0.391,0.5379999999999999,0,2008-04-04,76,20,56,0.263,76,46,30,0.605
20701131,1610612740,1610612752,118.0,110.0,0.512,0.55,1,2008-04-04,75,53,22,0.7070000000000001,76,20,56,0.263
20701132,1610612749,1610612754,101.0,105.0,0.43,0.472,0,2008-04-04,75,26,49,0.347,76,32,44,0.421
20701133,1610612762,1610612759,90.0,64.0,0.41,0.364,1,2008-04-04,77,51,26,0.662,76,52,24,0.684
20701135,1610612747,1610612742,112.0,108.0,0.527,0.524,1,2008-04-04,76,52,24,0.684,76,47,29,0.618
20701136,1610612760,1610612745,66.0,79.0,0.301,0.397,0,2008-04-04,76,17,59,0.2239999999999999,76,51,25,0.6709999999999999
20701125,1610612757,1610612745,86.0,95.0,0.3979999999999999,0.466,0,2008-04-03,76,38,38,0.5,75,50,25,0.667
20701123,1610612739,1610612741,98.0,101.0,0.4579999999999999,0.535,0,2008-04-03,76,42,34,0.5529999999999999,75,30,45,0.4
20701124,1610612758,1610612746,110.0,98.0,0.469,0.426,1,2008-04-03,75,35,40,0.467,76,23,53,0.303
20701122,1610612747,1610612757,104.0,91.0,0.493,0.42,1,2008-04-02,75,51,24,0.68,75,38,37,0.507
20701120,1610612742,1610612744,111.0,86.0,0.479,0.384,1,2008-04-02,75,47,28,0.627,75,45,30,0.6
20701119,1610612762,1610612750,117.0,100.0,0.595,0.473,1,2008-04-02,76,50,26,0.6579999999999999,74,19,55,0.257
20701113,1610612764,1610612749,109.0,110.0,0.5579999999999999,0.5479999999999999,0,2008-04-02,75,38,37,0.507,74,26,48,0.351
20701114,1610612766,1610612739,114.0,118.0,0.531,0.529,0,2008-04-02,75,28,47,0.373,75,42,33,0.56
20701115,1610612737,1610612761,127.0,120.0,0.511,0.522,1,2008-04-02,75,35,40,0.467,75,38,37,0.507
20701116,1610612738,1610612754,92.0,77.0,0.4429999999999999,0.356,1,2008-04-02,75,60,15,0.8,75,31,44,0.413
20701117,1610612748,1610612740,77.0,106.0,0.365,0.482,0,2008-04-02,75,13,62,0.173,74,52,22,0.703
20701118,1610612763,1610612752,130.0,114.0,0.6,0.442,1,2008-04-02,75,20,55,0.267,75,20,55,0.267
20701121,1610612760,1610612746,84.0,102.0,0.376,0.476,0,2008-04-02,75,17,58,0.2269999999999999,75,23,52,0.307
20701111,1610612743,1610612756,126.0,120.0,0.513,0.528,1,2008-04-01,75,46,29,0.613,75,50,25,0.667
20701105,1610612753,1610612740,97.0,98.0,0.5,0.407,0,2008-04-01,75,47,28,0.627,73,51,22,0.6990000000000001
20701106,1610612751,1610612755,99.0,108.0,0.488,0.5,0,2008-04-01,75,31,44,0.413,75,38,37,0.507
20701107,1610612749,1610612752,119.0,115.0,0.489,0.48,1,2008-04-01,73,25,48,0.342,74,20,54,0.27
20701108,1610612750,1610612765,90.0,94.0,0.4270000000000001,0.4,0,2008-04-01,73,19,54,0.26,74,53,21,0.716
20701109,1610612741,1610612738,92.0,106.0,0.417,0.493,0,2008-04-01,74,29,45,0.392,74,59,15,0.797
20701110,1610612759,1610612744,116.0,92.0,0.551,0.375,1,2008-04-01,75,52,23,0.693,74,45,29,0.608
20701112,1610612758,1610612745,99.0,98.0,0.507,0.402,1,2008-04-01,74,34,40,0.4589999999999999,74,49,25,0.662
20701102,1610612762,1610612764,129.0,87.0,0.595,0.441,1,2008-03-31,75,49,26,0.653,74,38,36,0.514
20701104,1610612746,1610612742,86.0,93.0,0.368,0.446,0,2008-03-31,74,22,52,0.297,74,46,28,0.622
20701099,1610612766,1610612761,100.0,104.0,0.452,0.4679999999999999,0,2008-03-31,74,28,46,0.3779999999999999,74,38,36,0.514
20701100,1610612754,1610612748,105.0,85.0,0.439,0.418,1,2008-03-31,74,31,43,0.419,74,13,61,0.176
20701101,1610612763,1610612737,99.0,116.0,0.539,0.5579999999999999,0,2008-03-31,74,19,55,0.257,74,34,40,0.4589999999999999
20701103,1610612756,1610612743,132.0,117.0,0.484,0.527,1,2008-03-31,74,50,24,0.6759999999999999,74,45,29,0.608
20701096,1610612744,1610612742,114.0,104.0,0.471,0.449,1,2008-03-30,73,45,28,0.616,73,45,28,0.616
20701097,1610612760,1610612758,107.0,120.0,0.478,0.551,0,2008-03-30,74,17,57,0.23,73,33,40,0.452
20701098,1610612747,1610612764,126.0,120.0,0.494,0.466,1,2008-03-30,74,50,24,0.6759999999999999,73,38,35,0.521
20701090,1610612759,1610612745,109.0,88.0,0.53,0.402,1,2008-03-30,74,51,23,0.6890000000000001,73,49,24,0.6709999999999999
20701091,1610612750,1610612762,110.0,103.0,0.532,0.539,1,2008-03-30,72,19,53,0.264,74,48,26,0.649
20701092,1610612737,1610612752,114.0,109.0,0.518,0.466,1,2008-03-30,73,33,40,0.452,73,20,53,0.2739999999999999
20701093,1610612738,1610612748,88.0,62.0,0.386,0.288,1,2008-03-30,73,58,15,0.795,73,13,60,0.178
20701094,1610612761,1610612740,111.0,118.0,0.523,0.6,0,2008-03-30,73,37,36,0.507,72,50,22,0.6940000000000001
20701095,1610612739,1610612755,91.0,88.0,0.4579999999999999,0.439,1,2008-03-30,74,41,33,0.5539999999999999,74,37,37,0.5
20701087,1610612743,1610612744,119.0,112.0,0.46,0.4039999999999999,1,2008-03-29,73,45,28,0.616,72,44,28,0.611
20701089,1610612746,1610612763,110.0,97.0,0.532,0.475,1,2008-03-29,73,22,51,0.301,73,19,54,0.26
20701084,1610612751,1610612756,104.0,110.0,0.44,0.494,0,2008-03-29,74,31,43,0.419,73,49,24,0.6709999999999999
20701085,1610612765,1610612739,85.0,71.0,0.452,0.365,1,2008-03-29,73,52,21,0.7120000000000001,73,40,33,0.5479999999999999
20701086,1610612741,1610612749,114.0,111.0,0.475,0.449,1,2008-03-29,73,29,44,0.397,72,24,48,0.3329999999999999
20701088,1610612757,1610612766,85.0,93.0,0.363,0.5,0,2008-03-29,74,38,36,0.514,73,28,45,0.384
20701082,1610612747,1610612763,111.0,114.0,0.3939999999999999,0.494,0,2008-03-28,73,49,24,0.6709999999999999,72,19,53,0.264
20701083,1610612760,1610612766,93.0,96.0,0.4629999999999999,0.436,0,2008-03-28,73,17,56,0.233,72,27,45,0.375
20701081,1610612758,1610612764,108.0,114.0,0.486,0.461,0,2008-03-28,72,32,40,0.444,72,38,34,0.528
20701078,1610612749,1610612753,86.0,103.0,0.3429999999999999,0.4429999999999999,0,2008-03-28,71,24,47,0.3379999999999999,74,47,27,0.635
20701080,1610612762,1610612746,121.0,101.0,0.578,0.515,1,2008-03-28,73,48,25,0.6579999999999999,72,21,51,0.292
20701073,1610612761,1610612752,103.0,95.0,0.507,0.3929999999999999,1,2008-03-28,72,37,35,0.514,72,20,52,0.278
20701074,1610612755,1610612756,93.0,107.0,0.3929999999999999,0.512,0,2008-03-28,73,37,36,0.507,72,48,24,0.667
20701075,1610612754,1610612751,123.0,115.0,0.456,0.426,1,2008-03-28,73,30,43,0.411,73,31,42,0.425
20701076,1610612738,1610612740,112.0,92.0,0.595,0.436,1,2008-03-28,72,57,15,0.792,71,49,22,0.69
20701077,1610612737,1610612741,106.0,103.0,0.436,0.457,1,2008-03-28,72,32,40,0.444,72,28,44,0.389
20701079,1610612759,1610612750,99.0,84.0,0.535,0.444,1,2008-03-28,73,50,23,0.685,71,18,53,0.254
20701072,1610612744,1610612757,111.0,95.0,0.4639999999999999,0.402,1,2008-03-27,71,44,27,0.62,73,38,35,0.521
20701070,1610612765,1610612748,85.0,69.0,0.471,0.358,1,2008-03-27,72,51,21,0.708,72,13,59,0.181
20701071,1610612743,1610612742,118.0,105.0,0.489,0.506,1,2008-03-27,72,44,28,0.611,72,45,27,0.625
20701069,1610612747,1610612766,95.0,108.0,0.41,0.5,0,2008-03-26,72,49,23,0.6809999999999999,71,26,45,0.366
20701068,1610612760,1610612764,99.0,104.0,0.4589999999999999,0.4629999999999999,0,2008-03-26,72,17,55,0.236,71,37,34,0.521
20701058,1610612761,1610612765,89.0,82.0,0.493,0.408,1,2008-03-26,71,36,35,0.507,71,50,21,0.7040000000000001
20701059,1610612752,1610612748,103.0,96.0,0.4039999999999999,0.3720000000000001,1,2008-03-26,71,20,51,0.282,71,13,58,0.183
20701060,1610612755,1610612741,121.0,99.0,0.5429999999999999,0.395,1,2008-03-26,72,37,35,0.514,71,28,43,0.3939999999999999
20701061,1610612737,1610612749,115.0,96.0,0.573,0.481,1,2008-03-26,71,31,40,0.4370000000000001,70,24,46,0.3429999999999999
20701062,1610612739,1610612740,99.0,100.0,0.5,0.4379999999999999,0,2008-03-26,72,40,32,0.556,70,49,21,0.7
20701063,1610612738,1610612756,117.0,97.0,0.523,0.5589999999999999,1,2008-03-26,71,56,15,0.789,71,47,24,0.662
20701064,1610612751,1610612754,124.0,117.0,0.544,0.461,1,2008-03-26,72,31,41,0.431,72,29,43,0.4029999999999999
20701065,1610612745,1610612750,97.0,86.0,0.426,0.429,1,2008-03-26,72,49,23,0.6809999999999999,70,18,52,0.257
20701066,1610612759,1610612746,97.0,88.0,0.5,0.39,1,2008-03-26,72,49,23,0.6809999999999999,71,21,50,0.296
20701067,1610612758,1610612763,107.0,106.0,0.3979999999999999,0.488,1,2008-03-26,71,32,39,0.451,71,18,53,0.254
20701056,1610612762,1610612766,128.0,106.0,0.536,0.5,1,2008-03-25,72,47,25,0.653,70,25,45,0.357
20701052,1610612753,1610612759,97.0,107.0,0.455,0.541,0,2008-03-25,73,46,27,0.63,71,48,23,0.6759999999999999
20701053,1610612754,1610612740,106.0,114.0,0.466,0.494,0,2008-03-25,71,29,42,0.408,69,48,21,0.696
20701054,1610612741,1610612737,103.0,94.0,0.441,0.417,1,2008-03-25,70,28,42,0.4,70,30,40,0.429
20701055,1610612742,1610612746,103.0,90.0,0.439,0.442,1,2008-03-25,71,45,26,0.634,70,21,49,0.3
20701057,1610612757,1610612764,102.0,82.0,0.494,0.358,1,2008-03-25,72,38,34,0.528,70,36,34,0.514
20701044,1610612738,1610612755,90.0,95.0,0.4529999999999999,0.444,0,2008-03-24,70,55,15,0.7859999999999999,71,36,35,0.507
20701045,1610612752,1610612751,91.0,106.0,0.3979999999999999,0.536,0,2008-03-24,70,19,51,0.271,71,30,41,0.423
20701046,1610612748,1610612749,78.0,73.0,0.377,0.355,1,2008-03-24,70,13,57,0.186,69,24,45,0.348
20701047,1610612765,1610612756,110.0,105.0,0.449,0.5,1,2008-03-24,70,50,20,0.7140000000000001,70,47,23,0.6709999999999999
20701048,1610612763,1610612743,106.0,120.0,0.433,0.5,0,2008-03-24,70,18,52,0.257,71,43,28,0.606
20701049,1610612745,1610612758,108.0,100.0,0.5,0.519,1,2008-03-24,71,48,23,0.6759999999999999,70,31,39,0.4429999999999999
20701050,1610612760,1610612757,97.0,84.0,0.5,0.384,1,2008-03-24,71,17,54,0.239,71,37,34,0.521
20701051,1610612744,1610612747,119.0,123.0,0.4370000000000001,0.451,0,2008-03-24,70,43,27,0.614,71,49,22,0.69
20701041,1610612761,1610612743,100.0,109.0,0.5,0.481,0,2008-03-23,70,35,35,0.5,70,42,28,0.6
20701042,1610612764,1610612765,95.0,83.0,0.528,0.43,1,2008-03-23,69,36,33,0.522,69,49,20,0.71
20701043,1610612747,1610612744,111.0,115.0,0.411,0.4270000000000001,0,2008-03-23,70,48,22,0.6859999999999999,69,43,26,0.623
20701040,1610612742,1610612759,81.0,88.0,0.434,0.33,0,2008-03-23,70,44,26,0.629,70,47,23,0.6709999999999999
20701029,1610612755,1610612751,91.0,87.0,0.3829999999999999,0.3779999999999999,1,2008-03-22,70,35,35,0.5,70,29,41,0.414
20701030,1610612766,1610612748,94.0,82.0,0.444,0.41,1,2008-03-22,69,25,44,0.362,69,12,57,0.174
20701031,1610612737,1610612753,98.0,90.0,0.474,0.412,1,2008-03-22,69,30,39,0.435,72,46,26,0.639
20701032,1610612763,1610612758,117.0,111.0,0.506,0.483,1,2008-03-22,69,18,51,0.261,69,31,38,0.449
20701033,1610612740,1610612738,113.0,106.0,0.506,0.5539999999999999,1,2008-03-22,68,47,21,0.691,69,55,14,0.797
20701034,1610612750,1610612752,114.0,93.0,0.532,0.435,1,2008-03-22,69,18,51,0.261,69,19,50,0.275
20701035,1610612741,1610612754,101.0,108.0,0.482,0.4370000000000001,0,2008-03-22,69,27,42,0.391,70,29,41,0.414
20701036,1610612749,1610612739,108.0,98.0,0.519,0.374,1,2008-03-22,68,24,44,0.353,71,40,31,0.563
20701037,1610612762,1610612760,115.0,101.0,0.477,0.481,1,2008-03-22,71,46,25,0.648,70,16,54,0.2289999999999999
20701038,1610612756,1610612745,122.0,113.0,0.565,0.449,1,2008-03-22,69,47,22,0.6809999999999999,70,47,23,0.6709999999999999
20701039,1610612746,1610612757,72.0,83.0,0.392,0.376,0,2008-03-22,69,21,48,0.304,70,37,33,0.529
20701019,1610612753,1610612755,113.0,95.0,0.532,0.442,1,2008-03-21,71,46,25,0.648,69,34,35,0.493
20701020,1610612754,1610612750,124.0,113.0,0.494,0.561,1,2008-03-21,69,28,41,0.406,68,17,51,0.25
20701021,1610612751,1610612743,114.0,125.0,0.506,0.539,0,2008-03-21,69,29,40,0.42,69,41,28,0.594
20701022,1610612752,1610612763,106.0,120.0,0.44,0.519,0,2008-03-21,68,19,49,0.2789999999999999,68,17,51,0.25
20701023,1610612748,1610612764,86.0,103.0,0.4629999999999999,0.532,0,2008-03-21,68,12,56,0.176,68,35,33,0.515
20701024,1610612739,1610612761,90.0,83.0,0.4679999999999999,0.395,1,2008-03-21,70,40,30,0.5710000000000001,69,35,34,0.507
20701025,1610612759,1610612758,102.0,89.0,0.494,0.387,1,2008-03-21,69,46,23,0.667,68,31,37,0.456
20701026,1610612757,1610612746,107.0,102.0,0.5529999999999999,0.562,1,2008-03-21,69,36,33,0.522,68,21,47,0.309
20701027,1610612747,1610612760,130.0,105.0,0.607,0.467,1,2008-03-21,69,48,21,0.696,69,16,53,0.2319999999999999
20701028,1610612744,1610612745,106.0,109.0,0.462,0.476,0,2008-03-21,68,42,26,0.618,69,47,22,0.6809999999999999
20701016,1610612741,1610612759,80.0,102.0,0.3779999999999999,0.447,0,2008-03-20,68,27,41,0.397,68,45,23,0.662
20701017,1610612742,1610612738,90.0,94.0,0.3929999999999999,0.345,0,2008-03-20,69,44,25,0.638,68,55,13,0.809
20701018,1610612762,1610612747,95.0,106.0,0.45,0.525,0,2008-03-20,70,45,25,0.643,68,47,21,0.691
20701006,1610612761,1610612748,96.0,54.0,0.542,0.256,1,2008-03-19,68,35,33,0.515,67,12,55,0.179
20701007,1610612755,1610612743,115.0,113.0,0.603,0.478,1,2008-03-19,68,34,34,0.5,68,40,28,0.588
20701008,1610612753,1610612764,86.0,87.0,0.3379999999999999,0.4270000000000001,0,2008-03-19,70,45,25,0.643,67,34,33,0.507
20701009,1610612754,1610612766,102.0,95.0,0.494,0.436,1,2008-03-19,68,27,41,0.397,68,24,44,0.353
20701010,1610612751,1610612737,125.0,117.0,0.5820000000000001,0.525,1,2008-03-19,68,29,39,0.426,68,29,39,0.426
20701011,1610612739,1610612765,89.0,73.0,0.444,0.397,1,2008-03-19,69,39,30,0.565,68,49,19,0.721
20701012,1610612740,1610612745,90.0,69.0,0.447,0.341,1,2008-03-19,67,46,21,0.687,68,46,22,0.6759999999999999
20701013,1610612750,1610612763,98.0,94.0,0.3929999999999999,0.415,1,2008-03-19,67,17,50,0.254,67,16,51,0.239
20701014,1610612760,1610612756,98.0,110.0,0.475,0.573,0,2008-03-19,68,16,52,0.235,68,46,22,0.6759999999999999
20701015,1610612746,1610612744,100.0,116.0,0.455,0.516,0,2008-03-19,67,21,46,0.313,67,42,25,0.627
20700999,1610612765,1610612743,136.0,120.0,0.604,0.5660000000000001,1,2008-03-18,67,49,18,0.731,67,40,27,0.597
20701000,1610612749,1610612748,106.0,112.0,0.434,0.513,0,2008-03-18,67,23,44,0.3429999999999999,66,12,54,0.182
20701001,1610612741,1610612751,112.0,96.0,0.494,0.456,1,2008-03-18,67,27,40,0.4029999999999999,67,28,39,0.418
20701003,1610612742,1610612747,100.0,102.0,0.444,0.416,0,2008-03-18,68,44,24,0.647,67,46,21,0.687
20701002,1610612745,1610612738,74.0,94.0,0.414,0.4320000000000001,0,2008-03-18,67,46,21,0.687,67,54,13,0.8059999999999999
20701004,1610612758,1610612744,122.0,105.0,0.58,0.409,1,2008-03-18,67,31,36,0.4629999999999999,66,41,25,0.621
20701005,1610612757,1610612756,98.0,111.0,0.439,0.55,0,2008-03-18,68,35,33,0.515,67,45,22,0.672
20700991,1610612764,1610612737,96.0,105.0,0.457,0.5539999999999999,0,2008-03-17,66,33,33,0.5,67,29,38,0.433
20700992,1610612753,1610612739,104.0,90.0,0.395,0.4379999999999999,1,2008-03-17,69,45,24,0.652,68,38,30,0.5589999999999999
20700993,1610612754,1610612752,110.0,98.0,0.4379999999999999,0.3720000000000001,1,2008-03-17,67,26,41,0.3879999999999999,67,19,48,0.284
20700994,1610612763,1610612766,98.0,80.0,0.452,0.408,1,2008-03-17,66,16,50,0.242,67,24,43,0.358
20700995,1610612740,1610612741,108.0,97.0,0.488,0.43,1,2008-03-17,66,45,21,0.682,66,26,40,0.3939999999999999
20700996,1610612750,1610612746,99.0,90.0,0.5,0.3879999999999999,1,2008-03-17,66,16,50,0.242,66,21,45,0.318
20700997,1610612759,1610612738,91.0,93.0,0.4379999999999999,0.466,0,2008-03-17,67,44,23,0.657,66,53,13,0.8029999999999999
20700998,1610612762,1610612761,96.0,79.0,0.551,0.4,1,2008-03-17,69,45,24,0.652,67,34,33,0.507
20700988,1610612745,1610612747,104.0,92.0,0.422,0.412,1,2008-03-16,66,46,20,0.6970000000000001,66,45,21,0.682
20700984,1610612748,1610612742,73.0,98.0,0.42,0.507,0,2008-03-16,65,11,54,0.1689999999999999,67,44,23,0.657
20700985,1610612752,1610612737,98.0,109.0,0.426,0.488,0,2008-03-16,66,19,47,0.288,66,28,38,0.424
20700987,1610612739,1610612766,98.0,91.0,0.4270000000000001,0.4320000000000001,1,2008-03-16,67,38,29,0.5670000000000001,66,24,42,0.364
20700989,1610612743,1610612760,168.0,116.0,0.604,0.43,1,2008-03-16,66,40,26,0.606,67,16,51,0.239
20700990,1610612758,1610612761,106.0,100.0,0.482,0.467,1,2008-03-16,66,30,36,0.455,66,34,32,0.515
20700986,1610612765,1610612740,105.0,84.0,0.527,0.4320000000000001,1,2008-03-16,66,48,18,0.727,65,44,21,0.677
20700976,1610612755,1610612759,103.0,96.0,0.4629999999999999,0.487,1,2008-03-15,67,33,34,0.493,66,44,22,0.667
20700977,1610612764,1610612746,119.0,109.0,0.42,0.465,1,2008-03-15,65,33,32,0.508,65,21,44,0.3229999999999999
20700978,1610612753,1610612754,122.0,111.0,0.636,0.5,1,2008-03-15,68,44,24,0.647,66,25,41,0.379
20700979,1610612751,1610612762,117.0,115.0,0.513,0.478,1,2008-03-15,66,28,38,0.424,68,44,24,0.647
20700980,1610612749,1610612738,77.0,99.0,0.341,0.519,0,2008-03-15,66,23,43,0.348,65,52,13,0.8
20700981,1610612756,1610612758,127.0,99.0,0.608,0.43,1,2008-03-15,66,44,22,0.667,65,29,36,0.446
20700982,1610612757,1610612750,107.0,96.0,0.531,0.519,1,2008-03-15,67,35,32,0.522,65,15,50,0.231
20700983,1610612744,1610612763,110.0,107.0,0.494,0.46,1,2008-03-15,65,41,24,0.631,65,15,50,0.231
20700966,1610612738,1610612762,92.0,110.0,0.485,0.507,0,2008-03-14,64,51,13,0.797,67,44,23,0.657
20700967,1610612737,1610612746,117.0,93.0,0.54,0.455,1,2008-03-14,65,27,38,0.415,64,21,43,0.3279999999999999
20700968,1610612748,1610612753,94.0,103.0,0.476,0.473,0,2008-03-14,64,11,53,0.172,67,43,24,0.642
20700969,1610612765,1610612759,84.0,80.0,0.407,0.4320000000000001,1,2008-03-14,65,47,18,0.723,65,44,21,0.677
20700970,1610612740,1610612747,108.0,98.0,0.488,0.38,1,2008-03-14,64,44,20,0.688,65,45,20,0.6920000000000001
20700971,1610612741,1610612755,106.0,110.0,0.451,0.418,0,2008-03-14,65,26,39,0.4,66,32,34,0.485
20700972,1610612745,1610612766,89.0,80.0,0.409,0.416,1,2008-03-14,65,45,20,0.6920000000000001,65,24,41,0.369
20700973,1610612742,1610612754,116.0,97.0,0.58,0.382,1,2008-03-14,66,43,23,0.652,65,25,40,0.385
20700974,1610612743,1610612761,137.0,105.0,0.5529999999999999,0.489,1,2008-03-14,65,39,26,0.6,65,34,31,0.523
20700975,1610612760,1610612750,116.0,121.0,0.523,0.506,0,2008-03-14,66,16,50,0.242,64,15,49,0.2339999999999999
20700963,1610612764,1610612739,101.0,99.0,0.486,0.42,1,2008-03-13,64,32,32,0.5,66,37,29,0.561
20700964,1610612758,1610612757,96.0,85.0,0.4589999999999999,0.385,1,2008-03-13,64,29,35,0.4529999999999999,66,34,32,0.515
20700965,1610612756,1610612744,123.0,115.0,0.5489999999999999,0.41,1,2008-03-13,65,43,22,0.662,64,40,24,0.625
20700952,1610612737,1610612745,75.0,83.0,0.3379999999999999,0.3329999999999999,0,2008-03-12,64,26,38,0.406,64,44,20,0.688
20700953,1610612753,1610612746,110.0,88.0,0.519,0.41,1,2008-03-12,66,42,24,0.636,63,21,42,0.3329999999999999
20700954,1610612738,1610612760,111.0,82.0,0.506,0.38,1,2008-03-12,63,51,12,0.81,65,16,49,0.246
20700955,1610612751,1610612739,104.0,99.0,0.513,0.4320000000000001,1,2008-03-12,65,27,38,0.415,65,37,28,0.569
20700956,1610612748,1610612752,88.0,91.0,0.419,0.4270000000000001,0,2008-03-12,63,11,52,0.175,65,19,46,0.292
20700957,1610612765,1610612755,82.0,83.0,0.462,0.407,0,2008-03-12,64,46,18,0.7190000000000001,65,31,34,0.477
20700958,1610612749,1610612762,110.0,114.0,0.477,0.519,0,2008-03-12,65,23,42,0.354,66,43,23,0.652
20700959,1610612740,1610612759,100.0,75.0,0.5870000000000001,0.429,1,2008-03-12,63,43,20,0.6829999999999999,64,44,20,0.688
20700960,1610612742,1610612766,118.0,93.0,0.537,0.455,1,2008-03-12,65,42,23,0.6459999999999999,64,24,40,0.375
20700961,1610612743,1610612763,108.0,86.0,0.471,0.356,1,2008-03-12,64,38,26,0.594,64,15,49,0.2339999999999999
20700962,1610612744,1610612761,117.0,106.0,0.557,0.5,1,2008-03-12,63,40,23,0.635,64,34,30,0.531
20700946,1610612764,1610612749,105.0,97.0,0.5,0.4270000000000001,1,2008-03-11,63,31,32,0.4920000000000001,64,23,41,0.359
20700947,1610612754,1610612760,114.0,107.0,0.457,0.506,1,2008-03-11,64,25,39,0.391,64,16,48,0.25
20700948,1610612750,1610612757,96.0,103.0,0.494,0.457,0,2008-03-11,63,14,49,0.222,65,34,31,0.523
20700949,1610612741,1610612762,108.0,96.0,0.467,0.4270000000000001,1,2008-03-11,64,26,38,0.406,65,42,23,0.6459999999999999
20700950,1610612756,1610612763,132.0,111.0,0.596,0.417,1,2008-03-11,64,42,22,0.6559999999999999,63,15,48,0.238
20700951,1610612747,1610612761,117.0,108.0,0.536,0.461,1,2008-03-11,64,45,19,0.703,63,34,29,0.54
20700939,1610612755,1610612738,86.0,100.0,0.316,0.474,0,2008-03-10,64,30,34,0.469,62,50,12,0.8059999999999999
20700940,1610612753,1610612737,123.0,112.0,0.536,0.511,1,2008-03-10,65,41,24,0.631,63,26,37,0.413
20700941,1610612739,1610612757,88.0,80.0,0.426,0.397,1,2008-03-10,64,37,27,0.578,64,33,31,0.516
20700942,1610612748,1610612746,98.0,99.0,0.487,0.545,0,2008-03-10,62,11,51,0.177,62,21,41,0.3389999999999999
20700943,1610612745,1610612751,91.0,73.0,0.4589999999999999,0.304,1,2008-03-10,63,43,20,0.6829999999999999,64,26,38,0.406
20700944,1610612742,1610612752,108.0,79.0,0.526,0.36,1,2008-03-10,64,41,23,0.6409999999999999,64,18,46,0.281
20700945,1610612759,1610612743,107.0,103.0,0.476,0.471,1,2008-03-10,63,44,19,0.698,63,37,26,0.5870000000000001
20700934,1610612761,1610612760,114.0,106.0,0.489,0.541,1,2008-03-09,62,34,28,0.5479999999999999,63,16,47,0.254
20700935,1610612749,1610612755,97.0,119.0,0.465,0.603,0,2008-03-09,63,23,40,0.365,63,30,33,0.476
20700936,1610612756,1610612759,94.0,87.0,0.457,0.349,1,2008-03-09,63,41,22,0.6509999999999999,62,43,19,0.6940000000000001
20700937,1610612765,1610612741,116.0,109.0,0.506,0.474,1,2008-03-09,63,46,17,0.73,63,25,38,0.397
20700938,1610612747,1610612758,113.0,114.0,0.477,0.55,0,2008-03-09,63,44,19,0.698,63,28,35,0.444
20700924,1610612739,1610612754,103.0,95.0,0.407,0.494,1,2008-03-08,63,36,27,0.5710000000000001,63,24,39,0.381
20700925,1610612764,1610612766,97.0,100.0,0.4270000000000001,0.4579999999999999,0,2008-03-08,62,30,32,0.484,63,24,39,0.381
20700926,1610612737,1610612748,97.0,94.0,0.4379999999999999,0.457,1,2008-03-08,62,26,36,0.419,61,11,50,0.18
20700927,1610612753,1610612744,95.0,104.0,0.4529999999999999,0.4039999999999999,0,2008-03-08,64,40,24,0.625,62,39,23,0.629
20700928,1610612752,1610612757,114.0,120.0,0.483,0.4629999999999999,0,2008-03-08,63,18,45,0.286,63,33,30,0.524
20700929,1610612763,1610612738,89.0,119.0,0.397,0.58,0,2008-03-08,62,15,47,0.242,61,49,12,0.8029999999999999
20700930,1610612745,1610612740,106.0,96.0,0.5,0.44,1,2008-03-08,62,42,20,0.677,62,42,20,0.677
20700931,1610612742,1610612751,111.0,91.0,0.474,0.386,1,2008-03-08,63,40,23,0.635,63,26,37,0.413
20700932,1610612762,1610612743,132.0,105.0,0.602,0.475,1,2008-03-08,64,42,22,0.6559999999999999,62,37,25,0.597
20700933,1610612746,1610612750,96.0,99.0,0.4379999999999999,0.481,0,2008-03-08,61,20,41,0.3279999999999999,62,14,48,0.226
20700912,1610612761,1610612764,106.0,110.0,0.3939999999999999,0.5,0,2008-03-07,61,33,28,0.541,61,30,31,0.4920000000000001
20700913,1610612755,1610612760,117.0,83.0,0.562,0.48,1,2008-03-07,62,29,33,0.4679999999999999,62,16,46,0.258
20700914,1610612766,1610612737,108.0,93.0,0.512,0.4379999999999999,1,2008-03-07,62,23,39,0.371,61,25,36,0.41
20700915,1610612752,1610612765,97.0,101.0,0.461,0.5,0,2008-03-07,62,18,44,0.29,62,45,17,0.726
20700916,1610612748,1610612744,99.0,134.0,0.457,0.541,0,2008-03-07,60,11,49,0.183,61,38,23,0.623
20700917,1610612738,1610612741,116.0,93.0,0.456,0.318,1,2008-03-07,60,48,12,0.8,62,25,37,0.4029999999999999
20700918,1610612740,1610612751,107.0,96.0,0.521,0.494,1,2008-03-07,61,42,19,0.6890000000000001,62,26,36,0.419
20700919,1610612749,1610612757,101.0,103.0,0.487,0.545,0,2008-03-07,62,23,39,0.371,62,32,30,0.516
20700920,1610612756,1610612762,118.0,126.0,0.5,0.57,0,2008-03-07,62,40,22,0.645,63,41,22,0.6509999999999999
20700921,1610612758,1610612750,103.0,111.0,0.451,0.518,0,2008-03-07,62,27,35,0.435,61,13,48,0.213
20700922,1610612743,1610612759,109.0,96.0,0.541,0.493,1,2008-03-07,61,37,24,0.607,61,43,18,0.705
20700923,1610612747,1610612746,119.0,82.0,0.541,0.3779999999999999,1,2008-03-07,62,44,18,0.71,60,20,40,0.3329999999999999
20700909,1610612741,1610612739,107.0,96.0,0.44,0.3929999999999999,1,2008-03-06,61,25,36,0.41,62,35,27,0.565
20700910,1610612759,1610612754,108.0,97.0,0.481,0.481,1,2008-03-06,60,43,17,0.7170000000000001,62,24,38,0.387
20700911,1610612742,1610612745,98.0,113.0,0.446,0.542,0,2008-03-06,62,39,23,0.629,61,41,20,0.672
20700897,1610612764,1610612753,92.0,122.0,0.4270000000000001,0.561,0,2008-03-05,60,29,31,0.483,63,40,23,0.635
20700898,1610612766,1610612744,118.0,109.0,0.426,0.488,1,2008-03-05,61,22,39,0.361,60,37,23,0.617
20700899,1610612738,1610612765,90.0,78.0,0.461,0.364,1,2008-03-05,59,47,12,0.797,61,44,17,0.721
20700900,1610612752,1610612739,105.0,119.0,0.514,0.482,0,2008-03-05,61,18,43,0.295,61,35,26,0.574
20700901,1610612748,1610612761,83.0,108.0,0.435,0.5489999999999999,0,2008-03-05,59,11,48,0.186,60,33,27,0.55
20700902,1610612749,1610612760,118.0,106.0,0.484,0.465,1,2008-03-05,61,23,38,0.377,61,16,45,0.262
20700903,1610612763,1610612751,100.0,93.0,0.487,0.451,1,2008-03-05,61,15,46,0.246,61,26,35,0.426
20700904,1610612740,1610612737,116.0,101.0,0.475,0.513,1,2008-03-05,60,41,19,0.6829999999999999,60,25,35,0.417
20700905,1610612745,1610612754,117.0,99.0,0.495,0.425,1,2008-03-05,60,40,20,0.667,61,24,37,0.3929999999999999
20700906,1610612743,1610612756,126.0,113.0,0.527,0.532,1,2008-03-05,60,36,24,0.6,61,40,21,0.6559999999999999
20700907,1610612762,1610612750,105.0,76.0,0.506,0.375,1,2008-03-05,62,40,22,0.645,60,12,48,0.2
20700908,1610612746,1610612758,116.0,109.0,0.43,0.478,1,2008-03-05,59,20,39,0.3389999999999999,61,27,34,0.4429999999999999
20700889,1610612737,1610612744,118.0,135.0,0.506,0.545,0,2008-03-04,59,25,34,0.424,59,37,22,0.627
20700890,1610612753,1610612761,102.0,87.0,0.526,0.409,1,2008-03-04,62,39,23,0.629,59,32,27,0.542
20700891,1610612765,1610612760,100.0,97.0,0.38,0.457,1,2008-03-04,60,44,16,0.733,60,16,44,0.267
20700892,1610612750,1610612766,89.0,109.0,0.487,0.514,0,2008-03-04,59,12,47,0.203,60,21,39,0.35
20700893,1610612741,1610612763,112.0,97.0,0.537,0.424,1,2008-03-04,60,24,36,0.4,60,14,46,0.233
20700894,1610612759,1610612751,81.0,70.0,0.3379999999999999,0.373,1,2008-03-04,59,42,17,0.7120000000000001,60,26,34,0.433
20700895,1610612758,1610612747,105.0,117.0,0.4479999999999999,0.4529999999999999,0,2008-03-04,60,27,33,0.45,61,43,18,0.705
20700896,1610612757,1610612756,92.0,97.0,0.41,0.414,0,2008-03-04,61,31,30,0.508,60,40,20,0.667
20700886,1610612752,1610612740,88.0,100.0,0.407,0.4320000000000001,0,2008-03-03,60,18,42,0.3,59,40,19,0.6779999999999999
20700887,1610612762,1610612742,116.0,110.0,0.532,0.5,1,2008-03-03,61,39,22,0.639,61,39,22,0.639
20700888,1610612746,1610612755,80.0,106.0,0.4629999999999999,0.59,0,2008-03-03,58,19,39,0.3279999999999999,61,28,33,0.4589999999999999
20700875,1610612739,1610612741,95.0,86.0,0.4629999999999999,0.392,1,2008-03-02,60,34,26,0.5670000000000001,59,23,36,0.39
20700876,1610612747,1610612742,108.0,104.0,0.379,0.369,1,2008-03-02,60,42,18,0.7,60,39,21,0.65
20700877,1610612738,1610612737,98.0,88.0,0.446,0.395,1,2008-03-02,58,46,12,0.7929999999999999,58,25,33,0.431
20700878,1610612751,1610612759,83.0,93.0,0.346,0.424,0,2008-03-02,59,26,33,0.441,58,41,17,0.7070000000000001
20700879,1610612764,1610612740,101.0,84.0,0.4320000000000001,0.41,1,2008-03-02,59,29,30,0.4920000000000001,58,39,19,0.672
20700880,1610612766,1610612761,110.0,98.0,0.426,0.514,1,2008-03-02,59,20,39,0.3389999999999999,58,32,26,0.552
20700881,1610612754,1610612749,128.0,106.0,0.484,0.38,1,2008-03-02,60,24,36,0.4,60,22,38,0.3670000000000001
20700882,1610612750,1610612760,108.0,111.0,0.495,0.55,0,2008-03-02,58,12,46,0.207,59,16,43,0.271
20700883,1610612745,1610612743,103.0,89.0,0.489,0.418,1,2008-03-02,59,39,20,0.6609999999999999,59,35,24,0.593
20700884,1610612744,1610612757,110.0,104.0,0.467,0.476,1,2008-03-02,58,36,22,0.621,60,31,29,0.517
20700885,1610612758,1610612748,120.0,109.0,0.562,0.563,1,2008-03-02,59,27,32,0.4579999999999999,58,11,47,0.19
20700870,1610612753,1610612752,118.0,92.0,0.519,0.4039999999999999,1,2008-03-01,61,38,23,0.623,59,18,41,0.305
20700871,1610612763,1610612762,92.0,113.0,0.457,0.57,0,2008-03-01,59,14,45,0.237,60,38,22,0.633
20700872,1610612749,1610612759,94.0,96.0,0.3979999999999999,0.467,0,2008-03-01,59,22,37,0.373,57,40,17,0.7020000000000001
20700873,1610612756,1610612755,114.0,119.0,0.494,0.5670000000000001,0,2008-03-01,59,39,20,0.6609999999999999,60,27,33,0.45
20700874,1610612746,1610612765,73.0,103.0,0.348,0.5429999999999999,0,2008-03-01,57,19,38,0.3329999999999999,59,43,16,0.7290000000000001
20700858,1610612761,1610612754,111.0,122.0,0.489,0.494,0,2008-02-29,57,32,25,0.561,59,23,36,0.39
20700859,1610612738,1610612766,108.0,100.0,0.477,0.402,1,2008-02-29,57,45,12,0.789,58,19,39,0.3279999999999999
20700860,1610612737,1610612752,99.0,93.0,0.447,0.42,1,2008-02-29,57,25,32,0.439,58,18,40,0.31
20700861,1610612739,1610612750,92.0,84.0,0.486,0.391,1,2008-02-29,59,33,26,0.5589999999999999,57,12,45,0.211
20700862,1610612741,1610612764,91.0,97.0,0.43,0.419,0,2008-02-29,58,23,35,0.397,58,28,30,0.483
20700863,1610612740,1610612762,110.0,98.0,0.474,0.494,1,2008-02-29,57,39,18,0.684,59,37,22,0.627
20700864,1610612745,1610612763,116.0,95.0,0.506,0.385,1,2008-02-29,58,38,20,0.655,58,14,44,0.241
20700865,1610612742,1610612758,115.0,106.0,0.489,0.47,1,2008-02-29,59,39,20,0.6609999999999999,58,26,32,0.4479999999999999
20700866,1610612743,1610612746,110.0,104.0,0.447,0.4379999999999999,1,2008-02-29,58,35,23,0.603,56,19,37,0.3389999999999999
20700867,1610612744,1610612755,119.0,97.0,0.511,0.4039999999999999,1,2008-02-29,57,35,22,0.614,59,26,33,0.441
20700868,1610612757,1610612747,119.0,111.0,0.529,0.488,1,2008-02-29,59,31,28,0.525,59,41,18,0.695
20700869,1610612760,1610612748,93.0,103.0,0.447,0.442,0,2008-02-29,58,15,43,0.259,57,11,46,0.193
20700855,1610612751,1610612749,120.0,106.0,0.506,0.506,1,2008-02-28,58,26,32,0.4479999999999999,58,22,36,0.379
20700856,1610612759,1610612742,97.0,94.0,0.457,0.4320000000000001,1,2008-02-28,56,39,17,0.696,58,38,20,0.655
20700857,1610612747,1610612748,106.0,88.0,0.476,0.375,1,2008-02-28,58,41,17,0.7070000000000001,56,10,46,0.179
20700845,1610612761,1610612750,107.0,85.0,0.494,0.5,1,2008-02-27,56,32,24,0.5710000000000001,56,12,44,0.214
20700846,1610612755,1610612753,101.0,89.0,0.446,0.405,1,2008-02-27,58,26,32,0.4479999999999999,60,37,23,0.617
20700847,1610612737,1610612758,123.0,117.0,0.482,0.494,1,2008-02-27,56,24,32,0.429,57,26,31,0.456
20700848,1610612754,1610612741,107.0,113.0,0.41,0.471,0,2008-02-27,58,22,36,0.379,57,23,34,0.4039999999999999
20700849,1610612738,1610612739,92.0,87.0,0.523,0.3829999999999999,1,2008-02-27,56,44,12,0.7859999999999999,58,32,26,0.552
20700850,1610612752,1610612766,113.0,89.0,0.511,0.41,1,2008-02-27,57,18,39,0.316,57,19,38,0.3329999999999999
20700851,1610612740,1610612756,120.0,103.0,0.5329999999999999,0.479,1,2008-02-27,56,38,18,0.679,58,39,19,0.672
20700852,1610612762,1610612765,103.0,95.0,0.494,0.421,1,2008-02-27,58,37,21,0.638,58,42,16,0.7240000000000001
20700853,1610612760,1610612743,96.0,138.0,0.363,0.67,0,2008-02-27,57,15,42,0.263,57,34,23,0.596
20700854,1610612746,1610612757,80.0,82.0,0.313,0.423,0,2008-02-27,55,19,36,0.345,58,30,28,0.517
20700837,1610612751,1610612753,92.0,102.0,0.4270000000000001,0.523,0,2008-02-26,57,25,32,0.439,59,37,22,0.627
20700838,1610612748,1610612758,107.0,86.0,0.52,0.421,1,2008-02-26,55,10,45,0.182,56,26,30,0.4639999999999999
20700839,1610612749,1610612739,105.0,102.0,0.436,0.494,1,2008-02-26,57,22,35,0.386,57,32,25,0.561
20700840,1610612763,1610612756,113.0,127.0,0.4589999999999999,0.578,0,2008-02-26,57,14,43,0.246,57,39,18,0.684
20700841,1610612750,1610612762,111.0,100.0,0.4320000000000001,0.4639999999999999,1,2008-02-26,55,12,43,0.218,57,36,21,0.632
20700842,1610612745,1610612764,94.0,69.0,0.482,0.313,1,2008-02-26,57,37,20,0.649,57,27,30,0.474
20700843,1610612747,1610612757,96.0,83.0,0.474,0.361,1,2008-02-26,57,40,17,0.7020000000000001,57,29,28,0.509
20700844,1610612744,1610612760,105.0,99.0,0.441,0.506,1,2008-02-26,56,34,22,0.607,56,15,41,0.268
20700831,1610612754,1610612761,98.0,102.0,0.425,0.479,0,2008-02-25,57,22,35,0.386,55,31,24,0.564
20700832,1610612740,1610612764,92.0,95.0,0.467,0.425,0,2008-02-25,55,37,18,0.6729999999999999,56,27,29,0.482
20700833,1610612742,1610612741,102.0,94.0,0.481,0.3979999999999999,1,2008-02-25,57,38,19,0.667,56,22,34,0.3929999999999999
20700834,1610612759,1610612737,89.0,74.0,0.421,0.3329999999999999,1,2008-02-25,55,38,17,0.691,55,23,32,0.418
20700835,1610612743,1610612765,93.0,98.0,0.36,0.4320000000000001,0,2008-02-25,56,33,23,0.589,57,42,15,0.737
20700836,1610612746,1610612738,76.0,104.0,0.4,0.551,0,2008-02-25,54,19,35,0.352,55,43,12,0.782
20700823,1610612756,1610612765,86.0,116.0,0.416,0.517,0,2008-02-24,56,38,18,0.679,56,41,15,0.732
20700824,1610612761,1610612752,115.0,92.0,0.489,0.3829999999999999,1,2008-02-24,54,30,24,0.556,56,17,39,0.304
20700825,1610612753,1610612758,112.0,93.0,0.482,0.4320000000000001,1,2008-02-24,58,36,22,0.621,55,26,29,0.473
20700826,1610612739,1610612763,109.0,89.0,0.519,0.423,1,2008-02-24,56,32,24,0.5710000000000001,56,14,42,0.25
20700827,1610612757,1610612738,102.0,112.0,0.4529999999999999,0.579,0,2008-02-24,56,29,27,0.518,54,42,12,0.778
20700828,1610612750,1610612742,83.0,99.0,0.494,0.45,0,2008-02-24,54,11,43,0.204,56,37,19,0.6609999999999999
20700829,1610612745,1610612741,110.0,97.0,0.506,0.46,1,2008-02-24,56,36,20,0.643,55,22,33,0.4
20700830,1610612760,1610612747,91.0,111.0,0.4,0.489,0,2008-02-24,55,15,40,0.273,56,39,17,0.696
20700816,1610612764,1610612766,110.0,95.0,0.479,0.5,1,2008-02-23,55,26,29,0.473,56,19,37,0.3389999999999999
20700817,1610612751,1610612754,102.0,91.0,0.467,0.3979999999999999,1,2008-02-23,56,25,31,0.446,56,22,34,0.3929999999999999
20700818,1610612748,1610612755,96.0,101.0,0.451,0.482,0,2008-02-23,54,9,45,0.1669999999999999,57,25,32,0.439
20700819,1610612749,1610612743,115.0,109.0,0.435,0.442,1,2008-02-23,56,21,35,0.375,55,33,22,0.6
20700820,1610612759,1610612740,98.0,89.0,0.481,0.436,1,2008-02-23,54,37,17,0.685,54,37,17,0.685
20700821,1610612762,1610612737,100.0,94.0,0.47,0.48,1,2008-02-23,56,36,20,0.643,54,23,31,0.426
20700822,1610612746,1610612747,95.0,113.0,0.45,0.4639999999999999,0,2008-02-23,53,19,34,0.358,55,38,17,0.691
20700803,1610612766,1610612758,115.0,116.0,0.439,0.46,0,2008-02-22,55,19,36,0.345,54,26,28,0.481
20700804,1610612753,1610612755,115.0,99.0,0.512,0.456,1,2008-02-22,57,35,22,0.614,56,24,32,0.429
20700805,1610612754,1610612751,113.0,103.0,0.4479999999999999,0.487,1,2008-02-22,55,22,33,0.4,55,24,31,0.436
20700806,1610612752,1610612761,103.0,99.0,0.444,0.467,1,2008-02-22,55,17,38,0.309,53,29,24,0.547
20700807,1610612739,1610612764,90.0,89.0,0.447,0.457,1,2008-02-22,55,31,24,0.564,54,25,29,0.4629999999999999
20700808,1610612765,1610612749,127.0,100.0,0.517,0.493,1,2008-02-22,55,40,15,0.727,55,20,35,0.364
20700809,1610612741,1610612743,135.0,121.0,0.5710000000000001,0.483,1,2008-02-22,54,22,32,0.407,54,33,21,0.611
20700810,1610612763,1610612742,83.0,98.0,0.375,0.5,0,2008-02-22,55,14,41,0.255,55,36,19,0.655
20700811,1610612740,1610612745,80.0,100.0,0.4,0.494,0,2008-02-22,53,37,16,0.698,55,35,20,0.636
20700812,1610612756,1610612738,85.0,77.0,0.425,0.385,1,2008-02-22,55,38,17,0.691,53,41,12,0.774
20700813,1610612746,1610612762,114.0,104.0,0.48,0.513,1,2008-02-22,52,19,33,0.365,55,35,20,0.636
20700814,1610612744,1610612737,110.0,117.0,0.479,0.467,0,2008-02-22,55,33,22,0.6,53,23,30,0.434
20700815,1610612760,1610612757,99.0,87.0,0.462,0.3720000000000001,1,2008-02-22,54,15,39,0.278,55,29,26,0.527
20700800,1610612745,1610612748,112.0,100.0,0.5379999999999999,0.475,1,2008-02-21,54,34,20,0.63,53,9,44,0.17
20700801,1610612750,1610612759,99.0,100.0,0.506,0.473,0,2008-02-21,53,11,42,0.208,53,36,17,0.679
20700802,1610612757,1610612760,92.0,88.0,0.382,0.3879999999999999,1,2008-02-21,54,29,25,0.537,53,14,39,0.264
20700790,1610612761,1610612753,127.0,110.0,0.588,0.452,1,2008-02-20,52,29,23,0.5579999999999999,56,34,22,0.607
20700791,1610612755,1610612752,124.0,84.0,0.57,0.4589999999999999,1,2008-02-20,55,24,31,0.436,54,16,38,0.296
20700792,1610612754,1610612739,97.0,106.0,0.4379999999999999,0.481,0,2008-02-20,54,21,33,0.389,54,30,24,0.556
20700793,1610612751,1610612741,110.0,102.0,0.429,0.381,1,2008-02-20,54,24,30,0.444,53,21,32,0.396
20700794,1610612749,1610612765,103.0,98.0,0.4379999999999999,0.39,1,2008-02-20,54,20,34,0.37,54,39,15,0.722
20700795,1610612740,1610612742,104.0,93.0,0.467,0.452,1,2008-02-20,52,37,15,0.7120000000000001,54,35,19,0.648
20700796,1610612756,1610612747,124.0,130.0,0.516,0.565,0,2008-02-20,54,37,17,0.685,54,37,17,0.685
20700797,1610612758,1610612737,119.0,107.0,0.465,0.493,1,2008-02-20,53,25,28,0.472,52,22,30,0.423
20700798,1610612746,1610612763,100.0,86.0,0.45,0.364,1,2008-02-20,51,18,33,0.353,54,14,40,0.259
20700799,1610612744,1610612738,119.0,117.0,0.472,0.481,1,2008-02-20,54,33,21,0.611,52,41,11,0.7879999999999999
20700780,1610612764,1610612752,100.0,113.0,0.409,0.4679999999999999,0,2008-02-19,53,25,28,0.472,53,16,37,0.302
20700781,1610612739,1610612745,85.0,93.0,0.3879999999999999,0.405,0,2008-02-19,53,29,24,0.547,53,33,20,0.623
20700782,1610612765,1610612753,85.0,103.0,0.386,0.486,0,2008-02-19,53,39,14,0.736,55,34,21,0.618
20700783,1610612750,1610612755,104.0,88.0,0.494,0.449,1,2008-02-19,52,11,41,0.212,54,23,31,0.426
20700784,1610612759,1610612766,85.0,65.0,0.431,0.286,1,2008-02-19,52,35,17,0.6729999999999999,54,19,35,0.352
20700785,1610612743,1610612738,124.0,118.0,0.512,0.444,1,2008-02-19,53,33,20,0.623,51,41,10,0.804
20700786,1610612762,1610612744,119.0,109.0,0.536,0.494,1,2008-02-19,54,35,19,0.648,53,32,21,0.604
20700787,1610612757,1610612758,94.0,105.0,0.4529999999999999,0.481,0,2008-02-19,53,28,25,0.528,52,24,28,0.462
20700788,1610612760,1610612763,108.0,101.0,0.525,0.418,1,2008-02-19,52,14,38,0.2689999999999999,53,14,39,0.264
20700789,1610612747,1610612737,122.0,93.0,0.511,0.42,1,2008-02-19,53,36,17,0.679,51,22,29,0.431
20700778,1610612741,1610612748,99.0,92.0,0.447,0.4589999999999999,1,2008-02-14,52,21,31,0.4039999999999999,52,9,43,0.173
20700779,1610612756,1610612742,109.0,97.0,0.569,0.4,1,2008-02-14,53,37,16,0.698,53,35,18,0.66
20700764,1610612761,1610612751,109.0,91.0,0.513,0.486,1,2008-02-13,51,28,23,0.5489999999999999,53,23,30,0.434
20700765,1610612755,1610612763,102.0,88.0,0.506,0.422,1,2008-02-13,53,23,30,0.434,52,14,38,0.2689999999999999
20700766,1610612766,1610612737,100.0,98.0,0.447,0.452,1,2008-02-13,53,19,34,0.358,50,22,28,0.44
20700767,1610612753,1610612743,109.0,98.0,0.462,0.44,1,2008-02-13,54,33,21,0.611,52,32,20,0.615
20700768,1610612739,1610612759,105.0,112.0,0.512,0.487,0,2008-02-13,52,29,23,0.5579999999999999,51,34,17,0.667
20700769,1610612738,1610612752,111.0,103.0,0.507,0.4429999999999999,1,2008-02-13,50,41,9,0.82,52,15,37,0.288
20700770,1610612765,1610612754,96.0,80.0,0.425,0.316,1,2008-02-13,52,39,13,0.75,53,21,32,0.396
20700771,1610612749,1610612740,107.0,111.0,0.5,0.551,0,2008-02-13,53,19,34,0.358,51,36,15,0.706
20700772,1610612750,1610612747,92.0,117.0,0.409,0.484,0,2008-02-13,51,10,41,0.196,52,35,17,0.6729999999999999
20700773,1610612745,1610612758,89.0,87.0,0.407,0.4429999999999999,1,2008-02-13,52,32,20,0.615,51,23,28,0.451
20700774,1610612742,1610612757,96.0,76.0,0.434,0.413,1,2008-02-13,52,35,17,0.6729999999999999,52,28,24,0.5379999999999999
20700775,1610612744,1610612756,120.0,118.0,0.542,0.517,1,2008-02-13,52,32,20,0.615,52,36,16,0.6920000000000001
20700776,1610612760,1610612762,93.0,112.0,0.452,0.512,0,2008-02-13,51,13,38,0.255,53,34,19,0.642
20700777,1610612746,1610612764,89.0,91.0,0.485,0.435,0,2008-02-13,50,17,33,0.34,52,25,27,0.481
20700758,1610612737,1610612765,90.0,94.0,0.4270000000000001,0.461,0,2008-02-12,49,22,27,0.449,51,38,13,0.745
20700759,1610612754,1610612738,97.0,104.0,0.425,0.422,0,2008-02-12,52,21,31,0.4039999999999999,49,40,9,0.816
20700760,1610612751,1610612750,92.0,88.0,0.422,0.365,1,2008-02-12,52,23,29,0.442,50,10,40,0.2
20700761,1610612748,1610612743,113.0,114.0,0.47,0.474,0,2008-02-12,51,9,42,0.176,51,32,19,0.627
20700762,1610612763,1610612758,107.0,94.0,0.5,0.374,1,2008-02-12,51,14,37,0.275,50,23,27,0.46
20700763,1610612741,1610612740,86.0,100.0,0.402,0.487,0,2008-02-12,51,20,31,0.392,50,35,15,0.7
20700751,1610612761,1610612759,88.0,93.0,0.442,0.481,0,2008-02-11,50,27,23,0.54,50,33,17,0.66
20700752,1610612755,1610612742,84.0,76.0,0.444,0.351,1,2008-02-11,52,22,30,0.423,51,34,17,0.667
20700753,1610612766,1610612747,97.0,106.0,0.5,0.5,0,2008-02-11,52,18,34,0.346,51,34,17,0.667
20700754,1610612753,1610612739,111.0,118.0,0.482,0.535,0,2008-02-11,53,32,21,0.604,51,29,22,0.569
20700755,1610612749,1610612746,89.0,96.0,0.4270000000000001,0.451,0,2008-02-11,52,19,33,0.365,49,17,32,0.347
20700756,1610612745,1610612757,95.0,83.0,0.485,0.461,1,2008-02-11,51,31,20,0.608,51,28,23,0.5489999999999999
20700757,1610612744,1610612764,120.0,117.0,0.524,0.467,1,2008-02-11,51,31,20,0.608,51,24,27,0.471
20700749,1610612738,1610612759,98.0,90.0,0.465,0.4429999999999999,1,2008-02-10,48,39,9,0.813,49,32,17,0.653
20700745,1610612748,1610612747,94.0,104.0,0.475,0.457,0,2008-02-10,50,9,41,0.18,50,33,17,0.66
20700746,1610612751,1610612742,101.0,82.0,0.479,0.365,1,2008-02-10,51,22,29,0.431,50,34,16,0.68
20700747,1610612765,1610612766,113.0,87.0,0.482,0.389,1,2008-02-10,50,37,13,0.74,51,18,33,0.353
20700748,1610612750,1610612761,82.0,105.0,0.41,0.506,0,2008-02-10,49,10,39,0.204,49,27,22,0.551
20700744,1610612739,1610612743,83.0,113.0,0.344,0.455,0,2008-02-10,50,28,22,0.56,50,31,19,0.62
20700750,1610612756,1610612764,108.0,107.0,0.488,0.4370000000000001,1,2008-02-10,51,36,15,0.706,50,24,26,0.48
20700737,1610612754,1610612757,101.0,93.0,0.369,0.45,1,2008-02-09,51,21,30,0.412,50,28,22,0.56
20700738,1610612755,1610612746,101.0,80.0,0.526,0.405,1,2008-02-09,51,21,30,0.412,48,16,32,0.3329999999999999
20700739,1610612740,1610612763,112.0,99.0,0.483,0.4629999999999999,1,2008-02-09,49,34,15,0.6940000000000001,50,13,37,0.26
20700740,1610612749,1610612752,98.0,99.0,0.444,0.456,0,2008-02-09,51,19,32,0.373,51,15,36,0.294
20700741,1610612745,1610612737,108.0,89.0,0.5429999999999999,0.3720000000000001,1,2008-02-09,50,30,20,0.6,48,22,26,0.4579999999999999
20700742,1610612762,1610612741,97.0,87.0,0.493,0.41,1,2008-02-09,52,33,19,0.635,50,20,30,0.4
20700743,1610612744,1610612758,105.0,102.0,0.418,0.457,1,2008-02-09,50,30,20,0.6,49,23,26,0.469
20700726,1610612761,1610612746,98.0,102.0,0.412,0.529,0,2008-02-08,48,26,22,0.542,47,16,31,0.34
20700727,1610612766,1610612751,90.0,104.0,0.407,0.482,0,2008-02-08,50,18,32,0.36,50,21,29,0.42
20700728,1610612753,1610612747,113.0,117.0,0.494,0.532,0,2008-02-08,52,32,20,0.615,49,32,17,0.653
20700729,1610612752,1610612759,93.0,99.0,0.408,0.487,0,2008-02-08,50,14,36,0.28,48,32,16,0.667
20700730,1610612737,1610612739,95.0,100.0,0.455,0.466,0,2008-02-08,47,22,25,0.4679999999999999,49,28,21,0.5710000000000001
20700731,1610612765,1610612757,91.0,82.0,0.493,0.44,1,2008-02-08,49,36,13,0.735,49,28,21,0.5710000000000001
20700732,1610612750,1610612738,86.0,88.0,0.417,0.4589999999999999,0,2008-02-08,48,10,38,0.208,47,38,9,0.809
20700733,1610612742,1610612763,92.0,81.0,0.44,0.39,1,2008-02-08,49,34,15,0.6940000000000001,49,13,36,0.265
20700734,1610612756,1610612760,103.0,99.0,0.395,0.423,1,2008-02-08,50,35,15,0.7,50,13,37,0.26
20700735,1610612758,1610612762,117.0,104.0,0.493,0.47,1,2008-02-08,48,23,25,0.479,51,32,19,0.627
20700736,1610612743,1610612764,111.0,100.0,0.564,0.449,1,2008-02-08,49,30,19,0.612,49,24,25,0.49
20700723,1610612755,1610612748,101.0,84.0,0.481,0.362,1,2008-02-07,50,20,30,0.4,49,9,40,0.184
20700724,1610612745,1610612739,92.0,77.0,0.435,0.397,1,2008-02-07,49,29,20,0.5920000000000001,48,27,21,0.563
20700725,1610612744,1610612741,108.0,114.0,0.4320000000000001,0.561,0,2008-02-07,49,29,20,0.5920000000000001,49,20,29,0.408
20700712,1610612764,1610612759,77.0,85.0,0.354,0.444,0,2008-02-06,48,24,24,0.5,47,31,16,0.66
20700713,1610612737,1610612747,98.0,95.0,0.47,0.435,1,2008-02-06,46,22,24,0.478,48,31,17,0.6459999999999999
20700714,1610612753,1610612751,100.0,84.0,0.472,0.418,1,2008-02-06,51,32,19,0.627,49,20,29,0.408
20700715,1610612738,1610612746,111.0,100.0,0.532,0.411,1,2008-02-06,46,37,9,0.804,46,15,31,0.326
20700716,1610612752,1610612754,100.0,103.0,0.4529999999999999,0.447,0,2008-02-06,49,14,35,0.286,50,20,30,0.4
20700717,1610612765,1610612748,100.0,95.0,0.474,0.5,1,2008-02-06,48,35,13,0.7290000000000001,48,9,39,0.188
20700718,1610612742,1610612749,107.0,96.0,0.487,0.451,1,2008-02-06,48,33,15,0.688,50,19,31,0.38
20700719,1610612743,1610612762,115.0,118.0,0.43,0.465,0,2008-02-06,48,29,19,0.604,50,32,18,0.64
20700720,1610612756,1610612740,130.0,132.0,0.552,0.474,0,2008-02-06,49,34,15,0.6940000000000001,48,33,15,0.688
20700721,1610612758,1610612760,92.0,105.0,0.3670000000000001,0.526,0,2008-02-06,47,22,25,0.4679999999999999,49,13,36,0.265
20700722,1610612757,1610612741,100.0,97.0,0.506,0.5,1,2008-02-06,48,28,20,0.583,48,19,29,0.396
20700707,1610612755,1610612764,101.0,96.0,0.569,0.4379999999999999,1,2008-02-05,49,19,30,0.3879999999999999,47,24,23,0.511
20700708,1610612739,1610612738,114.0,113.0,0.506,0.568,1,2008-02-05,47,27,20,0.574,45,36,9,0.8
20700709,1610612754,1610612759,89.0,116.0,0.447,0.535,0,2008-02-05,49,19,30,0.3879999999999999,46,30,16,0.652
20700710,1610612751,1610612747,90.0,105.0,0.41,0.452,0,2008-02-05,48,20,28,0.417,47,31,16,0.66
20700711,1610612763,1610612749,97.0,102.0,0.4679999999999999,0.478,0,2008-02-05,48,13,35,0.271,49,19,30,0.3879999999999999
20700698,1610612737,1610612755,96.0,91.0,0.476,0.4429999999999999,1,2008-02-04,45,21,24,0.467,48,18,30,0.375
20700699,1610612753,1610612742,98.0,107.0,0.462,0.512,0,2008-02-04,50,31,19,0.62,47,32,15,0.6809999999999999
20700700,1610612752,1610612746,94.0,103.0,0.507,0.4629999999999999,0,2008-02-04,48,14,34,0.292,45,15,30,0.3329999999999999
20700701,1610612748,1610612761,82.0,114.0,0.413,0.595,0,2008-02-04,47,9,38,0.191,47,26,21,0.5529999999999999
20700702,1610612750,1610612745,86.0,92.0,0.481,0.461,0,2008-02-04,47,10,37,0.213,48,28,20,0.583
20700703,1610612762,1610612740,110.0,88.0,0.506,0.449,1,2008-02-04,49,31,18,0.633,47,32,15,0.6809999999999999
20700704,1610612756,1610612766,118.0,104.0,0.519,0.494,1,2008-02-04,48,34,14,0.708,49,18,31,0.3670000000000001
20700705,1610612757,1610612743,103.0,105.0,0.413,0.414,0,2008-02-04,47,27,20,0.574,47,29,18,0.617
20700706,1610612760,1610612741,108.0,118.0,0.487,0.4579999999999999,0,2008-02-04,48,12,36,0.25,47,19,28,0.4039999999999999
20700696,1610612764,1610612747,91.0,103.0,0.43,0.562,0,2008-02-03,46,24,22,0.522,46,30,16,0.652
20700697,1610612765,1610612742,90.0,67.0,0.434,0.303,1,2008-02-03,47,34,13,0.723,46,31,15,0.674
20700688,1610612737,1610612751,104.0,92.0,0.518,0.514,1,2008-02-02,44,20,24,0.455,47,20,27,0.426
20700689,1610612754,1610612753,115.0,121.0,0.4479999999999999,0.557,0,2008-02-02,48,19,29,0.396,49,31,18,0.633
20700690,1610612739,1610612746,98.0,84.0,0.473,0.402,1,2008-02-02,46,26,20,0.565,44,14,30,0.318
20700691,1610612763,1610612762,91.0,110.0,0.4379999999999999,0.484,0,2008-02-02,47,13,34,0.2769999999999999,48,30,18,0.625
20700692,1610612749,1610612745,83.0,91.0,0.3879999999999999,0.507,0,2008-02-02,48,18,30,0.375,47,27,20,0.574
20700693,1610612743,1610612766,117.0,101.0,0.487,0.424,1,2008-02-02,46,28,18,0.609,48,18,30,0.375
20700694,1610612758,1610612741,105.0,101.0,0.381,0.4589999999999999,1,2008-02-02,46,22,24,0.478,46,18,28,0.391
20700695,1610612760,1610612752,86.0,85.0,0.395,0.444,1,2008-02-02,47,12,35,0.255,47,14,33,0.298
20700679,1610612761,1610612747,101.0,121.0,0.435,0.556,0,2008-02-01,46,25,21,0.5429999999999999,45,29,16,0.644
20700680,1610612755,1610612753,106.0,108.0,0.5,0.541,0,2008-02-01,47,18,29,0.3829999999999999,48,30,18,0.625
20700682,1610612754,1610612745,103.0,106.0,0.4320000000000001,0.481,0,2008-02-01,47,19,28,0.4039999999999999,46,26,20,0.565
20700681,1610612764,1610612762,87.0,96.0,0.3779999999999999,0.424,0,2008-02-01,45,24,21,0.5329999999999999,47,29,18,0.617
20700683,1610612748,1610612751,85.0,94.0,0.419,0.456,0,2008-02-01,46,9,37,0.196,46,20,26,0.435
20700684,1610612750,1610612746,104.0,83.0,0.489,0.405,1,2008-02-01,46,10,36,0.217,43,14,29,0.326
20700685,1610612758,1610612740,112.0,103.0,0.494,0.481,1,2008-02-01,45,21,24,0.467,46,32,14,0.696
20700686,1610612744,1610612766,127.0,96.0,0.5479999999999999,0.42,1,2008-02-01,48,29,19,0.604,47,18,29,0.3829999999999999
20700687,1610612757,1610612752,94.0,88.0,0.43,0.3939999999999999,1,2008-02-01,46,27,19,0.5870000000000001,46,14,32,0.304
20700675,1610612765,1610612747,90.0,89.0,0.439,0.426,1,2008-01-31,46,33,13,0.7170000000000001,44,28,16,0.636
20700676,1610612738,1610612742,96.0,90.0,0.429,0.4429999999999999,1,2008-01-31,44,36,8,0.818,45,31,14,0.6890000000000001
20700677,1610612760,1610612739,101.0,95.0,0.564,0.385,1,2008-01-31,46,11,35,0.239,45,25,20,0.556
20700678,1610612756,1610612759,81.0,84.0,0.38,0.387,0,2008-01-31,47,33,14,0.7020000000000001,45,29,16,0.644
20700665,1610612761,1610612764,122.0,83.0,0.5660000000000001,0.366,1,2008-01-30,45,25,20,0.556,44,24,20,0.545
20700666,1610612755,1610612749,112.0,69.0,0.5429999999999999,0.38,1,2008-01-30,46,18,28,0.391,47,18,29,0.3829999999999999
20700667,1610612753,1610612748,107.0,91.0,0.493,0.423,1,2008-01-30,47,29,18,0.617,45,9,36,0.2
20700668,1610612763,1610612743,102.0,106.0,0.429,0.506,0,2008-01-30,46,13,33,0.283,45,27,18,0.6
20700669,1610612740,1610612744,103.0,116.0,0.436,0.523,0,2008-01-30,45,32,13,0.711,47,28,19,0.596
20700670,1610612750,1610612741,83.0,67.0,0.366,0.3329999999999999,1,2008-01-30,45,9,36,0.2,45,18,27,0.4
20700671,1610612762,1610612752,100.0,89.0,0.512,0.471,1,2008-01-30,46,28,18,0.609,45,14,31,0.311
20700672,1610612757,1610612739,83.0,84.0,0.353,0.392,0,2008-01-30,45,26,19,0.578,44,25,19,0.568
20700673,1610612758,1610612766,105.0,91.0,0.456,0.41,1,2008-01-30,44,20,24,0.455,46,18,28,0.391
20700674,1610612746,1610612737,95.0,88.0,0.475,0.422,1,2008-01-30,42,14,28,0.3329999999999999,43,19,24,0.442
20700656,1610612764,1610612761,108.0,104.0,0.421,0.425,1,2008-01-29,43,24,19,0.5579999999999999,44,24,20,0.545
20700657,1610612754,1610612765,104.0,110.0,0.462,0.494,0,2008-01-29,46,19,27,0.413,45,32,13,0.711
20700658,1610612751,1610612749,87.0,80.0,0.405,0.375,1,2008-01-29,45,19,26,0.422,46,18,28,0.391
20700659,1610612748,1610612738,87.0,117.0,0.359,0.513,0,2008-01-29,44,9,35,0.205,43,35,8,0.8140000000000001
20700660,1610612741,1610612750,96.0,85.0,0.425,0.4370000000000001,1,2008-01-29,44,18,26,0.409,44,8,36,0.182
20700661,1610612745,1610612744,111.0,107.0,0.4589999999999999,0.42,1,2008-01-29,45,25,20,0.556,46,27,19,0.5870000000000001
20700662,1610612756,1610612737,125.0,92.0,0.642,0.3429999999999999,1,2008-01-29,46,33,13,0.7170000000000001,42,19,23,0.452
20700663,1610612760,1610612759,88.0,85.0,0.416,0.434,1,2008-01-29,45,10,35,0.222,44,28,16,0.636
20700664,1610612747,1610612752,120.0,109.0,0.506,0.444,1,2008-01-29,43,28,15,0.6509999999999999,44,14,30,0.318
20700652,1610612763,1610612742,84.0,103.0,0.417,0.537,0,2008-01-28,45,13,32,0.289,44,31,13,0.705
20700653,1610612740,1610612743,117.0,93.0,0.506,0.4270000000000001,1,2008-01-28,44,32,12,0.727,44,26,18,0.591
20700654,1610612762,1610612759,97.0,91.0,0.5,0.419,1,2008-01-28,45,27,18,0.6,43,28,15,0.6509999999999999
20700655,1610612746,1610612766,100.0,107.0,0.544,0.5670000000000001,0,2008-01-28,41,13,28,0.317,45,18,27,0.4
20700642,1610612741,1610612756,77.0,88.0,0.347,0.416,0,2008-01-27,43,17,26,0.395,45,32,13,0.711
20700644,1610612753,1610612738,96.0,93.0,0.4589999999999999,0.417,1,2008-01-27,46,28,18,0.609,42,34,8,0.81
20700643,1610612747,1610612739,95.0,98.0,0.472,0.442,0,2008-01-27,42,27,15,0.643,43,24,19,0.5579999999999999
20700645,1610612749,1610612764,105.0,102.0,0.4589999999999999,0.412,1,2008-01-27,45,18,27,0.4,42,23,19,0.5479999999999999
20700646,1610612757,1610612737,94.0,93.0,0.5,0.526,1,2008-01-27,44,26,18,0.591,41,19,22,0.4629999999999999
20700647,1610612742,1610612743,90.0,85.0,0.455,0.382,1,2008-01-27,43,30,13,0.698,43,26,17,0.605
20700648,1610612750,1610612751,98.0,95.0,0.412,0.4320000000000001,1,2008-01-27,43,8,35,0.186,44,18,26,0.409
20700649,1610612745,1610612762,89.0,97.0,0.439,0.472,0,2008-01-27,44,24,20,0.545,44,26,18,0.591
20700650,1610612744,1610612752,106.0,104.0,0.435,0.449,1,2008-01-27,45,27,18,0.6,43,14,29,0.326
20700651,1610612760,1610612758,101.0,103.0,0.42,0.457,0,2008-01-27,44,9,35,0.205,43,19,24,0.442
20700638,1610612748,1610612754,98.0,96.0,0.494,0.4379999999999999,1,2008-01-26,43,9,34,0.209,45,19,26,0.422
20700639,1610612766,1610612755,96.0,103.0,0.402,0.481,0,2008-01-26,44,17,27,0.386,45,17,28,0.3779999999999999
20700640,1610612763,1610612746,125.0,120.0,0.525,0.524,1,2008-01-26,44,13,31,0.295,40,13,27,0.325
20700641,1610612759,1610612740,78.0,102.0,0.418,0.5429999999999999,0,2008-01-26,42,28,14,0.667,43,31,12,0.721
20700625,1610612761,1610612749,106.0,75.0,0.507,0.425,1,2008-01-25,43,24,19,0.5579999999999999,44,17,27,0.386
20700626,1610612764,1610612763,104.0,93.0,0.494,0.429,1,2008-01-25,41,23,18,0.561,43,12,31,0.2789999999999999
20700627,1610612739,1610612756,108.0,110.0,0.456,0.537,0,2008-01-25,42,23,19,0.5479999999999999,44,31,13,0.705
20700630,1610612765,1610612753,101.0,93.0,0.506,0.4429999999999999,1,2008-01-25,44,31,13,0.705,45,27,18,0.6
20700628,1610612738,1610612750,87.0,86.0,0.42,0.41,1,2008-01-25,41,34,7,0.8290000000000001,42,7,35,0.1669999999999999
20700629,1610612752,1610612755,89.0,81.0,0.461,0.423,1,2008-01-25,42,14,28,0.3329999999999999,44,16,28,0.364
20700631,1610612740,1610612746,111.0,92.0,0.472,0.462,1,2008-01-25,42,30,12,0.7140000000000001,39,13,26,0.3329999999999999
20700632,1610612741,1610612766,77.0,90.0,0.37,0.493,0,2008-01-25,42,17,25,0.405,43,17,26,0.395
20700633,1610612742,1610612747,112.0,105.0,0.476,0.563,1,2008-01-25,42,29,13,0.69,41,27,14,0.659
20700634,1610612743,1610612751,100.0,85.0,0.36,0.384,1,2008-01-25,42,26,16,0.619,43,18,25,0.419
20700635,1610612762,1610612758,127.0,113.0,0.5770000000000001,0.486,1,2008-01-25,43,25,18,0.581,42,18,24,0.429
20700636,1610612757,1610612745,79.0,89.0,0.357,0.405,0,2008-01-25,43,25,18,0.581,43,24,19,0.5579999999999999
20700637,1610612760,1610612737,90.0,99.0,0.409,0.434,0,2008-01-25,43,9,34,0.209,40,19,21,0.475
20700622,1610612748,1610612759,89.0,90.0,0.493,0.473,0,2008-01-24,42,8,34,0.19,41,28,13,0.6829999999999999
20700623,1610612749,1610612754,104.0,92.0,0.47,0.41,1,2008-01-24,43,17,26,0.395,44,19,25,0.4320000000000001
20700624,1610612744,1610612751,121.0,119.0,0.506,0.4270000000000001,1,2008-01-24,44,26,18,0.591,42,18,24,0.429
20700610,1610612755,1610612765,78.0,86.0,0.434,0.451,0,2008-01-23,43,16,27,0.3720000000000001,43,30,13,0.698
20700611,1610612766,1610612742,95.0,102.0,0.444,0.476,0,2008-01-23,42,16,26,0.381,41,28,13,0.6829999999999999
20700612,1610612739,1610612764,121.0,85.0,0.56,0.39,1,2008-01-23,41,23,18,0.561,40,22,18,0.55
20700613,1610612738,1610612761,112.0,114.0,0.494,0.58,0,2008-01-23,40,33,7,0.825,42,23,19,0.5479999999999999
20700614,1610612763,1610612753,85.0,112.0,0.435,0.547,0,2008-01-23,42,12,30,0.286,44,27,17,0.614
20700615,1610612740,1610612757,96.0,81.0,0.4679999999999999,0.395,1,2008-01-23,41,29,12,0.7070000000000001,42,25,17,0.595
20700616,1610612750,1610612756,117.0,107.0,0.5,0.56,1,2008-01-23,41,7,34,0.171,43,30,13,0.698
20700617,1610612741,1610612754,108.0,95.0,0.476,0.386,1,2008-01-23,41,17,24,0.415,43,19,24,0.442
20700618,1610612759,1610612747,103.0,91.0,0.471,0.467,1,2008-01-23,40,27,13,0.675,40,27,13,0.675
20700619,1610612743,1610612737,107.0,100.0,0.442,0.392,1,2008-01-23,41,25,16,0.61,39,18,21,0.462
20700620,1610612760,1610612745,107.0,109.0,0.519,0.466,0,2008-01-23,42,9,33,0.214,42,23,19,0.5479999999999999
20700621,1610612746,1610612758,111.0,85.0,0.471,0.419,1,2008-01-23,38,13,25,0.342,41,18,23,0.439
20700608,1610612749,1610612756,105.0,114.0,0.4639999999999999,0.494,0,2008-01-22,42,16,26,0.381,42,30,12,0.7140000000000001
20700609,1610612758,1610612751,128.0,94.0,0.575,0.45,1,2008-01-22,40,18,22,0.45,41,18,23,0.439
20700595,1610612752,1610612738,93.0,109.0,0.4320000000000001,0.547,0,2008-01-21,41,13,28,0.317,39,33,6,0.846
20700596,1610612764,1610612742,102.0,84.0,0.4529999999999999,0.413,1,2008-01-21,39,22,17,0.564,40,27,13,0.675
20700597,1610612766,1610612759,86.0,95.0,0.469,0.487,0,2008-01-21,41,16,25,0.39,39,26,13,0.667
20700598,1610612755,1610612754,103.0,110.0,0.4429999999999999,0.519,0,2008-01-21,42,16,26,0.381,42,19,23,0.452
20700599,1610612737,1610612757,109.0,111.0,0.4320000000000001,0.467,0,2008-01-21,38,18,20,0.474,41,25,16,0.61
20700600,1610612745,1610612760,96.0,89.0,0.425,0.424,1,2008-01-21,41,22,19,0.537,41,9,32,0.22
20700601,1610612740,1610612749,106.0,92.0,0.471,0.436,1,2008-01-21,40,28,12,0.7,41,16,25,0.39
20700602,1610612746,1610612762,93.0,109.0,0.486,0.57,0,2008-01-21,37,12,25,0.324,42,24,18,0.5710000000000001
20700603,1610612744,1610612750,108.0,109.0,0.435,0.506,0,2008-01-21,43,25,18,0.581,40,6,34,0.15
20700604,1610612763,1610612741,104.0,90.0,0.521,0.365,1,2008-01-21,41,12,29,0.293,40,16,24,0.4
20700605,1610612753,1610612765,102.0,100.0,0.508,0.4379999999999999,1,2008-01-21,43,26,17,0.605,42,29,13,0.69
20700606,1610612748,1610612739,90.0,97.0,0.446,0.465,0,2008-01-21,41,8,33,0.195,40,22,18,0.55
20700607,1610612747,1610612743,116.0,99.0,0.476,0.4479999999999999,1,2008-01-21,39,27,12,0.6920000000000001,40,24,16,0.6
20700594,1610612756,1610612751,116.0,92.0,0.479,0.4579999999999999,1,2008-01-20,41,29,12,0.7070000000000001,40,18,22,0.45
20700583,1610612755,1610612761,99.0,95.0,0.475,0.478,1,2008-01-19,41,16,25,0.39,41,22,19,0.537
20700584,1610612766,1610612763,105.0,87.0,0.5,0.4,1,2008-01-19,40,16,24,0.4,40,11,29,0.275
20700585,1610612753,1610612757,101.0,94.0,0.5,0.418,1,2008-01-19,42,25,17,0.595,40,24,16,0.6
20700586,1610612754,1610612758,104.0,110.0,0.426,0.4629999999999999,0,2008-01-19,41,18,23,0.439,39,17,22,0.436
20700587,1610612748,1610612752,84.0,88.0,0.392,0.402,0,2008-01-19,40,8,32,0.2,40,13,27,0.325
20700588,1610612741,1610612765,97.0,81.0,0.423,0.406,1,2008-01-19,39,16,23,0.41,41,29,12,0.7070000000000001
20700589,1610612749,1610612744,99.0,119.0,0.48,0.544,0,2008-01-19,40,16,24,0.4,42,25,17,0.595
20700590,1610612745,1610612759,83.0,81.0,0.386,0.451,1,2008-01-19,40,21,19,0.525,38,25,13,0.6579999999999999
20700591,1610612742,1610612760,111.0,96.0,0.517,0.4429999999999999,1,2008-01-19,39,27,12,0.6920000000000001,40,9,31,0.225
20700592,1610612743,1610612750,111.0,108.0,0.429,0.531,1,2008-01-19,39,24,15,0.615,39,5,34,0.128
20700593,1610612746,1610612751,120.0,107.0,0.483,0.413,1,2008-01-19,36,12,24,0.3329999999999999,39,18,21,0.462
20700573,1610612761,1610612737,89.0,78.0,0.478,0.413,1,2008-01-18,40,22,18,0.55,37,18,19,0.486
20700574,1610612764,1610612752,111.0,98.0,0.568,0.43,1,2008-01-18,38,21,17,0.5529999999999999,39,12,27,0.308
20700575,1610612748,1610612757,91.0,98.0,0.4,0.446,0,2008-01-18,39,8,31,0.205,39,24,15,0.615
20700576,1610612738,1610612755,116.0,89.0,0.589,0.4529999999999999,1,2008-01-18,38,32,6,0.8420000000000001,40,15,25,0.375
20700577,1610612765,1610612758,93.0,100.0,0.42,0.507,0,2008-01-18,40,29,11,0.725,38,16,22,0.421
20700578,1610612763,1610612760,124.0,100.0,0.52,0.434,1,2008-01-18,39,11,28,0.282,39,9,30,0.231
20700579,1610612740,1610612766,112.0,84.0,0.603,0.42,1,2008-01-18,39,27,12,0.6920000000000001,39,15,24,0.385
20700580,1610612762,1610612746,106.0,88.0,0.518,0.4579999999999999,1,2008-01-18,41,23,18,0.561,35,11,24,0.314
20700581,1610612756,1610612750,115.0,95.0,0.5429999999999999,0.429,1,2008-01-18,40,28,12,0.7,38,5,33,0.132
20700582,1610612741,1610612744,111.0,119.0,0.5,0.461,0,2008-01-18,38,15,23,0.395,41,24,17,0.585
20700570,1610612759,1610612739,88.0,90.0,0.434,0.455,0,2008-01-17,37,25,12,0.6759999999999999,39,21,18,0.5379999999999999
20700571,1610612743,1610612762,120.0,109.0,0.446,0.446,1,2008-01-17,38,23,15,0.605,40,22,18,0.55
20700572,1610612747,1610612756,98.0,106.0,0.379,0.519,0,2008-01-17,38,26,12,0.684,39,27,12,0.6920000000000001
20700562,1610612761,1610612758,116.0,91.0,0.524,0.466,1,2008-01-16,39,21,18,0.5379999999999999,37,15,22,0.405
20700563,1610612766,1610612753,99.0,93.0,0.402,0.4320000000000001,1,2008-01-16,38,15,23,0.395,41,24,17,0.585
20700564,1610612748,1610612741,96.0,126.0,0.4679999999999999,0.573,0,2008-01-16,38,8,30,0.211,37,15,22,0.405
20700565,1610612754,1610612744,125.0,117.0,0.4629999999999999,0.429,1,2008-01-16,40,18,22,0.45,40,23,17,0.575
20700566,1610612738,1610612757,100.0,90.0,0.436,0.4639999999999999,1,2008-01-16,37,31,6,0.838,38,23,15,0.605
20700567,1610612751,1610612752,105.0,111.0,0.47,0.48,0,2008-01-16,38,18,20,0.474,38,12,26,0.316
20700568,1610612749,1610612737,87.0,80.0,0.379,0.365,1,2008-01-16,39,16,23,0.41,36,18,18,0.5
20700569,1610612740,1610612760,123.0,92.0,0.516,0.43,1,2008-01-16,38,26,12,0.684,38,9,29,0.237
20700554,1610612737,1610612743,104.0,93.0,0.519,0.4,1,2008-01-15,35,18,17,0.514,37,22,15,0.595
20700555,1610612753,1610612741,102.0,88.0,0.457,0.474,1,2008-01-15,40,24,16,0.6,36,14,22,0.389
20700556,1610612752,1610612764,105.0,93.0,0.512,0.395,1,2008-01-15,37,11,26,0.297,37,20,17,0.541
20700557,1610612765,1610612761,103.0,89.0,0.5,0.4429999999999999,1,2008-01-15,39,29,10,0.7440000000000001,38,20,18,0.526
20700558,1610612763,1610612739,124.0,132.0,0.544,0.5329999999999999,0,2008-01-15,38,10,28,0.263,38,20,18,0.526
20700559,1610612750,1610612744,98.0,105.0,0.446,0.444,0,2008-01-15,37,5,32,0.135,39,23,16,0.59
20700560,1610612745,1610612755,107.0,111.0,0.487,0.488,0,2008-01-15,39,20,19,0.513,39,15,24,0.385
20700561,1610612746,1610612756,97.0,90.0,0.525,0.407,1,2008-01-15,34,11,23,0.324,38,26,12,0.684
20700547,1610612766,1610612743,119.0,116.0,0.483,0.494,1,2008-01-14,37,14,23,0.3779999999999999,36,22,14,0.611
20700548,1610612738,1610612764,83.0,88.0,0.419,0.386,0,2008-01-14,36,30,6,0.833,36,20,16,0.556
20700549,1610612751,1610612757,73.0,99.0,0.3379999999999999,0.529,0,2008-01-14,37,18,19,0.486,37,23,14,0.622
20700550,1610612759,1610612755,89.0,82.0,0.395,0.382,1,2008-01-14,36,25,11,0.6940000000000001,38,14,24,0.368
20700551,1610612762,1610612749,98.0,87.0,0.493,0.4589999999999999,1,2008-01-14,39,22,17,0.564,38,15,23,0.395
20700552,1610612758,1610612742,122.0,120.0,0.506,0.5710000000000001,1,2008-01-14,36,15,21,0.417,38,26,12,0.684
20700553,1610612760,1610612747,121.0,123.0,0.481,0.461,0,2008-01-14,37,9,28,0.243,37,26,11,0.703
20700541,1610612761,1610612757,116.0,109.0,0.484,0.411,1,2008-01-13,37,20,17,0.541,36,22,14,0.611
20700542,1610612737,1610612741,105.0,84.0,0.4639999999999999,0.345,1,2008-01-13,34,17,17,0.5,35,14,21,0.4
20700543,1610612745,1610612740,82.0,87.0,0.425,0.424,0,2008-01-13,38,20,18,0.526,37,25,12,0.6759999999999999
20700544,1610612752,1610612765,89.0,65.0,0.472,0.307,1,2008-01-13,36,10,26,0.278,38,28,10,0.737
20700545,1610612744,1610612754,106.0,101.0,0.418,0.481,1,2008-01-13,38,22,16,0.579,39,17,22,0.436
20700546,1610612747,1610612763,100.0,99.0,0.434,0.4270000000000001,1,2008-01-13,36,25,11,0.6940000000000001,37,10,27,0.27
20700535,1610612766,1610612765,100.0,103.0,0.475,0.3879999999999999,0,2008-01-12,36,13,23,0.361,37,28,9,0.757
20700534,1610612764,1610612738,85.0,78.0,0.368,0.413,1,2008-01-12,35,19,16,0.5429999999999999,35,30,5,0.857
20700536,1610612759,1610612750,105.0,88.0,0.507,0.486,1,2008-01-12,35,24,11,0.6859999999999999,36,5,31,0.139
20700537,1610612762,1610612753,119.0,115.0,0.534,0.4639999999999999,1,2008-01-12,38,21,17,0.5529999999999999,39,23,16,0.59
20700538,1610612756,1610612749,122.0,114.0,0.57,0.5579999999999999,1,2008-01-12,37,26,11,0.703,37,15,22,0.405
20700539,1610612758,1610612754,105.0,111.0,0.5,0.475,0,2008-01-12,35,14,21,0.4,38,17,21,0.447
20700540,1610612746,1610612742,94.0,95.0,0.522,0.452,0,2008-01-12,33,10,23,0.303,37,26,11,0.703
20700523,1610612755,1610612741,97.0,100.0,0.42,0.451,0,2008-01-11,37,14,23,0.3779999999999999,34,14,20,0.412
20700524,1610612751,1610612738,77.0,86.0,0.365,0.479,0,2008-01-11,36,18,18,0.5,34,30,4,0.882
20700525,1610612752,1610612761,90.0,99.0,0.507,0.4679999999999999,0,2008-01-11,35,9,26,0.257,36,19,17,0.528
20700526,1610612737,1610612764,98.0,102.0,0.466,0.416,0,2008-01-11,33,16,17,0.485,34,18,16,0.529
20700527,1610612739,1610612766,113.0,106.0,0.455,0.408,1,2008-01-11,37,19,18,0.514,35,13,22,0.371
20700528,1610612740,1610612748,114.0,88.0,0.61,0.474,1,2008-01-11,36,24,12,0.667,37,8,29,0.216
20700529,1610612745,1610612750,113.0,82.0,0.537,0.436,1,2008-01-11,37,20,17,0.541,35,5,30,0.143
20700530,1610612743,1610612753,113.0,103.0,0.472,0.4639999999999999,1,2008-01-11,35,22,13,0.629,38,23,15,0.605
20700531,1610612747,1610612749,110.0,105.0,0.4579999999999999,0.477,1,2008-01-11,35,24,11,0.6859999999999999,36,15,21,0.417
20700532,1610612744,1610612763,116.0,104.0,0.516,0.455,1,2008-01-11,37,21,16,0.568,36,10,26,0.278
20700533,1610612760,1610612742,70.0,90.0,0.354,0.41,0,2008-01-11,36,9,27,0.25,36,25,11,0.6940000000000001
20700520,1610612759,1610612765,80.0,90.0,0.433,0.4679999999999999,0,2008-01-10,34,23,11,0.6759999999999999,36,27,9,0.75
20700521,1610612758,1610612763,116.0,113.0,0.483,0.514,1,2008-01-10,34,14,20,0.412,35,10,25,0.286
20700522,1610612762,1610612756,108.0,86.0,0.473,0.361,1,2008-01-10,37,20,17,0.541,36,25,11,0.6940000000000001
20700509,1610612761,1610612755,109.0,96.0,0.551,0.4370000000000001,1,2008-01-09,35,18,17,0.514,36,14,22,0.389
20700510,1610612737,1610612739,90.0,81.0,0.4579999999999999,0.364,1,2008-01-09,32,16,16,0.5,36,18,18,0.5
20700511,1610612738,1610612766,83.0,95.0,0.417,0.487,0,2008-01-09,33,29,4,0.879,34,13,21,0.382
20700512,1610612751,1610612760,99.0,88.0,0.475,0.405,1,2008-01-09,35,18,17,0.514,35,9,26,0.257
20700513,1610612752,1610612745,92.0,101.0,0.444,0.5,0,2008-01-09,34,9,25,0.265,36,19,17,0.528
20700514,1610612749,1610612748,98.0,92.0,0.442,0.4,1,2008-01-09,35,15,20,0.429,36,8,28,0.222
20700515,1610612740,1610612747,80.0,109.0,0.369,0.5489999999999999,0,2008-01-09,35,23,12,0.657,34,23,11,0.6759999999999999
20700516,1610612742,1610612765,102.0,86.0,0.568,0.4,1,2008-01-09,35,24,11,0.6859999999999999,35,26,9,0.743
20700517,1610612756,1610612754,129.0,122.0,0.446,0.455,1,2008-01-09,35,25,10,0.7140000000000001,37,16,21,0.4320000000000001
20700518,1610612757,1610612744,109.0,91.0,0.46,0.3929999999999999,1,2008-01-09,35,22,13,0.629,36,20,16,0.556
20700519,1610612746,1610612753,106.0,113.0,0.4679999999999999,0.488,0,2008-01-09,32,10,22,0.313,37,23,14,0.622
20700500,1610612755,1610612749,83.0,87.0,0.4,0.434,0,2008-01-08,35,14,21,0.4,34,14,20,0.412
20700501,1610612764,1610612745,84.0,92.0,0.411,0.478,0,2008-01-08,33,17,16,0.515,35,18,17,0.514
20700502,1610612766,1610612751,115.0,99.0,0.5870000000000001,0.461,1,2008-01-08,33,12,21,0.364,34,17,17,0.5
20700503,1610612739,1610612760,95.0,79.0,0.4,0.405,1,2008-01-08,35,18,17,0.514,34,9,25,0.265
20700504,1610612763,1610612747,101.0,117.0,0.441,0.527,0,2008-01-08,34,10,24,0.294,33,22,11,0.667
20700505,1610612750,1610612748,101.0,91.0,0.488,0.485,1,2008-01-08,34,5,29,0.147,35,8,27,0.2289999999999999
20700506,1610612741,1610612752,100.0,105.0,0.442,0.506,0,2008-01-08,33,13,20,0.3939999999999999,33,9,24,0.273
20700507,1610612762,1610612754,111.0,89.0,0.476,0.43,1,2008-01-08,36,19,17,0.528,36,16,20,0.444
20700508,1610612758,1610612753,104.0,100.0,0.5,0.4529999999999999,1,2008-01-08,33,13,20,0.3939999999999999,36,22,14,0.611
20700498,1610612756,1610612743,137.0,115.0,0.5379999999999999,0.4270000000000001,1,2008-01-07,34,24,10,0.706,34,21,13,0.618
20700499,1610612744,1610612759,130.0,121.0,0.516,0.451,1,2008-01-07,35,20,15,0.5710000000000001,33,23,10,0.6970000000000001
20700490,1610612761,1610612739,90.0,93.0,0.493,0.412,0,2008-01-06,34,17,17,0.5,34,17,17,0.5
20700491,1610612764,1610612760,108.0,86.0,0.483,0.381,1,2008-01-06,32,17,15,0.531,33,9,24,0.273
20700492,1610612750,1610612742,78.0,101.0,0.409,0.4629999999999999,0,2008-01-06,33,4,29,0.121,34,23,11,0.6759999999999999
20700493,1610612746,1610612759,82.0,88.0,0.456,0.405,0,2008-01-06,31,10,21,0.3229999999999999,32,23,9,0.7190000000000001
20700494,1610612763,1610612748,101.0,94.0,0.473,0.455,1,2008-01-06,33,10,23,0.303,34,8,26,0.235
20700495,1610612766,1610612749,89.0,93.0,0.471,0.45,0,2008-01-06,32,11,21,0.344,33,13,20,0.3939999999999999
20700496,1610612743,1610612755,109.0,96.0,0.473,0.411,1,2008-01-06,33,21,12,0.636,34,14,20,0.412
20700497,1610612747,1610612754,112.0,96.0,0.462,0.416,1,2008-01-06,32,21,11,0.6559999999999999,35,16,19,0.457
20700484,1610612737,1610612751,107.0,113.0,0.488,0.481,0,2008-01-05,31,15,16,0.484,33,17,16,0.515
20700485,1610612765,1610612738,85.0,92.0,0.392,0.419,0,2008-01-05,34,26,8,0.765,32,29,3,0.906
20700486,1610612741,1610612758,94.0,93.0,0.361,0.446,1,2008-01-05,32,13,19,0.406,32,12,20,0.375
20700487,1610612745,1610612752,103.0,91.0,0.532,0.449,1,2008-01-05,34,17,17,0.5,32,8,24,0.25
20700488,1610612756,1610612740,113.0,118.0,0.532,0.495,0,2008-01-05,33,23,10,0.6970000000000001,34,23,11,0.6759999999999999
20700489,1610612757,1610612762,103.0,89.0,0.507,0.474,1,2008-01-05,34,21,13,0.618,35,18,17,0.514
20700472,1610612761,1610612765,85.0,101.0,0.412,0.506,0,2008-01-04,33,17,16,0.515,33,26,7,0.7879999999999999
20700473,1610612753,1610612745,94.0,96.0,0.447,0.474,0,2008-01-04,35,22,13,0.629,33,16,17,0.485
20700474,1610612754,1610612737,113.0,91.0,0.477,0.4270000000000001,1,2008-01-04,34,16,18,0.471,30,15,15,0.5
20700475,1610612738,1610612763,100.0,96.0,0.462,0.429,1,2008-01-04,31,28,3,0.903,32,9,23,0.281
20700476,1610612751,1610612766,102.0,96.0,0.4379999999999999,0.4679999999999999,1,2008-01-04,32,16,16,0.5,31,11,20,0.355
20700477,1610612739,1610612758,97.0,93.0,0.385,0.5529999999999999,1,2008-01-04,33,16,17,0.485,31,12,19,0.387
20700478,1610612750,1610612743,107.0,118.0,0.449,0.5429999999999999,0,2008-01-04,32,4,28,0.125,32,20,12,0.625
20700479,1610612749,1610612764,77.0,101.0,0.385,0.5539999999999999,0,2008-01-04,32,12,20,0.375,31,16,15,0.516
20700480,1610612759,1610612752,97.0,93.0,0.424,0.493,1,2008-01-04,31,22,9,0.71,31,8,23,0.258
20700481,1610612742,1610612748,94.0,89.0,0.44,0.486,1,2008-01-04,33,22,11,0.667,33,8,25,0.242
20700482,1610612747,1610612755,124.0,93.0,0.662,0.424,1,2008-01-04,31,20,11,0.645,33,14,19,0.424
20700483,1610612744,1610612740,104.0,116.0,0.532,0.483,0,2008-01-04,34,19,15,0.5589999999999999,33,22,11,0.667
20700469,1610612741,1610612757,109.0,115.0,0.413,0.4379999999999999,0,2008-01-03,31,12,19,0.387,33,20,13,0.606
20700470,1610612743,1610612759,80.0,77.0,0.4,0.37,1,2008-01-03,31,19,12,0.613,30,21,9,0.7
20700471,1610612756,1610612760,104.0,96.0,0.444,0.3879999999999999,1,2008-01-03,32,23,9,0.7190000000000001,32,9,23,0.281
20700457,1610612764,1610612765,93.0,106.0,0.4479999999999999,0.487,0,2008-01-02,30,15,15,0.5,32,25,7,0.7809999999999999
20700458,1610612766,1610612741,97.0,109.0,0.449,0.494,0,2008-01-02,30,11,19,0.3670000000000001,30,12,18,0.4
20700459,1610612753,1610612751,95.0,96.0,0.4379999999999999,0.4679999999999999,0,2008-01-02,34,22,12,0.647,31,15,16,0.484
20700460,1610612739,1610612737,98.0,94.0,0.506,0.408,1,2008-01-02,32,15,17,0.469,29,15,14,0.517
20700461,1610612754,1610612763,72.0,90.0,0.308,0.462,0,2008-01-02,33,15,18,0.455,31,9,22,0.29
20700462,1610612738,1610612745,97.0,93.0,0.532,0.422,1,2008-01-02,30,27,3,0.9,32,15,17,0.469
20700463,1610612752,1610612758,97.0,107.0,0.4379999999999999,0.436,0,2008-01-02,30,8,22,0.267,30,12,18,0.4
20700464,1610612748,1610612749,98.0,103.0,0.514,0.521,0,2008-01-02,32,8,24,0.25,31,12,19,0.387
20700465,1610612750,1610612757,79.0,90.0,0.35,0.39,0,2008-01-02,31,4,27,0.129,32,19,13,0.594
20700466,1610612742,1610612744,121.0,99.0,0.537,0.418,1,2008-01-02,32,21,11,0.6559999999999999,33,19,14,0.5760000000000001
20700467,1610612762,1610612755,110.0,107.0,0.5329999999999999,0.482,1,2008-01-02,34,18,16,0.529,32,14,18,0.4379999999999999
20700468,1610612746,1610612740,81.0,95.0,0.44,0.416,0,2008-01-02,30,10,20,0.3329999999999999,32,21,11,0.6559999999999999
20700449,1610612766,1610612754,107.0,103.0,0.42,0.455,1,2007-12-31,29,11,18,0.379,32,15,17,0.469
20700450,1610612741,1610612753,110.0,112.0,0.433,0.494,0,2007-12-31,29,11,18,0.379,33,22,11,0.667
20700451,1610612765,1610612749,114.0,69.0,0.584,0.361,1,2007-12-31,31,24,7,0.774,30,11,19,0.3670000000000001
20700452,1610612745,1610612744,95.0,112.0,0.429,0.46,0,2007-12-31,31,15,16,0.484,32,19,13,0.594
20700453,1610612740,1610612761,92.0,97.0,0.434,0.514,0,2007-12-31,31,20,11,0.645,32,17,15,0.531
20700454,1610612762,1610612757,111.0,101.0,0.512,0.484,1,2007-12-31,33,17,16,0.515,31,18,13,0.581
20700455,1610612746,1610612750,91.0,82.0,0.452,0.402,1,2007-12-31,29,10,19,0.345,30,4,26,0.133
20700456,1610612760,1610612755,90.0,98.0,0.425,0.493,0,2007-12-31,31,9,22,0.29,31,14,17,0.452
20700443,1610612752,1610612741,83.0,100.0,0.3720000000000001,0.5,0,2007-12-30,29,8,21,0.276,28,11,17,0.3929999999999999
20700444,1610612757,1610612755,97.0,72.0,0.474,0.385,1,2007-12-30,30,18,12,0.6,30,13,17,0.433
20700445,1610612743,1610612744,95.0,105.0,0.345,0.435,0,2007-12-30,30,18,12,0.6,31,18,13,0.581
20700446,1610612759,1610612763,111.0,87.0,0.513,0.452,1,2007-12-30,29,21,8,0.7240000000000001,30,8,22,0.267
20700447,1610612758,1610612756,102.0,117.0,0.4320000000000001,0.4579999999999999,0,2007-12-30,29,11,18,0.379,31,22,9,0.71
20700448,1610612747,1610612738,91.0,110.0,0.354,0.4629999999999999,0,2007-12-30,30,19,11,0.633,29,26,3,0.897
20700434,1610612742,1610612737,97.0,84.0,0.4379999999999999,0.417,1,2007-12-29,31,20,11,0.645,28,15,13,0.536
20700435,1610612764,1610612748,96.0,74.0,0.522,0.3939999999999999,1,2007-12-29,29,15,14,0.517,31,8,23,0.258
20700436,1610612753,1610612766,104.0,95.0,0.45,0.473,1,2007-12-29,32,21,11,0.6559999999999999,28,10,18,0.357
20700437,1610612754,1610612765,92.0,98.0,0.4320000000000001,0.4379999999999999,0,2007-12-29,31,15,16,0.484,30,23,7,0.767
20700438,1610612740,1610612739,86.0,76.0,0.419,0.39,1,2007-12-29,30,20,10,0.667,31,14,17,0.452
20700439,1610612749,1610612751,95.0,97.0,0.446,0.5,0,2007-12-29,29,11,18,0.379,30,14,16,0.467
20700440,1610612745,1610612761,91.0,79.0,0.395,0.37,1,2007-12-29,30,15,15,0.5,31,16,15,0.516
20700441,1610612762,1610612738,98.0,104.0,0.5479999999999999,0.4629999999999999,0,2007-12-29,32,16,16,0.5,28,25,3,0.893
20700442,1610612760,1610612750,109.0,90.0,0.537,0.3939999999999999,1,2007-12-29,30,9,21,0.3,29,4,25,0.138
20700422,1610612766,1610612740,85.0,99.0,0.41,0.451,0,2007-12-28,27,10,17,0.37,29,19,10,0.655
20700423,1610612751,1610612764,109.0,106.0,0.439,0.442,1,2007-12-28,29,13,16,0.4479999999999999,28,14,14,0.5
20700424,1610612748,1610612753,114.0,121.0,0.506,0.457,0,2007-12-28,30,8,22,0.267,31,20,11,0.645
20700425,1610612765,1610612754,114.0,101.0,0.489,0.469,1,2007-12-28,29,22,7,0.759,30,15,15,0.5
20700426,1610612763,1610612745,83.0,103.0,0.36,0.483,0,2007-12-28,29,8,21,0.276,29,14,15,0.483
20700427,1610612741,1610612749,103.0,99.0,0.436,0.462,1,2007-12-28,27,10,17,0.37,28,11,17,0.3929999999999999
20700428,1610612759,1610612761,73.0,83.0,0.319,0.405,0,2007-12-28,28,20,8,0.7140000000000001,30,16,14,0.5329999999999999
20700429,1610612756,1610612746,94.0,88.0,0.481,0.347,1,2007-12-28,30,21,9,0.7,28,9,19,0.321
20700430,1610612758,1610612755,80.0,92.0,0.421,0.5,0,2007-12-28,28,11,17,0.3929999999999999,29,13,16,0.4479999999999999
20700431,1610612757,1610612750,109.0,98.0,0.494,0.4629999999999999,1,2007-12-28,29,17,12,0.586,28,4,24,0.143
20700432,1610612747,1610612762,123.0,109.0,0.544,0.456,1,2007-12-28,29,19,10,0.655,31,16,15,0.516
20700433,1610612744,1610612743,120.0,124.0,0.423,0.506,0,2007-12-28,30,17,13,0.5670000000000001,29,18,11,0.621
20700419,1610612742,1610612739,81.0,88.0,0.365,0.364,0,2007-12-27,30,19,11,0.633,30,14,16,0.467
20700420,1610612746,1610612756,88.0,108.0,0.37,0.526,0,2007-12-27,27,9,18,0.3329999999999999,29,20,9,0.69
20700421,1610612760,1610612738,96.0,104.0,0.457,0.395,0,2007-12-27,29,8,21,0.276,27,24,3,0.889
20700408,1610612755,1610612748,96.0,85.0,0.5,0.405,1,2007-12-26,28,12,16,0.429,29,8,21,0.276
20700409,1610612766,1610612764,104.0,108.0,0.4320000000000001,0.488,0,2007-12-26,26,10,16,0.385,27,14,13,0.519
20700410,1610612737,1610612754,107.0,95.0,0.452,0.417,1,2007-12-26,27,15,12,0.556,29,15,14,0.517
20700411,1610612753,1610612752,110.0,96.0,0.5329999999999999,0.402,1,2007-12-26,30,19,11,0.633,28,8,20,0.286
20700412,1610612751,1610612765,83.0,101.0,0.462,0.5379999999999999,0,2007-12-26,28,12,16,0.429,28,21,7,0.75
20700413,1610612763,1610612740,98.0,116.0,0.476,0.5579999999999999,0,2007-12-26,28,8,20,0.286,28,18,10,0.643
20700414,1610612759,1610612741,94.0,79.0,0.474,0.41,1,2007-12-26,27,20,7,0.741,26,9,17,0.346
20700415,1610612743,1610612749,125.0,105.0,0.547,0.409,1,2007-12-26,28,17,11,0.607,27,11,16,0.407
20700416,1610612762,1610612742,99.0,90.0,0.5,0.4270000000000001,1,2007-12-26,30,16,14,0.5329999999999999,29,19,10,0.655
20700417,1610612758,1610612738,69.0,89.0,0.382,0.408,0,2007-12-26,27,11,16,0.407,26,23,3,0.885
20700418,1610612744,1610612750,105.0,101.0,0.422,0.407,1,2007-12-26,29,17,12,0.586,27,4,23,0.148
20700405,1610612739,1610612748,96.0,82.0,0.442,0.431,1,2007-12-25,29,13,16,0.4479999999999999,28,8,20,0.286
20700406,1610612747,1610612756,122.0,115.0,0.523,0.472,1,2007-12-25,28,18,10,0.643,28,19,9,0.679
20700407,1610612757,1610612760,89.0,79.0,0.387,0.408,1,2007-12-25,28,16,12,0.5710000000000001,28,8,20,0.286
20700400,1610612752,1610612747,90.0,95.0,0.395,0.435,0,2007-12-23,27,8,19,0.296,27,17,10,0.63
20700401,1610612765,1610612745,94.0,82.0,0.416,0.4029999999999999,1,2007-12-23,27,20,7,0.741,28,13,15,0.4639999999999999
20700402,1610612739,1610612744,96.0,105.0,0.411,0.521,0,2007-12-23,28,12,16,0.429,28,16,12,0.5710000000000001
20700403,1610612738,1610612753,103.0,91.0,0.521,0.441,1,2007-12-23,25,22,3,0.88,29,18,11,0.621
20700404,1610612758,1610612743,105.0,106.0,0.433,0.429,0,2007-12-23,26,11,15,0.423,27,16,11,0.593
20700391,1610612754,1610612764,93.0,85.0,0.402,0.4029999999999999,1,2007-12-22,28,15,13,0.536,26,13,13,0.5
20700392,1610612751,1610612744,100.0,95.0,0.422,0.386,1,2007-12-22,27,12,15,0.444,27,15,12,0.556
20700393,1610612748,1610612762,104.0,102.0,0.519,0.447,1,2007-12-22,27,8,19,0.296,29,15,14,0.517
20700394,1610612763,1610612755,97.0,99.0,0.493,0.442,0,2007-12-22,27,8,19,0.296,27,11,16,0.407
20700395,1610612740,1610612750,110.0,76.0,0.53,0.3879999999999999,1,2007-12-22,27,17,10,0.63,26,4,22,0.154
20700396,1610612741,1610612745,98.0,116.0,0.456,0.484,0,2007-12-22,25,9,16,0.36,27,13,14,0.481
20700397,1610612749,1610612766,103.0,99.0,0.494,0.506,1,2007-12-22,26,11,15,0.423,25,10,15,0.4
20700398,1610612759,1610612746,99.0,90.0,0.451,0.4629999999999999,1,2007-12-22,26,19,7,0.731,26,9,17,0.346
20700399,1610612756,1610612761,122.0,103.0,0.523,0.4,1,2007-12-22,27,19,8,0.7040000000000001,29,15,14,0.517
20700381,1610612738,1610612741,107.0,82.0,0.4429999999999999,0.355,1,2007-12-21,24,21,3,0.875,24,9,15,0.375
20700382,1610612755,1610612747,101.0,106.0,0.455,0.489,0,2007-12-21,26,10,16,0.385,26,16,10,0.615
20700383,1610612764,1610612737,92.0,97.0,0.446,0.452,0,2007-12-21,25,13,12,0.52,26,14,12,0.5379999999999999
20700384,1610612766,1610612752,105.0,95.0,0.5,0.409,1,2007-12-21,24,10,14,0.417,26,8,18,0.308
20700385,1610612753,1610612762,94.0,113.0,0.455,0.532,0,2007-12-21,28,18,10,0.643,28,15,13,0.536
20700386,1610612765,1610612763,94.0,67.0,0.42,0.3379999999999999,1,2007-12-21,26,19,7,0.731,26,8,18,0.308
20700387,1610612750,1610612754,131.0,118.0,0.5379999999999999,0.451,1,2007-12-21,25,4,21,0.16,27,14,13,0.519
20700388,1610612742,1610612746,102.0,89.0,0.551,0.43,1,2007-12-21,28,19,9,0.679,25,9,16,0.36
20700389,1610612757,1610612743,99.0,96.0,0.4529999999999999,0.456,1,2007-12-21,27,15,12,0.556,26,15,11,0.5770000000000001
20700390,1610612760,1610612761,123.0,115.0,0.56,0.495,1,2007-12-21,27,8,19,0.296,28,15,13,0.536
20700378,1610612748,1610612751,103.0,107.0,0.465,0.46,0,2007-12-20,26,7,19,0.2689999999999999,26,11,15,0.423
20700379,1610612739,1610612747,94.0,90.0,0.415,0.45,1,2007-12-20,27,12,15,0.444,25,15,10,0.6
20700380,1610612743,1610612745,112.0,111.0,0.366,0.402,1,2007-12-20,25,15,10,0.6,26,12,14,0.462
20700365,1610612764,1610612741,84.0,95.0,0.386,0.416,0,2007-12-19,24,13,11,0.542,23,9,14,0.391
20700366,1610612766,1610612762,98.0,92.0,0.435,0.461,1,2007-12-19,23,9,14,0.391,27,14,13,0.519
20700367,1610612737,1610612748,114.0,111.0,0.519,0.465,1,2007-12-19,25,13,12,0.52,25,7,18,0.28
20700368,1610612754,1610612755,102.0,85.0,0.457,0.346,1,2007-12-19,26,14,12,0.5379999999999999,25,10,15,0.4
20700369,1610612738,1610612765,85.0,87.0,0.493,0.4029999999999999,0,2007-12-19,23,20,3,0.87,25,18,7,0.72
20700370,1610612752,1610612739,108.0,90.0,0.562,0.4379999999999999,1,2007-12-19,25,8,17,0.32,26,11,15,0.423
20700371,1610612749,1610612758,89.0,102.0,0.486,0.487,0,2007-12-19,25,10,15,0.4,25,11,14,0.44
20700372,1610612763,1610612759,88.0,85.0,0.44,0.414,1,2007-12-19,25,8,17,0.32,25,18,7,0.72
20700373,1610612750,1610612744,98.0,111.0,0.4479999999999999,0.488,0,2007-12-19,24,3,21,0.125,26,15,11,0.5770000000000001
20700374,1610612745,1610612753,92.0,97.0,0.341,0.41,0,2007-12-19,25,12,13,0.48,27,18,9,0.667
20700375,1610612742,1610612756,108.0,105.0,0.46,0.524,1,2007-12-19,27,18,9,0.667,26,18,8,0.6920000000000001
20700376,1610612757,1610612761,101.0,96.0,0.506,0.5,1,2007-12-19,26,14,12,0.5379999999999999,27,15,12,0.556
20700377,1610612760,1610612740,93.0,107.0,0.424,0.489,0,2007-12-19,26,7,19,0.2689999999999999,26,16,10,0.615
20700362,1610612751,1610612758,101.0,106.0,0.506,0.455,0,2007-12-18,25,10,15,0.4,24,10,14,0.417
20700363,1610612741,1610612747,91.0,103.0,0.481,0.43,0,2007-12-18,22,8,14,0.364,24,15,9,0.625
20700364,1610612746,1610612761,77.0,80.0,0.39,0.375,0,2007-12-18,24,9,15,0.375,26,15,11,0.5770000000000001
20700354,1610612737,1610612762,116.0,111.0,0.5760000000000001,0.482,1,2007-12-17,24,12,12,0.5,26,14,12,0.5379999999999999
20700355,1610612739,1610612749,104.0,99.0,0.4,0.424,1,2007-12-17,25,11,14,0.44,24,10,14,0.417
20700356,1610612752,1610612754,92.0,119.0,0.38,0.583,0,2007-12-17,24,7,17,0.292,25,13,12,0.52
20700357,1610612748,1610612750,91.0,87.0,0.3720000000000001,0.384,1,2007-12-17,24,7,17,0.292,23,3,20,0.13
20700358,1610612763,1610612744,117.0,125.0,0.518,0.534,0,2007-12-17,24,7,17,0.292,25,14,11,0.56
20700359,1610612742,1610612753,111.0,108.0,0.525,0.524,1,2007-12-17,26,17,9,0.654,26,17,9,0.654
20700360,1610612759,1610612756,95.0,100.0,0.4589999999999999,0.4679999999999999,0,2007-12-17,24,18,6,0.75,25,18,7,0.72
20700361,1610612757,1610612740,88.0,76.0,0.418,0.408,1,2007-12-17,25,13,12,0.52,25,15,10,0.6
20700350,1610612765,1610612744,109.0,87.0,0.506,0.418,1,2007-12-16,24,17,7,0.708,24,13,11,0.542
20700351,1610612761,1610612738,77.0,90.0,0.389,0.493,0,2007-12-16,25,14,11,0.56,22,20,2,0.909
20700352,1610612743,1610612757,105.0,116.0,0.487,0.545,0,2007-12-16,24,14,10,0.583,24,12,12,0.5
20700353,1610612747,1610612746,113.0,92.0,0.537,0.3879999999999999,1,2007-12-16,23,14,9,0.609,23,9,14,0.391
20700339,1610612764,1610612758,92.0,79.0,0.42,0.433,1,2007-12-15,23,13,10,0.565,23,9,14,0.391
20700340,1610612737,1610612766,93.0,84.0,0.485,0.485,1,2007-12-15,23,11,12,0.478,22,8,14,0.364
20700341,1610612753,1610612763,119.0,123.0,0.512,0.529,0,2007-12-15,25,17,8,0.68,23,7,16,0.304
20700342,1610612752,1610612751,94.0,86.0,0.421,0.4629999999999999,1,2007-12-15,23,7,16,0.304,24,10,14,0.417
20700343,1610612748,1610612754,103.0,106.0,0.467,0.447,0,2007-12-15,23,6,17,0.261,24,12,12,0.5
20700344,1610612739,1610612755,86.0,92.0,0.4270000000000001,0.386,0,2007-12-15,24,10,14,0.417,24,10,14,0.417
20700345,1610612740,1610612756,101.0,98.0,0.407,0.475,1,2007-12-15,24,15,9,0.625,24,17,7,0.708
20700346,1610612749,1610612750,95.0,92.0,0.429,0.4629999999999999,1,2007-12-15,23,10,13,0.435,22,3,19,0.136
20700347,1610612745,1610612742,83.0,96.0,0.408,0.507,0,2007-12-15,24,12,12,0.5,25,16,9,0.64
20700348,1610612759,1610612743,102.0,91.0,0.488,0.474,1,2007-12-15,23,18,5,0.7829999999999999,23,14,9,0.609
20700349,1610612762,1610612760,96.0,75.0,0.493,0.3289999999999999,1,2007-12-15,25,14,11,0.56,25,7,18,0.28
20700327,1610612755,1610612758,99.0,109.0,0.514,0.537,0,2007-12-14,23,9,14,0.391,22,9,13,0.409
20700329,1610612754,1610612761,93.0,104.0,0.433,0.457,0,2007-12-14,23,11,12,0.478,24,14,10,0.583
20700330,1610612738,1610612749,104.0,82.0,0.467,0.43,1,2007-12-14,21,19,2,0.905,22,9,13,0.409
20700328,1610612766,1610612753,87.0,103.0,0.456,0.536,0,2007-12-14,21,8,13,0.381,24,17,7,0.708
20700331,1610612751,1610612739,105.0,97.0,0.487,0.469,1,2007-12-14,23,10,13,0.435,23,10,13,0.435
20700332,1610612765,1610612737,91.0,81.0,0.452,0.355,1,2007-12-14,23,16,7,0.696,22,10,12,0.455
20700333,1610612763,1610612746,91.0,98.0,0.405,0.4320000000000001,0,2007-12-14,22,6,16,0.273,22,9,13,0.409
20700334,1610612750,1610612760,88.0,99.0,0.3929999999999999,0.435,0,2007-12-14,21,3,18,0.143,24,7,17,0.292
20700335,1610612741,1610612752,101.0,96.0,0.47,0.414,1,2007-12-14,21,8,13,0.381,22,6,16,0.273
20700336,1610612742,1610612740,89.0,80.0,0.473,0.357,1,2007-12-14,24,15,9,0.625,23,14,9,0.609
20700337,1610612757,1610612762,99.0,91.0,0.441,0.3939999999999999,1,2007-12-14,23,11,12,0.478,24,13,11,0.542
20700338,1610612744,1610612747,108.0,106.0,0.444,0.424,1,2007-12-14,23,13,10,0.565,22,13,9,0.591
20700325,1610612748,1610612764,91.0,104.0,0.466,0.456,0,2007-12-13,22,6,16,0.273,22,12,10,0.545
20700326,1610612747,1610612759,102.0,97.0,0.4320000000000001,0.41,1,2007-12-13,21,13,8,0.619,22,17,5,0.773
20700314,1610612761,1610612742,92.0,76.0,0.434,0.385,1,2007-12-12,23,13,10,0.565,23,14,9,0.609
20700315,1610612755,1610612750,98.0,94.0,0.4589999999999999,0.444,1,2007-12-12,22,9,13,0.409,20,3,17,0.15
20700316,1610612766,1610612746,108.0,103.0,0.5,0.449,1,2007-12-12,20,8,12,0.4,21,8,13,0.381
20700317,1610612754,1610612741,117.0,102.0,0.557,0.4270000000000001,1,2007-12-12,22,11,11,0.5,20,7,13,0.35
20700318,1610612738,1610612758,90.0,78.0,0.391,0.4429999999999999,1,2007-12-12,20,18,2,0.9,21,8,13,0.381
20700319,1610612752,1610612760,110.0,117.0,0.474,0.58,0,2007-12-12,21,6,15,0.286,23,6,17,0.261
20700320,1610612749,1610612753,100.0,86.0,0.5,0.3379999999999999,1,2007-12-12,21,9,12,0.429,23,16,7,0.696
20700321,1610612745,1610612765,80.0,77.0,0.4589999999999999,0.361,1,2007-12-12,23,12,11,0.522,22,15,7,0.682
20700322,1610612743,1610612740,105.0,99.0,0.4639999999999999,0.471,1,2007-12-12,22,14,8,0.636,22,14,8,0.636
20700323,1610612757,1610612744,105.0,95.0,0.4629999999999999,0.402,1,2007-12-12,22,10,12,0.455,22,12,10,0.545
20700324,1610612756,1610612762,103.0,98.0,0.46,0.4379999999999999,1,2007-12-12,23,17,6,0.7390000000000001,23,13,10,0.565
20700306,1610612764,1610612750,102.0,88.0,0.424,0.407,1,2007-12-11,21,11,10,0.524,19,3,16,0.158
20700307,1610612737,1610612761,88.0,100.0,0.3879999999999999,0.45,0,2007-12-11,21,10,11,0.476,22,12,10,0.545
20700308,1610612739,1610612754,118.0,105.0,0.547,0.4629999999999999,1,2007-12-11,22,10,12,0.455,21,10,11,0.476
20700309,1610612751,1610612746,82.0,91.0,0.321,0.446,0,2007-12-11,22,9,13,0.409,20,8,12,0.4
20700310,1610612763,1610612765,103.0,113.0,0.4679999999999999,0.506,0,2007-12-11,21,6,15,0.286,21,15,6,0.7140000000000001
20700311,1610612741,1610612760,123.0,96.0,0.537,0.494,1,2007-12-11,19,7,12,0.368,22,5,17,0.2269999999999999
20700312,1610612762,1610612757,89.0,97.0,0.386,0.478,0,2007-12-11,22,13,9,0.591,21,9,12,0.429
20700313,1610612744,1610612759,96.0,84.0,0.392,0.385,1,2007-12-11,21,12,9,0.5710000000000001,21,17,4,0.81
20700301,1610612755,1610612745,100.0,88.0,0.512,0.411,1,2007-12-10,21,8,13,0.381,22,11,11,0.5
20700302,1610612753,1610612737,87.0,98.0,0.397,0.4270000000000001,0,2007-12-10,22,16,6,0.727,20,10,10,0.5
20700303,1610612752,1610612742,89.0,99.0,0.402,0.537,0,2007-12-10,20,6,14,0.3,22,14,8,0.636
20700304,1610612756,1610612748,113.0,117.0,0.484,0.588,0,2007-12-10,22,16,6,0.727,21,6,15,0.286
20700305,1610612758,1610612749,96.0,93.0,0.462,0.429,1,2007-12-10,20,8,12,0.4,20,8,12,0.4
20700294,1610612761,1610612745,93.0,80.0,0.419,0.4,1,2007-12-09,21,11,10,0.524,21,11,10,0.524
20700295,1610612746,1610612748,94.0,100.0,0.4629999999999999,0.506,0,2007-12-09,19,7,12,0.368,20,5,15,0.25
20700296,1610612765,1610612766,104.0,85.0,0.471,0.43,1,2007-12-09,20,14,6,0.7,19,7,12,0.368
20700297,1610612757,1610612749,117.0,113.0,0.563,0.435,1,2007-12-09,20,8,12,0.4,19,8,11,0.421
20700298,1610612764,1610612751,104.0,89.0,0.412,0.486,1,2007-12-09,20,10,10,0.5,21,9,12,0.429
20700299,1610612740,1610612760,91.0,88.0,0.457,0.3779999999999999,1,2007-12-09,21,14,7,0.667,21,5,16,0.238
20700300,1610612747,1610612744,123.0,113.0,0.531,0.4629999999999999,1,2007-12-09,20,12,8,0.6,20,11,9,0.55
20700287,1610612766,1610612739,96.0,93.0,0.4379999999999999,0.457,1,2007-12-08,18,7,11,0.389,21,9,12,0.429
20700288,1610612737,1610612763,86.0,78.0,0.405,0.41,1,2007-12-08,19,9,10,0.474,20,6,14,0.3
20700289,1610612752,1610612755,77.0,105.0,0.357,0.531,0,2007-12-08,19,6,13,0.316,20,7,13,0.35
20700290,1610612750,1610612756,100.0,93.0,0.444,0.4579999999999999,1,2007-12-08,18,3,15,0.1669999999999999,21,16,5,0.762
20700291,1610612741,1610612738,81.0,92.0,0.36,0.516,0,2007-12-08,18,6,12,0.3329999999999999,19,17,2,0.895
20700292,1610612742,1610612762,125.0,117.0,0.597,0.605,1,2007-12-08,21,13,8,0.619,21,13,8,0.619
20700293,1610612743,1610612758,101.0,97.0,0.462,0.444,1,2007-12-08,21,13,8,0.619,19,7,12,0.368
20700276,1610612755,1610612752,101.0,90.0,0.488,0.43,1,2007-12-07,19,6,13,0.316,18,6,12,0.3329999999999999
20700277,1610612764,1610612756,107.0,122.0,0.474,0.5489999999999999,0,2007-12-07,19,9,10,0.474,20,16,4,0.8
20700278,1610612753,1610612754,109.0,115.0,0.4320000000000001,0.4529999999999999,0,2007-12-07,21,16,5,0.762,20,10,10,0.5
20700279,1610612765,1610612741,91.0,98.0,0.395,0.4379999999999999,0,2007-12-07,19,13,6,0.684,17,6,11,0.353
20700280,1610612738,1610612761,112.0,84.0,0.527,0.425,1,2007-12-07,18,16,2,0.889,20,10,10,0.5
20700281,1610612751,1610612745,89.0,96.0,0.422,0.467,0,2007-12-07,20,9,11,0.45,20,11,9,0.55
20700282,1610612740,1610612763,118.0,116.0,0.455,0.55,1,2007-12-07,20,13,7,0.65,19,6,13,0.316
20700283,1610612759,1610612762,104.0,98.0,0.4379999999999999,0.542,1,2007-12-07,20,17,3,0.85,20,13,7,0.65
20700284,1610612758,1610612746,87.0,97.0,0.38,0.479,0,2007-12-07,18,7,11,0.389,18,7,11,0.389
20700285,1610612744,1610612748,120.0,113.0,0.415,0.494,1,2007-12-07,19,11,8,0.579,19,4,15,0.211
20700286,1610612760,1610612749,104.0,98.0,0.44,0.374,1,2007-12-07,20,5,15,0.25,18,8,10,0.444
20700273,1610612737,1610612750,90.0,89.0,0.405,0.389,1,2007-12-06,18,8,10,0.444,17,2,15,0.118
20700274,1610612742,1610612743,109.0,122.0,0.414,0.505,0,2007-12-06,20,12,8,0.6,20,12,8,0.6
20700275,1610612757,1610612748,112.0,106.0,0.506,0.512,1,2007-12-06,19,7,12,0.368,18,4,14,0.222
20700262,1610612761,1610612756,123.0,136.0,0.5539999999999999,0.589,0,2007-12-05,19,10,9,0.526,19,15,4,0.789
20700263,1610612755,1610612738,103.0,113.0,0.557,0.526,0,2007-12-05,18,5,13,0.278,17,15,2,0.882
20700264,1610612764,1610612739,105.0,86.0,0.53,0.4320000000000001,1,2007-12-05,18,9,9,0.5,20,9,11,0.45
20700265,1610612766,1610612741,82.0,91.0,0.408,0.478,0,2007-12-05,17,6,11,0.353,16,5,11,0.313
20700266,1610612751,1610612752,93.0,100.0,0.4429999999999999,0.485,0,2007-12-05,19,9,10,0.474,17,6,11,0.353
20700267,1610612740,1610612765,76.0,91.0,0.347,0.412,0,2007-12-05,19,12,7,0.632,18,13,5,0.722
20700268,1610612745,1610612763,105.0,92.0,0.506,0.43,1,2007-12-05,19,10,9,0.526,18,6,12,0.3329999999999999
20700269,1610612759,1610612742,97.0,95.0,0.456,0.449,1,2007-12-05,19,16,3,0.8420000000000001,19,12,7,0.632
20700270,1610612743,1610612747,107.0,111.0,0.45,0.476,0,2007-12-05,19,11,8,0.579,19,11,8,0.579
20700271,1610612744,1610612749,120.0,90.0,0.523,0.402,1,2007-12-05,18,10,8,0.556,17,8,9,0.471
20700272,1610612760,1610612746,95.0,88.0,0.461,0.346,1,2007-12-05,19,4,15,0.211,17,6,11,0.353
20700256,1610612737,1610612765,95.0,106.0,0.4320000000000001,0.519,0,2007-12-04,17,7,10,0.412,17,12,5,0.706
20700257,1610612739,1610612751,79.0,100.0,0.346,0.515,0,2007-12-04,19,9,10,0.474,18,9,9,0.5
20700258,1610612754,1610612756,117.0,121.0,0.471,0.495,0,2007-12-04,19,9,10,0.474,18,14,4,0.778
20700259,1610612750,1610612747,95.0,116.0,0.444,0.5429999999999999,0,2007-12-04,16,2,14,0.125,18,10,8,0.556
20700260,1610612758,1610612762,117.0,107.0,0.5,0.472,1,2007-12-04,17,7,10,0.412,19,13,6,0.684
20700261,1610612746,1610612749,78.0,87.0,0.387,0.44,0,2007-12-04,16,6,10,0.375,16,8,8,0.5
20700250,1610612761,1610612766,98.0,79.0,0.507,0.3329999999999999,1,2007-12-03,18,10,8,0.556,16,6,10,0.375
20700251,1610612755,1610612737,79.0,88.0,0.4,0.446,0,2007-12-03,17,5,12,0.294,16,7,9,0.4379999999999999
20700252,1610612763,1610612757,105.0,106.0,0.465,0.512,0,2007-12-03,17,6,11,0.353,18,6,12,0.3329999999999999
20700253,1610612741,1610612742,98.0,103.0,0.345,0.486,0,2007-12-03,15,4,11,0.267,18,12,6,0.667
20700254,1610612762,1610612748,110.0,101.0,0.5379999999999999,0.5329999999999999,1,2007-12-03,18,13,5,0.722,17,4,13,0.235
20700255,1610612744,1610612753,117.0,123.0,0.3779999999999999,0.479,0,2007-12-03,17,9,8,0.529,20,16,4,0.8
20700242,1610612738,1610612739,80.0,70.0,0.375,0.3289999999999999,1,2007-12-02,16,14,2,0.875,18,9,9,0.5
20700243,1610612759,1610612757,100.0,79.0,0.487,0.4,1,2007-12-02,18,15,3,0.833,17,5,12,0.294
20700244,1610612746,1610612754,95.0,101.0,0.442,0.416,0,2007-12-02,15,6,9,0.4,18,9,9,0.5
20700246,1610612765,1610612751,118.0,95.0,0.563,0.455,1,2007-12-02,16,11,5,0.688,17,8,9,0.471
20700245,1610612752,1610612756,104.0,115.0,0.465,0.583,0,2007-12-02,16,5,11,0.313,17,13,4,0.765
20700247,1610612743,1610612748,115.0,89.0,0.489,0.375,1,2007-12-02,18,11,7,0.611,16,4,12,0.25
20700248,1610612760,1610612744,96.0,109.0,0.414,0.4270000000000001,0,2007-12-02,18,3,15,0.1669999999999999,16,9,7,0.563
20700249,1610612747,1610612753,97.0,104.0,0.412,0.4320000000000001,0,2007-12-02,17,9,8,0.529,19,15,4,0.789
20700235,1610612764,1610612761,101.0,97.0,0.565,0.4320000000000001,1,2007-12-01,17,8,9,0.471,17,9,8,0.529
20700236,1610612751,1610612755,94.0,92.0,0.405,0.419,1,2007-12-01,16,8,8,0.5,16,5,11,0.313
20700237,1610612763,1610612750,109.0,80.0,0.494,0.384,1,2007-12-01,16,6,10,0.375,15,2,13,0.133
20700238,1610612740,1610612742,112.0,108.0,0.4370000000000001,0.433,1,2007-12-01,18,12,6,0.667,17,11,6,0.647
20700239,1610612741,1610612766,111.0,95.0,0.5429999999999999,0.493,1,2007-12-01,14,4,10,0.286,15,6,9,0.4
20700240,1610612749,1610612765,91.0,117.0,0.557,0.512,0,2007-12-01,15,7,8,0.467,15,10,5,0.667
20700241,1610612758,1610612745,107.0,99.0,0.4479999999999999,0.4270000000000001,1,2007-12-01,16,6,10,0.375,18,9,9,0.5
20700224,1610612761,1610612739,91.0,82.0,0.479,0.39,1,2007-11-30,16,9,7,0.563,17,9,8,0.529
20700225,1610612755,1610612764,85.0,84.0,0.3879999999999999,0.418,1,2007-11-30,15,5,10,0.3329999999999999,16,7,9,0.4379999999999999
20700226,1610612752,1610612749,91.0,88.0,0.474,0.462,1,2007-11-30,15,5,10,0.3329999999999999,14,7,7,0.5
20700227,1610612737,1610612740,86.0,92.0,0.456,0.407,0,2007-11-30,15,6,9,0.4,17,11,6,0.647
20700228,1610612748,1610612738,85.0,95.0,0.457,0.397,0,2007-11-30,15,4,11,0.267,15,13,2,0.867
20700229,1610612750,1610612759,91.0,106.0,0.457,0.526,0,2007-11-30,14,2,12,0.143,17,14,3,0.8240000000000001
20700230,1610612742,1610612757,91.0,80.0,0.451,0.4320000000000001,1,2007-11-30,16,11,5,0.688,16,5,11,0.313
20700232,1610612756,1610612753,110.0,106.0,0.494,0.46,1,2007-11-30,16,12,4,0.75,18,14,4,0.778
20700231,1610612762,1610612747,120.0,96.0,0.511,0.442,1,2007-11-30,17,12,5,0.706,16,9,7,0.563
20700233,1610612743,1610612746,123.0,107.0,0.541,0.4679999999999999,1,2007-11-30,17,10,7,0.588,14,6,8,0.429
20700234,1610612760,1610612754,95.0,93.0,0.4270000000000001,0.359,1,2007-11-30,17,3,14,0.176,17,8,9,0.471
20700221,1610612738,1610612752,104.0,59.0,0.4679999999999999,0.303,1,2007-11-29,14,12,2,0.857,14,4,10,0.286
20700222,1610612747,1610612743,127.0,99.0,0.505,0.444,1,2007-11-29,15,9,6,0.6,16,9,7,0.563
20700223,1610612744,1610612745,113.0,94.0,0.519,0.446,1,2007-11-29,15,8,7,0.5329999999999999,17,9,8,0.529
20700211,1610612761,1610612763,103.0,91.0,0.512,0.385,1,2007-11-28,15,8,7,0.5329999999999999,15,5,10,0.3329999999999999
20700212,1610612755,1610612762,95.0,106.0,0.429,0.5489999999999999,0,2007-11-28,14,4,10,0.286,16,11,5,0.688
20700213,1610612737,1610612749,96.0,80.0,0.473,0.4429999999999999,1,2007-11-28,14,6,8,0.429,13,7,6,0.5379999999999999
20700214,1610612765,1610612739,109.0,74.0,0.584,0.4,1,2007-11-28,14,9,5,0.643,16,9,7,0.563
20700215,1610612742,1610612750,109.0,103.0,0.5,0.494,1,2007-11-28,15,10,5,0.667,13,2,11,0.154
20700216,1610612759,1610612764,109.0,94.0,0.5660000000000001,0.467,1,2007-11-28,16,13,3,0.813,15,7,8,0.467
20700217,1610612756,1610612745,94.0,100.0,0.415,0.519,0,2007-11-28,15,11,4,0.733,16,9,7,0.563
20700218,1610612758,1610612744,96.0,103.0,0.345,0.416,0,2007-11-28,15,5,10,0.3329999999999999,14,7,7,0.5
20700219,1610612757,1610612754,89.0,95.0,0.4,0.43,0,2007-11-28,15,5,10,0.3329999999999999,16,8,8,0.5
20700220,1610612760,1610612753,94.0,110.0,0.354,0.434,0,2007-11-28,16,2,14,0.125,17,14,3,0.8240000000000001
20700204,1610612739,1610612738,109.0,104.0,0.481,0.43,1,2007-11-27,15,9,6,0.6,13,11,2,0.846
20700205,1610612751,1610612763,103.0,110.0,0.452,0.5,0,2007-11-27,15,7,8,0.467,14,5,9,0.357
20700206,1610612748,1610612766,110.0,90.0,0.58,0.4589999999999999,1,2007-11-27,14,4,10,0.286,14,6,8,0.429
20700207,1610612749,1610612755,99.0,114.0,0.493,0.523,0,2007-11-27,12,7,5,0.583,13,4,9,0.308
20700208,1610612741,1610612737,90.0,78.0,0.3979999999999999,0.397,1,2007-11-27,13,3,10,0.231,13,5,8,0.385
20700209,1610612743,1610612754,110.0,112.0,0.361,0.484,0,2007-11-27,15,9,6,0.6,15,7,8,0.467
20700210,1610612747,1610612760,106.0,99.0,0.456,0.418,1,2007-11-27,14,8,6,0.5710000000000001,15,2,13,0.133
20700197,1610612752,1610612762,113.0,109.0,0.532,0.506,1,2007-11-26,13,4,9,0.308,15,10,5,0.667
20700198,1610612740,1610612750,94.0,103.0,0.419,0.52,0,2007-11-26,16,10,6,0.625,12,2,10,0.1669999999999999
20700199,1610612742,1610612764,98.0,110.0,0.3929999999999999,0.507,0,2007-11-26,14,9,5,0.643,14,7,7,0.5
20700200,1610612758,1610612759,112.0,99.0,0.551,0.4479999999999999,1,2007-11-26,14,5,9,0.357,15,12,3,0.8
20700201,1610612757,1610612753,74.0,85.0,0.39,0.412,0,2007-11-26,14,5,9,0.357,16,13,3,0.813
20700202,1610612746,1610612745,71.0,88.0,0.3289999999999999,0.4370000000000001,0,2007-11-26,13,6,7,0.462,15,8,7,0.5329999999999999
20700203,1610612744,1610612756,129.0,114.0,0.515,0.489,1,2007-11-26,13,6,7,0.462,14,11,3,0.7859999999999999
20700192,1610612761,1610612741,93.0,78.0,0.43,0.38,1,2007-11-25,14,7,7,0.5,12,2,10,0.1669999999999999
20700194,1610612765,1610612762,93.0,103.0,0.395,0.52,0,2007-11-25,13,8,5,0.615,14,10,4,0.7140000000000001
20700193,1610612754,1610612739,106.0,111.0,0.4320000000000001,0.465,0,2007-11-25,14,6,8,0.429,14,8,6,0.5710000000000001
20700195,1610612760,1610612759,101.0,116.0,0.526,0.512,0,2007-11-25,14,2,12,0.143,14,12,2,0.857
20700196,1610612747,1610612751,100.0,102.0,0.446,0.467,0,2007-11-25,13,7,6,0.5379999999999999,14,7,7,0.5
20700182,1610612752,1610612741,85.0,78.0,0.3939999999999999,0.345,1,2007-11-24,12,3,9,0.25,11,2,9,0.182
20700183,1610612739,1610612761,111.0,108.0,0.518,0.494,1,2007-11-24,13,7,6,0.5379999999999999,13,6,7,0.462
20700184,1610612755,1610612744,98.0,100.0,0.42,0.396,0,2007-11-24,12,3,9,0.25,12,5,7,0.417
20700185,1610612766,1610612738,95.0,96.0,0.486,0.436,0,2007-11-24,13,6,7,0.462,12,11,1,0.917
20700186,1610612753,1610612748,120.0,99.0,0.56,0.4679999999999999,1,2007-11-24,15,12,3,0.8,13,3,10,0.231
20700187,1610612763,1610612764,124.0,118.0,0.526,0.495,1,2007-11-24,13,4,9,0.308,13,6,7,0.462
20700188,1610612750,1610612737,87.0,94.0,0.472,0.45,0,2007-11-24,11,1,10,0.091,12,5,7,0.417
20700189,1610612745,1610612743,109.0,81.0,0.484,0.354,1,2007-11-24,14,7,7,0.5,14,9,5,0.643
20700190,1610612749,1610612742,97.0,95.0,0.508,0.452,1,2007-11-24,11,7,4,0.636,13,9,4,0.6920000000000001
20700191,1610612746,1610612740,89.0,98.0,0.4,0.4629999999999999,0,2007-11-24,12,6,6,0.5,15,10,5,0.667
20700170,1610612764,1610612744,115.0,123.0,0.512,0.511,0,2007-11-23,12,6,6,0.5,11,4,7,0.364
20700171,1610612753,1610612766,105.0,92.0,0.475,0.411,1,2007-11-23,14,11,3,0.7859999999999999,12,6,6,0.5
20700172,1610612738,1610612747,107.0,94.0,0.506,0.422,1,2007-11-23,11,10,1,0.909,12,7,5,0.583
20700173,1610612748,1610612745,98.0,91.0,0.5539999999999999,0.439,1,2007-11-23,12,3,9,0.25,13,6,7,0.462
20700174,1610612765,1610612755,83.0,78.0,0.415,0.391,1,2007-11-23,12,8,4,0.667,11,3,8,0.273
20700175,1610612754,1610612742,111.0,107.0,0.4479999999999999,0.417,1,2007-11-23,13,6,7,0.462,12,9,3,0.75
20700176,1610612759,1610612763,101.0,88.0,0.489,0.4320000000000001,1,2007-11-23,13,11,2,0.846,12,3,9,0.25
20700177,1610612743,1610612750,99.0,93.0,0.38,0.386,1,2007-11-23,13,9,4,0.6920000000000001,10,1,9,0.1
20700178,1610612762,1610612740,99.0,71.0,0.474,0.3289999999999999,1,2007-11-23,13,9,4,0.6920000000000001,14,9,5,0.643
20700179,1610612756,1610612746,113.0,94.0,0.489,0.412,1,2007-11-23,13,11,2,0.846,11,6,5,0.545
20700180,1610612757,1610612758,87.0,84.0,0.452,0.444,1,2007-11-23,13,5,8,0.385,13,4,9,0.308
20700181,1610612760,1610612751,93.0,98.0,0.479,0.494,0,2007-11-23,13,2,11,0.154,13,6,7,0.462
20700157,1610612766,1610612764,111.0,114.0,0.444,0.4479999999999999,0,2007-11-21,11,6,5,0.545,11,6,5,0.545
20700158,1610612738,1610612744,105.0,82.0,0.481,0.3329999999999999,1,2007-11-21,10,9,1,0.9,10,3,7,0.3
20700159,1610612748,1610612737,79.0,82.0,0.424,0.351,0,2007-11-21,11,2,9,0.182,11,4,7,0.364
20700160,1610612745,1610612742,94.0,100.0,0.4429999999999999,0.4320000000000001,0,2007-11-21,12,6,6,0.5,11,9,2,0.818
20700161,1610612765,1610612752,98.0,86.0,0.487,0.45,1,2007-11-21,11,7,4,0.636,11,2,9,0.182
20700162,1610612749,1610612747,110.0,103.0,0.494,0.431,1,2007-11-21,10,6,4,0.6,11,7,4,0.636
20700163,1610612763,1610612761,89.0,95.0,0.405,0.391,0,2007-11-21,11,3,8,0.273,12,6,6,0.5
20700164,1610612740,1610612754,93.0,105.0,0.391,0.461,0,2007-11-21,13,9,4,0.6920000000000001,12,5,7,0.417
20700165,1610612750,1610612739,86.0,97.0,0.457,0.466,0,2007-11-21,9,1,8,0.111,12,6,6,0.5
20700166,1610612759,1610612753,128.0,110.0,0.516,0.56,1,2007-11-21,12,10,2,0.833,13,10,3,0.769
20700167,1610612756,1610612758,127.0,111.0,0.5329999999999999,0.4529999999999999,1,2007-11-21,12,10,2,0.833,12,4,8,0.3329999999999999
20700168,1610612757,1610612751,101.0,106.0,0.544,0.537,0,2007-11-21,12,4,8,0.3329999999999999,12,5,7,0.417
20700169,1610612746,1610612743,101.0,90.0,0.471,0.391,1,2007-11-21,10,6,4,0.6,12,8,4,0.667
20700149,1610612764,1610612755,116.0,101.0,0.573,0.473,1,2007-11-20,10,5,5,0.5,10,3,7,0.3
20700150,1610612737,1610612759,83.0,95.0,0.418,0.5,0,2007-11-20,10,3,7,0.3,11,9,2,0.818
20700151,1610612739,1610612749,107.0,111.0,0.47,0.475,0,2007-11-20,11,5,6,0.455,9,5,4,0.556
20700152,1610612754,1610612747,114.0,134.0,0.408,0.583,0,2007-11-20,11,4,7,0.364,10,7,3,0.7
20700153,1610612752,1610612744,82.0,108.0,0.392,0.477,0,2007-11-20,10,2,8,0.2,9,3,6,0.3329999999999999
20700154,1610612742,1610612761,105.0,99.0,0.493,0.45,1,2007-11-20,10,8,2,0.8,11,5,6,0.455
20700155,1610612743,1610612741,112.0,91.0,0.506,0.4,1,2007-11-20,11,8,3,0.727,10,2,8,0.2
20700156,1610612758,1610612756,98.0,100.0,0.4429999999999999,0.434,0,2007-11-20,11,4,7,0.364,11,9,2,0.818
20700145,1610612766,1610612757,101.0,92.0,0.47,0.421,1,2007-11-19,10,6,4,0.6,11,4,7,0.364
20700146,1610612763,1610612760,125.0,108.0,0.5579999999999999,0.4479999999999999,1,2007-11-19,10,3,7,0.3,12,2,10,0.1669999999999999
20700147,1610612740,1610612753,88.0,95.0,0.434,0.472,0,2007-11-19,12,9,3,0.75,12,10,2,0.833
20700148,1610612762,1610612751,102.0,75.0,0.522,0.352,1,2007-11-19,12,8,4,0.667,11,4,7,0.364
20700141,1610612761,1610612744,100.0,106.0,0.435,0.471,0,2007-11-18,10,5,5,0.5,8,2,6,0.25
20700142,1610612753,1610612738,104.0,102.0,0.508,0.5329999999999999,1,2007-11-18,11,9,2,0.818,9,8,1,0.889
20700143,1610612758,1610612765,105.0,95.0,0.473,0.486,1,2007-11-18,10,4,6,0.4,10,6,4,0.6
20700144,1610612747,1610612741,106.0,78.0,0.456,0.348,1,2007-11-18,9,6,3,0.667,9,2,7,0.222
20700131,1610612764,1610612757,109.0,90.0,0.449,0.4429999999999999,1,2007-11-17,9,4,5,0.444,10,4,6,0.4
20700132,1610612766,1610612760,100.0,84.0,0.4379999999999999,0.31,1,2007-11-17,9,5,4,0.556,11,2,9,0.182
20700133,1610612754,1610612762,117.0,97.0,0.579,0.47,1,2007-11-17,10,4,6,0.4,11,7,4,0.636
20700134,1610612751,1610612748,87.0,91.0,0.466,0.408,0,2007-11-17,10,4,6,0.4,10,2,8,0.2
20700135,1610612750,1610612740,82.0,100.0,0.419,0.488,0,2007-11-17,8,1,7,0.125,11,9,2,0.818
20700136,1610612749,1610612737,105.0,96.0,0.523,0.476,1,2007-11-17,8,4,4,0.5,9,3,6,0.3329999999999999
20700137,1610612745,1610612756,105.0,115.0,0.3929999999999999,0.623,0,2007-11-17,11,6,5,0.545,10,8,2,0.8
20700138,1610612742,1610612763,108.0,105.0,0.476,0.4639999999999999,1,2007-11-17,9,7,2,0.778,9,2,7,0.222
20700139,1610612743,1610612752,115.0,83.0,0.489,0.381,1,2007-11-17,10,7,3,0.7,9,2,7,0.222
20700140,1610612746,1610612741,73.0,92.0,0.3939999999999999,0.435,0,2007-11-17,9,5,4,0.556,8,2,6,0.25
20700119,1610612761,1610612754,110.0,101.0,0.469,0.439,1,2007-11-16,9,5,4,0.556,9,3,6,0.3329999999999999
20700120,1610612755,1610612757,92.0,88.0,0.507,0.451,1,2007-11-16,9,3,6,0.3329999999999999,9,4,5,0.444
20700121,1610612738,1610612748,92.0,91.0,0.493,0.473,1,2007-11-16,8,8,0,1.0,9,1,8,0.111
20700122,1610612751,1610612753,70.0,95.0,0.298,0.41,0,2007-11-16,9,4,5,0.444,10,8,2,0.8
20700123,1610612737,1610612760,123.0,126.0,0.455,0.475,0,2007-11-16,8,3,5,0.375,10,2,8,0.2
20700124,1610612739,1610612762,99.0,94.0,0.417,0.405,1,2007-11-16,10,5,5,0.5,10,7,3,0.7
20700125,1610612763,1610612740,118.0,120.0,0.505,0.5,0,2007-11-16,8,2,6,0.25,10,8,2,0.8
20700126,1610612759,1610612745,90.0,84.0,0.486,0.507,1,2007-11-16,10,8,2,0.8,10,6,4,0.6
20700127,1610612750,1610612764,89.0,105.0,0.419,0.519,0,2007-11-16,7,1,6,0.143,8,3,5,0.375
20700128,1610612758,1610612752,123.0,118.0,0.477,0.4,1,2007-11-16,9,3,6,0.3329999999999999,8,2,6,0.25
20700129,1610612747,1610612765,103.0,91.0,0.385,0.434,1,2007-11-16,8,5,3,0.625,9,6,3,0.667
20700130,1610612744,1610612746,122.0,105.0,0.5,0.412,1,2007-11-16,7,1,6,0.143,8,5,3,0.625
20700118,1610612756,1610612741,112.0,102.0,0.506,0.424,1,2007-11-15,9,7,2,0.778,7,1,6,0.143
20700117,1610612742,1610612759,105.0,92.0,0.521,0.4,1,2007-11-15,8,6,2,0.75,9,7,2,0.778
20700104,1610612761,1610612762,88.0,92.0,0.385,0.429,0,2007-11-14,8,4,4,0.5,9,7,2,0.778
20700105,1610612764,1610612754,103.0,90.0,0.486,0.3929999999999999,1,2007-11-14,7,2,5,0.286,8,3,5,0.375
20700106,1610612737,1610612766,117.0,109.0,0.597,0.494,1,2007-11-14,7,3,4,0.429,8,4,4,0.5
20700107,1610612739,1610612753,116.0,117.0,0.455,0.477,0,2007-11-14,9,4,5,0.444,9,7,2,0.778
20700108,1610612738,1610612751,91.0,69.0,0.465,0.3329999999999999,1,2007-11-14,7,7,0,1.0,8,4,4,0.5
20700109,1610612748,1610612760,95.0,104.0,0.386,0.493,0,2007-11-14,8,1,7,0.125,9,1,8,0.111
20700110,1610612749,1610612763,102.0,99.0,0.465,0.476,1,2007-11-14,7,3,4,0.429,7,2,5,0.286
20700111,1610612740,1610612755,95.0,76.0,0.479,0.4,1,2007-11-14,9,7,2,0.778,8,2,6,0.25
20700112,1610612750,1610612758,108.0,103.0,0.532,0.5,1,2007-11-14,6,1,5,0.1669999999999999,8,2,6,0.25
20700113,1610612745,1610612747,90.0,93.0,0.353,0.444,0,2007-11-14,9,6,3,0.667,7,4,3,0.5710000000000001
20700114,1610612743,1610612757,110.0,93.0,0.525,0.39,1,2007-11-14,9,6,3,0.667,8,4,4,0.5
20700115,1610612746,1610612752,84.0,81.0,0.365,0.346,1,2007-11-14,7,5,2,0.7140000000000001,7,2,5,0.286
20700116,1610612744,1610612765,104.0,111.0,0.411,0.53,0,2007-11-14,6,0,6,0.0,8,6,2,0.75
20700096,1610612766,1610612748,91.0,76.0,0.43,0.385,1,2007-11-13,7,4,3,0.5710000000000001,7,1,6,0.143
20700097,1610612753,1610612760,103.0,76.0,0.4629999999999999,0.344,1,2007-11-13,8,6,2,0.75,8,0,8,0.0
20700098,1610612754,1610612738,86.0,101.0,0.349,0.425,0,2007-11-13,7,3,4,0.429,6,6,0,1.0
20700099,1610612763,1610612745,105.0,99.0,0.5,0.47,1,2007-11-13,6,2,4,0.3329999999999999,8,6,2,0.75
20700100,1610612742,1610612755,99.0,84.0,0.446,0.402,1,2007-11-13,7,5,2,0.7140000000000001,7,2,5,0.286
20700101,1610612759,1610612747,107.0,92.0,0.44,0.439,1,2007-11-13,8,7,1,0.875,6,3,3,0.5
20700102,1610612756,1610612752,113.0,102.0,0.562,0.465,1,2007-11-13,8,6,2,0.75,6,2,4,0.3329999999999999
20700103,1610612757,1610612765,102.0,94.0,0.5479999999999999,0.44,1,2007-11-13,7,4,3,0.5710000000000001,7,5,2,0.7140000000000001
20700093,1610612751,1610612740,82.0,84.0,0.408,0.421,0,2007-11-12,7,4,3,0.5710000000000001,8,6,2,0.75
20700094,1610612743,1610612739,122.0,100.0,0.55,0.419,1,2007-11-12,8,5,3,0.625,8,4,4,0.5
20700095,1610612762,1610612758,117.0,93.0,0.5,0.449,1,2007-11-12,8,6,2,0.75,7,2,5,0.286
20700086,1610612737,1610612764,90.0,101.0,0.39,0.4320000000000001,0,2007-11-11,6,2,4,0.3329999999999999,6,1,5,0.1669999999999999
20700087,1610612752,1610612748,72.0,75.0,0.373,0.4379999999999999,0,2007-11-11,5,2,3,0.4,6,1,5,0.1669999999999999
20700088,1610612755,1610612740,72.0,93.0,0.405,0.474,0,2007-11-11,6,2,4,0.3329999999999999,7,5,2,0.7140000000000001
20700089,1610612766,1610612745,82.0,85.0,0.397,0.433,0,2007-11-11,6,3,3,0.5,7,6,1,0.857
20700090,1610612759,1610612749,113.0,88.0,0.557,0.415,1,2007-11-11,7,6,1,0.857,6,2,4,0.3329999999999999
20700091,1610612760,1610612765,103.0,107.0,0.43,0.4320000000000001,0,2007-11-11,7,0,7,0.0,6,5,1,0.833
20700092,1610612746,1610612739,95.0,103.0,0.455,0.506,0,2007-11-11,6,4,2,0.667,7,4,3,0.5710000000000001
20700079,1610612753,1610612756,96.0,106.0,0.471,0.479,0,2007-11-10,7,5,2,0.7140000000000001,7,5,2,0.7140000000000001
20700080,1610612754,1610612743,106.0,113.0,0.4379999999999999,0.439,0,2007-11-10,6,3,3,0.5,7,4,3,0.5710000000000001
20700081,1610612751,1610612738,101.0,112.0,0.446,0.456,0,2007-11-10,6,4,2,0.667,5,5,0,1.0
20700082,1610612741,1610612761,71.0,101.0,0.3329999999999999,0.547,0,2007-11-10,6,1,5,0.1669999999999999,7,4,3,0.5710000000000001
20700083,1610612762,1610612763,118.0,94.0,0.5329999999999999,0.471,1,2007-11-10,7,5,2,0.7140000000000001,5,1,4,0.2
20700084,1610612758,1610612750,100.0,93.0,0.405,0.439,1,2007-11-10,6,2,4,0.3329999999999999,5,0,5,0.0
20700085,1610612757,1610612742,91.0,82.0,0.5,0.354,1,2007-11-10,6,3,3,0.5,6,4,2,0.667
20700066,1610612755,1610612761,103.0,105.0,0.455,0.4589999999999999,0,2007-11-09,5,2,3,0.4,6,3,3,0.5
20700067,1610612766,1610612754,96.0,87.0,0.451,0.425,1,2007-11-09,5,3,2,0.6,5,3,2,0.6
20700068,1610612738,1610612737,106.0,83.0,0.603,0.429,1,2007-11-09,4,4,0,1.0,5,2,3,0.4
20700069,1610612752,1610612753,102.0,112.0,0.4429999999999999,0.471,0,2007-11-09,4,2,2,0.5,6,5,1,0.833
20700070,1610612748,1610612756,101.0,106.0,0.489,0.4379999999999999,0,2007-11-09,5,0,5,0.0,6,4,2,0.667
20700071,1610612764,1610612743,92.0,118.0,0.3829999999999999,0.511,0,2007-11-09,5,0,5,0.0,6,3,3,0.5
20700072,1610612765,1610612746,103.0,79.0,0.483,0.351,1,2007-11-09,5,4,1,0.8,5,4,1,0.8
20700073,1610612740,1610612759,85.0,97.0,0.4320000000000001,0.519,0,2007-11-09,6,4,2,0.667,6,5,1,0.833
20700074,1610612745,1610612749,104.0,88.0,0.434,0.381,1,2007-11-09,6,5,1,0.833,5,2,3,0.4
20700075,1610612757,1610612763,110.0,98.0,0.512,0.416,1,2007-11-09,5,2,3,0.4,4,1,3,0.25
20700076,1610612747,1610612750,107.0,93.0,0.474,0.389,1,2007-11-09,5,3,2,0.6,4,0,4,0.0
20700077,1610612758,1610612739,91.0,93.0,0.4,0.38,0,2007-11-09,5,1,4,0.2,6,3,3,0.5
20700078,1610612760,1610612762,101.0,103.0,0.471,0.488,0,2007-11-09,6,0,6,0.0,6,4,2,0.667
20700063,1610612751,1610612764,87.0,85.0,0.389,0.397,1,2007-11-08,5,4,1,0.8,4,0,4,0.0
20700064,1610612741,1610612765,97.0,93.0,0.4589999999999999,0.444,1,2007-11-08,5,1,4,0.2,4,3,1,0.75
20700065,1610612744,1610612742,115.0,120.0,0.494,0.5,0,2007-11-08,5,0,5,0.0,5,4,1,0.8
20700054,1610612761,1610612753,96.0,105.0,0.382,0.5,0,2007-11-07,5,2,3,0.4,5,4,1,0.8
20700055,1610612755,1610612766,94.0,63.0,0.4579999999999999,0.307,1,2007-11-07,4,2,2,0.5,4,2,2,0.5
20700056,1610612737,1610612756,105.0,96.0,0.456,0.407,1,2007-11-07,4,2,2,0.5,5,3,2,0.6
20700057,1610612754,1610612746,89.0,104.0,0.386,0.41,0,2007-11-07,4,3,1,0.75,4,4,0,1.0
20700058,1610612738,1610612743,119.0,93.0,0.645,0.4589999999999999,1,2007-11-07,3,3,0,1.0,5,2,3,0.4
20700059,1610612759,1610612748,88.0,78.0,0.479,0.431,1,2007-11-07,5,4,1,0.8,4,0,4,0.0
20700061,1610612760,1610612763,98.0,105.0,0.4589999999999999,0.376,0,2007-11-07,5,0,5,0.0,3,1,2,0.3329999999999999
20700060,1610612762,1610612739,103.0,101.0,0.4589999999999999,0.435,1,2007-11-07,5,3,2,0.6,5,2,3,0.4
20700062,1610612757,1610612740,93.0,90.0,0.407,0.391,1,2007-11-07,4,1,3,0.25,5,4,1,0.8
20700044,1610612766,1610612756,83.0,115.0,0.366,0.5,0,2007-11-06,3,2,1,0.667,4,3,1,0.75
20700045,1610612751,1610612737,87.0,82.0,0.436,0.382,1,2007-11-06,4,3,1,0.75,3,1,2,0.3329999999999999
20700046,1610612752,1610612743,119.0,112.0,0.527,0.5,1,2007-11-06,3,2,1,0.667,4,2,2,0.5
20700047,1610612749,1610612761,112.0,85.0,0.603,0.416,1,2007-11-06,4,2,2,0.5,4,2,2,0.5
20700048,1610612750,1610612753,103.0,111.0,0.494,0.479,0,2007-11-06,3,0,3,0.0,4,3,1,0.75
20700049,1610612741,1610612746,91.0,97.0,0.357,0.456,0,2007-11-06,4,0,4,0.0,3,3,0,1.0
20700050,1610612745,1610612759,89.0,81.0,0.407,0.4639999999999999,1,2007-11-06,5,4,1,0.8,4,3,1,0.75
20700051,1610612758,1610612760,104.0,98.0,0.449,0.481,1,2007-11-06,4,1,3,0.25,4,0,4,0.0
20700052,1610612747,1610612740,104.0,118.0,0.473,0.472,0,2007-11-06,4,2,2,0.5,4,4,0,1.0
20700053,1610612744,1610612739,104.0,108.0,0.429,0.471,0,2007-11-06,4,0,4,0.0,4,2,2,0.5
20700043,1610612742,1610612745,107.0,98.0,0.4679999999999999,0.42,1,2007-11-05,4,3,1,0.75,4,3,1,0.75
20700035,1610612761,1610612738,95.0,98.0,0.3670000000000001,0.442,0,2007-11-04,3,2,1,0.667,2,2,0,1.0
20700036,1610612746,1610612760,115.0,101.0,0.461,0.47,1,2007-11-04,2,2,0,1.0,3,0,3,0.0
20700037,1610612752,1610612750,97.0,93.0,0.477,0.4479999999999999,1,2007-11-04,2,1,1,0.5,2,0,2,0.0
20700038,1610612748,1610612766,88.0,90.0,0.44,0.4639999999999999,0,2007-11-04,3,0,3,0.0,2,2,0,1.0
20700039,1610612765,1610612737,92.0,91.0,0.457,0.4579999999999999,1,2007-11-04,3,3,0,1.0,2,1,1,0.5
20700040,1610612743,1610612740,88.0,93.0,0.3670000000000001,0.384,0,2007-11-04,3,2,1,0.667,3,3,0,1.0
20700041,1610612756,1610612739,103.0,92.0,0.449,0.4429999999999999,1,2007-11-04,3,2,1,0.667,3,1,2,0.3329999999999999
20700042,1610612747,1610612762,119.0,109.0,0.5579999999999999,0.488,1,2007-11-04,3,2,1,0.667,4,2,2,0.5
20700028,1610612755,1610612751,88.0,93.0,0.395,0.412,0,2007-11-03,3,1,2,0.3329999999999999,3,2,1,0.667
20700029,1610612764,1610612753,82.0,94.0,0.348,0.429,0,2007-11-03,3,0,3,0.0,3,2,1,0.667
20700030,1610612763,1610612754,111.0,121.0,0.485,0.528,0,2007-11-03,2,0,2,0.0,3,3,0,1.0
20700031,1610612749,1610612741,78.0,72.0,0.3289999999999999,0.351,1,2007-11-03,3,1,2,0.3329999999999999,3,0,3,0.0
20700032,1610612745,1610612757,89.0,80.0,0.396,0.408,1,2007-11-03,3,3,0,1.0,3,0,3,0.0
20700033,1610612742,1610612758,123.0,102.0,0.652,0.5,1,2007-11-03,3,2,1,0.667,3,0,3,0.0
20700034,1610612762,1610612744,133.0,110.0,0.63,0.506,1,2007-11-03,3,2,1,0.667,3,0,3,0.0
20700015,1610612766,1610612749,102.0,99.0,0.487,0.483,1,2007-11-02,1,1,0,1.0,2,0,2,0.0
20700016,1610612753,1610612765,92.0,116.0,0.4029999999999999,0.589,0,2007-11-02,2,1,1,0.5,2,2,0,1.0
20700017,1610612754,1610612748,87.0,85.0,0.3979999999999999,0.375,1,2007-11-02,2,2,0,1.0,2,0,2,0.0
20700018,1610612751,1610612761,69.0,106.0,0.368,0.506,0,2007-11-02,2,1,1,0.5,2,2,0,1.0
20700019,1610612737,1610612742,101.0,94.0,0.456,0.4379999999999999,1,2007-11-02,1,1,0,1.0,2,1,1,0.5
20700020,1610612739,1610612752,110.0,106.0,0.469,0.462,1,2007-11-02,2,1,1,0.5,1,0,1,0.0
20700021,1610612738,1610612764,103.0,83.0,0.481,0.35,1,2007-11-02,1,1,0,1.0,2,0,2,0.0
20700022,1610612740,1610612757,113.0,93.0,0.564,0.482,1,2007-11-02,2,2,0,1.0,2,0,2,0.0
20700023,1610612750,1610612743,91.0,99.0,0.3979999999999999,0.466,0,2007-11-02,1,0,1,0.0,2,2,0,1.0
20700024,1610612741,1610612755,85.0,96.0,0.384,0.422,0,2007-11-02,2,0,2,0.0,2,1,1,0.5
20700025,1610612759,1610612758,96.0,80.0,0.413,0.387,1,2007-11-02,3,3,0,1.0,2,0,2,0.0
20700026,1610612756,1610612747,98.0,119.0,0.425,0.565,0,2007-11-02,2,1,1,0.5,2,1,1,0.5
20700027,1610612746,1610612744,120.0,114.0,0.482,0.4679999999999999,1,2007-11-02,1,1,0,1.0,2,0,2,0.0
20700012,1610612748,1610612765,80.0,91.0,0.44,0.3879999999999999,0,2007-11-01,1,0,1,0.0,1,1,0,1.0
20700013,1610612762,1610612745,95.0,106.0,0.444,0.487,0,2007-11-01,2,1,1,0.5,2,2,0,1.0
20700014,1610612760,1610612756,99.0,106.0,0.414,0.5,0,2007-11-01,2,0,2,0.0,1,1,0,1.0
20700004,1610612761,1610612755,106.0,97.0,0.482,0.4629999999999999,1,2007-10-31,1,1,0,1.0,1,0,1,0.0
20700005,1610612753,1610612749,102.0,83.0,0.4379999999999999,0.379,1,2007-10-31,1,1,0,1.0,1,0,1,0.0
20700006,1610612754,1610612764,119.0,110.0,0.413,0.364,1,2007-10-31,1,1,0,1.0,1,0,1,0.0
20700007,1610612751,1610612741,112.0,103.0,0.402,0.396,1,2007-10-31,1,1,0,1.0,1,0,1,0.0
20700008,1610612739,1610612742,74.0,92.0,0.364,0.478,0,2007-10-31,1,0,1,0.0,1,1,0,1.0
20700009,1610612763,1610612759,101.0,104.0,0.475,0.4370000000000001,0,2007-10-31,1,0,1,0.0,2,2,0,1.0
20700010,1610612740,1610612758,104.0,90.0,0.506,0.444,1,2007-10-31,1,1,0,1.0,1,0,1,0.0
20700011,1610612743,1610612760,120.0,103.0,0.462,0.417,1,2007-10-31,1,1,0,1.0,1,0,1,0.0
20700001,1610612759,1610612757,106.0,97.0,0.471,0.5,1,2007-10-30,1,1,0,1.0,1,0,1,0.0
20700002,1610612747,1610612745,93.0,95.0,0.421,0.4589999999999999,0,2007-10-30,1,0,1,0.0,1,1,0,1.0
20700003,1610612744,1610612762,96.0,117.0,0.416,0.456,0,2007-10-30,1,0,1,0.0,1,1,0,1.0
10700104,1610612761,1610612739,111.0,78.0,0.471,0.412,1,2007-10-25,6,4,2,0.667,6,1,5,0.1669999999999999
10700105,1610612753,1610612759,99.0,90.0,0.513,0.4320000000000001,1,2007-10-25,7,6,1,0.857,6,4,2,0.667
10700108,1610612751,1610612755,83.0,91.0,0.415,0.402,0,2007-10-25,5,3,2,0.6,6,2,4,0.3329999999999999
10700109,1610612741,1610612749,97.0,81.0,0.494,0.433,1,2007-10-25,7,4,3,0.5710000000000001,7,3,4,0.429
10700106,1610612756,1610612743,116.0,113.0,0.477,0.447,1,2007-10-25,7,5,2,0.7140000000000001,7,4,3,0.5710000000000001
10700101,1610612752,1610612755,103.0,90.0,0.515,0.397,1,2007-10-24,5,3,2,0.6,5,1,4,0.2
10700102,1610612765,1610612764,104.0,85.0,0.472,0.3979999999999999,1,2007-10-24,8,4,4,0.5,7,4,3,0.5710000000000001
10700098,1610612763,1610612745,96.0,90.0,0.449,0.451,1,2007-10-24,7,5,2,0.7140000000000001,6,3,3,0.5
10700099,1610612740,1610612737,98.0,107.0,0.397,0.447,0,2007-10-24,7,3,4,0.429,8,7,1,0.875
10700100,1610612757,1610612760,109.0,107.0,0.4529999999999999,0.512,1,2007-10-24,6,4,2,0.667,7,1,6,0.143
10700103,1610612746,1610612758,92.0,90.0,0.47,0.387,1,2007-10-24,7,4,3,0.5710000000000001,7,3,4,0.429
10700094,1610612751,1610612738,82.0,71.0,0.412,0.3289999999999999,1,2007-10-23,4,3,1,0.75,6,3,3,0.5
10700095,1610612748,1610612759,87.0,104.0,0.467,0.451,0,2007-10-23,7,0,7,0.0,5,4,1,0.8
10700090,1610612750,1610612754,95.0,106.0,0.406,0.4679999999999999,0,2007-10-23,7,2,5,0.286,7,5,2,0.7140000000000001
10700096,1610612745,1610612763,107.0,109.0,0.434,0.4270000000000001,0,2007-10-23,5,3,2,0.6,6,4,2,0.667
10700097,1610612742,1610612741,96.0,88.0,0.42,0.405,1,2007-10-23,8,5,3,0.625,6,3,3,0.5
10700091,1610612743,1610612749,114.0,102.0,0.486,0.407,1,2007-10-23,6,4,2,0.667,6,3,3,0.5
10700092,1610612747,1610612762,81.0,102.0,0.397,0.439,0,2007-10-23,6,2,4,0.3329999999999999,7,4,3,0.5710000000000001
10700093,1610612760,1610612744,122.0,126.0,0.41,0.47,0,2007-10-23,6,1,5,0.1669999999999999,6,4,2,0.667
10700088,1610612737,1610612764,103.0,99.0,0.4679999999999999,0.43,1,2007-10-22,7,6,1,0.857,6,4,2,0.667
10700089,1610612752,1610612738,94.0,87.0,0.405,0.364,1,2007-10-22,4,2,2,0.5,5,3,2,0.6
10700084,1610612766,1610612756,88.0,98.0,0.422,0.43,0,2007-10-21,7,2,5,0.286,6,4,2,0.667
10700086,1610612742,1610612740,103.0,97.0,0.506,0.481,1,2007-10-21,7,4,3,0.5710000000000001,6,3,3,0.5
10700085,1610612758,1610612757,111.0,87.0,0.5,0.389,1,2007-10-21,6,3,3,0.5,5,3,2,0.6
10700087,1610612747,1610612746,96.0,112.0,0.405,0.465,0,2007-10-21,5,2,3,0.4,6,3,3,0.5
10700076,1610612746,1610612756,110.0,103.0,0.5,0.407,1,2007-10-20,5,2,3,0.4,5,3,2,0.6
10700079,1610612738,1610612755,78.0,96.0,0.38,0.462,0,2007-10-20,4,3,1,0.75,4,1,3,0.25
10700077,1610612763,1610612748,104.0,98.0,0.442,0.4589999999999999,1,2007-10-20,5,3,2,0.6,6,0,6,0.0
10700080,1610612741,1610612754,100.0,88.0,0.493,0.3720000000000001,1,2007-10-20,5,3,2,0.6,6,4,2,0.667
10700081,1610612749,1610612750,106.0,97.0,0.42,0.474,1,2007-10-20,5,3,2,0.6,6,2,4,0.3329999999999999
10700082,1610612759,1610612765,104.0,80.0,0.5579999999999999,0.33,1,2007-10-20,4,3,1,0.75,7,3,4,0.429
10700078,1610612760,1610612745,94.0,117.0,0.439,0.455,0,2007-10-20,5,1,4,0.2,4,3,1,0.75
10700083,1610612747,1610612766,113.0,93.0,0.57,0.38,1,2007-10-20,4,2,2,0.5,6,2,4,0.3329999999999999
10700075,1610612753,1610612739,100.0,84.0,0.5379999999999999,0.39,1,2007-10-20,6,5,1,0.833,5,1,4,0.2
10700068,1610612761,1610612741,92.0,82.0,0.486,0.429,1,2007-10-19,5,3,2,0.6,4,2,2,0.5
10700069,1610612754,1610612750,110.0,113.0,0.384,0.409,0,2007-10-19,5,4,1,0.8,5,2,3,0.4
10700072,1610612738,1610612751,36.0,33.0,0.414,0.29,1,2007-10-19,3,3,0,1.0,3,2,1,0.667
10700073,1610612748,1610612740,85.0,92.0,0.461,0.487,0,2007-10-19,5,0,5,0.0,5,3,2,0.6
10700074,1610612742,1610612765,122.0,94.0,0.544,0.4029999999999999,1,2007-10-19,6,3,3,0.5,6,3,3,0.5
10700070,1610612757,1610612758,101.0,77.0,0.474,0.3329999999999999,1,2007-10-19,4,3,1,0.75,5,2,3,0.4
10700063,1610612751,1610612752,110.0,94.0,0.56,0.4,1,2007-10-18,3,2,1,0.667,3,1,2,0.3329999999999999
10700064,1610612745,1610612742,104.0,90.0,0.563,0.434,1,2007-10-18,3,2,1,0.667,5,2,3,0.4
10700065,1610612759,1610612744,116.0,111.0,0.512,0.418,1,2007-10-18,3,2,1,0.667,5,3,2,0.6
10700061,1610612762,1610612758,91.0,105.0,0.4529999999999999,0.5,0,2007-10-18,6,3,3,0.5,4,2,2,0.5
10700062,1610612747,1610612760,126.0,106.0,0.561,0.506,1,2007-10-18,3,1,2,0.3329999999999999,4,1,3,0.25
10700066,1610612746,1610612756,97.0,118.0,0.418,0.517,0,2007-10-18,4,1,3,0.25,4,3,1,0.75
10700060,1610612766,1610612737,98.0,104.0,0.521,0.474,0,2007-10-18,5,2,3,0.4,6,5,1,0.833
10700054,1610612765,1610612743,119.0,110.0,0.48,0.525,1,2007-10-17,5,3,2,0.6,5,3,2,0.6
10700055,1610612754,1610612763,122.0,115.0,0.4039999999999999,0.423,1,2007-10-17,4,4,0,1.0,4,2,2,0.5
10700058,1610612738,1610612752,101.0,61.0,0.563,0.259,1,2007-10-17,3,3,0,1.0,2,1,1,0.5
10700059,1610612739,1610612753,86.0,90.0,0.418,0.385,0,2007-10-17,4,1,3,0.25,4,3,1,0.75
10700056,1610612762,1610612755,101.0,93.0,0.524,0.431,1,2007-10-17,5,3,2,0.6,3,0,3,0.0
10700050,1610612737,1610612750,103.0,77.0,0.486,0.384,1,2007-10-16,5,4,1,0.8,4,1,3,0.25
10700052,1610612749,1610612743,78.0,104.0,0.325,0.462,0,2007-10-16,4,2,2,0.5,4,3,1,0.75
10700051,1610612741,1610612764,97.0,76.0,0.447,0.3229999999999999,1,2007-10-16,3,2,1,0.667,4,3,1,0.75
10700053,1610612758,1610612742,99.0,101.0,0.486,0.4320000000000001,0,2007-10-16,3,1,2,0.3329999999999999,4,2,2,0.5
10700045,1610612766,1610612751,96.0,86.0,0.422,0.408,1,2007-10-15,4,2,2,0.5,2,1,1,0.5
10700046,1610612763,1610612750,101.0,93.0,0.439,0.446,1,2007-10-15,3,2,1,0.667,3,1,2,0.3329999999999999
10700047,1610612740,1610612754,104.0,117.0,0.4920000000000001,0.526,0,2007-10-15,4,2,2,0.5,3,3,0,1.0
10700048,1610612756,1610612762,124.0,101.0,0.524,0.4,1,2007-10-15,3,2,1,0.667,4,2,2,0.5
10700041,1610612737,1610612757,89.0,102.0,0.391,0.457,0,2007-10-14,4,3,1,0.75,3,2,1,0.667
10700042,1610612755,1610612764,80.0,86.0,0.373,0.429,0,2007-10-14,2,0,2,0.0,3,3,0,1.0
10700043,1610612765,1610612743,109.0,106.0,0.41,0.465,1,2007-10-14,4,2,2,0.5,3,2,1,0.667
10700044,1610612744,1610612746,89.0,99.0,0.3289999999999999,0.402,0,2007-10-14,3,2,1,0.667,3,1,2,0.3329999999999999
10700035,1610612764,1610612742,90.0,86.0,0.366,0.426,1,2007-10-13,2,2,0,1.0,3,1,2,0.3329999999999999
10700036,1610612766,1610612748,92.0,76.0,0.4639999999999999,0.408,1,2007-10-13,3,1,2,0.3329999999999999,4,0,4,0.0
10700037,1610612754,1610612760,97.0,87.0,0.376,0.37,1,2007-10-13,2,2,0,1.0,3,1,2,0.3329999999999999
10700039,1610612749,1610612762,78.0,92.0,0.412,0.377,0,2007-10-13,3,2,1,0.667,3,2,1,0.667
10700038,1610612756,1610612740,106.0,111.0,0.483,0.4270000000000001,0,2007-10-13,2,1,1,0.5,3,2,1,0.667
10700029,1610612755,1610612751,90.0,91.0,0.41,0.3939999999999999,0,2007-10-12,1,0,1,0.0,1,1,0,1.0
10700030,1610612753,1610612748,102.0,69.0,0.467,0.358,1,2007-10-12,3,2,1,0.667,3,0,3,0.0
10700032,1610612739,1610612760,90.0,96.0,0.392,0.407,0,2007-10-12,3,1,2,0.3329999999999999,2,1,1,0.5
10700033,1610612765,1610612762,85.0,100.0,0.416,0.417,0,2007-10-12,3,1,2,0.3329999999999999,2,1,1,0.5
10700034,1610612741,1610612742,100.0,92.0,0.508,0.436,1,2007-10-12,2,1,1,0.5,2,1,1,0.5
10700031,1610612743,1610612757,118.0,102.0,0.4579999999999999,0.3670000000000001,1,2007-10-12,2,2,0,1.0,2,1,1,0.5
10700023,1610612737,1610612766,109.0,104.0,0.471,0.4529999999999999,1,2007-10-11,3,3,0,1.0,2,0,2,0.0
10700024,1610612739,1610612765,96.0,90.0,0.416,0.369,1,2007-10-11,2,1,1,0.5,2,1,1,0.5
10700025,1610612758,1610612756,99.0,110.0,0.4589999999999999,0.513,0,2007-10-11,2,1,1,0.5,1,1,0,1.0
10700026,1610612747,1610612744,106.0,119.0,0.4679999999999999,0.4579999999999999,0,2007-10-11,2,0,2,0.0,2,2,0,1.0
10700020,1610612750,1610612738,81.0,92.0,0.397,0.4920000000000001,0,2007-10-10,2,1,1,0.5,2,2,0,1.0
10700015,1610612753,1610612766,123.0,99.0,0.6409999999999999,0.451,1,2007-10-10,2,1,1,0.5,1,0,1,0.0
10700016,1610612754,1610612740,101.0,96.0,0.384,0.384,1,2007-10-10,1,1,0,1.0,2,1,1,0.5
10700019,1610612748,1610612737,100.0,106.0,0.429,0.455,0,2007-10-10,2,0,2,0.0,2,2,0,1.0
10700017,1610612762,1610612749,81.0,90.0,0.4370000000000001,0.43,0,2007-10-10,1,0,1,0.0,2,2,0,1.0
10700018,1610612757,1610612746,111.0,102.0,0.4529999999999999,0.3829999999999999,1,2007-10-10,1,1,0,1.0,2,0,2,0.0
10700007,1610612739,1610612764,62.0,81.0,0.306,0.354,0,2007-10-09,1,0,1,0.0,1,1,0,1.0
10700008,1610612749,1610612741,93.0,88.0,0.417,0.485,1,2007-10-09,1,1,0,1.0,1,0,1,0.0
10700009,1610612740,1610612745,94.0,92.0,0.353,0.452,1,2007-10-09,1,1,0,1.0,1,0,1,0.0
10700013,1610612742,1610612759,88.0,67.0,0.471,0.306,1,2007-10-09,1,1,0,1.0,1,0,1,0.0
10700010,1610612743,1610612746,119.0,107.0,0.506,0.426,1,2007-10-09,1,1,0,1.0,1,0,1,0.0
10700011,1610612758,1610612760,104.0,98.0,0.407,0.5,1,2007-10-09,1,1,0,1.0,1,0,1,0.0
10700012,1610612747,1610612744,110.0,111.0,0.39,0.456,0,2007-10-09,1,0,1,0.0,1,1,0,1.0
10700005,1610612753,1610612737,93.0,94.0,0.413,0.408,0,2007-10-08,1,0,1,0.0,1,1,0,1.0
10700006,1610612765,1610612748,103.0,86.0,0.479,0.4029999999999999,1,2007-10-08,1,1,0,1.0,1,0,1,0.0
10700001,1610612738,1610612761,89.0,85.0,0.461,0.3879999999999999,1,2007-10-06,1,1,0,1.0,1,0,1,0.0
40600404,1610612739,1610612759,82.0,83.0,0.381,0.426,0,2007-06-14,82,50,32,0.61,82,58,24,0.7070000000000001
40600403,1610612739,1610612759,72.0,75.0,0.3670000000000001,0.412,0,2007-06-12,82,50,32,0.61,82,58,24,0.7070000000000001
40600402,1610612759,1610612739,103.0,92.0,0.481,0.407,1,2007-06-10,82,58,24,0.7070000000000001,82,50,32,0.61
40600401,1610612759,1610612739,85.0,76.0,0.4529999999999999,0.429,1,2007-06-07,82,58,24,0.7070000000000001,82,50,32,0.61
40600306,1610612739,1610612765,98.0,82.0,0.389,0.359,1,2007-06-02,82,50,32,0.61,82,53,29,0.6459999999999999
40600305,1610612765,1610612739,107.0,109.0,0.425,0.451,0,2007-05-31,82,53,29,0.6459999999999999,82,50,32,0.61
40600315,1610612759,1610612762,109.0,84.0,0.513,0.382,1,2007-05-30,82,58,24,0.7070000000000001,82,51,31,0.622
40600304,1610612739,1610612765,91.0,87.0,0.441,0.413,1,2007-05-29,82,50,32,0.61,82,53,29,0.6459999999999999
40600314,1610612762,1610612759,79.0,91.0,0.471,0.406,0,2007-05-28,82,51,31,0.622,82,58,24,0.7070000000000001
40600303,1610612739,1610612765,88.0,82.0,0.493,0.4479999999999999,1,2007-05-27,82,50,32,0.61,82,53,29,0.6459999999999999
40600313,1610612762,1610612759,109.0,83.0,0.532,0.4379999999999999,1,2007-05-26,82,51,31,0.622,82,58,24,0.7070000000000001
40600302,1610612765,1610612739,79.0,76.0,0.444,0.4,1,2007-05-24,82,53,29,0.6459999999999999,82,50,32,0.61
40600312,1610612759,1610612762,105.0,96.0,0.556,0.439,1,2007-05-22,82,58,24,0.7070000000000001,82,51,31,0.622
40600301,1610612765,1610612739,79.0,76.0,0.431,0.3720000000000001,1,2007-05-21,82,53,29,0.6459999999999999,82,50,32,0.61
40600311,1610612759,1610612762,108.0,100.0,0.5429999999999999,0.419,1,2007-05-20,82,58,24,0.7070000000000001,82,51,31,0.622
40600216,1610612751,1610612739,72.0,88.0,0.377,0.434,0,2007-05-18,82,41,41,0.5,82,50,32,0.61
40600236,1610612759,1610612756,114.0,106.0,0.489,0.482,1,2007-05-18,82,58,24,0.7070000000000001,82,61,21,0.7440000000000001
40600206,1610612741,1610612765,85.0,95.0,0.373,0.421,0,2007-05-17,82,49,33,0.598,82,53,29,0.6459999999999999
40600215,1610612739,1610612751,72.0,83.0,0.3329999999999999,0.478,0,2007-05-16,82,50,32,0.61,82,41,41,0.5
40600235,1610612756,1610612759,85.0,88.0,0.4029999999999999,0.4029999999999999,0,2007-05-16,82,61,21,0.7440000000000001,82,58,24,0.7070000000000001
40600205,1610612765,1610612741,92.0,108.0,0.423,0.573,0,2007-05-15,82,53,29,0.6459999999999999,82,49,33,0.598
40600225,1610612762,1610612744,100.0,87.0,0.446,0.364,1,2007-05-15,82,51,31,0.622,82,42,40,0.512
40600214,1610612751,1610612739,85.0,87.0,0.36,0.415,0,2007-05-14,82,41,41,0.5,82,50,32,0.61
40600234,1610612759,1610612756,98.0,104.0,0.475,0.481,0,2007-05-14,82,58,24,0.7070000000000001,82,61,21,0.7440000000000001
40600204,1610612741,1610612765,102.0,87.0,0.493,0.373,1,2007-05-13,82,49,33,0.598,82,53,29,0.6459999999999999
40600224,1610612744,1610612762,101.0,115.0,0.405,0.514,0,2007-05-13,82,42,40,0.512,82,51,31,0.622
40600213,1610612751,1610612739,96.0,85.0,0.472,0.414,1,2007-05-12,82,41,41,0.5,82,50,32,0.61
40600233,1610612759,1610612756,108.0,101.0,0.439,0.487,1,2007-05-12,82,58,24,0.7070000000000001,82,61,21,0.7440000000000001
40600223,1610612744,1610612762,125.0,105.0,0.526,0.474,1,2007-05-11,82,42,40,0.512,82,51,31,0.622
40600203,1610612741,1610612765,74.0,81.0,0.337,0.395,0,2007-05-10,82,49,33,0.598,82,53,29,0.6459999999999999
40600222,1610612762,1610612744,127.0,117.0,0.529,0.422,1,2007-05-09,82,51,31,0.622,82,42,40,0.512
40600212,1610612739,1610612751,102.0,92.0,0.447,0.523,1,2007-05-08,82,50,32,0.61,82,41,41,0.5
40600232,1610612756,1610612759,101.0,81.0,0.526,0.429,1,2007-05-08,82,61,21,0.7440000000000001,82,58,24,0.7070000000000001
40600202,1610612765,1610612741,108.0,87.0,0.526,0.3429999999999999,1,2007-05-07,82,53,29,0.6459999999999999,82,49,33,0.598
40600221,1610612762,1610612744,116.0,112.0,0.477,0.456,1,2007-05-07,82,51,31,0.622,82,42,40,0.512
40600211,1610612739,1610612751,81.0,77.0,0.402,0.3720000000000001,1,2007-05-06,82,50,32,0.61,82,41,41,0.5
40600231,1610612756,1610612759,106.0,111.0,0.4639999999999999,0.5,0,2007-05-06,82,61,21,0.7440000000000001,82,58,24,0.7070000000000001
40600201,1610612765,1610612741,95.0,69.0,0.439,0.3289999999999999,1,2007-05-05,82,53,29,0.6459999999999999,82,49,33,0.598
40600177,1610612745,1610612762,99.0,103.0,0.466,0.513,0,2007-05-05,82,52,30,0.634,82,51,31,0.622
40600126,1610612751,1610612761,98.0,97.0,0.4920000000000001,0.486,1,2007-05-04,82,41,41,0.5,82,47,35,0.573
40600176,1610612762,1610612745,94.0,82.0,0.486,0.433,1,2007-05-03,82,51,31,0.622,82,52,30,0.634
40600146,1610612744,1610612742,111.0,86.0,0.4679999999999999,0.376,1,2007-05-03,82,42,40,0.512,82,67,15,0.8170000000000001
40600165,1610612759,1610612743,93.0,78.0,0.475,0.377,1,2007-05-02,82,58,24,0.7070000000000001,82,45,37,0.5489999999999999
40600155,1610612756,1610612747,119.0,110.0,0.465,0.478,1,2007-05-02,82,61,21,0.7440000000000001,82,42,40,0.512
40600125,1610612761,1610612751,98.0,96.0,0.493,0.444,1,2007-05-01,82,47,35,0.573,82,41,41,0.5
40600145,1610612742,1610612744,118.0,112.0,0.506,0.47,1,2007-05-01,82,67,15,0.8170000000000001,82,42,40,0.512
40600114,1610612764,1610612739,90.0,97.0,0.425,0.4270000000000001,0,2007-04-30,82,41,41,0.5,82,50,32,0.61
40600175,1610612745,1610612762,96.0,92.0,0.467,0.4679999999999999,1,2007-04-30,82,52,30,0.634,82,51,31,0.622
40600164,1610612743,1610612759,89.0,96.0,0.474,0.457,0,2007-04-30,82,45,37,0.5489999999999999,82,58,24,0.7070000000000001
40600134,1610612748,1610612741,79.0,92.0,0.431,0.381,0,2007-04-29,82,44,38,0.537,82,49,33,0.598
40600154,1610612747,1610612756,100.0,113.0,0.4429999999999999,0.477,0,2007-04-29,82,42,40,0.512,82,61,21,0.7440000000000001
40600124,1610612751,1610612761,102.0,81.0,0.474,0.418,1,2007-04-29,82,41,41,0.5,82,47,35,0.573
40600144,1610612744,1610612742,103.0,99.0,0.4589999999999999,0.4379999999999999,1,2007-04-29,82,42,40,0.512,82,67,15,0.8170000000000001
40600104,1610612753,1610612765,93.0,97.0,0.4679999999999999,0.462,0,2007-04-28,82,40,42,0.488,82,53,29,0.6459999999999999
40600113,1610612764,1610612739,92.0,98.0,0.434,0.5,0,2007-04-28,82,41,41,0.5,82,50,32,0.61
40600163,1610612743,1610612759,91.0,96.0,0.429,0.43,0,2007-04-28,82,45,37,0.5489999999999999,82,58,24,0.7070000000000001
40600174,1610612762,1610612745,98.0,85.0,0.461,0.421,1,2007-04-28,82,51,31,0.622,82,52,30,0.634
40600123,1610612751,1610612761,102.0,89.0,0.526,0.44,1,2007-04-27,82,41,41,0.5,82,47,35,0.573
40600133,1610612748,1610612741,96.0,104.0,0.457,0.493,0,2007-04-27,82,44,38,0.537,82,49,33,0.598
40600143,1610612744,1610612742,109.0,91.0,0.481,0.3879999999999999,1,2007-04-27,82,42,40,0.512,82,67,15,0.8170000000000001
40600103,1610612753,1610612765,77.0,93.0,0.419,0.436,0,2007-04-26,82,40,42,0.488,82,53,29,0.6459999999999999
40600173,1610612762,1610612745,81.0,67.0,0.3879999999999999,0.3279999999999999,1,2007-04-26,82,51,31,0.622,82,52,30,0.634
40600153,1610612747,1610612756,95.0,89.0,0.42,0.48,1,2007-04-26,82,42,40,0.512,82,61,21,0.7440000000000001
40600162,1610612759,1610612743,97.0,88.0,0.4379999999999999,0.386,1,2007-04-25,82,58,24,0.7070000000000001,82,45,37,0.5489999999999999
40600112,1610612739,1610612764,109.0,102.0,0.476,0.422,1,2007-04-25,82,50,32,0.61,82,41,41,0.5
40600142,1610612742,1610612744,112.0,99.0,0.487,0.474,1,2007-04-25,82,67,15,0.8170000000000001,82,42,40,0.512
40600122,1610612761,1610612751,89.0,83.0,0.408,0.408,1,2007-04-24,82,47,35,0.573,82,41,41,0.5
40600132,1610612741,1610612748,107.0,89.0,0.551,0.466,1,2007-04-24,82,49,33,0.598,82,44,38,0.537
40600152,1610612756,1610612747,126.0,98.0,0.5429999999999999,0.414,1,2007-04-24,82,61,21,0.7440000000000001,82,42,40,0.512
40600102,1610612765,1610612753,98.0,90.0,0.41,0.461,1,2007-04-23,82,53,29,0.6459999999999999,82,40,42,0.488
40600172,1610612745,1610612762,98.0,90.0,0.361,0.452,1,2007-04-23,82,52,30,0.634,82,51,31,0.622
40600111,1610612739,1610612764,97.0,82.0,0.444,0.3670000000000001,1,2007-04-22,82,50,32,0.61,82,41,41,0.5
40600151,1610612756,1610612747,95.0,87.0,0.429,0.452,1,2007-04-22,82,61,21,0.7440000000000001,82,42,40,0.512
40600161,1610612759,1610612743,89.0,95.0,0.42,0.455,0,2007-04-22,82,58,24,0.7070000000000001,82,45,37,0.5489999999999999
40600141,1610612742,1610612744,85.0,97.0,0.353,0.4320000000000001,0,2007-04-22,82,67,15,0.8170000000000001,82,42,40,0.512
40600121,1610612761,1610612751,91.0,96.0,0.413,0.424,0,2007-04-21,82,47,35,0.573,82,41,41,0.5
40600131,1610612741,1610612748,96.0,91.0,0.4270000000000001,0.425,1,2007-04-21,82,49,33,0.598,82,44,38,0.537
40600101,1610612765,1610612753,100.0,92.0,0.493,0.581,1,2007-04-21,82,53,29,0.6459999999999999,82,40,42,0.488
40600171,1610612745,1610612762,84.0,75.0,0.391,0.356,1,2007-04-21,82,52,30,0.634,82,51,31,0.622
20601217,1610612761,1610612755,119.0,122.0,0.535,0.53,0,2007-04-18,82,47,35,0.573,82,35,47,0.4270000000000001
20601218,1610612766,1610612752,93.0,94.0,0.457,0.4589999999999999,0,2007-04-18,82,33,49,0.402,82,33,49,0.402
20601219,1610612753,1610612748,94.0,68.0,0.4429999999999999,0.377,1,2007-04-18,82,40,42,0.488,82,44,38,0.537
20601220,1610612739,1610612749,109.0,96.0,0.483,0.449,1,2007-04-18,82,50,32,0.61,82,28,54,0.341
20601221,1610612738,1610612765,89.0,91.0,0.43,0.469,0,2007-04-18,82,24,58,0.293,82,53,29,0.6459999999999999
20601222,1610612751,1610612741,106.0,97.0,0.456,0.422,1,2007-04-18,82,41,41,0.5,82,49,33,0.598
20601223,1610612754,1610612764,95.0,98.0,0.43,0.477,0,2007-04-18,82,35,47,0.4270000000000001,82,41,41,0.5
20601224,1610612759,1610612743,77.0,100.0,0.358,0.494,0,2007-04-18,82,58,24,0.7070000000000001,82,45,37,0.5489999999999999
20601225,1610612750,1610612763,94.0,116.0,0.396,0.529,0,2007-04-18,82,32,50,0.39,82,22,60,0.268
20601226,1610612762,1610612745,101.0,91.0,0.493,0.419,1,2007-04-18,82,51,31,0.622,82,52,30,0.634
20601227,1610612758,1610612747,106.0,117.0,0.482,0.57,0,2007-04-18,82,33,49,0.402,82,42,40,0.512
20601228,1610612757,1610612744,98.0,120.0,0.429,0.527,0,2007-04-18,82,32,50,0.39,82,42,40,0.512
20601229,1610612760,1610612742,75.0,106.0,0.42,0.531,0,2007-04-18,82,31,51,0.3779999999999999,82,67,15,0.8170000000000001
20601230,1610612746,1610612740,83.0,86.0,0.4029999999999999,0.4320000000000001,0,2007-04-18,82,40,42,0.488,82,39,43,0.476
20601211,1610612755,1610612739,92.0,98.0,0.457,0.494,0,2007-04-17,81,34,47,0.42,81,49,32,0.605
20601212,1610612764,1610612753,89.0,95.0,0.35,0.5,0,2007-04-17,81,40,41,0.494,81,39,42,0.481
20601213,1610612737,1610612754,118.0,102.0,0.53,0.493,1,2007-04-17,82,30,52,0.366,81,35,46,0.4320000000000001
20601214,1610612765,1610612761,100.0,84.0,0.525,0.39,1,2007-04-17,81,52,29,0.642,81,47,34,0.58
20601215,1610612756,1610612746,99.0,103.0,0.43,0.422,0,2007-04-17,82,61,21,0.7440000000000001,81,40,41,0.494
20601216,1610612744,1610612742,111.0,82.0,0.417,0.368,1,2007-04-17,81,41,40,0.506,81,66,15,0.815
20601203,1610612752,1610612751,95.0,104.0,0.41,0.42,0,2007-04-16,81,32,49,0.395,81,40,41,0.494
20601204,1610612748,1610612738,89.0,91.0,0.444,0.4429999999999999,0,2007-04-16,81,44,37,0.5429999999999999,81,24,57,0.296
20601205,1610612749,1610612737,102.0,96.0,0.477,0.456,1,2007-04-16,81,28,53,0.346,81,29,52,0.358
20601206,1610612763,1610612759,101.0,91.0,0.528,0.429,1,2007-04-16,81,21,60,0.259,81,58,23,0.716
20601207,1610612745,1610612756,120.0,117.0,0.484,0.573,1,2007-04-16,81,52,29,0.642,81,61,20,0.753
20601208,1610612743,1610612750,122.0,107.0,0.5,0.478,1,2007-04-16,81,44,37,0.5429999999999999,81,32,49,0.395
20601209,1610612762,1610612757,130.0,93.0,0.584,0.435,1,2007-04-16,81,50,31,0.617,81,32,49,0.395
20601210,1610612758,1610612740,118.0,125.0,0.495,0.5579999999999999,0,2007-04-16,81,33,48,0.407,81,38,43,0.469
20601195,1610612764,1610612741,68.0,101.0,0.3379999999999999,0.469,0,2007-04-15,80,40,40,0.5,81,49,32,0.605
20601194,1610612742,1610612759,91.0,86.0,0.442,0.436,1,2007-04-15,80,66,14,0.825,80,58,22,0.725
20601196,1610612754,1610612751,107.0,111.0,0.4639999999999999,0.513,0,2007-04-15,80,35,45,0.4379999999999999,80,39,41,0.488
20601197,1610612746,1610612758,100.0,105.0,0.434,0.4679999999999999,0,2007-04-15,80,39,41,0.488,80,33,47,0.413
20601198,1610612744,1610612750,121.0,108.0,0.467,0.429,1,2007-04-15,80,40,40,0.5,80,32,48,0.4
20601199,1610612761,1610612752,107.0,105.0,0.519,0.493,1,2007-04-15,80,47,33,0.588,80,32,48,0.4
20601200,1610612753,1610612738,88.0,86.0,0.444,0.449,1,2007-04-15,80,38,42,0.475,80,23,57,0.288
20601201,1610612765,1610612755,91.0,102.0,0.442,0.474,0,2007-04-15,80,51,29,0.638,80,34,46,0.425
20601202,1610612747,1610612760,109.0,98.0,0.525,0.486,1,2007-04-15,81,41,40,0.506,81,31,50,0.3829999999999999
20601187,1610612755,1610612753,87.0,104.0,0.392,0.531,0,2007-04-14,79,33,46,0.418,79,37,42,0.4679999999999999
20601188,1610612739,1610612737,110.0,76.0,0.5710000000000001,0.4379999999999999,1,2007-04-14,80,48,32,0.6,80,29,51,0.363
20601189,1610612763,1610612743,133.0,118.0,0.578,0.523,1,2007-04-14,80,20,60,0.25,80,43,37,0.5379999999999999
20601190,1610612749,1610612766,92.0,113.0,0.4579999999999999,0.6,0,2007-04-14,80,27,53,0.3379999999999999,81,33,48,0.407
20601191,1610612745,1610612740,123.0,112.0,0.583,0.542,1,2007-04-14,80,51,29,0.638,80,37,43,0.4629999999999999
20601192,1610612762,1610612756,98.0,126.0,0.442,0.524,0,2007-04-14,80,49,31,0.613,80,61,19,0.763
20601193,1610612757,1610612760,108.0,102.0,0.494,0.402,1,2007-04-14,80,32,48,0.4,80,31,49,0.3879999999999999
20601175,1610612761,1610612765,87.0,84.0,0.369,0.3879999999999999,1,2007-04-13,79,46,33,0.5820000000000001,79,51,28,0.6459999999999999
20601176,1610612738,1610612749,102.0,104.0,0.466,0.529,0,2007-04-13,79,23,56,0.291,79,27,52,0.342
20601177,1610612751,1610612752,100.0,86.0,0.467,0.456,1,2007-04-13,79,38,41,0.481,79,32,47,0.405
20601178,1610612737,1610612764,85.0,98.0,0.478,0.493,0,2007-04-13,79,29,50,0.3670000000000001,79,40,39,0.506
20601179,1610612748,1610612754,100.0,96.0,0.526,0.4579999999999999,1,2007-04-13,80,44,36,0.55,79,35,44,0.4429999999999999
20601180,1610612740,1610612743,105.0,107.0,0.467,0.524,0,2007-04-13,79,37,42,0.4679999999999999,79,43,36,0.544
20601181,1610612750,1610612759,91.0,110.0,0.419,0.513,0,2007-04-13,79,32,47,0.405,79,58,21,0.7340000000000001
20601182,1610612741,1610612766,100.0,81.0,0.513,0.395,1,2007-04-13,80,48,32,0.6,80,32,48,0.4
20601183,1610612742,1610612762,89.0,104.0,0.446,0.521,0,2007-04-13,79,65,14,0.823,79,49,30,0.62
20601184,1610612758,1610612744,108.0,125.0,0.436,0.484,0,2007-04-13,79,32,47,0.405,79,39,40,0.494
20601185,1610612756,1610612747,93.0,85.0,0.382,0.3929999999999999,1,2007-04-13,79,60,19,0.759,80,40,40,0.5
20601186,1610612746,1610612757,107.0,89.0,0.531,0.461,1,2007-04-13,79,39,40,0.494,79,31,48,0.392
20601173,1610612739,1610612751,94.0,76.0,0.521,0.418,1,2007-04-12,79,47,32,0.595,78,37,41,0.474
20601174,1610612747,1610612746,110.0,118.0,0.476,0.482,0,2007-04-12,79,40,39,0.506,78,38,40,0.487
20601164,1610612738,1610612755,94.0,102.0,0.4589999999999999,0.562,0,2007-04-11,78,23,55,0.295,78,33,45,0.423
20601165,1610612748,1610612764,85.0,82.0,0.508,0.3929999999999999,1,2007-04-11,79,43,36,0.544,78,39,39,0.5
20601166,1610612765,1610612753,104.0,99.0,0.547,0.5,1,2007-04-11,78,51,27,0.654,78,36,42,0.462
20601167,1610612749,1610612754,98.0,104.0,0.457,0.4370000000000001,0,2007-04-11,78,26,52,0.3329999999999999,78,35,43,0.449
20601168,1610612759,1610612758,109.0,100.0,0.56,0.4320000000000001,1,2007-04-11,78,57,21,0.731,78,32,46,0.41
20601169,1610612750,1610612742,88.0,105.0,0.413,0.477,0,2007-04-11,78,32,46,0.41,78,65,13,0.833
20601170,1610612762,1610612743,106.0,115.0,0.495,0.535,0,2007-04-11,78,48,30,0.615,78,42,36,0.5379999999999999
20601171,1610612756,1610612760,109.0,91.0,0.494,0.474,1,2007-04-11,78,59,19,0.7559999999999999,79,31,48,0.392
20601172,1610612757,1610612745,95.0,99.0,0.44,0.4370000000000001,0,2007-04-11,78,31,47,0.397,79,50,29,0.633
20601157,1610612755,1610612754,90.0,86.0,0.4479999999999999,0.327,1,2007-04-10,77,32,45,0.416,77,34,43,0.442
20601158,1610612764,1610612751,92.0,96.0,0.413,0.4639999999999999,0,2007-04-10,77,39,38,0.506,77,37,40,0.481
20601159,1610612766,1610612748,92.0,82.0,0.436,0.441,1,2007-04-10,79,32,47,0.405,78,42,36,0.5379999999999999
20601160,1610612737,1610612738,104.0,96.0,0.603,0.462,1,2007-04-10,78,29,49,0.3720000000000001,77,23,54,0.299
20601161,1610612763,1610612758,100.0,112.0,0.4529999999999999,0.519,0,2007-04-10,79,19,60,0.241,77,32,45,0.416
20601162,1610612740,1610612746,103.0,100.0,0.451,0.4429999999999999,1,2007-04-10,78,37,41,0.474,77,37,40,0.481
20601163,1610612741,1610612752,98.0,69.0,0.47,0.371,1,2007-04-10,79,47,32,0.595,78,32,46,0.41
20601149,1610612752,1610612765,83.0,91.0,0.423,0.414,0,2007-04-09,77,32,45,0.416,77,50,27,0.649
20601150,1610612749,1610612753,94.0,117.0,0.442,0.625,0,2007-04-09,77,26,51,0.3379999999999999,77,36,41,0.4679999999999999
20601151,1610612759,1610612757,112.0,96.0,0.591,0.521,1,2007-04-09,77,56,21,0.727,77,31,46,0.4029999999999999
20601152,1610612750,1610612761,100.0,111.0,0.469,0.481,0,2007-04-09,77,32,45,0.416,78,45,33,0.5770000000000001
20601153,1610612742,1610612746,96.0,86.0,0.5,0.472,1,2007-04-09,77,64,13,0.831,76,37,39,0.487
20601154,1610612743,1610612747,115.0,111.0,0.449,0.436,1,2007-04-09,77,41,36,0.532,78,40,38,0.513
20601155,1610612760,1610612745,90.0,95.0,0.3979999999999999,0.423,0,2007-04-09,78,31,47,0.397,78,49,29,0.628
20601156,1610612744,1610612762,126.0,102.0,0.5529999999999999,0.402,1,2007-04-09,78,38,40,0.487,77,48,29,0.623
20601143,1610612765,1610612739,87.0,82.0,0.4429999999999999,0.478,1,2007-04-08,76,49,27,0.645,78,46,32,0.59
20601144,1610612747,1610612756,107.0,115.0,0.489,0.452,0,2007-04-08,77,40,37,0.519,77,58,19,0.753
20601145,1610612761,1610612741,103.0,89.0,0.44,0.42,1,2007-04-08,77,44,33,0.5710000000000001,78,46,32,0.59
20601146,1610612748,1610612766,103.0,111.0,0.537,0.482,0,2007-04-08,77,42,35,0.545,78,31,47,0.397
20601147,1610612755,1610612737,109.0,104.0,0.439,0.483,1,2007-04-08,76,31,45,0.408,77,28,49,0.364
20601148,1610612758,1610612745,106.0,112.0,0.3979999999999999,0.5,0,2007-04-08,76,31,45,0.408,77,48,29,0.623
20601134,1610612753,1610612763,116.0,89.0,0.5820000000000001,0.3779999999999999,1,2007-04-07,76,35,41,0.461,78,19,59,0.244
20601135,1610612754,1610612738,105.0,98.0,0.544,0.4479999999999999,1,2007-04-07,76,34,42,0.447,76,23,53,0.303
20601136,1610612751,1610612764,120.0,114.0,0.526,0.436,1,2007-04-07,76,36,40,0.474,76,39,37,0.513
20601137,1610612759,1610612744,112.0,99.0,0.525,0.426,1,2007-04-07,76,55,21,0.7240000000000001,77,37,40,0.481
20601138,1610612750,1610612740,94.0,96.0,0.467,0.33,0,2007-04-07,76,32,44,0.421,77,36,41,0.4679999999999999
20601139,1610612749,1610612752,113.0,118.0,0.435,0.511,0,2007-04-07,76,26,50,0.342,76,32,44,0.421
20601140,1610612742,1610612757,86.0,74.0,0.507,0.377,1,2007-04-07,76,63,13,0.8290000000000001,76,31,45,0.408
20601141,1610612762,1610612760,103.0,106.0,0.563,0.565,0,2007-04-07,76,48,28,0.632,77,31,46,0.4029999999999999
20601142,1610612746,1610612743,93.0,96.0,0.434,0.487,0,2007-04-07,75,37,38,0.493,76,40,36,0.526
20601121,1610612755,1610612761,85.0,94.0,0.429,0.473,0,2007-04-06,75,30,45,0.4,76,43,33,0.5660000000000001
20601122,1610612766,1610612754,102.0,112.0,0.435,0.5479999999999999,0,2007-04-06,77,30,47,0.39,75,33,42,0.44
20601123,1610612738,1610612748,85.0,88.0,0.425,0.4679999999999999,0,2007-04-06,75,23,52,0.307,76,42,34,0.5529999999999999
20601124,1610612752,1610612750,94.0,99.0,0.43,0.487,0,2007-04-06,75,31,44,0.413,75,32,43,0.4270000000000001
20601125,1610612737,1610612749,115.0,102.0,0.466,0.44,1,2007-04-06,76,28,48,0.368,75,26,49,0.347
20601126,1610612764,1610612739,94.0,99.0,0.514,0.442,0,2007-04-06,75,39,36,0.52,77,46,31,0.597
20601127,1610612763,1610612744,104.0,116.0,0.5,0.5,0,2007-04-06,77,19,58,0.247,76,37,39,0.487
20601128,1610612740,1610612756,95.0,103.0,0.475,0.506,0,2007-04-06,76,35,41,0.461,76,57,19,0.75
20601129,1610612741,1610612751,105.0,74.0,0.46,0.342,1,2007-04-06,77,46,31,0.597,75,35,40,0.467
20601130,1610612745,1610612757,78.0,85.0,0.382,0.4429999999999999,0,2007-04-06,76,47,29,0.618,75,31,44,0.413
20601131,1610612758,1610612762,107.0,103.0,0.514,0.4429999999999999,1,2007-04-06,75,31,44,0.413,75,48,27,0.64
20601132,1610612743,1610612742,75.0,71.0,0.355,0.361,1,2007-04-06,75,39,36,0.52,75,62,13,0.8270000000000001
20601133,1610612760,1610612747,109.0,112.0,0.487,0.506,0,2007-04-06,76,30,46,0.395,76,40,36,0.526
20601119,1610612739,1610612748,90.0,94.0,0.369,0.449,0,2007-04-05,76,45,31,0.5920000000000001,75,41,34,0.547
20601120,1610612759,1610612756,92.0,85.0,0.418,0.386,1,2007-04-05,75,54,21,0.72,75,56,19,0.747
20601108,1610612764,1610612766,100.0,108.0,0.461,0.5,0,2007-04-04,74,39,35,0.527,76,30,46,0.395
20601109,1610612753,1610612761,108.0,111.0,0.52,0.493,0,2007-04-04,75,34,41,0.4529999999999999,75,42,33,0.56
20601110,1610612751,1610612737,101.0,86.0,0.479,0.407,1,2007-04-04,74,35,39,0.473,75,27,48,0.36
20601111,1610612752,1610612755,90.0,92.0,0.44,0.486,0,2007-04-04,74,31,43,0.419,74,30,44,0.405
20601112,1610612765,1610612741,88.0,106.0,0.405,0.5379999999999999,0,2007-04-04,75,48,27,0.64,76,45,31,0.5920000000000001
20601113,1610612749,1610612738,98.0,89.0,0.481,0.374,1,2007-04-04,74,26,48,0.351,74,23,51,0.311
20601114,1610612740,1610612760,101.0,92.0,0.4370000000000001,0.415,1,2007-04-04,75,35,40,0.467,75,30,45,0.4
20601115,1610612745,1610612744,99.0,110.0,0.413,0.439,0,2007-04-04,75,47,28,0.627,75,36,39,0.48
20601116,1610612743,1610612758,120.0,115.0,0.494,0.4529999999999999,1,2007-04-04,74,38,36,0.514,74,30,44,0.405
20601117,1610612757,1610612762,94.0,89.0,0.456,0.43,1,2007-04-04,74,30,44,0.405,74,48,26,0.649
20601118,1610612746,1610612747,90.0,82.0,0.423,0.425,1,2007-04-04,74,37,37,0.5,75,39,36,0.52
20601100,1610612766,1610612764,122.0,102.0,0.573,0.44,1,2007-04-03,75,29,46,0.387,73,39,34,0.534
20601101,1610612754,1610612765,85.0,100.0,0.522,0.451,0,2007-04-03,74,32,42,0.4320000000000001,74,48,26,0.649
20601102,1610612748,1610612761,92.0,89.0,0.507,0.379,1,2007-04-03,74,40,34,0.541,74,41,33,0.5539999999999999
20600547,1610612749,1610612740,101.0,119.0,0.482,0.545,0,2007-04-03,73,25,48,0.342,74,34,40,0.4589999999999999
20601103,1610612763,1610612756,111.0,116.0,0.481,0.512,0,2007-04-03,76,19,57,0.25,74,56,18,0.757
20601104,1610612759,1610612760,110.0,91.0,0.557,0.493,1,2007-04-03,74,53,21,0.716,74,30,44,0.405
20601105,1610612750,1610612739,88.0,101.0,0.423,0.47,0,2007-04-03,74,31,43,0.419,75,45,30,0.6
20601106,1610612758,1610612742,93.0,97.0,0.39,0.462,0,2007-04-03,73,30,43,0.411,74,62,12,0.838
20601107,1610612747,1610612743,105.0,111.0,0.444,0.482,0,2007-04-03,74,39,35,0.527,73,37,36,0.507
20601088,1610612765,1610612748,94.0,88.0,0.449,0.471,1,2007-04-01,73,47,26,0.644,73,39,34,0.534
20601089,1610612737,1610612741,97.0,105.0,0.462,0.471,0,2007-04-01,74,27,47,0.365,75,44,31,0.5870000000000001
20601093,1610612744,1610612763,122.0,117.0,0.517,0.487,1,2007-04-01,74,35,39,0.473,75,19,56,0.253
20601091,1610612749,1610612764,107.0,121.0,0.506,0.5429999999999999,0,2007-04-01,72,25,47,0.347,72,39,33,0.542
20601092,1610612756,1610612742,126.0,104.0,0.648,0.456,1,2007-04-01,73,55,18,0.753,73,61,12,0.836
20601094,1610612738,1610612739,98.0,96.0,0.481,0.429,1,2007-04-01,73,23,50,0.315,74,44,30,0.595
20601095,1610612761,1610612766,107.0,94.0,0.4589999999999999,0.451,1,2007-04-01,73,41,32,0.562,74,28,46,0.3779999999999999
20601096,1610612753,1610612750,104.0,105.0,0.471,0.4629999999999999,0,2007-04-01,74,34,40,0.4589999999999999,73,31,42,0.425
20601097,1610612745,1610612762,83.0,86.0,0.3879999999999999,0.38,0,2007-04-01,74,47,27,0.635,73,48,25,0.6579999999999999
20601090,1610612754,1610612759,100.0,99.0,0.4629999999999999,0.473,1,2007-04-01,73,32,41,0.4379999999999999,73,52,21,0.7120000000000001
20601098,1610612760,1610612743,103.0,114.0,0.462,0.5539999999999999,0,2007-04-01,73,30,43,0.411,72,36,36,0.5
20601099,1610612747,1610612758,126.0,103.0,0.617,0.442,1,2007-04-01,73,39,34,0.534,72,30,42,0.417
20601084,1610612741,1610612739,108.0,112.0,0.513,0.476,0,2007-03-31,74,43,31,0.581,73,44,29,0.603
20601085,1610612751,1610612755,86.0,82.0,0.4429999999999999,0.4429999999999999,1,2007-03-31,73,34,39,0.466,73,29,44,0.397
20601086,1610612740,1610612752,103.0,94.0,0.449,0.435,1,2007-03-31,73,33,40,0.452,73,31,42,0.425
20601087,1610612757,1610612746,86.0,99.0,0.414,0.581,0,2007-03-31,73,29,44,0.397,73,36,37,0.493
20601072,1610612755,1610612738,88.0,82.0,0.426,0.423,1,2007-03-30,72,29,43,0.4029999999999999,72,22,50,0.306
20601073,1610612764,1610612761,118.0,123.0,0.3979999999999999,0.5,0,2007-03-30,71,38,33,0.535,72,40,32,0.556
20601074,1610612766,1610612749,97.0,81.0,0.387,0.3879999999999999,1,2007-03-30,73,28,45,0.384,71,25,46,0.352
20601075,1610612753,1610612754,95.0,87.0,0.475,0.421,1,2007-03-30,73,34,39,0.466,72,31,41,0.431
20601076,1610612765,1610612751,110.0,105.0,0.493,0.506,1,2007-03-30,72,46,26,0.639,72,33,39,0.4579999999999999
20601077,1610612759,1610612762,102.0,93.0,0.52,0.429,1,2007-03-30,72,52,20,0.722,72,47,25,0.653
20601078,1610612750,1610612748,77.0,92.0,0.369,0.487,0,2007-03-30,72,30,42,0.417,72,39,33,0.542
20601079,1610612742,1610612752,105.0,103.0,0.385,0.461,1,2007-03-30,72,61,11,0.847,72,31,41,0.431
20601080,1610612756,1610612743,125.0,108.0,0.551,0.476,1,2007-03-30,72,54,18,0.75,71,35,36,0.493
20601081,1610612747,1610612745,104.0,107.0,0.409,0.381,0,2007-03-30,72,38,34,0.528,73,47,26,0.644
20601082,1610612758,1610612746,101.0,105.0,0.42,0.475,0,2007-03-30,71,30,41,0.423,72,35,37,0.486
20601083,1610612760,1610612763,120.0,93.0,0.58,0.4679999999999999,1,2007-03-30,72,30,42,0.417,74,19,55,0.257
20601069,1610612741,1610612765,83.0,81.0,0.357,0.413,1,2007-03-29,73,43,30,0.589,71,45,26,0.634
20601070,1610612757,1610612763,92.0,96.0,0.439,0.397,0,2007-03-29,72,29,43,0.4029999999999999,73,19,54,0.26
20601071,1610612744,1610612756,124.0,119.0,0.52,0.517,1,2007-03-29,73,34,39,0.466,71,53,18,0.746
20601058,1610612761,1610612748,96.0,83.0,0.456,0.411,1,2007-03-28,71,39,32,0.5489999999999999,71,38,33,0.535
20601059,1610612764,1610612755,111.0,108.0,0.476,0.516,1,2007-03-28,70,38,32,0.5429999999999999,71,28,43,0.3939999999999999
20601060,1610612766,1610612737,101.0,87.0,0.487,0.4,1,2007-03-28,72,27,45,0.375,73,27,46,0.37
20601061,1610612738,1610612753,105.0,96.0,0.435,0.417,1,2007-03-28,71,22,49,0.31,72,33,39,0.4579999999999999
20601062,1610612751,1610612754,118.0,94.0,0.5479999999999999,0.349,1,2007-03-28,71,33,38,0.465,71,31,40,0.4370000000000001
20601063,1610612752,1610612739,97.0,93.0,0.5,0.3879999999999999,1,2007-03-28,71,31,40,0.4370000000000001,72,43,29,0.597
20601064,1610612759,1610612740,92.0,88.0,0.436,0.47,1,2007-03-28,71,51,20,0.718,72,32,40,0.444
20601065,1610612742,1610612749,105.0,103.0,0.4479999999999999,0.5,1,2007-03-28,71,60,11,0.845,70,25,45,0.357
20601066,1610612743,1610612760,97.0,100.0,0.409,0.5479999999999999,0,2007-03-28,70,35,35,0.5,71,29,42,0.408
20601067,1610612762,1610612750,108.0,102.0,0.507,0.47,1,2007-03-28,71,47,24,0.662,71,30,41,0.423
20601068,1610612746,1610612745,87.0,92.0,0.421,0.45,0,2007-03-28,71,34,37,0.479,72,46,26,0.639
20601054,1610612754,1610612739,94.0,105.0,0.474,0.521,0,2007-03-27,70,31,39,0.4429999999999999,71,43,28,0.606
20601055,1610612740,1610612742,89.0,105.0,0.42,0.55,0,2007-03-27,71,32,39,0.451,70,59,11,0.843
20601056,1610612750,1610612760,106.0,114.0,0.525,0.494,0,2007-03-27,70,30,40,0.429,70,28,42,0.4
20601057,1610612747,1610612763,86.0,88.0,0.347,0.435,0,2007-03-27,71,38,33,0.535,72,18,54,0.25
20601045,1610612738,1610612761,95.0,87.0,0.43,0.4029999999999999,1,2007-03-26,70,21,49,0.3,70,38,32,0.5429999999999999
20601046,1610612752,1610612753,89.0,94.0,0.471,0.521,0,2007-03-26,70,30,40,0.429,71,33,38,0.465
20601047,1610612748,1610612737,106.0,89.0,0.493,0.493,1,2007-03-26,70,38,32,0.5429999999999999,72,27,45,0.375
20601048,1610612765,1610612743,113.0,109.0,0.506,0.424,1,2007-03-26,70,45,25,0.643,69,35,34,0.507
20601049,1610612741,1610612757,100.0,89.0,0.476,0.525,1,2007-03-26,72,42,30,0.583,71,29,42,0.408
20601050,1610612745,1610612749,106.0,87.0,0.477,0.405,1,2007-03-26,71,45,26,0.634,69,25,44,0.362
20601051,1610612762,1610612764,103.0,97.0,0.43,0.397,1,2007-03-26,70,46,24,0.657,69,37,32,0.536
20601052,1610612756,1610612763,105.0,87.0,0.5479999999999999,0.442,1,2007-03-26,70,53,17,0.757,71,17,54,0.239
20601053,1610612744,1610612759,89.0,126.0,0.371,0.597,0,2007-03-26,72,33,39,0.4579999999999999,70,50,20,0.7140000000000001
20601036,1610612737,1610612742,97.0,104.0,0.412,0.529,0,2007-03-25,71,27,44,0.38,69,58,11,0.841
20601037,1610612754,1610612741,90.0,92.0,0.421,0.4,0,2007-03-25,69,31,38,0.449,71,41,30,0.5770000000000001
20601038,1610612749,1610612765,95.0,121.0,0.439,0.57,0,2007-03-25,68,25,43,0.368,69,44,25,0.638
20601040,1610612750,1610612757,94.0,93.0,0.551,0.481,1,2007-03-25,69,30,39,0.435,70,29,41,0.414
20601041,1610612758,1610612756,107.0,100.0,0.521,0.461,1,2007-03-25,70,30,40,0.429,69,52,17,0.754
20601039,1610612740,1610612745,106.0,94.0,0.494,0.435,1,2007-03-25,70,32,38,0.457,70,44,26,0.629
20601042,1610612739,1610612743,93.0,105.0,0.451,0.597,0,2007-03-25,70,42,28,0.6,68,35,33,0.515
20601043,1610612760,1610612759,79.0,120.0,0.366,0.532,0,2007-03-25,69,27,42,0.391,69,49,20,0.71
20601044,1610612747,1610612744,115.0,113.0,0.476,0.433,1,2007-03-25,70,38,32,0.5429999999999999,71,33,38,0.465
20601032,1610612766,1610612751,107.0,113.0,0.519,0.5329999999999999,0,2007-03-24,71,26,45,0.366,70,32,38,0.457
20601033,1610612748,1610612755,85.0,93.0,0.429,0.4629999999999999,0,2007-03-24,69,37,32,0.536,70,28,42,0.4
20601034,1610612762,1610612763,118.0,108.0,0.5,0.527,1,2007-03-24,69,45,24,0.652,70,17,53,0.243
20601035,1610612746,1610612764,111.0,105.0,0.481,0.422,1,2007-03-24,70,34,36,0.486,68,37,31,0.544
20601020,1610612761,1610612743,121.0,94.0,0.57,0.379,1,2007-03-23,69,38,31,0.551,67,34,33,0.507
20601021,1610612755,1610612766,106.0,97.0,0.551,0.4429999999999999,1,2007-03-23,69,27,42,0.391,70,26,44,0.371
20601022,1610612753,1610612751,90.0,82.0,0.423,0.345,1,2007-03-23,70,32,38,0.457,69,31,38,0.449
20601023,1610612754,1610612748,95.0,70.0,0.515,0.325,1,2007-03-23,68,31,37,0.456,68,37,31,0.544
20601024,1610612738,1610612742,95.0,109.0,0.364,0.564,0,2007-03-23,69,20,49,0.29,68,57,11,0.838
20601025,1610612737,1610612757,100.0,102.0,0.419,0.407,0,2007-03-23,70,27,43,0.386,69,29,40,0.42
20601026,1610612739,1610612752,90.0,68.0,0.4589999999999999,0.409,1,2007-03-23,69,42,27,0.609,69,30,39,0.435
20601027,1610612740,1610612747,105.0,111.0,0.413,0.5,0,2007-03-23,69,31,38,0.449,69,37,32,0.536
20601028,1610612759,1610612765,90.0,89.0,0.451,0.45,1,2007-03-23,68,48,20,0.706,68,43,25,0.632
20601029,1610612746,1610612762,104.0,72.0,0.506,0.397,1,2007-03-23,69,33,36,0.478,68,44,24,0.647
20601030,1610612744,1610612764,135.0,128.0,0.583,0.5329999999999999,1,2007-03-23,70,33,37,0.471,67,37,30,0.552
20601031,1610612760,1610612750,85.0,82.0,0.364,0.4589999999999999,1,2007-03-23,68,27,41,0.397,68,29,39,0.426
20601015,1610612752,1610612757,86.0,92.0,0.405,0.4579999999999999,0,2007-03-22,68,30,38,0.441,68,28,40,0.412
20601016,1610612763,1610612747,119.0,121.0,0.55,0.532,0,2007-03-22,69,17,52,0.246,68,36,32,0.529
20601017,1610612741,1610612743,109.0,108.0,0.465,0.5539999999999999,1,2007-03-22,70,40,30,0.5710000000000001,66,34,32,0.515
20601018,1610612745,1610612765,91.0,85.0,0.467,0.4039999999999999,1,2007-03-22,69,44,25,0.638,67,43,24,0.642
20601019,1610612756,1610612758,118.0,100.0,0.522,0.389,1,2007-03-22,68,52,16,0.765,69,29,40,0.42
20601007,1610612761,1610612753,92.0,85.0,0.423,0.373,1,2007-03-21,68,37,31,0.544,69,31,38,0.449
20601008,1610612737,1610612748,83.0,91.0,0.402,0.5,0,2007-03-21,69,27,42,0.391,67,37,30,0.552
20601009,1610612738,1610612766,84.0,92.0,0.395,0.4429999999999999,0,2007-03-21,68,20,48,0.294,69,26,43,0.377
20601010,1610612739,1610612742,90.0,98.0,0.4,0.474,0,2007-03-21,68,41,27,0.603,67,56,11,0.836
20601011,1610612749,1610612746,103.0,104.0,0.473,0.506,0,2007-03-21,67,25,42,0.373,68,32,36,0.471
20601012,1610612759,1610612754,90.0,72.0,0.486,0.354,1,2007-03-21,67,47,20,0.701,67,30,37,0.4479999999999999
20601013,1610612758,1610612750,89.0,95.0,0.413,0.474,0,2007-03-21,68,29,39,0.426,67,29,38,0.433
20601014,1610612760,1610612764,106.0,108.0,0.407,0.4429999999999999,0,2007-03-21,67,26,41,0.3879999999999999,66,37,29,0.561
20600997,1610612751,1610612743,90.0,94.0,0.4,0.4,0,2007-03-20,68,31,37,0.456,65,34,31,0.523
20600998,1610612766,1610612739,108.0,100.0,0.446,0.419,1,2007-03-20,68,25,43,0.368,67,41,26,0.612
20600999,1610612752,1610612742,77.0,92.0,0.359,0.531,0,2007-03-20,67,30,37,0.4479999999999999,66,55,11,0.833
20601000,1610612765,1610612755,96.0,75.0,0.506,0.377,1,2007-03-20,66,43,23,0.652,68,26,42,0.382
20601001,1610612763,1610612740,103.0,114.0,0.513,0.6,0,2007-03-20,68,17,51,0.25,68,31,37,0.456
20601002,1610612741,1610612746,89.0,103.0,0.42,0.508,0,2007-03-20,69,39,30,0.565,67,31,36,0.4629999999999999
20601003,1610612762,1610612744,104.0,100.0,0.527,0.45,1,2007-03-20,67,44,23,0.657,69,32,37,0.4639999999999999
20601004,1610612745,1610612754,86.0,76.0,0.392,0.381,1,2007-03-20,68,43,25,0.632,66,30,36,0.455
20601005,1610612756,1610612750,108.0,90.0,0.484,0.395,1,2007-03-20,67,51,16,0.7609999999999999,66,28,38,0.424
20601006,1610612757,1610612764,100.0,98.0,0.442,0.402,1,2007-03-20,67,27,40,0.4029999999999999,65,36,29,0.5539999999999999
20600995,1610612737,1610612758,99.0,76.0,0.483,0.3779999999999999,1,2007-03-19,68,27,41,0.397,67,29,38,0.433
20600996,1610612740,1610612738,106.0,88.0,0.526,0.439,1,2007-03-19,67,30,37,0.4479999999999999,67,20,47,0.299
20600988,1610612752,1610612761,92.0,74.0,0.47,0.342,1,2007-03-18,66,30,36,0.455,67,36,31,0.537
20600989,1610612765,1610612742,88.0,92.0,0.462,0.4920000000000001,0,2007-03-18,65,42,23,0.6459999999999999,65,54,11,0.831
20600990,1610612751,1610612746,101.0,95.0,0.429,0.442,1,2007-03-18,67,31,36,0.4629999999999999,66,30,36,0.455
20600991,1610612748,1610612753,83.0,97.0,0.408,0.5,0,2007-03-18,66,36,30,0.545,68,31,37,0.456
20600992,1610612755,1610612745,74.0,124.0,0.3379999999999999,0.5329999999999999,0,2007-03-18,67,26,41,0.3879999999999999,67,42,25,0.627
20600994,1610612747,1610612750,109.0,102.0,0.525,0.451,1,2007-03-18,67,35,32,0.522,65,28,37,0.431
20600993,1610612757,1610612760,77.0,95.0,0.405,0.425,0,2007-03-18,66,26,40,0.3939999999999999,66,26,40,0.3939999999999999
20600979,1610612764,1610612740,125.0,103.0,0.584,0.488,1,2007-03-17,64,36,28,0.563,66,29,37,0.439
20600980,1610612753,1610612758,83.0,95.0,0.419,0.3379999999999999,0,2007-03-17,67,30,37,0.4479999999999999,66,29,37,0.439
20600981,1610612754,1610612737,113.0,90.0,0.532,0.449,1,2007-03-17,65,30,35,0.462,67,26,41,0.3879999999999999
20600982,1610612739,1610612762,82.0,73.0,0.375,0.349,1,2007-03-17,66,41,25,0.621,66,43,23,0.652
20600983,1610612763,1610612741,104.0,103.0,0.4379999999999999,0.42,1,2007-03-17,67,17,50,0.254,68,39,29,0.574
20600984,1610612759,1610612738,85.0,91.0,0.373,0.442,0,2007-03-17,66,46,20,0.6970000000000001,66,20,46,0.303
20600985,1610612749,1610612766,97.0,91.0,0.4320000000000001,0.456,1,2007-03-17,66,25,41,0.379,67,24,43,0.358
20600986,1610612743,1610612756,131.0,107.0,0.573,0.444,1,2007-03-17,64,33,31,0.516,66,50,16,0.758
20600987,1610612760,1610612744,98.0,99.0,0.413,0.442,0,2007-03-17,65,25,40,0.385,68,32,36,0.471
20600970,1610612761,1610612745,100.0,114.0,0.481,0.495,0,2007-03-16,66,36,30,0.545,66,41,25,0.621
20600971,1610612755,1610612762,89.0,88.0,0.444,0.481,1,2007-03-16,66,26,40,0.3939999999999999,65,43,22,0.662
20600972,1610612766,1610612746,93.0,102.0,0.41,0.5,0,2007-03-16,66,24,42,0.364,65,30,35,0.462
20600973,1610612752,1610612740,90.0,92.0,0.48,0.425,0,2007-03-16,65,29,36,0.446,65,29,36,0.446
20600974,1610612748,1610612758,103.0,97.0,0.545,0.4589999999999999,1,2007-03-16,65,36,29,0.5539999999999999,65,28,37,0.431
20600975,1610612742,1610612738,106.0,101.0,0.507,0.462,1,2007-03-16,64,53,11,0.828,65,19,46,0.292
20600976,1610612756,1610612765,83.0,105.0,0.507,0.536,0,2007-03-16,65,50,15,0.769,64,42,22,0.6559999999999999
20600977,1610612747,1610612757,116.0,111.0,0.512,0.4539999999999999,1,2007-03-16,66,34,32,0.515,65,26,39,0.4
20600978,1610612744,1610612750,106.0,86.0,0.488,0.356,1,2007-03-16,67,31,36,0.4629999999999999,64,28,36,0.4379999999999999
20600967,1610612751,1610612748,86.0,93.0,0.3879999999999999,0.447,0,2007-03-15,66,30,36,0.455,64,35,29,0.547
20600968,1610612749,1610612759,101.0,90.0,0.534,0.431,1,2007-03-15,65,24,41,0.369,65,46,19,0.708
20600969,1610612743,1610612747,113.0,86.0,0.539,0.41,1,2007-03-15,63,32,31,0.508,65,33,32,0.508
20600957,1610612761,1610612752,104.0,94.0,0.507,0.472,1,2007-03-14,65,36,29,0.5539999999999999,64,29,35,0.4529999999999999
20600958,1610612755,1610612741,87.0,88.0,0.5,0.4320000000000001,0,2007-03-14,65,25,40,0.385,67,39,28,0.5820000000000001
20600959,1610612766,1610612758,111.0,108.0,0.467,0.521,1,2007-03-14,65,24,41,0.369,64,28,36,0.4379999999999999
20600960,1610612753,1610612762,101.0,90.0,0.557,0.442,1,2007-03-14,66,30,36,0.455,64,43,21,0.672
20600961,1610612754,1610612764,96.0,112.0,0.473,0.506,0,2007-03-14,64,29,35,0.4529999999999999,63,35,28,0.556
20600962,1610612738,1610612737,109.0,88.0,0.506,0.381,1,2007-03-14,64,19,45,0.297,66,26,40,0.3939999999999999
20600963,1610612763,1610612739,96.0,118.0,0.4629999999999999,0.541,0,2007-03-14,66,16,50,0.242,65,40,25,0.615
20600964,1610612745,1610612746,109.0,105.0,0.506,0.469,1,2007-03-14,65,40,25,0.615,64,29,35,0.4529999999999999
20600965,1610612742,1610612756,127.0,129.0,0.452,0.557,0,2007-03-14,63,52,11,0.825,64,50,14,0.7809999999999999
20600966,1610612757,1610612765,75.0,87.0,0.3939999999999999,0.514,0,2007-03-14,64,26,38,0.406,63,41,22,0.6509999999999999
20600948,1610612737,1610612755,104.0,92.0,0.494,0.43,1,2007-03-13,65,26,39,0.4,64,25,39,0.391
20600949,1610612739,1610612758,124.0,100.0,0.541,0.424,1,2007-03-13,64,39,25,0.609,63,28,35,0.444
20600950,1610612748,1610612762,88.0,86.0,0.434,0.406,1,2007-03-13,63,34,29,0.54,63,43,20,0.6829999999999999
20600951,1610612740,1610612751,108.0,112.0,0.465,0.583,0,2007-03-13,64,28,36,0.4379999999999999,65,30,35,0.462
20600952,1610612759,1610612746,93.0,84.0,0.473,0.494,1,2007-03-13,64,46,18,0.7190000000000001,63,29,34,0.46
20600953,1610612750,1610612754,86.0,81.0,0.38,0.405,1,2007-03-13,63,28,35,0.444,63,29,34,0.46
20600954,1610612741,1610612738,95.0,87.0,0.462,0.479,1,2007-03-13,66,38,28,0.5760000000000001,63,18,45,0.286
20600955,1610612743,1610612757,107.0,99.0,0.452,0.426,1,2007-03-13,62,31,31,0.5,63,26,37,0.413
20600956,1610612760,1610612765,97.0,101.0,0.474,0.514,0,2007-03-13,64,25,39,0.391,62,40,22,0.645
20600943,1610612766,1610612753,119.0,108.0,0.56,0.494,1,2007-03-12,64,23,41,0.359,65,29,36,0.446
20600944,1610612749,1610612761,93.0,108.0,0.5,0.494,0,2007-03-12,64,23,41,0.359,64,35,29,0.547
20600945,1610612763,1610612751,102.0,113.0,0.475,0.488,0,2007-03-12,65,16,49,0.246,64,29,35,0.4529999999999999
20600946,1610612756,1610612745,103.0,82.0,0.5,0.386,1,2007-03-12,63,49,14,0.778,64,39,25,0.609
20600947,1610612744,1610612742,117.0,100.0,0.5710000000000001,0.423,1,2007-03-12,66,30,36,0.455,62,52,10,0.8390000000000001
20600934,1610612761,1610612760,120.0,119.0,0.557,0.474,1,2007-03-11,63,34,29,0.54,63,25,38,0.397
20600935,1610612746,1610612765,80.0,98.0,0.4629999999999999,0.542,0,2007-03-11,62,29,33,0.4679999999999999,61,39,22,0.639
20600938,1610612758,1610612743,101.0,113.0,0.434,0.489,0,2007-03-11,62,28,34,0.452,61,30,31,0.4920000000000001
20600936,1610612738,1610612741,78.0,94.0,0.387,0.514,0,2007-03-11,62,18,44,0.29,65,37,28,0.569
20600939,1610612748,1610612764,106.0,104.0,0.473,0.4379999999999999,1,2007-03-11,62,33,29,0.532,62,34,28,0.5479999999999999
20600940,1610612739,1610612754,99.0,88.0,0.487,0.4,1,2007-03-11,63,38,25,0.603,62,29,33,0.4679999999999999
20600937,1610612745,1610612753,103.0,92.0,0.529,0.452,1,2007-03-11,63,39,24,0.619,64,29,35,0.4529999999999999
20600941,1610612747,1610612742,72.0,108.0,0.368,0.481,0,2007-03-11,64,33,31,0.516,61,52,9,0.852
20600942,1610612757,1610612744,106.0,87.0,0.488,0.373,1,2007-03-11,62,26,36,0.419,65,29,36,0.446
20600927,1610612764,1610612752,89.0,90.0,0.4029999999999999,0.413,0,2007-03-10,61,34,27,0.557,63,29,34,0.46
20600928,1610612766,1610612763,107.0,115.0,0.435,0.556,0,2007-03-10,63,22,41,0.349,64,16,48,0.25
20600929,1610612737,1610612750,99.0,93.0,0.48,0.5,1,2007-03-10,64,25,39,0.391,62,27,35,0.435
20600930,1610612754,1610612755,96.0,100.0,0.513,0.493,0,2007-03-10,61,29,32,0.475,63,25,38,0.397
20600931,1610612759,1610612751,93.0,77.0,0.466,0.42,1,2007-03-10,63,45,18,0.7140000000000001,63,28,35,0.444
20600932,1610612749,1610612739,92.0,94.0,0.47,0.486,0,2007-03-10,63,23,40,0.365,62,37,25,0.597
20600933,1610612762,1610612740,96.0,86.0,0.444,0.452,1,2007-03-10,62,43,19,0.6940000000000001,63,28,35,0.444
20600919,1610612755,1610612747,108.0,92.0,0.474,0.4429999999999999,1,2007-03-09,62,24,38,0.387,63,33,30,0.524
20600920,1610612738,1610612760,118.0,103.0,0.5920000000000001,0.482,1,2007-03-09,61,18,43,0.295,62,25,37,0.4029999999999999
20600921,1610612737,1610612763,106.0,105.0,0.476,0.5,1,2007-03-09,63,24,39,0.381,63,15,48,0.238
20600922,1610612748,1610612750,105.0,91.0,0.583,0.4679999999999999,1,2007-03-09,61,32,29,0.525,61,27,34,0.4429999999999999
20600923,1610612745,1610612751,112.0,91.0,0.462,0.39,1,2007-03-09,62,38,24,0.613,62,28,34,0.452
20600924,1610612743,1610612765,82.0,95.0,0.377,0.4270000000000001,0,2007-03-09,60,29,31,0.483,60,38,22,0.633
20600925,1610612756,1610612740,104.0,103.0,0.465,0.482,1,2007-03-09,62,48,14,0.774,62,28,34,0.452
20600926,1610612744,1610612746,99.0,89.0,0.451,0.408,1,2007-03-09,64,29,35,0.4529999999999999,61,29,32,0.475
20600917,1610612753,1610612741,76.0,100.0,0.3939999999999999,0.466,0,2007-03-08,63,29,34,0.46,64,36,28,0.563
20600918,1610612758,1610612759,93.0,100.0,0.48,0.4320000000000001,0,2007-03-08,61,28,33,0.4589999999999999,62,44,18,0.71
20600907,1610612761,1610612763,94.0,87.0,0.5,0.4429999999999999,1,2007-03-07,62,33,29,0.532,62,15,47,0.242
20600908,1610612755,1610612760,92.0,89.0,0.494,0.38,1,2007-03-07,61,23,38,0.377,61,25,36,0.41
20600909,1610612737,1610612764,100.0,97.0,0.449,0.435,1,2007-03-07,62,23,39,0.371,60,34,26,0.5670000000000001
20600910,1610612738,1610612745,80.0,111.0,0.359,0.513,0,2007-03-07,60,17,43,0.283,61,37,24,0.607
20600911,1610612748,1610612741,103.0,70.0,0.551,0.351,1,2007-03-07,60,31,29,0.517,63,35,28,0.556
20600912,1610612765,1610612739,97.0,101.0,0.435,0.462,0,2007-03-07,59,37,22,0.627,61,36,25,0.59
20600913,1610612749,1610612747,110.0,90.0,0.595,0.471,1,2007-03-07,62,23,39,0.371,62,33,29,0.532
20600914,1610612762,1610612754,94.0,72.0,0.41,0.377,1,2007-03-07,61,42,19,0.6890000000000001,60,29,31,0.483
20600915,1610612756,1610612766,115.0,106.0,0.476,0.442,1,2007-03-07,61,47,14,0.77,62,22,40,0.355
20600916,1610612744,1610612743,110.0,96.0,0.441,0.384,1,2007-03-07,63,28,35,0.444,59,29,30,0.4920000000000001
20600900,1610612764,1610612761,129.0,109.0,0.511,0.519,1,2007-03-06,59,34,25,0.5760000000000001,61,32,29,0.525
20600901,1610612752,1610612760,99.0,100.0,0.471,0.52,0,2007-03-06,62,28,34,0.452,60,25,35,0.417
20600902,1610612750,1610612747,117.0,107.0,0.424,0.3979999999999999,1,2007-03-06,60,27,33,0.45,61,33,28,0.541
20600903,1610612742,1610612751,102.0,89.0,0.488,0.434,1,2007-03-06,60,51,9,0.85,61,28,33,0.4589999999999999
20600904,1610612743,1610612740,106.0,91.0,0.506,0.391,1,2007-03-06,58,29,29,0.5,61,28,33,0.4589999999999999
20600905,1610612758,1610612754,102.0,98.0,0.48,0.488,1,2007-03-06,60,28,32,0.467,59,29,30,0.4920000000000001
20600906,1610612757,1610612759,94.0,99.0,0.5,0.487,0,2007-03-06,61,25,36,0.41,61,43,18,0.705
20600894,1610612753,1610612749,99.0,81.0,0.5,0.395,1,2007-03-05,62,29,33,0.4679999999999999,61,22,39,0.361
20600895,1610612739,1610612745,91.0,85.0,0.444,0.36,1,2007-03-05,60,35,25,0.583,60,36,24,0.6
20600896,1610612748,1610612737,88.0,81.0,0.433,0.408,1,2007-03-05,59,30,29,0.508,61,22,39,0.361
20600897,1610612765,1610612744,93.0,111.0,0.4320000000000001,0.545,0,2007-03-05,58,37,21,0.638,62,27,35,0.435
20600898,1610612762,1610612766,120.0,95.0,0.562,0.466,1,2007-03-05,60,41,19,0.6829999999999999,61,22,39,0.361
20600899,1610612746,1610612759,74.0,88.0,0.375,0.476,0,2007-03-05,60,29,31,0.483,60,42,18,0.7
20600887,1610612738,1610612750,124.0,117.0,0.455,0.5,1,2007-03-04,59,17,42,0.288,59,26,33,0.441
20600888,1610612764,1610612744,107.0,106.0,0.435,0.442,1,2007-03-04,58,33,25,0.569,61,26,35,0.426
20600889,1610612749,1610612741,121.0,126.0,0.489,0.534,0,2007-03-04,60,22,38,0.3670000000000001,62,35,27,0.565
20600890,1610612756,1610612747,99.0,94.0,0.467,0.422,1,2007-03-04,60,46,14,0.767,60,33,27,0.55
20600892,1610612755,1610612751,99.0,86.0,0.494,0.384,1,2007-03-04,60,22,38,0.3670000000000001,60,28,32,0.467
20600891,1610612740,1610612762,94.0,108.0,0.447,0.486,0,2007-03-04,60,28,32,0.467,59,40,19,0.6779999999999999
20600893,1610612760,1610612766,96.0,89.0,0.431,0.4379999999999999,1,2007-03-04,59,24,35,0.407,60,22,38,0.3670000000000001
20600879,1610612751,1610612738,88.0,96.0,0.4639999999999999,0.3429999999999999,0,2007-03-03,59,28,31,0.475,58,16,42,0.276
20600880,1610612737,1610612752,100.0,104.0,0.4379999999999999,0.417,0,2007-03-03,60,22,38,0.3670000000000001,61,28,33,0.4589999999999999
20600881,1610612739,1610612761,120.0,97.0,0.465,0.387,1,2007-03-03,59,34,25,0.5760000000000001,60,32,28,0.5329999999999999
20600882,1610612763,1610612765,89.0,92.0,0.39,0.48,0,2007-03-03,61,15,46,0.246,57,37,20,0.649
20600883,1610612745,1610612759,74.0,97.0,0.385,0.522,0,2007-03-03,59,36,23,0.61,59,41,18,0.695
20600884,1610612742,1610612753,103.0,98.0,0.535,0.514,1,2007-03-03,59,50,9,0.847,61,28,33,0.4589999999999999
20600885,1610612757,1610612758,96.0,104.0,0.42,0.4639999999999999,0,2007-03-03,60,25,35,0.417,59,27,32,0.4579999999999999
20600886,1610612746,1610612754,87.0,64.0,0.4429999999999999,0.357,1,2007-03-03,59,29,30,0.4920000000000001,58,29,29,0.5
20600868,1610612761,1610612749,81.0,94.0,0.368,0.451,0,2007-03-02,59,32,27,0.542,59,22,37,0.373
20600869,1610612755,1610612763,117.0,112.0,0.556,0.473,1,2007-03-02,59,21,38,0.356,60,15,45,0.25
20600870,1610612764,1610612737,93.0,92.0,0.4370000000000001,0.408,1,2007-03-02,57,32,25,0.561,59,22,37,0.373
20600871,1610612752,1610612744,106.0,97.0,0.507,0.449,1,2007-03-02,60,27,33,0.45,60,26,34,0.433
20600872,1610612748,1610612765,85.0,82.0,0.4589999999999999,0.375,1,2007-03-02,58,29,29,0.5,56,36,20,0.643
20600873,1610612759,1610612753,98.0,74.0,0.456,0.431,1,2007-03-02,58,40,18,0.69,60,28,32,0.467
20600874,1610612750,1610612762,83.0,109.0,0.431,0.575,0,2007-03-02,58,26,32,0.4479999999999999,58,39,19,0.672
20600875,1610612741,1610612740,104.0,93.0,0.547,0.395,1,2007-03-02,61,34,27,0.557,59,28,31,0.475
20600877,1610612756,1610612754,115.0,90.0,0.526,0.3879999999999999,1,2007-03-02,59,45,14,0.763,57,29,28,0.509
20600876,1610612743,1610612745,97.0,108.0,0.474,0.418,0,2007-03-02,57,28,29,0.491,58,36,22,0.621
20600878,1610612747,1610612758,108.0,116.0,0.525,0.527,0,2007-03-02,59,33,26,0.5589999999999999,58,26,32,0.4479999999999999
20600865,1610612742,1610612739,95.0,92.0,0.475,0.488,1,2007-03-01,58,49,9,0.845,58,33,25,0.569
20600866,1610612757,1610612766,127.0,90.0,0.583,0.42,1,2007-03-01,59,25,34,0.424,59,22,37,0.373
20600867,1610612760,1610612746,77.0,75.0,0.386,0.4029999999999999,1,2007-03-01,58,23,35,0.397,58,28,30,0.483
20600855,1610612755,1610612756,99.0,94.0,0.4370000000000001,0.444,1,2007-02-28,58,20,38,0.345,58,44,14,0.759
20600856,1610612764,1610612748,83.0,92.0,0.358,0.418,0,2007-02-28,56,31,25,0.5539999999999999,57,28,29,0.491
20600857,1610612738,1610612752,102.0,94.0,0.507,0.493,1,2007-02-28,57,15,42,0.263,59,26,33,0.441
20600858,1610612763,1610612762,88.0,104.0,0.375,0.541,0,2007-02-28,59,15,44,0.254,57,38,19,0.667
20600859,1610612740,1610612737,107.0,100.0,0.434,0.526,1,2007-02-28,58,28,30,0.483,58,22,36,0.379
20600860,1610612741,1610612744,113.0,83.0,0.494,0.402,1,2007-02-28,60,33,27,0.55,59,26,33,0.441
20600861,1610612745,1610612761,90.0,106.0,0.488,0.5710000000000001,0,2007-02-28,57,35,22,0.614,58,32,26,0.552
20600862,1610612743,1610612753,111.0,101.0,0.5,0.488,1,2007-02-28,56,28,28,0.5,59,28,31,0.475
20600863,1610612758,1610612766,135.0,120.0,0.627,0.518,1,2007-02-28,57,25,32,0.439,58,22,36,0.379
20600864,1610612746,1610612760,96.0,91.0,0.457,0.465,1,2007-02-28,57,28,29,0.491,57,22,35,0.386
20600850,1610612739,1610612740,97.0,89.0,0.488,0.476,1,2007-02-27,57,33,24,0.579,57,27,30,0.474
20600851,1610612754,1610612756,92.0,103.0,0.429,0.441,0,2007-02-27,56,29,27,0.518,57,44,13,0.772
20600852,1610612751,1610612764,113.0,101.0,0.457,0.435,1,2007-02-27,58,28,30,0.483,55,31,24,0.564
20600853,1610612749,1610612744,122.0,101.0,0.5379999999999999,0.467,1,2007-02-27,58,21,37,0.362,58,26,32,0.4479999999999999
20600854,1610612750,1610612742,65.0,91.0,0.296,0.451,0,2007-02-27,57,26,31,0.456,57,48,9,0.8420000000000001
20600840,1610612755,1610612758,89.0,82.0,0.429,0.4,1,2007-02-26,57,19,38,0.3329999999999999,56,24,32,0.429
20600841,1610612752,1610612748,99.0,93.0,0.431,0.494,1,2007-02-26,58,26,32,0.4479999999999999,56,27,29,0.482
20600842,1610612763,1610612743,107.0,111.0,0.524,0.494,0,2007-02-26,58,15,43,0.259,55,27,28,0.491
20600843,1610612759,1610612761,107.0,91.0,0.532,0.42,1,2007-02-26,57,39,18,0.684,57,31,26,0.544
20600844,1610612741,1610612753,87.0,94.0,0.395,0.4379999999999999,0,2007-02-26,59,32,27,0.542,58,28,30,0.483
20600845,1610612745,1610612738,72.0,77.0,0.321,0.342,0,2007-02-26,56,35,21,0.625,56,14,42,0.25
20600846,1610612742,1610612737,110.0,87.0,0.5429999999999999,0.515,1,2007-02-26,56,47,9,0.8390000000000001,57,22,35,0.386
20600847,1610612762,1610612747,94.0,102.0,0.407,0.441,0,2007-02-26,56,37,19,0.6609999999999999,58,33,25,0.569
20600848,1610612760,1610612757,97.0,73.0,0.457,0.4,1,2007-02-26,56,22,34,0.3929999999999999,58,24,34,0.414
20600849,1610612746,1610612766,100.0,93.0,0.429,0.4429999999999999,1,2007-02-26,56,27,29,0.482,57,22,35,0.386
20600832,1610612765,1610612741,95.0,93.0,0.3779999999999999,0.48,1,2007-02-25,55,36,19,0.655,58,32,26,0.552
20600834,1610612753,1610612745,93.0,97.0,0.392,0.433,0,2007-02-25,57,27,30,0.474,55,35,20,0.636
20600835,1610612748,1610612739,86.0,81.0,0.43,0.36,1,2007-02-25,55,27,28,0.491,56,32,24,0.5710000000000001
20600836,1610612750,1610612764,98.0,94.0,0.4370000000000001,0.376,1,2007-02-25,56,26,30,0.4639999999999999,54,31,23,0.574
20600833,1610612737,1610612756,106.0,115.0,0.482,0.506,0,2007-02-25,56,22,34,0.3929999999999999,56,43,13,0.768
20600837,1610612751,1610612752,101.0,92.0,0.481,0.473,1,2007-02-25,57,27,30,0.474,57,25,32,0.439
20600838,1610612744,1610612747,85.0,102.0,0.43,0.4579999999999999,0,2007-02-25,57,26,31,0.456,57,32,25,0.561
20600839,1610612754,1610612758,93.0,110.0,0.382,0.456,0,2007-02-25,55,29,26,0.527,55,24,31,0.436
20600826,1610612746,1610612744,103.0,90.0,0.4679999999999999,0.439,1,2007-02-24,55,26,29,0.473,56,26,30,0.4639999999999999
20600827,1610612766,1610612761,76.0,93.0,0.3289999999999999,0.449,0,2007-02-24,56,22,34,0.3929999999999999,56,31,25,0.5539999999999999
20600828,1610612759,1610612760,102.0,71.0,0.532,0.3379999999999999,1,2007-02-24,56,38,18,0.679,55,21,34,0.382
20600829,1610612749,1610612755,109.0,90.0,0.526,0.514,1,2007-02-24,57,20,37,0.351,56,18,38,0.321
20600830,1610612742,1610612743,115.0,95.0,0.511,0.44,1,2007-02-24,55,46,9,0.836,54,26,28,0.481
20600831,1610612762,1610612738,105.0,87.0,0.513,0.425,1,2007-02-24,55,37,18,0.6729999999999999,55,13,42,0.236
20600814,1610612761,1610612754,110.0,88.0,0.562,0.386,1,2007-02-23,55,30,25,0.545,54,29,25,0.537
20600815,1610612766,1610612755,102.0,87.0,0.512,0.444,1,2007-02-23,55,22,33,0.4,55,18,37,0.327
20600816,1610612753,1610612765,89.0,94.0,0.4679999999999999,0.3939999999999999,0,2007-02-23,56,27,29,0.482,54,35,19,0.648
20600817,1610612751,1610612758,109.0,96.0,0.526,0.4029999999999999,1,2007-02-23,56,26,30,0.4639999999999999,54,23,31,0.426
20600818,1610612752,1610612749,95.0,93.0,0.423,0.442,1,2007-02-23,56,25,31,0.446,56,19,37,0.3389999999999999
20600819,1610612737,1610612745,105.0,99.0,0.474,0.457,1,2007-02-23,55,22,33,0.4,54,34,20,0.63
20600820,1610612741,1610612764,105.0,90.0,0.4270000000000001,0.421,1,2007-02-23,57,32,25,0.561,53,31,22,0.585
20600821,1610612740,1610612760,98.0,97.0,0.371,0.521,1,2007-02-23,56,27,29,0.482,54,21,33,0.389
20600822,1610612750,1610612756,104.0,116.0,0.5,0.518,0,2007-02-23,55,25,30,0.455,55,42,13,0.764
20600823,1610612757,1610612763,102.0,103.0,0.5,0.452,0,2007-02-23,57,24,33,0.421,57,15,42,0.263
20600824,1610612743,1610612762,104.0,114.0,0.522,0.482,0,2007-02-23,53,26,27,0.491,54,36,18,0.667
20600825,1610612747,1610612738,122.0,96.0,0.542,0.421,1,2007-02-23,56,31,25,0.5539999999999999,54,13,41,0.241
20600811,1610612764,1610612758,109.0,106.0,0.475,0.506,1,2007-02-22,52,31,21,0.596,53,23,30,0.434
20600812,1610612739,1610612741,78.0,84.0,0.384,0.436,0,2007-02-22,55,32,23,0.5820000000000001,56,31,25,0.5539999999999999
20600813,1610612742,1610612748,112.0,100.0,0.542,0.439,1,2007-02-22,54,45,9,0.833,54,26,28,0.481
20600800,1610612761,1610612739,85.0,86.0,0.423,0.434,0,2007-02-21,54,29,25,0.537,54,32,22,0.593
20600801,1610612755,1610612752,104.0,84.0,0.551,0.429,1,2007-02-21,54,18,36,0.3329999999999999,55,24,31,0.436
20600802,1610612737,1610612759,96.0,103.0,0.44,0.4270000000000001,0,2007-02-21,54,21,33,0.389,55,37,18,0.6729999999999999
20600803,1610612754,1610612749,136.0,129.0,0.494,0.489,1,2007-02-21,53,29,24,0.547,55,19,36,0.345
20600804,1610612751,1610612740,107.0,111.0,0.481,0.507,0,2007-02-21,55,25,30,0.455,55,26,29,0.473
20600805,1610612765,1610612753,110.0,88.0,0.52,0.47,1,2007-02-21,53,34,19,0.642,55,27,28,0.491
20600806,1610612750,1610612766,95.0,100.0,0.486,0.435,0,2007-02-21,54,25,29,0.4629999999999999,54,21,33,0.389
20600807,1610612745,1610612748,112.0,102.0,0.506,0.446,1,2007-02-21,53,34,19,0.642,53,26,27,0.491
20600808,1610612756,1610612738,118.0,108.0,0.494,0.4320000000000001,1,2007-02-21,54,41,13,0.759,53,13,40,0.245
20600809,1610612747,1610612757,108.0,112.0,0.47,0.597,0,2007-02-21,55,30,25,0.545,56,24,32,0.429
20600810,1610612744,1610612763,118.0,115.0,0.46,0.446,1,2007-02-21,55,26,29,0.473,56,14,42,0.25
20600790,1610612764,1610612750,112.0,100.0,0.506,0.43,1,2007-02-20,51,30,21,0.588,53,25,28,0.472
20600791,1610612766,1610612740,104.0,100.0,0.447,0.4579999999999999,1,2007-02-20,53,20,33,0.377,54,25,29,0.4629999999999999
20600792,1610612752,1610612753,100.0,94.0,0.4920000000000001,0.424,1,2007-02-20,54,24,30,0.444,54,27,27,0.5
20600793,1610612749,1610612765,83.0,84.0,0.4579999999999999,0.405,0,2007-02-20,54,19,35,0.352,52,33,19,0.635
20600794,1610612759,1610612743,95.0,80.0,0.4629999999999999,0.425,1,2007-02-20,54,36,18,0.667,52,26,26,0.5
20600795,1610612741,1610612737,106.0,81.0,0.477,0.356,1,2007-02-20,55,30,25,0.545,53,21,32,0.396
20600796,1610612758,1610612738,104.0,101.0,0.47,0.5,1,2007-02-20,52,23,29,0.442,52,13,39,0.25
20600797,1610612757,1610612762,103.0,100.0,0.494,0.425,1,2007-02-20,55,23,32,0.418,53,35,18,0.66
20600798,1610612760,1610612763,121.0,105.0,0.466,0.4379999999999999,1,2007-02-20,53,21,32,0.396,55,14,41,0.255
20600799,1610612746,1610612756,90.0,115.0,0.43,0.536,0,2007-02-20,54,25,29,0.4629999999999999,53,40,13,0.755
20600788,1610612745,1610612742,77.0,80.0,0.3879999999999999,0.417,0,2007-02-15,52,33,19,0.635,53,44,9,0.83
20600789,1610612747,1610612739,108.0,114.0,0.419,0.473,0,2007-02-15,54,30,24,0.556,53,31,22,0.585
20600775,1610612761,1610612751,120.0,109.0,0.589,0.506,1,2007-02-14,53,29,24,0.547,54,25,29,0.4629999999999999
20600776,1610612755,1610612764,85.0,92.0,0.38,0.402,0,2007-02-14,53,17,36,0.321,50,29,21,0.58
20600777,1610612766,1610612741,100.0,85.0,0.486,0.384,1,2007-02-14,52,19,33,0.365,54,29,25,0.537
20600778,1610612753,1610612757,103.0,91.0,0.526,0.405,1,2007-02-14,53,27,26,0.509,54,22,32,0.407
20600779,1610612754,1610612763,114.0,104.0,0.467,0.488,1,2007-02-14,52,28,24,0.5379999999999999,54,14,40,0.259
20600780,1610612738,1610612749,117.0,97.0,0.5489999999999999,0.513,1,2007-02-14,51,13,38,0.255,53,19,34,0.358
20600781,1610612765,1610612759,81.0,90.0,0.41,0.507,0,2007-02-14,51,32,19,0.627,53,35,18,0.66
20600782,1610612740,1610612758,110.0,93.0,0.5770000000000001,0.4029999999999999,1,2007-02-14,53,25,28,0.472,51,22,29,0.431
20600783,1610612750,1610612743,99.0,94.0,0.452,0.514,1,2007-02-14,52,25,27,0.481,51,26,25,0.51
20600784,1610612762,1610612739,99.0,98.0,0.494,0.4379999999999999,1,2007-02-14,52,35,17,0.6729999999999999,52,30,22,0.5770000000000001
20600785,1610612760,1610612756,114.0,90.0,0.5429999999999999,0.389,1,2007-02-14,52,20,32,0.385,52,39,13,0.75
20600786,1610612746,1610612737,93.0,96.0,0.4379999999999999,0.402,0,2007-02-14,53,25,28,0.472,52,21,31,0.4039999999999999
20600787,1610612744,1610612752,120.0,101.0,0.6,0.426,1,2007-02-14,54,25,29,0.4629999999999999,53,23,30,0.434
20600768,1610612751,1610612759,82.0,107.0,0.39,0.534,0,2007-02-13,53,25,28,0.472,52,34,18,0.654
20600769,1610612748,1610612757,104.0,85.0,0.557,0.423,1,2007-02-13,52,26,26,0.5,53,22,31,0.415
20600770,1610612749,1610612742,93.0,99.0,0.413,0.487,0,2007-02-13,52,19,33,0.365,52,43,9,0.8270000000000001
20600771,1610612763,1610612740,108.0,104.0,0.429,0.3979999999999999,1,2007-02-13,53,14,39,0.264,52,24,28,0.462
20600772,1610612741,1610612761,111.0,112.0,0.5329999999999999,0.539,0,2007-02-13,53,29,24,0.547,52,28,24,0.5379999999999999
20600773,1610612745,1610612758,109.0,104.0,0.483,0.444,1,2007-02-13,51,33,18,0.647,50,22,28,0.44
20600774,1610612747,1610612752,106.0,107.0,0.425,0.5,0,2007-02-13,53,30,23,0.5660000000000001,52,23,29,0.442
20600765,1610612765,1610612746,92.0,74.0,0.466,0.324,1,2007-02-12,50,32,18,0.64,52,25,27,0.481
20600766,1610612743,1610612744,123.0,111.0,0.51,0.53,1,2007-02-12,50,26,24,0.52,53,24,29,0.4529999999999999
20600767,1610612762,1610612737,102.0,76.0,0.444,0.37,1,2007-02-12,51,34,17,0.667,51,20,31,0.392
20600756,1610612764,1610612757,73.0,94.0,0.38,0.5,0,2007-02-11,49,28,21,0.5710000000000001,52,22,30,0.423
20600757,1610612748,1610612759,100.0,85.0,0.528,0.429,1,2007-02-11,51,25,26,0.49,51,33,18,0.647
20600758,1610612754,1610612746,94.0,80.0,0.494,0.368,1,2007-02-11,51,27,24,0.529,51,25,26,0.49
20600759,1610612739,1610612747,99.0,90.0,0.4270000000000001,0.397,1,2007-02-11,51,30,21,0.588,52,30,22,0.5770000000000001
20600760,1610612750,1610612738,109.0,107.0,0.5,0.5379999999999999,1,2007-02-11,51,24,27,0.471,50,12,38,0.24
20600761,1610612755,1610612742,89.0,106.0,0.43,0.52,0,2007-02-11,52,17,35,0.327,51,42,9,0.8240000000000001
20600762,1610612756,1610612741,103.0,116.0,0.407,0.506,0,2007-02-11,51,39,12,0.765,52,29,23,0.5579999999999999
20600763,1610612744,1610612737,105.0,106.0,0.4639999999999999,0.506,0,2007-02-11,52,24,28,0.462,50,20,30,0.4
20600764,1610612758,1610612760,103.0,114.0,0.4629999999999999,0.4679999999999999,0,2007-02-11,49,22,27,0.449,51,19,32,0.373
20600749,1610612751,1610612753,93.0,78.0,0.476,0.408,1,2007-02-10,52,25,27,0.481,52,26,26,0.5
20600750,1610612765,1610612761,98.0,92.0,0.5,0.4579999999999999,1,2007-02-10,49,31,18,0.633,51,27,24,0.529
20600751,1610612740,1610612763,114.0,99.0,0.5579999999999999,0.439,1,2007-02-10,51,24,27,0.471,52,13,39,0.25
20600752,1610612749,1610612743,102.0,109.0,0.5,0.482,0,2007-02-10,51,19,32,0.373,49,25,24,0.51
20600753,1610612745,1610612766,104.0,83.0,0.452,0.446,1,2007-02-10,50,32,18,0.64,51,18,33,0.353
20600754,1610612762,1610612752,104.0,102.0,0.488,0.487,1,2007-02-10,50,33,17,0.66,51,22,29,0.431
20600755,1610612760,1610612758,93.0,114.0,0.389,0.5,0,2007-02-10,50,18,32,0.36,48,22,26,0.4579999999999999
20600738,1610612761,1610612747,96.0,92.0,0.486,0.4320000000000001,1,2007-02-09,50,27,23,0.54,51,30,21,0.588
20600739,1610612755,1610612746,89.0,90.0,0.423,0.442,0,2007-02-09,51,17,34,0.3329999999999999,50,25,25,0.5
20600740,1610612766,1610612757,100.0,108.0,0.4,0.4,0,2007-02-09,50,18,32,0.36,51,21,30,0.412
20600741,1610612753,1610612759,106.0,104.0,0.545,0.506,1,2007-02-09,51,26,25,0.51,50,33,17,0.66
20600742,1610612754,1610612743,95.0,102.0,0.4270000000000001,0.485,0,2007-02-09,50,26,24,0.52,48,24,24,0.5
20600743,1610612738,1610612751,78.0,92.0,0.346,0.451,0,2007-02-09,49,12,37,0.245,51,24,27,0.471
20600744,1610612739,1610612748,103.0,79.0,0.482,0.425,1,2007-02-09,50,29,21,0.58,50,24,26,0.48
20600745,1610612763,1610612750,105.0,97.0,0.419,0.5,1,2007-02-09,51,13,38,0.255,50,23,27,0.46
20600746,1610612742,1610612745,95.0,74.0,0.45,0.3329999999999999,1,2007-02-09,50,41,9,0.82,49,31,18,0.633
20600747,1610612756,1610612737,111.0,120.0,0.494,0.519,0,2007-02-09,50,39,11,0.78,49,19,30,0.3879999999999999
20600748,1610612744,1610612741,123.0,121.0,0.4270000000000001,0.452,1,2007-02-09,51,24,27,0.471,51,28,23,0.5489999999999999
20600735,1610612765,1610612747,93.0,78.0,0.449,0.3779999999999999,1,2007-02-08,48,30,18,0.625,50,30,20,0.6
20600736,1610612740,1610612749,109.0,101.0,0.371,0.421,1,2007-02-08,50,23,27,0.46,50,19,31,0.38
20600737,1610612758,1610612741,86.0,77.0,0.431,0.3329999999999999,1,2007-02-08,47,21,26,0.447,50,28,22,0.56
20600725,1610612761,1610612753,113.0,103.0,0.52,0.506,1,2007-02-07,49,26,23,0.531,50,25,25,0.5
20600726,1610612755,1610612766,92.0,83.0,0.446,0.352,1,2007-02-07,50,17,33,0.34,49,18,31,0.3670000000000001
20600727,1610612764,1610612759,83.0,110.0,0.326,0.5379999999999999,0,2007-02-07,48,28,20,0.583,49,33,16,0.6729999999999999
20600728,1610612737,1610612751,85.0,87.0,0.368,0.461,0,2007-02-07,48,18,30,0.375,50,23,27,0.46
20600729,1610612739,1610612746,94.0,77.0,0.41,0.346,1,2007-02-07,49,28,21,0.5710000000000001,49,24,25,0.49
20600730,1610612754,1610612760,102.0,103.0,0.396,0.5529999999999999,0,2007-02-07,49,26,23,0.531,49,18,31,0.3670000000000001
20600731,1610612738,1610612748,79.0,91.0,0.32,0.515,0,2007-02-07,48,12,36,0.25,49,24,25,0.49
20600732,1610612750,1610612744,121.0,93.0,0.505,0.37,1,2007-02-07,49,23,26,0.469,50,23,27,0.46
20600733,1610612742,1610612763,113.0,97.0,0.466,0.487,1,2007-02-07,49,40,9,0.816,50,12,38,0.24
20600734,1610612743,1610612740,112.0,114.0,0.449,0.434,0,2007-02-07,47,23,24,0.489,49,22,27,0.449
20600720,1610612752,1610612746,102.0,90.0,0.462,0.4429999999999999,1,2007-02-06,50,22,28,0.44,48,24,24,0.5
20600721,1610612765,1610612738,109.0,102.0,0.579,0.56,1,2007-02-06,47,29,18,0.617,47,12,35,0.255
20600722,1610612749,1610612753,116.0,111.0,0.506,0.527,1,2007-02-06,49,19,30,0.3879999999999999,49,25,24,0.51
20600723,1610612763,1610612745,90.0,98.0,0.4320000000000001,0.494,0,2007-02-06,49,12,37,0.245,48,31,17,0.6459999999999999
20600724,1610612757,1610612756,102.0,109.0,0.434,0.473,0,2007-02-06,50,20,30,0.4,49,39,10,0.7959999999999999
20600712,1610612755,1610612751,100.0,98.0,0.446,0.435,1,2007-02-05,49,16,33,0.327,49,22,27,0.449
20600713,1610612764,1610612760,118.0,108.0,0.494,0.536,1,2007-02-05,47,28,19,0.596,48,17,31,0.354
20600714,1610612737,1610612747,83.0,90.0,0.3939999999999999,0.4270000000000001,0,2007-02-05,47,18,29,0.3829999999999999,49,30,19,0.612
20600715,1610612754,1610612744,98.0,113.0,0.351,0.435,0,2007-02-05,48,26,22,0.542,49,23,26,0.469
20600716,1610612748,1610612766,113.0,93.0,0.62,0.456,1,2007-02-05,48,23,25,0.479,48,18,30,0.375
20600717,1610612745,1610612750,105.0,77.0,0.471,0.411,1,2007-02-05,47,30,17,0.638,48,22,26,0.4579999999999999
20600373,1610612743,1610612756,108.0,113.0,0.473,0.481,0,2007-02-05,46,23,23,0.5,48,38,10,0.792
20600718,1610612762,1610612741,100.0,95.0,0.5,0.4,1,2007-02-05,49,32,17,0.653,49,28,21,0.5710000000000001
20600719,1610612758,1610612740,105.0,99.0,0.526,0.424,1,2007-02-05,46,20,26,0.435,48,21,27,0.4379999999999999
20600709,1610612761,1610612746,122.0,110.0,0.5870000000000001,0.47,1,2007-02-04,48,25,23,0.521,47,24,23,0.511
20600710,1610612751,1610612737,99.0,101.0,0.493,0.4629999999999999,0,2007-02-04,48,22,26,0.4579999999999999,46,18,28,0.391
20600711,1610612739,1610612765,78.0,90.0,0.425,0.485,0,2007-02-04,48,27,21,0.563,46,28,18,0.609
20600699,1610612764,1610612747,102.0,118.0,0.363,0.519,0,2007-02-03,46,27,19,0.5870000000000001,48,29,19,0.604
20600700,1610612766,1610612744,98.0,90.0,0.434,0.419,1,2007-02-03,47,18,29,0.3829999999999999,48,22,26,0.4579999999999999
20600701,1610612753,1610612752,86.0,94.0,0.377,0.5,0,2007-02-03,48,25,23,0.521,49,21,28,0.429
20600702,1610612763,1610612754,110.0,116.0,0.494,0.529,0,2007-02-03,48,12,36,0.25,47,26,21,0.5529999999999999
20600703,1610612749,1610612748,98.0,117.0,0.447,0.542,0,2007-02-03,48,18,30,0.375,47,22,25,0.4679999999999999
20600704,1610612745,1610612740,74.0,87.0,0.3720000000000001,0.4029999999999999,0,2007-02-03,46,29,17,0.63,47,21,26,0.447
20600705,1610612742,1610612750,94.0,93.0,0.416,0.4679999999999999,1,2007-02-03,48,39,9,0.813,47,22,25,0.4679999999999999
20600706,1610612756,1610612762,105.0,108.0,0.534,0.506,0,2007-02-03,47,37,10,0.787,48,31,17,0.6459999999999999
20600707,1610612758,1610612743,94.0,87.0,0.379,0.381,1,2007-02-03,45,19,26,0.422,45,23,22,0.511
20600708,1610612757,1610612741,86.0,88.0,0.423,0.429,0,2007-02-03,49,20,29,0.408,48,28,20,0.583
20600689,1610612755,1610612744,101.0,102.0,0.481,0.465,0,2007-02-02,48,15,33,0.313,47,22,25,0.4679999999999999
20600691,1610612754,1610612747,95.0,84.0,0.43,0.381,1,2007-02-02,46,25,21,0.5429999999999999,47,28,19,0.596
20600692,1610612738,1610612746,89.0,100.0,0.486,0.4529999999999999,0,2007-02-02,46,12,34,0.261,46,24,22,0.522
20600693,1610612737,1610612761,91.0,103.0,0.456,0.493,0,2007-02-02,45,17,28,0.3779999999999999,47,24,23,0.511
20600694,1610612739,1610612766,101.0,81.0,0.475,0.418,1,2007-02-02,47,27,20,0.574,46,17,29,0.37
20600690,1610612753,1610612751,119.0,86.0,0.625,0.446,1,2007-02-02,47,25,22,0.532,47,22,25,0.4679999999999999
20600695,1610612765,1610612749,96.0,86.0,0.429,0.442,1,2007-02-02,45,27,18,0.6,47,18,29,0.3829999999999999
20600696,1610612740,1610612750,90.0,83.0,0.435,0.3879999999999999,1,2007-02-02,46,20,26,0.435,46,22,24,0.478
20600697,1610612743,1610612757,114.0,107.0,0.532,0.417,1,2007-02-02,44,23,21,0.523,48,20,28,0.417
20600698,1610612760,1610612741,101.0,107.0,0.44,0.506,0,2007-02-02,47,17,30,0.362,47,27,20,0.574
20600687,1610612748,1610612739,92.0,89.0,0.455,0.434,1,2007-02-01,46,21,25,0.457,46,26,20,0.565
20600688,1610612756,1610612759,103.0,87.0,0.44,0.386,1,2007-02-01,46,37,9,0.804,48,32,16,0.667
20600674,1610612761,1610612764,119.0,109.0,0.593,0.493,1,2007-01-31,46,23,23,0.5,45,27,18,0.6
20600675,1610612766,1610612752,104.0,87.0,0.462,0.364,1,2007-01-31,45,17,28,0.3779999999999999,48,20,28,0.417
20600676,1610612737,1610612744,115.0,94.0,0.482,0.4379999999999999,1,2007-01-31,44,17,27,0.386,46,21,25,0.457
20600677,1610612753,1610612749,98.0,73.0,0.466,0.373,1,2007-01-31,46,24,22,0.522,46,18,28,0.391
20600678,1610612738,1610612747,98.0,111.0,0.45,0.494,0,2007-01-31,45,12,33,0.267,46,28,18,0.609
20600679,1610612751,1610612765,89.0,113.0,0.407,0.544,0,2007-01-31,46,22,24,0.478,44,26,18,0.591
20600680,1610612763,1610612742,94.0,95.0,0.44,0.425,0,2007-01-31,47,12,35,0.255,47,38,9,0.809
20600681,1610612740,1610612755,78.0,89.0,0.3929999999999999,0.4029999999999999,0,2007-01-31,45,19,26,0.422,47,15,32,0.319
20600683,1610612750,1610612758,98.0,100.0,0.488,0.417,0,2007-01-31,45,22,23,0.489,44,18,26,0.409
20600682,1610612745,1610612760,112.0,102.0,0.527,0.517,1,2007-01-31,45,29,16,0.644,46,17,29,0.37
20600684,1610612762,1610612759,97.0,93.0,0.421,0.441,1,2007-01-31,47,30,17,0.638,47,32,15,0.6809999999999999
20600685,1610612757,1610612743,100.0,91.0,0.481,0.444,1,2007-01-31,47,20,27,0.426,43,22,21,0.512
20600686,1610612746,1610612741,110.0,98.0,0.4629999999999999,0.471,1,2007-01-31,45,23,22,0.511,46,26,20,0.565
20600668,1610612764,1610612765,104.0,99.0,0.494,0.521,1,2007-01-30,44,27,17,0.614,43,25,18,0.581
20600669,1610612739,1610612744,124.0,97.0,0.494,0.408,1,2007-01-30,45,26,19,0.578,45,21,24,0.467
20600670,1610612754,1610612738,103.0,96.0,0.536,0.4629999999999999,1,2007-01-30,45,24,21,0.5329999999999999,44,12,32,0.273
20600671,1610612752,1610612747,99.0,94.0,0.493,0.435,1,2007-01-30,47,20,27,0.426,45,27,18,0.6
20600672,1610612748,1610612749,110.0,80.0,0.603,0.405,1,2007-01-30,45,20,25,0.444,45,18,27,0.4
20600673,1610612742,1610612760,122.0,102.0,0.545,0.471,1,2007-01-30,46,37,9,0.804,45,17,28,0.3779999999999999
20600661,1610612737,1610612753,93.0,83.0,0.485,0.3939999999999999,1,2007-01-29,43,16,27,0.3720000000000001,45,23,22,0.511
20600662,1610612763,1610612758,124.0,117.0,0.586,0.473,1,2007-01-29,46,12,34,0.261,43,17,26,0.395
20600663,1610612740,1610612757,103.0,91.0,0.487,0.42,1,2007-01-29,44,19,25,0.4320000000000001,46,19,27,0.413
20600664,1610612750,1610612756,121.0,112.0,0.59,0.5,1,2007-01-29,44,22,22,0.5,45,36,9,0.8
20600665,1610612745,1610612755,105.0,84.0,0.506,0.386,1,2007-01-29,44,28,16,0.636,46,14,32,0.304
20600666,1610612743,1610612766,101.0,105.0,0.4629999999999999,0.494,0,2007-01-29,42,22,20,0.524,44,16,28,0.364
20600667,1610612762,1610612751,115.0,116.0,0.514,0.535,0,2007-01-29,46,29,17,0.63,45,22,23,0.489
20600658,1610612738,1610612764,91.0,105.0,0.39,0.471,0,2007-01-28,43,12,31,0.2789999999999999,43,26,17,0.605
20600655,1610612739,1610612756,100.0,115.0,0.476,0.5710000000000001,0,2007-01-28,44,25,19,0.568,44,36,8,0.818
20600656,1610612749,1610612752,107.0,105.0,0.506,0.5,1,2007-01-28,44,18,26,0.409,46,19,27,0.413
20600657,1610612747,1610612759,94.0,96.0,0.4270000000000001,0.337,0,2007-01-28,44,27,17,0.614,46,32,14,0.696
20600659,1610612765,1610612754,95.0,87.0,0.37,0.425,1,2007-01-28,42,25,17,0.595,44,23,21,0.523
20600660,1610612760,1610612746,76.0,98.0,0.3289999999999999,0.429,0,2007-01-28,44,17,27,0.386,44,22,22,0.5
20600646,1610612737,1610612755,89.0,104.0,0.4029999999999999,0.542,0,2007-01-27,42,15,27,0.357,45,14,31,0.311
20600647,1610612754,1610612761,102.0,84.0,0.487,0.423,1,2007-01-27,43,23,20,0.535,45,22,23,0.489
20600648,1610612763,1610612757,132.0,135.0,0.528,0.486,0,2007-01-27,45,11,34,0.244,45,19,26,0.422
20600649,1610612740,1610612762,94.0,83.0,0.471,0.375,1,2007-01-27,43,18,25,0.419,45,29,16,0.644
20600650,1610612741,1610612748,100.0,97.0,0.421,0.411,1,2007-01-27,45,26,19,0.578,44,19,25,0.4320000000000001
20600651,1610612742,1610612758,106.0,104.0,0.526,0.527,1,2007-01-27,45,36,9,0.8,42,17,25,0.405
20600652,1610612743,1610612751,102.0,112.0,0.442,0.4639999999999999,0,2007-01-27,41,22,19,0.537,44,21,23,0.477
20600653,1610612746,1610612750,87.0,101.0,0.429,0.44,0,2007-01-27,43,21,22,0.488,43,21,22,0.488
20600654,1610612744,1610612766,131.0,105.0,0.557,0.446,1,2007-01-27,44,21,23,0.477,43,15,28,0.349
20600634,1610612761,1610612738,96.0,90.0,0.413,0.481,1,2007-01-26,44,22,22,0.5,42,12,30,0.286
20600635,1610612755,1610612739,97.0,105.0,0.5,0.494,0,2007-01-26,44,13,31,0.295,43,25,18,0.581
20600636,1610612753,1610612737,90.0,93.0,0.565,0.552,0,2007-01-26,44,23,21,0.523,41,15,26,0.366
20600638,1610612765,1610612764,96.0,99.0,0.4629999999999999,0.4379999999999999,0,2007-01-26,41,24,17,0.585,42,25,17,0.595
20600637,1610612752,1610612748,116.0,96.0,0.536,0.431,1,2007-01-26,45,19,26,0.422,43,19,24,0.442
20600639,1610612740,1610612758,88.0,84.0,0.444,0.364,1,2007-01-26,42,17,25,0.405,41,17,24,0.415
20600640,1610612759,1610612763,112.0,96.0,0.608,0.449,1,2007-01-26,45,31,14,0.6890000000000001,44,11,33,0.25
20600641,1610612749,1610612756,90.0,98.0,0.409,0.425,0,2007-01-26,43,17,26,0.395,43,35,8,0.8140000000000001
20600642,1610612745,1610612757,99.0,69.0,0.48,0.361,1,2007-01-26,43,27,16,0.628,44,18,26,0.409
20600643,1610612762,1610612743,116.0,111.0,0.512,0.5,1,2007-01-26,44,29,15,0.659,40,22,18,0.55
20600644,1610612747,1610612766,97.0,106.0,0.42,0.446,0,2007-01-26,43,27,16,0.628,42,15,27,0.357
20600645,1610612760,1610612750,102.0,100.0,0.461,0.5,1,2007-01-26,43,17,26,0.395,42,20,22,0.476
20600632,1610612741,1610612742,96.0,85.0,0.429,0.312,1,2007-01-25,44,25,19,0.568,44,35,9,0.795
20600633,1610612746,1610612751,102.0,101.0,0.436,0.5,1,2007-01-25,42,21,21,0.5,43,20,23,0.465
20600621,1610612761,1610612740,90.0,88.0,0.412,0.422,1,2007-01-24,43,21,22,0.488,41,16,25,0.39
20600622,1610612766,1610612765,92.0,103.0,0.4579999999999999,0.521,0,2007-01-24,41,14,27,0.341,40,24,16,0.6
20600623,1610612739,1610612755,115.0,118.0,0.3939999999999999,0.524,0,2007-01-24,42,24,18,0.5710000000000001,43,13,30,0.302
20600624,1610612754,1610612748,96.0,94.0,0.3929999999999999,0.435,1,2007-01-24,42,22,20,0.524,42,19,23,0.452
20600625,1610612738,1610612737,76.0,82.0,0.316,0.361,0,2007-01-24,41,12,29,0.293,40,14,26,0.35
20600626,1610612752,1610612756,107.0,112.0,0.471,0.4629999999999999,0,2007-01-24,44,18,26,0.409,42,34,8,0.81
20600627,1610612759,1610612745,85.0,90.0,0.42,0.5,0,2007-01-24,44,30,14,0.682,42,26,16,0.619
20600628,1610612762,1610612763,130.0,132.0,0.551,0.517,0,2007-01-24,43,28,15,0.6509999999999999,43,11,32,0.256
20600629,1610612758,1610612749,114.0,106.0,0.532,0.474,1,2007-01-24,40,17,23,0.425,42,17,25,0.405
20600630,1610612757,1610612750,101.0,98.0,0.4320000000000001,0.481,1,2007-01-24,43,18,25,0.419,41,20,21,0.488
20600631,1610612744,1610612751,110.0,109.0,0.4639999999999999,0.513,1,2007-01-24,43,20,23,0.465,42,20,22,0.476
20600615,1610612755,1610612740,102.0,96.0,0.494,0.422,1,2007-01-23,42,12,30,0.286,40,16,24,0.4
20600616,1610612764,1610612756,105.0,127.0,0.461,0.608,0,2007-01-23,41,24,17,0.585,41,33,8,0.805
20600617,1610612753,1610612742,95.0,111.0,0.4429999999999999,0.5579999999999999,0,2007-01-23,43,23,20,0.535,43,35,8,0.8140000000000001
20600618,1610612741,1610612737,94.0,86.0,0.474,0.429,1,2007-01-23,43,24,19,0.5579999999999999,39,13,26,0.3329999999999999
20600619,1610612760,1610612743,112.0,117.0,0.517,0.471,0,2007-01-23,42,16,26,0.381,39,22,17,0.564
20600620,1610612746,1610612749,115.0,96.0,0.523,0.4479999999999999,1,2007-01-23,41,20,21,0.488,41,17,24,0.415
20600614,1610612747,1610612744,108.0,103.0,0.43,0.477,1,2007-01-22,42,27,15,0.643,42,19,23,0.452
20600606,1610612761,1610612766,105.0,84.0,0.512,0.434,1,2007-01-22,42,20,22,0.476,40,14,26,0.35
20600607,1610612739,1610612753,79.0,90.0,0.392,0.545,0,2007-01-22,41,24,17,0.585,42,23,19,0.5479999999999999
20600608,1610612754,1610612741,98.0,91.0,0.43,0.452,1,2007-01-22,41,21,20,0.512,42,23,19,0.5479999999999999
20600609,1610612738,1610612759,89.0,93.0,0.439,0.486,0,2007-01-22,40,12,28,0.3,43,30,13,0.698
20600610,1610612748,1610612752,101.0,83.0,0.531,0.457,1,2007-01-22,41,19,22,0.4629999999999999,43,18,25,0.419
20600611,1610612743,1610612763,115.0,98.0,0.4479999999999999,0.457,1,2007-01-22,38,21,17,0.5529999999999999,42,10,32,0.238
20600612,1610612762,1610612750,106.0,91.0,0.556,0.461,1,2007-01-22,42,28,14,0.667,40,20,20,0.5
20600613,1610612758,1610612751,88.0,87.0,0.3720000000000001,0.45,1,2007-01-22,39,16,23,0.41,41,20,21,0.488
20600602,1610612748,1610612742,93.0,99.0,0.486,0.466,0,2007-01-21,40,18,22,0.45,42,34,8,0.81
20600603,1610612755,1610612759,85.0,99.0,0.3979999999999999,0.4579999999999999,0,2007-01-21,41,11,30,0.268,42,29,13,0.69
20600604,1610612756,1610612750,131.0,102.0,0.568,0.439,1,2007-01-21,40,32,8,0.8,39,20,19,0.513
20600605,1610612757,1610612749,99.0,95.0,0.479,0.416,1,2007-01-21,42,17,25,0.405,40,17,23,0.425
20600592,1610612746,1610612763,112.0,91.0,0.511,0.479,1,2007-01-20,40,19,21,0.475,41,10,31,0.244
20600593,1610612766,1610612737,104.0,85.0,0.6459999999999999,0.508,1,2007-01-20,39,14,25,0.359,38,13,25,0.342
20600594,1610612754,1610612752,106.0,108.0,0.4379999999999999,0.523,0,2007-01-20,40,20,20,0.5,42,18,24,0.429
20600596,1610612765,1610612758,91.0,74.0,0.447,0.355,1,2007-01-20,39,23,16,0.59,38,15,23,0.395
20600595,1610612764,1610612738,115.0,110.0,0.479,0.471,1,2007-01-20,40,24,16,0.6,39,12,27,0.308
20600597,1610612751,1610612753,101.0,94.0,0.423,0.457,1,2007-01-20,40,20,20,0.5,41,22,19,0.537
20600598,1610612740,1610612747,113.0,103.0,0.482,0.444,1,2007-01-20,39,16,23,0.41,41,26,15,0.634
20600599,1610612741,1610612762,85.0,95.0,0.382,0.418,0,2007-01-20,41,23,18,0.561,41,27,14,0.659
20600600,1610612745,1610612743,113.0,121.0,0.4479999999999999,0.461,0,2007-01-20,41,25,16,0.61,37,20,17,0.541
20600601,1610612744,1610612739,104.0,106.0,0.3979999999999999,0.478,0,2007-01-20,41,19,22,0.4629999999999999,40,24,16,0.6
20600581,1610612761,1610612762,94.0,102.0,0.456,0.487,0,2007-01-19,41,19,22,0.4629999999999999,40,26,14,0.65
20600582,1610612755,1610612748,98.0,95.0,0.481,0.364,1,2007-01-19,40,11,29,0.275,39,18,21,0.462
20600583,1610612753,1610612764,93.0,114.0,0.4679999999999999,0.4379999999999999,0,2007-01-19,40,22,18,0.55,39,23,16,0.59
20600584,1610612738,1610612758,91.0,96.0,0.481,0.494,0,2007-01-19,38,12,26,0.316,37,15,22,0.405
20600585,1610612752,1610612751,100.0,101.0,0.485,0.5,0,2007-01-19,41,17,24,0.415,39,19,20,0.487
20600586,1610612737,1610612766,75.0,96.0,0.405,0.481,0,2007-01-19,37,13,24,0.351,38,13,25,0.342
20600587,1610612759,1610612740,99.0,86.0,0.455,0.41,1,2007-01-19,41,28,13,0.6829999999999999,38,15,23,0.395
20600588,1610612750,1610612765,98.0,104.0,0.3979999999999999,0.442,0,2007-01-19,38,20,18,0.526,38,22,16,0.579
20600589,1610612756,1610612757,106.0,101.0,0.528,0.478,1,2007-01-19,39,31,8,0.795,41,16,25,0.39
20600590,1610612743,1610612739,110.0,99.0,0.506,0.422,1,2007-01-19,36,19,17,0.528,39,23,16,0.59
20600591,1610612760,1610612749,99.0,72.0,0.488,0.33,1,2007-01-19,41,16,25,0.39,39,17,22,0.436
20600579,1610612748,1610612754,104.0,101.0,0.584,0.494,1,2007-01-18,38,18,20,0.474,39,20,19,0.513
20600580,1610612742,1610612747,114.0,95.0,0.545,0.449,1,2007-01-18,41,33,8,0.805,40,26,14,0.65
20600568,1610612761,1610612758,101.0,85.0,0.476,0.429,1,2007-01-17,40,19,21,0.475,36,14,22,0.389
20600569,1610612764,1610612752,99.0,98.0,0.46,0.4479999999999999,1,2007-01-17,38,22,16,0.579,40,17,23,0.425
20600570,1610612766,1610612751,85.0,92.0,0.387,0.449,0,2007-01-17,37,12,25,0.324,38,18,20,0.474
20600571,1610612765,1610612762,99.0,100.0,0.4629999999999999,0.476,0,2007-01-17,37,21,16,0.568,39,25,14,0.6409999999999999
20600572,1610612749,1610612741,90.0,99.0,0.385,0.494,0,2007-01-17,38,17,21,0.447,40,23,17,0.575
20600573,1610612763,1610612755,118.0,102.0,0.5379999999999999,0.5,1,2007-01-17,40,10,30,0.25,39,10,29,0.256
20600574,1610612750,1610612737,88.0,105.0,0.4379999999999999,0.5429999999999999,0,2007-01-17,37,20,17,0.541,36,13,23,0.361
20600575,1610612745,1610612756,91.0,100.0,0.3929999999999999,0.4679999999999999,0,2007-01-17,40,25,15,0.625,38,30,8,0.789
20600576,1610612759,1610612747,96.0,100.0,0.436,0.469,0,2007-01-17,40,27,13,0.675,39,26,13,0.667
20600577,1610612757,1610612739,94.0,76.0,0.4629999999999999,0.354,1,2007-01-17,40,16,24,0.4,38,23,15,0.605
20600578,1610612746,1610612744,115.0,109.0,0.483,0.418,1,2007-01-17,39,18,21,0.462,40,19,21,0.475
20600565,1610612740,1610612753,84.0,78.0,0.375,0.349,1,2007-01-16,37,15,22,0.405,39,22,17,0.564
20600566,1610612742,1610612745,109.0,96.0,0.488,0.4529999999999999,1,2007-01-16,40,32,8,0.8,39,25,14,0.6409999999999999
20600567,1610612760,1610612739,101.0,96.0,0.42,0.41,1,2007-01-16,40,15,25,0.375,37,23,14,0.622
20600554,1610612752,1610612758,102.0,97.0,0.48,0.462,1,2007-01-15,39,17,22,0.436,35,14,21,0.4
20600555,1610612764,1610612762,114.0,111.0,0.4529999999999999,0.4529999999999999,1,2007-01-15,37,21,16,0.568,38,24,14,0.632
20600556,1610612766,1610612749,91.0,99.0,0.395,0.469,0,2007-01-15,36,12,24,0.3329999999999999,37,17,20,0.4589999999999999
20600557,1610612755,1610612761,86.0,104.0,0.473,0.542,0,2007-01-15,38,10,28,0.263,39,18,21,0.462
20600558,1610612737,1610612738,100.0,96.0,0.494,0.4529999999999999,1,2007-01-15,35,12,23,0.3429999999999999,37,12,25,0.324
20600559,1610612741,1610612759,99.0,87.0,0.494,0.395,1,2007-01-15,39,22,17,0.564,39,27,12,0.6920000000000001
20600560,1610612751,1610612754,105.0,95.0,0.476,0.4029999999999999,1,2007-01-15,37,17,20,0.4589999999999999,38,20,18,0.526
20600561,1610612765,1610612750,90.0,94.0,0.4270000000000001,0.446,0,2007-01-15,36,21,15,0.583,36,20,16,0.556
20600562,1610612744,1610612746,108.0,93.0,0.424,0.424,1,2007-01-15,39,19,20,0.487,38,17,21,0.447
20600563,1610612763,1610612756,122.0,137.0,0.583,0.556,0,2007-01-15,39,9,30,0.231,37,29,8,0.784
20600564,1610612747,1610612748,124.0,118.0,0.485,0.494,1,2007-01-15,38,25,13,0.6579999999999999,37,17,20,0.4589999999999999
20600552,1610612761,1610612742,96.0,97.0,0.486,0.402,0,2007-01-14,38,17,21,0.447,39,31,8,0.795
20600553,1610612757,1610612743,93.0,109.0,0.4320000000000001,0.494,0,2007-01-14,39,15,24,0.385,35,18,17,0.514
20600542,1610612766,1610612755,89.0,83.0,0.3829999999999999,0.397,1,2007-01-13,35,12,23,0.3429999999999999,37,10,27,0.27
20600543,1610612765,1610612738,81.0,73.0,0.341,0.358,1,2007-01-13,35,21,14,0.6,36,12,24,0.3329999999999999
20600544,1610612759,1610612764,93.0,80.0,0.4429999999999999,0.31,1,2007-01-13,38,27,11,0.711,36,20,16,0.556
20600545,1610612750,1610612751,109.0,98.0,0.569,0.488,1,2007-01-13,35,19,16,0.5429999999999999,36,16,20,0.444
20600546,1610612741,1610612763,111.0,66.0,0.484,0.304,1,2007-01-13,38,21,17,0.5529999999999999,38,9,29,0.237
20600548,1610612762,1610612748,110.0,119.0,0.522,0.508,0,2007-01-13,37,24,13,0.649,36,17,19,0.472
20600549,1610612756,1610612753,107.0,101.0,0.531,0.4629999999999999,1,2007-01-13,36,28,8,0.778,38,22,16,0.579
20600550,1610612758,1610612745,111.0,115.0,0.507,0.4429999999999999,0,2007-01-13,34,14,20,0.412,38,25,13,0.6579999999999999
20600551,1610612746,1610612739,92.0,104.0,0.465,0.5,0,2007-01-13,37,17,20,0.4589999999999999,36,23,13,0.639
20600530,1610612755,1610612749,110.0,97.0,0.494,0.477,1,2007-01-12,36,10,26,0.278,36,16,20,0.444
20600531,1610612754,1610612742,113.0,115.0,0.439,0.42,0,2007-01-12,37,20,17,0.541,38,30,8,0.789
20600532,1610612738,1610612761,86.0,95.0,0.4029999999999999,0.451,0,2007-01-12,35,12,23,0.3429999999999999,37,17,20,0.4589999999999999
20600533,1610612752,1610612766,110.0,126.0,0.471,0.593,0,2007-01-12,38,16,22,0.421,34,11,23,0.324
20600534,1610612737,1610612765,99.0,93.0,0.5,0.4320000000000001,1,2007-01-12,34,11,23,0.324,34,20,14,0.588
20600535,1610612763,1610612750,110.0,116.0,0.513,0.519,0,2007-01-12,37,9,28,0.243,34,18,16,0.529
20600536,1610612740,1610612764,104.0,97.0,0.545,0.4679999999999999,1,2007-01-12,36,14,22,0.389,35,20,15,0.5710000000000001
20600537,1610612757,1610612758,95.0,87.0,0.494,0.485,1,2007-01-12,38,15,23,0.395,33,14,19,0.424
20600538,1610612743,1610612745,86.0,90.0,0.348,0.4270000000000001,0,2007-01-12,34,17,17,0.5,37,24,13,0.649
20600539,1610612747,1610612753,109.0,106.0,0.494,0.507,1,2007-01-12,37,24,13,0.649,37,22,15,0.595
20600540,1610612744,1610612748,96.0,118.0,0.419,0.529,0,2007-01-12,38,18,20,0.474,35,16,19,0.457
20600541,1610612760,1610612762,122.0,114.0,0.447,0.494,1,2007-01-12,39,14,25,0.359,36,24,12,0.667
20600528,1610612741,1610612751,83.0,86.0,0.377,0.377,0,2007-01-11,37,20,17,0.541,35,16,19,0.457
20600529,1610612756,1610612739,109.0,90.0,0.483,0.379,1,2007-01-11,35,27,8,0.7709999999999999,35,22,13,0.629
20600516,1610612764,1610612741,113.0,103.0,0.442,0.421,1,2007-01-10,34,20,14,0.588,36,20,16,0.556
20600517,1610612737,1610612740,77.0,96.0,0.3329999999999999,0.523,0,2007-01-10,33,10,23,0.303,35,13,22,0.371
20600518,1610612738,1610612754,84.0,97.0,0.414,0.434,0,2007-01-10,34,12,22,0.353,36,20,16,0.556
20600519,1610612752,1610612755,106.0,99.0,0.531,0.4429999999999999,1,2007-01-10,37,16,21,0.4320000000000001,35,9,26,0.257
20600520,1610612765,1610612766,96.0,103.0,0.415,0.471,0,2007-01-10,33,20,13,0.606,33,10,23,0.303
20600521,1610612749,1610612761,77.0,90.0,0.421,0.4379999999999999,0,2007-01-10,35,16,19,0.457,36,16,20,0.444
20600522,1610612750,1610612746,91.0,92.0,0.457,0.461,0,2007-01-10,33,17,16,0.515,36,17,19,0.472
20600523,1610612745,1610612747,102.0,77.0,0.442,0.342,1,2007-01-10,36,23,13,0.639,36,23,13,0.639
20600524,1610612742,1610612757,99.0,74.0,0.515,0.3939999999999999,1,2007-01-10,37,29,8,0.784,37,14,23,0.3779999999999999
20600525,1610612743,1610612759,83.0,92.0,0.455,0.482,0,2007-01-10,33,17,16,0.515,37,26,11,0.703
20600526,1610612760,1610612748,103.0,107.0,0.477,0.527,0,2007-01-10,38,13,25,0.342,34,15,19,0.441
20600527,1610612744,1610612753,76.0,91.0,0.368,0.405,0,2007-01-10,37,18,19,0.486,36,22,14,0.611
20600508,1610612755,1610612765,89.0,98.0,0.4579999999999999,0.563,0,2007-01-09,34,9,25,0.265,32,20,12,0.625
20600509,1610612754,1610612737,91.0,72.0,0.424,0.321,1,2007-01-09,35,19,16,0.5429999999999999,32,10,22,0.313
20600510,1610612751,1610612761,101.0,86.0,0.5,0.429,1,2007-01-09,34,15,19,0.441,35,15,20,0.429
20600511,1610612763,1610612747,128.0,118.0,0.494,0.422,1,2007-01-09,36,9,27,0.25,35,23,12,0.657
20600512,1610612759,1610612757,98.0,84.0,0.485,0.451,1,2007-01-09,36,25,11,0.6940000000000001,36,14,22,0.389
20600513,1610612762,1610612742,105.0,108.0,0.507,0.529,0,2007-01-09,35,24,11,0.6859999999999999,36,28,8,0.778
20600514,1610612756,1610612760,113.0,102.0,0.575,0.447,1,2007-01-09,34,26,8,0.765,37,13,24,0.351
20600515,1610612758,1610612739,98.0,108.0,0.478,0.447,0,2007-01-09,32,14,18,0.4379999999999999,34,22,12,0.647
20600505,1610612740,1610612746,90.0,100.0,0.44,0.44,0,2007-01-08,34,12,22,0.353,35,16,19,0.457
20600506,1610612741,1610612745,77.0,84.0,0.366,0.391,0,2007-01-08,35,20,15,0.5710000000000001,35,22,13,0.629
20600507,1610612743,1610612749,104.0,92.0,0.4429999999999999,0.385,1,2007-01-08,32,17,15,0.531,34,16,18,0.471
20600498,1610612761,1610612764,116.0,111.0,0.511,0.4379999999999999,1,2007-01-07,34,15,19,0.441,33,19,14,0.5760000000000001
20600499,1610612750,1610612745,103.0,99.0,0.405,0.419,1,2007-01-07,32,17,15,0.531,34,21,13,0.618
20600500,1610612763,1610612759,96.0,110.0,0.462,0.5,0,2007-01-07,35,8,27,0.2289999999999999,35,24,11,0.6859999999999999
20600501,1610612753,1610612738,87.0,79.0,0.375,0.315,1,2007-01-07,35,21,14,0.6,33,12,21,0.364
20600502,1610612756,1610612744,128.0,105.0,0.519,0.435,1,2007-01-07,33,25,8,0.758,36,18,18,0.5
20600503,1610612757,1610612748,90.0,93.0,0.4379999999999999,0.4639999999999999,0,2007-01-07,35,14,21,0.4,33,14,19,0.424
20600504,1610612747,1610612742,101.0,98.0,0.5489999999999999,0.422,1,2007-01-07,34,23,11,0.6759999999999999,35,27,8,0.7709999999999999
20600491,1610612737,1610612746,86.0,74.0,0.425,0.4,1,2007-01-06,31,10,21,0.3229999999999999,34,15,19,0.441
20600492,1610612739,1610612751,96.0,91.0,0.446,0.473,1,2007-01-06,33,21,12,0.636,33,14,19,0.424
20600493,1610612740,1610612754,93.0,100.0,0.4579999999999999,0.471,0,2007-01-06,33,12,21,0.364,34,18,16,0.529
20600494,1610612741,1610612765,106.0,89.0,0.488,0.348,1,2007-01-06,34,20,14,0.588,31,19,12,0.613
20600495,1610612743,1610612762,84.0,96.0,0.387,0.4579999999999999,0,2007-01-06,31,16,15,0.516,34,24,10,0.706
20600496,1610612758,1610612757,105.0,110.0,0.446,0.409,0,2007-01-06,31,14,17,0.452,34,14,20,0.412
20600497,1610612744,1610612760,108.0,104.0,0.5,0.474,1,2007-01-06,35,18,17,0.514,36,13,23,0.361
20600484,1610612759,1610612742,85.0,90.0,0.441,0.455,0,2007-01-05,34,23,11,0.6759999999999999,34,27,7,0.794
20600479,1610612761,1610612737,105.0,92.0,0.5479999999999999,0.484,1,2007-01-05,33,14,19,0.424,30,9,21,0.3
20600480,1610612764,1610612746,116.0,105.0,0.516,0.4370000000000001,1,2007-01-05,32,19,13,0.594,33,15,18,0.455
20600481,1610612753,1610612766,106.0,74.0,0.574,0.291,1,2007-01-05,34,20,14,0.588,32,9,23,0.281
20600482,1610612751,1610612741,91.0,86.0,0.365,0.442,1,2007-01-05,32,14,18,0.4379999999999999,33,19,14,0.5760000000000001
20600483,1610612763,1610612738,119.0,128.0,0.563,0.575,0,2007-01-05,34,8,26,0.235,32,12,20,0.375
20600485,1610612750,1610612755,104.0,102.0,0.467,0.4429999999999999,1,2007-01-05,31,16,15,0.516,33,9,24,0.273
20600486,1610612749,1610612739,86.0,95.0,0.413,0.414,0,2007-01-05,33,16,17,0.485,32,20,12,0.625
20600487,1610612745,1610612762,100.0,86.0,0.415,0.4,1,2007-01-05,33,21,12,0.636,33,23,10,0.6970000000000001
20600488,1610612756,1610612748,108.0,80.0,0.474,0.439,1,2007-01-05,32,24,8,0.75,32,13,19,0.406
20600489,1610612747,1610612743,123.0,104.0,0.49,0.424,1,2007-01-05,33,22,11,0.667,30,16,14,0.5329999999999999
20600490,1610612760,1610612752,93.0,111.0,0.434,0.513,0,2007-01-05,35,13,22,0.371,36,15,21,0.417
20600476,1610612740,1610612765,68.0,92.0,0.33,0.461,0,2007-01-04,32,12,20,0.375,30,19,11,0.633
20600477,1610612742,1610612754,100.0,91.0,0.4629999999999999,0.4320000000000001,1,2007-01-04,33,26,7,0.7879999999999999,33,17,16,0.515
20600478,1610612758,1610612747,128.0,132.0,0.488,0.523,0,2007-01-04,30,14,16,0.467,32,21,11,0.6559999999999999
20600474,1610612762,1610612755,98.0,87.0,0.434,0.493,1,2007-01-03,32,23,9,0.7190000000000001,32,9,23,0.281
20600467,1610612761,1610612756,98.0,100.0,0.422,0.4629999999999999,0,2007-01-03,32,13,19,0.406,31,23,8,0.742
20600468,1610612764,1610612749,108.0,105.0,0.495,0.483,1,2007-01-03,31,18,13,0.581,32,16,16,0.5
20600469,1610612738,1610612739,104.0,107.0,0.494,0.481,0,2007-01-03,31,11,20,0.355,31,19,12,0.613
20600470,1610612748,1610612746,95.0,110.0,0.4370000000000001,0.605,0,2007-01-03,31,13,18,0.419,32,15,17,0.469
20600471,1610612763,1610612744,144.0,135.0,0.5579999999999999,0.475,1,2007-01-03,33,8,25,0.242,34,17,17,0.5
20600472,1610612750,1610612759,103.0,101.0,0.481,0.425,1,2007-01-03,30,15,15,0.5,33,23,10,0.6970000000000001
20600473,1610612745,1610612760,103.0,96.0,0.477,0.5,1,2007-01-03,32,20,12,0.625,34,13,21,0.382
20600475,1610612757,1610612752,81.0,99.0,0.423,0.494,0,2007-01-03,33,13,20,0.3939999999999999,35,14,21,0.4
20600460,1610612753,1610612746,91.0,86.0,0.473,0.507,1,2007-01-02,33,19,14,0.5760000000000001,31,14,17,0.452
20600461,1610612739,1610612759,82.0,78.0,0.36,0.384,1,2007-01-02,30,18,12,0.6,32,23,9,0.7190000000000001
20600462,1610612740,1610612744,89.0,97.0,0.474,0.395,0,2007-01-02,31,12,19,0.387,33,17,16,0.515
20600463,1610612741,1610612756,96.0,97.0,0.481,0.414,0,2007-01-02,32,19,13,0.594,30,22,8,0.733
20600464,1610612742,1610612760,112.0,88.0,0.4379999999999999,0.421,1,2007-01-02,32,25,7,0.7809999999999999,33,13,20,0.3939999999999999
20600465,1610612743,1610612755,97.0,108.0,0.3879999999999999,0.456,0,2007-01-02,29,16,13,0.552,31,9,22,0.29
20600466,1610612758,1610612752,112.0,100.0,0.563,0.494,1,2007-01-02,29,14,15,0.483,34,13,21,0.382
20600458,1610612766,1610612750,96.0,102.0,0.52,0.494,0,2007-01-01,31,9,22,0.29,29,14,15,0.483
20600459,1610612757,1610612738,81.0,89.0,0.389,0.4379999999999999,0,2007-01-01,32,13,19,0.406,30,11,19,0.3670000000000001
20600451,1610612759,1610612737,95.0,81.0,0.4629999999999999,0.392,1,2006-12-31,31,23,8,0.742,29,9,20,0.31
20600452,1610612746,1610612752,90.0,80.0,0.508,0.345,1,2006-12-31,30,14,16,0.467,33,13,20,0.3939999999999999
20600453,1610612765,1610612756,101.0,108.0,0.494,0.5,0,2006-12-31,29,18,11,0.621,29,21,8,0.7240000000000001
20600454,1610612745,1610612763,111.0,109.0,0.418,0.519,1,2006-12-31,31,19,12,0.613,32,7,25,0.2189999999999999
20600455,1610612743,1610612742,85.0,89.0,0.375,0.42,0,2006-12-31,28,16,12,0.5710000000000001,31,24,7,0.774
20600456,1610612747,1610612755,104.0,94.0,0.476,0.395,1,2006-12-31,31,20,11,0.645,30,8,22,0.267
20600457,1610612760,1610612738,101.0,95.0,0.541,0.42,1,2006-12-31,32,13,19,0.406,29,10,19,0.345
20600447,1610612749,1610612764,119.0,102.0,0.49,0.441,1,2006-12-30,31,16,15,0.516,30,17,13,0.5670000000000001
20600442,1610612753,1610612748,97.0,68.0,0.446,0.3429999999999999,1,2006-12-30,32,18,14,0.563,30,13,17,0.433
20600443,1610612754,1610612766,102.0,113.0,0.439,0.5,0,2006-12-30,32,17,15,0.531,30,9,21,0.3
20600444,1610612751,1610612750,100.0,92.0,0.526,0.493,1,2006-12-30,31,13,18,0.419,28,13,15,0.4639999999999999
20600445,1610612763,1610612761,110.0,104.0,0.481,0.462,1,2006-12-30,31,7,24,0.226,31,13,18,0.419
20600446,1610612741,1610612739,103.0,96.0,0.494,0.4529999999999999,1,2006-12-30,31,19,12,0.613,29,17,12,0.586
20600448,1610612742,1610612740,94.0,80.0,0.4429999999999999,0.406,1,2006-12-30,30,23,7,0.767,30,12,18,0.4
20600449,1610612762,1610612757,96.0,86.0,0.506,0.461,1,2006-12-30,31,22,9,0.71,31,13,18,0.419
20600450,1610612758,1610612744,119.0,96.0,0.452,0.37,1,2006-12-30,28,13,15,0.4639999999999999,32,16,16,0.5
20600429,1610612761,1610612741,97.0,107.0,0.407,0.597,0,2006-12-29,30,13,17,0.433,30,18,12,0.6
20600430,1610612764,1610612753,112.0,111.0,0.5429999999999999,0.519,1,2006-12-29,29,17,12,0.586,31,17,14,0.5479999999999999
20600431,1610612766,1610612747,133.0,124.0,0.42,0.46,1,2006-12-29,29,8,21,0.276,30,19,11,0.633
20600432,1610612748,1610612751,81.0,91.0,0.444,0.466,0,2006-12-29,29,13,16,0.4479999999999999,30,12,18,0.4
20600433,1610612739,1610612749,109.0,99.0,0.5,0.405,1,2006-12-29,28,17,11,0.607,30,15,15,0.5
20600434,1610612765,1610612754,92.0,93.0,0.422,0.405,0,2006-12-29,28,18,10,0.643,31,17,14,0.5479999999999999
20600435,1610612740,1610612743,99.0,89.0,0.469,0.371,1,2006-12-29,29,12,17,0.414,27,16,11,0.593
20600436,1610612750,1610612760,101.0,82.0,0.5,0.352,1,2006-12-29,27,13,14,0.481,31,12,19,0.387
20600437,1610612745,1610612737,94.0,68.0,0.507,0.347,1,2006-12-29,30,18,12,0.6,28,9,19,0.321
20600438,1610612756,1610612752,108.0,86.0,0.494,0.374,1,2006-12-29,28,20,8,0.7140000000000001,32,13,19,0.406
20600439,1610612757,1610612755,95.0,98.0,0.486,0.486,0,2006-12-29,30,13,17,0.433,29,8,21,0.276
20600440,1610612746,1610612758,102.0,93.0,0.493,0.421,1,2006-12-29,29,13,16,0.4479999999999999,27,12,15,0.444
20600441,1610612744,1610612738,110.0,100.0,0.4579999999999999,0.439,1,2006-12-29,31,16,15,0.516,28,10,18,0.357
20600426,1610612742,1610612756,101.0,99.0,0.412,0.514,1,2006-12-28,29,22,7,0.759,27,19,8,0.7040000000000001
20600427,1610612759,1610612762,106.0,83.0,0.5,0.423,1,2006-12-28,30,22,8,0.733,30,21,9,0.7
20600428,1610612743,1610612760,112.0,98.0,0.488,0.4629999999999999,1,2006-12-28,26,16,10,0.615,30,12,18,0.4
20600415,1610612761,1610612750,100.0,97.0,0.519,0.474,1,2006-12-27,29,13,16,0.4479999999999999,26,12,14,0.462
20600416,1610612766,1610612764,107.0,114.0,0.429,0.529,0,2006-12-27,28,7,21,0.25,28,16,12,0.5710000000000001
20600417,1610612737,1610612739,76.0,89.0,0.392,0.436,0,2006-12-27,27,9,18,0.3329999999999999,27,16,11,0.593
20600418,1610612753,1610612747,93.0,106.0,0.4429999999999999,0.5,0,2006-12-27,30,17,13,0.5670000000000001,29,19,10,0.655
20600419,1610612751,1610612745,71.0,96.0,0.3289999999999999,0.446,0,2006-12-27,29,11,18,0.379,29,17,12,0.586
20600420,1610612752,1610612765,151.0,145.0,0.563,0.439,1,2006-12-27,31,13,18,0.419,27,18,9,0.667
20600421,1610612763,1610612749,96.0,112.0,0.481,0.489,0,2006-12-27,30,6,24,0.2,29,15,14,0.517
20600422,1610612741,1610612748,109.0,103.0,0.481,0.4589999999999999,1,2006-12-27,29,17,12,0.586,28,13,15,0.4639999999999999
20600423,1610612758,1610612755,101.0,76.0,0.494,0.397,1,2006-12-27,26,12,14,0.462,28,7,21,0.25
20600424,1610612757,1610612740,100.0,85.0,0.4379999999999999,0.4029999999999999,1,2006-12-27,29,13,16,0.4479999999999999,28,11,17,0.3929999999999999
20600425,1610612746,1610612738,100.0,77.0,0.507,0.319,1,2006-12-27,28,12,16,0.429,27,10,17,0.37
20600404,1610612764,1610612763,116.0,101.0,0.489,0.465,1,2006-12-26,27,15,12,0.556,29,6,23,0.207
20600405,1610612754,1610612745,81.0,76.0,0.349,0.36,1,2006-12-26,30,16,14,0.5329999999999999,28,16,12,0.5710000000000001
20600406,1610612765,1610612751,92.0,91.0,0.417,0.462,1,2006-12-26,26,18,8,0.6920000000000001,28,11,17,0.3929999999999999
20600407,1610612759,1610612749,107.0,114.0,0.452,0.568,0,2006-12-26,29,21,8,0.7240000000000001,28,14,14,0.5
20600408,1610612750,1610612741,100.0,98.0,0.507,0.43,1,2006-12-26,25,12,13,0.48,28,16,12,0.5710000000000001
20600409,1610612742,1610612766,97.0,84.0,0.487,0.408,1,2006-12-26,28,21,7,0.75,27,7,20,0.259
20600410,1610612743,1610612738,116.0,105.0,0.444,0.452,1,2006-12-26,25,15,10,0.6,26,10,16,0.385
20600411,1610612762,1610612746,102.0,92.0,0.4679999999999999,0.472,1,2006-12-26,29,21,8,0.7240000000000001,27,11,16,0.407
20600412,1610612756,1610612757,110.0,87.0,0.537,0.402,1,2006-12-26,26,19,7,0.731,28,12,16,0.429
20600413,1610612760,1610612740,102.0,94.0,0.545,0.457,1,2006-12-26,29,12,17,0.414,27,11,16,0.407
20600414,1610612744,1610612755,116.0,97.0,0.5479999999999999,0.442,1,2006-12-26,30,15,15,0.5,27,7,20,0.259
20600403,1610612748,1610612747,101.0,85.0,0.515,0.392,1,2006-12-25,27,13,14,0.481,28,18,10,0.643
20600398,1610612740,1610612759,77.0,112.0,0.373,0.629,0,2006-12-23,26,11,15,0.423,28,21,7,0.75
20600392,1610612754,1610612750,71.0,78.0,0.386,0.392,0,2006-12-23,29,15,14,0.517,24,11,13,0.4579999999999999
20600393,1610612755,1610612752,98.0,77.0,0.4679999999999999,0.42,1,2006-12-23,26,7,19,0.2689999999999999,30,12,18,0.4
20600394,1610612748,1610612744,105.0,92.0,0.488,0.374,1,2006-12-23,26,12,14,0.462,29,14,15,0.483
20600395,1610612765,1610612737,108.0,81.0,0.493,0.363,1,2006-12-23,25,17,8,0.68,26,9,17,0.346
20600396,1610612739,1610612753,86.0,83.0,0.4,0.435,1,2006-12-23,26,15,11,0.5770000000000001,29,17,12,0.586
20600397,1610612763,1610612762,97.0,100.0,0.476,0.434,0,2006-12-23,28,6,22,0.214,28,20,8,0.7140000000000001
20600399,1610612741,1610612766,115.0,76.0,0.524,0.356,1,2006-12-23,27,16,11,0.593,26,7,19,0.2689999999999999
20600400,1610612749,1610612751,115.0,104.0,0.551,0.419,1,2006-12-23,27,13,14,0.481,27,11,16,0.407
20600401,1610612745,1610612746,93.0,98.0,0.4,0.486,0,2006-12-23,27,16,11,0.593,26,11,15,0.423
20600402,1610612760,1610612761,110.0,97.0,0.512,0.465,1,2006-12-23,28,11,17,0.3929999999999999,28,12,16,0.429
20600384,1610612738,1610612755,83.0,98.0,0.4029999999999999,0.539,0,2006-12-22,25,10,15,0.4,25,6,19,0.24
20600385,1610612740,1610612763,100.0,97.0,0.44,0.425,1,2006-12-22,25,11,14,0.44,27,6,21,0.222
20600379,1610612766,1610612762,101.0,89.0,0.44,0.449,1,2006-12-22,25,7,18,0.28,27,19,8,0.7040000000000001
20600380,1610612753,1610612744,108.0,117.0,0.476,0.482,0,2006-12-22,28,17,11,0.607,28,14,14,0.5
20600381,1610612751,1610612747,95.0,99.0,0.417,0.479,0,2006-12-22,26,11,15,0.423,27,18,9,0.667
20600382,1610612752,1610612741,103.0,92.0,0.44,0.41,1,2006-12-22,29,12,17,0.414,26,15,11,0.5770000000000001
20600383,1610612737,1610612754,90.0,100.0,0.4589999999999999,0.455,0,2006-12-22,25,9,16,0.36,28,15,13,0.536
20600386,1610612759,1610612745,78.0,97.0,0.4029999999999999,0.514,0,2006-12-22,27,20,7,0.741,26,16,10,0.615
20600387,1610612750,1610612749,107.0,113.0,0.5,0.4539999999999999,0,2006-12-22,23,10,13,0.435,26,12,14,0.462
20600388,1610612742,1610612746,115.0,83.0,0.512,0.412,1,2006-12-22,27,20,7,0.741,25,10,15,0.4
20600389,1610612743,1610612758,96.0,101.0,0.371,0.442,0,2006-12-22,24,14,10,0.583,25,11,14,0.44
20600390,1610612757,1610612761,100.0,101.0,0.444,0.483,0,2006-12-22,27,12,15,0.444,27,12,15,0.444
20600391,1610612756,1610612764,139.0,144.0,0.495,0.535,0,2006-12-22,25,18,7,0.72,26,14,12,0.5379999999999999
20600377,1610612739,1610612765,71.0,87.0,0.342,0.4379999999999999,0,2006-12-21,25,14,11,0.56,24,16,8,0.667
20600378,1610612758,1610612764,119.0,126.0,0.495,0.494,0,2006-12-21,24,10,14,0.417,25,13,12,0.52
20600364,1610612755,1610612754,93.0,101.0,0.461,0.5,0,2006-12-20,24,5,19,0.208,27,14,13,0.519
20600365,1610612737,1610612762,106.0,112.0,0.467,0.557,0,2006-12-20,24,9,15,0.375,26,19,7,0.731
20600366,1610612753,1610612740,86.0,83.0,0.452,0.369,1,2006-12-20,27,17,10,0.63,24,10,14,0.417
20600367,1610612738,1610612744,95.0,96.0,0.472,0.434,0,2006-12-20,24,10,14,0.417,27,13,14,0.481
20600368,1610612752,1610612766,111.0,109.0,0.467,0.425,1,2006-12-20,28,11,17,0.3929999999999999,24,6,18,0.25
20600369,1610612751,1610612739,113.0,111.0,0.574,0.422,1,2006-12-20,25,11,14,0.44,24,14,10,0.583
20600370,1610612749,1610612748,121.0,95.0,0.524,0.455,1,2006-12-20,25,11,14,0.44,25,11,14,0.44
20600371,1610612759,1610612763,105.0,98.0,0.552,0.52,1,2006-12-20,26,20,6,0.769,26,6,20,0.231
20600372,1610612750,1610612747,94.0,111.0,0.494,0.568,0,2006-12-20,22,10,12,0.455,26,17,9,0.654
20600374,1610612757,1610612745,89.0,87.0,0.436,0.419,1,2006-12-20,26,12,14,0.462,25,15,10,0.6
20600375,1610612746,1610612761,96.0,98.0,0.452,0.4270000000000001,0,2006-12-20,24,10,14,0.417,26,11,15,0.423
20600376,1610612760,1610612742,95.0,103.0,0.512,0.479,0,2006-12-20,27,10,17,0.37,26,19,7,0.731
20600362,1610612741,1610612747,94.0,89.0,0.5,0.474,1,2006-12-19,25,15,10,0.6,25,16,9,0.64
20600363,1610612756,1610612761,115.0,98.0,0.512,0.4,1,2006-12-19,24,18,6,0.75,25,10,15,0.4
20600356,1610612751,1610612744,105.0,97.0,0.4,0.452,1,2006-12-18,24,10,14,0.417,26,12,14,0.462
20600357,1610612752,1610612762,97.0,96.0,0.3939999999999999,0.3670000000000001,1,2006-12-18,27,10,17,0.37,25,18,7,0.72
20600358,1610612748,1610612740,101.0,99.0,0.494,0.494,1,2006-12-18,24,11,13,0.4579999999999999,23,10,13,0.435
20600359,1610612763,1610612760,134.0,126.0,0.511,0.484,1,2006-12-18,25,6,19,0.24,26,10,16,0.385
20600360,1610612743,1610612764,117.0,108.0,0.476,0.3929999999999999,1,2006-12-18,23,14,9,0.609,24,12,12,0.5
20600361,1610612758,1610612742,91.0,109.0,0.3979999999999999,0.525,0,2006-12-18,23,10,13,0.435,25,18,7,0.72
20600351,1610612761,1610612744,120.0,115.0,0.471,0.506,1,2006-12-17,24,10,14,0.417,25,12,13,0.48
20600352,1610612754,1610612762,94.0,104.0,0.365,0.4629999999999999,0,2006-12-17,26,13,13,0.5,24,18,6,0.75
20600353,1610612746,1610612745,103.0,108.0,0.486,0.527,0,2006-12-17,23,10,13,0.435,24,15,9,0.625
20600354,1610612765,1610612760,97.0,93.0,0.3939999999999999,0.5,1,2006-12-17,23,15,8,0.652,25,10,15,0.4
20600355,1610612747,1610612764,141.0,147.0,0.49,0.506,0,2006-12-17,24,16,8,0.667,23,12,11,0.522
20600347,1610612740,1610612742,79.0,90.0,0.41,0.425,0,2006-12-16,22,10,12,0.455,24,17,7,0.708
20600341,1610612766,1610612738,100.0,106.0,0.425,0.451,0,2006-12-16,23,6,17,0.261,23,10,13,0.435
20600342,1610612737,1610612741,104.0,106.0,0.451,0.449,0,2006-12-16,23,9,14,0.391,24,14,10,0.583
20600343,1610612753,1610612739,81.0,74.0,0.411,0.36,1,2006-12-16,26,16,10,0.615,23,14,9,0.609
20600344,1610612752,1610612743,100.0,123.0,0.4320000000000001,0.57,0,2006-12-16,26,9,17,0.346,22,13,9,0.591
20600345,1610612748,1610612763,98.0,90.0,0.506,0.465,1,2006-12-16,23,10,13,0.435,24,5,19,0.208
20600346,1610612751,1610612765,82.0,90.0,0.3720000000000001,0.452,0,2006-12-16,23,9,14,0.391,22,14,8,0.636
20600348,1610612759,1610612755,103.0,98.0,0.481,0.488,1,2006-12-16,25,19,6,0.76,23,5,18,0.217
20600349,1610612749,1610612750,108.0,104.0,0.506,0.521,1,2006-12-16,24,10,14,0.417,21,10,11,0.476
20600350,1610612758,1610612756,98.0,105.0,0.3979999999999999,0.519,0,2006-12-16,22,10,12,0.455,23,17,6,0.7390000000000001
20600329,1610612761,1610612751,90.0,78.0,0.446,0.39,1,2006-12-15,23,9,14,0.391,22,9,13,0.409
20600330,1610612764,1610612748,106.0,95.0,0.488,0.414,1,2006-12-15,22,11,11,0.5,22,9,13,0.409
20600331,1610612754,1610612752,112.0,96.0,0.475,0.444,1,2006-12-15,25,13,12,0.52,25,9,16,0.36
20600332,1610612738,1610612743,119.0,114.0,0.56,0.489,1,2006-12-15,22,9,13,0.409,21,12,9,0.5710000000000001
20600333,1610612739,1610612760,106.0,84.0,0.542,0.365,1,2006-12-15,22,14,8,0.636,24,10,14,0.417
20600334,1610612763,1610612737,88.0,97.0,0.369,0.535,0,2006-12-15,23,5,18,0.217,22,9,13,0.409
20600335,1610612742,1610612755,93.0,79.0,0.466,0.457,1,2006-12-15,23,16,7,0.696,22,5,17,0.2269999999999999
20600336,1610612741,1610612749,117.0,111.0,0.42,0.483,1,2006-12-15,23,13,10,0.565,23,9,14,0.391
20600337,1610612762,1610612758,97.0,98.0,0.466,0.405,0,2006-12-15,23,17,6,0.7390000000000001,21,10,11,0.476
20600338,1610612756,1610612744,105.0,101.0,0.4320000000000001,0.4039999999999999,1,2006-12-15,22,16,6,0.727,24,12,12,0.5
20600339,1610612757,1610612746,109.0,99.0,0.513,0.588,1,2006-12-15,25,11,14,0.44,22,10,12,0.455
20600340,1610612747,1610612745,112.0,101.0,0.426,0.4679999999999999,1,2006-12-15,23,16,7,0.696,23,14,9,0.609
20600326,1610612766,1610612753,99.0,89.0,0.407,0.493,1,2006-12-14,22,6,16,0.273,25,15,10,0.6
20600327,1610612740,1610612759,77.0,103.0,0.405,0.5,0,2006-12-14,21,10,11,0.476,24,18,6,0.75
20600328,1610612744,1610612745,109.0,107.0,0.475,0.417,1,2006-12-14,23,12,11,0.522,22,14,8,0.636
20600313,1610612755,1610612738,81.0,101.0,0.397,0.521,0,2006-12-13,21,5,16,0.238,21,8,13,0.381
20600314,1610612764,1610612743,120.0,91.0,0.5,0.451,1,2006-12-13,21,10,11,0.476,20,12,8,0.6
20600315,1610612753,1610612761,84.0,91.0,0.376,0.47,0,2006-12-13,24,15,9,0.625,22,8,14,0.364
20600316,1610612748,1610612756,89.0,99.0,0.3979999999999999,0.479,0,2006-12-13,21,9,12,0.429,21,15,6,0.7140000000000001
20600317,1610612739,1610612766,104.0,101.0,0.48,0.466,1,2006-12-13,21,13,8,0.619,21,5,16,0.238
20600318,1610612754,1610612765,101.0,90.0,0.474,0.39,1,2006-12-13,24,12,12,0.5,21,13,8,0.619
20600319,1610612751,1610612749,108.0,95.0,0.494,0.472,1,2006-12-13,21,9,12,0.429,22,9,13,0.409
20600320,1610612752,1610612737,94.0,82.0,0.446,0.377,1,2006-12-13,24,9,15,0.375,21,8,13,0.381
20600321,1610612763,1610612757,79.0,85.0,0.4320000000000001,0.477,0,2006-12-13,22,5,17,0.2269999999999999,24,10,14,0.417
20600322,1610612759,1610612750,95.0,82.0,0.493,0.471,1,2006-12-13,23,17,6,0.7390000000000001,20,10,10,0.5
20600323,1610612741,1610612760,99.0,84.0,0.424,0.42,1,2006-12-13,22,12,10,0.545,23,10,13,0.435
20600324,1610612742,1610612747,110.0,101.0,0.6,0.4379999999999999,1,2006-12-13,22,15,7,0.682,22,15,7,0.682
20600325,1610612746,1610612762,86.0,105.0,0.4029999999999999,0.513,0,2006-12-13,21,10,11,0.476,22,17,5,0.773
20600309,1610612737,1610612743,87.0,100.0,0.407,0.493,0,2006-12-12,20,8,12,0.4,19,12,7,0.632
20600310,1610612749,1610612760,94.0,93.0,0.479,0.513,1,2006-12-12,21,9,12,0.429,22,10,12,0.455
20600311,1610612745,1610612747,94.0,102.0,0.452,0.476,0,2006-12-12,21,14,7,0.667,21,15,6,0.7140000000000001
20600312,1610612744,1610612758,126.0,113.0,0.531,0.4270000000000001,1,2006-12-12,22,11,11,0.5,20,9,11,0.45
20600307,1610612762,1610612742,101.0,79.0,0.481,0.377,1,2006-12-11,21,16,5,0.762,21,14,7,0.667
20600300,1610612755,1610612757,79.0,81.0,0.377,0.4379999999999999,0,2006-12-11,20,5,15,0.25,23,9,14,0.391
20600301,1610612753,1610612756,89.0,103.0,0.452,0.514,0,2006-12-11,23,15,8,0.652,20,14,6,0.7
20600302,1610612751,1610612763,105.0,92.0,0.476,0.446,1,2006-12-11,20,8,12,0.4,21,5,16,0.238
20600303,1610612752,1610612738,90.0,97.0,0.389,0.481,0,2006-12-11,23,8,15,0.348,20,7,13,0.35
20600304,1610612748,1610612761,99.0,77.0,0.507,0.4320000000000001,1,2006-12-11,20,9,11,0.45,21,7,14,0.3329999999999999
20600305,1610612740,1610612739,95.0,89.0,0.5479999999999999,0.429,1,2006-12-11,20,10,10,0.5,20,12,8,0.6
20600306,1610612741,1610612754,106.0,91.0,0.5710000000000001,0.514,1,2006-12-11,21,11,10,0.524,23,11,12,0.478
20600308,1610612746,1610612759,81.0,103.0,0.451,0.52,0,2006-12-11,20,10,10,0.5,22,16,6,0.727
20600295,1610612761,1610612757,83.0,93.0,0.349,0.425,0,2006-12-10,20,7,13,0.35,22,8,14,0.364
20600296,1610612766,1610612756,84.0,114.0,0.407,0.529,0,2006-12-10,20,5,15,0.25,19,13,6,0.684
20600297,1610612758,1610612737,117.0,92.0,0.573,0.416,1,2006-12-10,19,9,10,0.474,19,8,11,0.421
20600298,1610612760,1610612744,117.0,115.0,0.482,0.476,1,2006-12-10,21,10,11,0.476,21,10,11,0.476
20600299,1610612747,1610612759,106.0,99.0,0.489,0.514,1,2006-12-10,20,14,6,0.7,21,15,6,0.7140000000000001
20600286,1610612764,1610612745,109.0,114.0,0.3979999999999999,0.551,0,2006-12-09,20,9,11,0.45,20,14,6,0.7
20600287,1610612753,1610612755,86.0,84.0,0.446,0.523,1,2006-12-09,22,15,7,0.682,19,5,14,0.263
20600288,1610612751,1610612738,90.0,92.0,0.423,0.3879999999999999,0,2006-12-09,19,7,12,0.368,19,6,13,0.316
20600289,1610612752,1610612749,115.0,107.0,0.562,0.517,1,2006-12-09,22,8,14,0.364,20,8,12,0.4
20600290,1610612739,1610612754,107.0,75.0,0.527,0.325,1,2006-12-09,19,12,7,0.632,22,11,11,0.5
20600291,1610612763,1610612746,82.0,89.0,0.424,0.457,0,2006-12-09,20,5,15,0.25,19,10,9,0.526
20600292,1610612741,1610612750,81.0,91.0,0.395,0.442,0,2006-12-09,20,10,10,0.5,19,10,9,0.526
20600293,1610612742,1610612743,105.0,90.0,0.494,0.384,1,2006-12-09,20,14,6,0.7,18,11,7,0.611
20600294,1610612744,1610612740,101.0,80.0,0.494,0.429,1,2006-12-09,20,10,10,0.5,19,9,10,0.474
20600274,1610612766,1610612745,62.0,92.0,0.284,0.44,0,2006-12-08,19,5,14,0.263,19,13,6,0.684
20600275,1610612753,1610612765,83.0,87.0,0.446,0.472,0,2006-12-08,21,14,7,0.667,20,13,7,0.65
20600276,1610612754,1610612757,108.0,95.0,0.493,0.447,1,2006-12-08,21,11,10,0.524,21,7,14,0.3329999999999999
20600277,1610612738,1610612756,111.0,116.0,0.429,0.606,0,2006-12-08,18,5,13,0.278,18,12,6,0.667
20600278,1610612755,1610612764,98.0,113.0,0.494,0.5,0,2006-12-08,18,5,13,0.278,19,9,10,0.474
20600279,1610612759,1610612746,111.0,82.0,0.529,0.444,1,2006-12-08,20,15,5,0.75,18,9,9,0.5
20600280,1610612750,1610612762,110.0,103.0,0.512,0.494,1,2006-12-08,18,9,9,0.5,20,15,5,0.75
20600281,1610612741,1610612761,93.0,90.0,0.473,0.4320000000000001,1,2006-12-08,19,10,9,0.526,19,7,12,0.368
20600282,1610612749,1610612763,100.0,94.0,0.532,0.479,1,2006-12-08,19,8,11,0.421,19,5,14,0.263
20600283,1610612743,1610612748,123.0,107.0,0.541,0.456,1,2006-12-08,17,11,6,0.647,19,8,11,0.421
20600284,1610612747,1610612737,106.0,95.0,0.557,0.434,1,2006-12-08,19,13,6,0.684,18,8,10,0.444
20600285,1610612760,1610612740,94.0,74.0,0.455,0.389,1,2006-12-08,20,9,11,0.45,18,9,9,0.5
20600271,1610612751,1610612756,157.0,161.0,0.561,0.521,0,2006-12-07,18,7,11,0.389,17,11,6,0.647
20600272,1610612742,1610612765,82.0,92.0,0.419,0.475,0,2006-12-07,19,13,6,0.684,19,12,7,0.632
20600273,1610612758,1610612748,91.0,93.0,0.361,0.434,0,2006-12-07,18,8,10,0.444,18,8,10,0.444
20600261,1610612766,1610612759,76.0,96.0,0.408,0.462,0,2006-12-06,18,5,13,0.278,19,14,5,0.737
20600262,1610612739,1610612761,95.0,91.0,0.4579999999999999,0.4589999999999999,1,2006-12-06,18,11,7,0.611,18,7,11,0.389
20600263,1610612754,1610612753,94.0,80.0,0.481,0.411,1,2006-12-06,20,10,10,0.5,20,14,6,0.7
20600264,1610612738,1610612763,96.0,98.0,0.478,0.412,0,2006-12-06,17,5,12,0.294,18,5,13,0.278
20600265,1610612752,1610612764,102.0,113.0,0.444,0.488,0,2006-12-06,21,7,14,0.3329999999999999,18,8,10,0.444
20600266,1610612749,1610612757,102.0,94.0,0.469,0.4270000000000001,1,2006-12-06,18,7,11,0.389,20,7,13,0.35
20600267,1610612750,1610612745,90.0,84.0,0.449,0.348,1,2006-12-06,17,8,9,0.471,18,12,6,0.667
20600268,1610612741,1610612755,121.0,94.0,0.615,0.466,1,2006-12-06,18,9,9,0.5,17,5,12,0.294
20600269,1610612743,1610612737,96.0,98.0,0.4579999999999999,0.416,0,2006-12-06,16,10,6,0.625,17,8,9,0.471
20600270,1610612747,1610612740,89.0,105.0,0.493,0.478,0,2006-12-06,18,12,6,0.667,17,9,8,0.529
20600255,1610612751,1610612742,75.0,92.0,0.351,0.41,0,2006-12-05,17,7,10,0.412,18,13,5,0.722
20600256,1610612765,1610612757,85.0,88.0,0.4270000000000001,0.41,0,2006-12-05,18,11,7,0.611,19,7,12,0.368
20600257,1610612745,1610612744,118.0,90.0,0.536,0.39,1,2006-12-05,17,12,5,0.706,19,9,10,0.474
20600258,1610612756,1610612758,127.0,102.0,0.495,0.429,1,2006-12-05,16,10,6,0.625,17,8,9,0.471
20600259,1610612760,1610612737,102.0,87.0,0.5529999999999999,0.386,1,2006-12-05,19,8,11,0.421,16,7,9,0.4379999999999999
20600260,1610612746,1610612748,101.0,97.0,0.481,0.407,1,2006-12-05,17,9,8,0.529,17,7,10,0.412
20600248,1610612764,1610612742,106.0,97.0,0.495,0.392,1,2006-12-04,17,7,10,0.412,17,12,5,0.706
20600249,1610612752,1610612763,98.0,90.0,0.563,0.434,1,2006-12-04,20,7,13,0.35,17,4,13,0.235
20600250,1610612759,1610612744,129.0,89.0,0.521,0.407,1,2006-12-04,18,13,5,0.722,18,9,9,0.5
20600251,1610612741,1610612738,100.0,82.0,0.4679999999999999,0.4029999999999999,1,2006-12-04,17,8,9,0.471,16,5,11,0.313
20600252,1610612762,1610612749,101.0,88.0,0.506,0.381,1,2006-12-04,19,15,4,0.789,17,6,11,0.353
20600253,1610612758,1610612753,89.0,92.0,0.395,0.529,0,2006-12-04,16,8,8,0.5,19,14,5,0.737
20600254,1610612747,1610612754,101.0,87.0,0.513,0.433,1,2006-12-04,17,12,5,0.706,19,9,10,0.474
20600244,1610612755,1610612750,84.0,95.0,0.39,0.519,0,2006-12-03,16,5,11,0.313,16,7,9,0.4379999999999999
20600245,1610612766,1610612765,97.0,89.0,0.493,0.407,1,2006-12-03,17,5,12,0.294,17,11,6,0.647
20600246,1610612757,1610612737,96.0,107.0,0.493,0.513,0,2006-12-03,18,6,12,0.3329999999999999,15,7,8,0.467
20600247,1610612746,1610612753,116.0,91.0,0.603,0.4679999999999999,1,2006-12-03,16,8,8,0.5,18,13,5,0.722
20600235,1610612752,1610612761,100.0,103.0,0.4479999999999999,0.4,0,2006-12-02,19,6,13,0.316,17,7,10,0.412
20600234,1610612751,1610612755,112.0,107.0,0.488,0.409,1,2006-12-02,16,7,9,0.4379999999999999,15,5,10,0.3329999999999999
20600236,1610612763,1610612748,97.0,98.0,0.447,0.507,0,2006-12-02,16,4,12,0.25,16,7,9,0.4379999999999999
20600237,1610612759,1610612758,100.0,98.0,0.473,0.494,1,2006-12-02,17,12,5,0.706,15,8,7,0.5329999999999999
20600238,1610612741,1610612764,112.0,94.0,0.506,0.425,1,2006-12-02,16,7,9,0.4379999999999999,16,6,10,0.375
20600239,1610612745,1610612739,81.0,63.0,0.392,0.282,1,2006-12-02,16,11,5,0.688,17,10,7,0.588
20600240,1610612743,1610612754,121.0,101.0,0.477,0.4589999999999999,1,2006-12-02,15,10,5,0.667,18,9,9,0.5
20600241,1610612762,1610612760,109.0,107.0,0.513,0.465,1,2006-12-02,18,14,4,0.778,18,7,11,0.389
20600242,1610612746,1610612747,88.0,97.0,0.436,0.5,0,2006-12-02,15,7,8,0.467,16,11,5,0.688
20600243,1610612744,1610612749,110.0,115.0,0.494,0.482,0,2006-12-02,17,9,8,0.529,16,6,10,0.375
20600224,1610612761,1610612738,106.0,102.0,0.5529999999999999,0.522,1,2006-12-01,16,6,10,0.375,15,5,10,0.3329999999999999
20600225,1610612764,1610612766,121.0,109.0,0.5479999999999999,0.525,1,2006-12-01,15,6,9,0.4,16,4,12,0.25
20600226,1610612737,1610612739,95.0,106.0,0.451,0.526,0,2006-12-01,14,6,8,0.429,16,10,6,0.625
20600227,1610612765,1610612752,108.0,100.0,0.481,0.434,1,2006-12-01,16,11,5,0.688,18,6,12,0.3329999999999999
20600228,1610612740,1610612741,108.0,111.0,0.462,0.477,0,2006-12-01,16,8,8,0.5,15,6,9,0.4
20600229,1610612750,1610612743,92.0,106.0,0.442,0.4529999999999999,0,2006-12-01,15,6,9,0.4,14,9,5,0.643
20600230,1610612742,1610612758,109.0,90.0,0.487,0.442,1,2006-12-01,16,12,4,0.75,14,8,6,0.5710000000000001
20600231,1610612756,1610612749,122.0,116.0,0.506,0.511,1,2006-12-01,15,9,6,0.6,15,5,10,0.3329999999999999
20600232,1610612757,1610612753,89.0,91.0,0.41,0.493,0,2006-12-01,17,6,11,0.353,17,13,4,0.765
20600233,1610612760,1610612754,105.0,103.0,0.471,0.5329999999999999,1,2006-12-01,17,7,10,0.412,17,9,8,0.529
20600222,1610612748,1610612765,85.0,87.0,0.41,0.449,0,2006-11-30,15,6,9,0.4,15,10,5,0.667
20600223,1610612747,1610612762,132.0,102.0,0.6,0.47,1,2006-11-30,15,10,5,0.667,17,13,4,0.765
20600213,1610612737,1610612766,99.0,90.0,0.474,0.366,1,2006-11-29,13,6,7,0.462,15,4,11,0.267
20600214,1610612739,1610612752,98.0,101.0,0.452,0.529,0,2006-11-29,15,9,6,0.6,17,6,11,0.353
20600215,1610612738,1610612751,103.0,106.0,0.486,0.48,0,2006-11-29,14,5,9,0.357,15,6,9,0.4
20600216,1610612742,1610612761,117.0,98.0,0.536,0.4679999999999999,1,2006-11-29,15,11,4,0.733,15,5,10,0.3329999999999999
20600217,1610612762,1610612759,83.0,75.0,0.411,0.397,1,2006-11-29,16,13,3,0.813,16,11,5,0.688
20600218,1610612756,1610612745,102.0,91.0,0.429,0.382,1,2006-11-29,14,8,6,0.5710000000000001,15,10,5,0.667
20600219,1610612760,1610612753,84.0,94.0,0.3879999999999999,0.507,0,2006-11-29,16,6,10,0.375,16,12,4,0.75
20600220,1610612746,1610612763,105.0,90.0,0.529,0.452,1,2006-11-29,14,7,7,0.5,15,4,11,0.267
20600221,1610612744,1610612754,106.0,108.0,0.511,0.426,0,2006-11-29,16,9,7,0.563,16,9,7,0.563
20600204,1610612764,1610612737,96.0,95.0,0.47,0.419,1,2006-11-28,14,5,9,0.357,12,5,7,0.417
20600205,1610612751,1610612766,92.0,96.0,0.406,0.4579999999999999,0,2006-11-28,14,5,9,0.357,14,4,10,0.286
20600206,1610612740,1610612761,77.0,94.0,0.416,0.449,0,2006-11-28,15,8,7,0.5329999999999999,14,5,9,0.357
20600207,1610612741,1610612752,102.0,85.0,0.44,0.478,1,2006-11-28,14,5,9,0.357,16,5,11,0.313
20600208,1610612745,1610612750,82.0,75.0,0.38,0.462,1,2006-11-28,14,10,4,0.7140000000000001,14,6,8,0.429
20600209,1610612743,1610612763,96.0,108.0,0.487,0.489,0,2006-11-28,13,8,5,0.615,14,4,10,0.286
20600210,1610612758,1610612746,93.0,80.0,0.413,0.306,1,2006-11-28,13,8,5,0.615,13,6,7,0.462
20600211,1610612757,1610612754,97.0,105.0,0.391,0.521,0,2006-11-28,16,6,10,0.375,15,8,7,0.5329999999999999
20600212,1610612747,1610612749,105.0,109.0,0.447,0.506,0,2006-11-28,14,9,5,0.643,14,5,9,0.357
20600202,1610612762,1610612753,75.0,88.0,0.426,0.395,0,2006-11-27,15,12,3,0.8,15,11,4,0.733
20600200,1610612748,1610612755,103.0,91.0,0.5870000000000001,0.371,1,2006-11-27,14,6,8,0.429,14,5,9,0.357
20600201,1610612742,1610612750,93.0,87.0,0.472,0.474,1,2006-11-27,14,10,4,0.7140000000000001,13,6,7,0.462
20600203,1610612744,1610612759,111.0,102.0,0.494,0.414,1,2006-11-27,15,9,6,0.6,15,11,4,0.733
20600195,1610612761,1610612754,92.0,83.0,0.435,0.3720000000000001,1,2006-11-26,13,4,9,0.308,14,7,7,0.5
20600196,1610612743,1610612746,103.0,88.0,0.519,0.364,1,2006-11-26,12,8,4,0.667,12,6,6,0.5
20600197,1610612757,1610612756,101.0,119.0,0.506,0.541,0,2006-11-26,15,6,9,0.4,13,7,6,0.5379999999999999
20600198,1610612760,1610612759,78.0,98.0,0.384,0.526,0,2006-11-26,15,6,9,0.4,14,11,3,0.7859999999999999
20600199,1610612747,1610612751,99.0,93.0,0.451,0.486,1,2006-11-26,13,9,4,0.6920000000000001,13,5,8,0.385
20600192,1610612749,1610612738,98.0,111.0,0.487,0.542,0,2006-11-25,13,4,9,0.308,13,5,8,0.385
20600184,1610612764,1610612765,111.0,115.0,0.494,0.4589999999999999,0,2006-11-25,13,4,9,0.308,14,9,5,0.643
20600185,1610612766,1610612748,93.0,102.0,0.407,0.551,0,2006-11-25,13,3,10,0.231,13,5,8,0.385
20600186,1610612753,1610612737,98.0,79.0,0.455,0.356,1,2006-11-25,14,10,4,0.7140000000000001,11,5,6,0.455
20600187,1610612752,1610612741,95.0,106.0,0.466,0.452,0,2006-11-25,15,5,10,0.3329999999999999,13,4,9,0.308
20600188,1610612739,1610612755,108.0,95.0,0.483,0.4029999999999999,1,2006-11-25,14,9,5,0.643,13,5,8,0.385
20600189,1610612750,1610612746,104.0,96.0,0.529,0.534,1,2006-11-25,12,6,6,0.5,11,6,5,0.545
20600190,1610612745,1610612763,85.0,76.0,0.44,0.377,1,2006-11-25,13,9,4,0.6920000000000001,13,3,10,0.231
20600191,1610612742,1610612740,85.0,73.0,0.3879999999999999,0.359,1,2006-11-25,13,9,4,0.6920000000000001,14,8,6,0.5710000000000001
20600193,1610612758,1610612757,105.0,85.0,0.493,0.457,1,2006-11-25,12,7,5,0.583,14,6,8,0.429
20600194,1610612744,1610612762,91.0,78.0,0.4039999999999999,0.325,1,2006-11-25,14,8,6,0.5710000000000001,14,12,2,0.857
20600171,1610612738,1610612752,77.0,101.0,0.382,0.5,0,2006-11-24,12,4,8,0.3329999999999999,14,5,9,0.357
20600172,1610612755,1610612741,123.0,108.0,0.5379999999999999,0.5479999999999999,1,2006-11-24,12,5,7,0.417,12,3,9,0.25
20600173,1610612737,1610612761,97.0,93.0,0.488,0.4429999999999999,1,2006-11-24,10,5,5,0.5,12,3,9,0.25
20600174,1610612748,1610612753,104.0,107.0,0.424,0.457,0,2006-11-24,12,4,8,0.3329999999999999,13,9,4,0.6920000000000001
20600175,1610612765,1610612766,104.0,95.0,0.494,0.481,1,2006-11-24,13,8,5,0.615,12,3,9,0.25
20600176,1610612754,1610612739,97.0,87.0,0.395,0.412,1,2006-11-24,13,7,6,0.5379999999999999,13,8,5,0.615
20600177,1610612763,1610612764,95.0,80.0,0.429,0.4,1,2006-11-24,12,3,9,0.25,12,4,8,0.3329999999999999
20600178,1610612740,1610612750,79.0,86.0,0.3379999999999999,0.479,0,2006-11-24,13,8,5,0.615,11,5,6,0.455
20600179,1610612759,1610612742,92.0,95.0,0.493,0.5,0,2006-11-24,13,10,3,0.769,12,8,4,0.667
20600180,1610612743,1610612744,140.0,129.0,0.5529999999999999,0.57,1,2006-11-24,11,7,4,0.636,13,7,6,0.5379999999999999
20600181,1610612762,1610612747,114.0,108.0,0.5379999999999999,0.473,1,2006-11-24,13,12,1,0.923,12,8,4,0.667
20600182,1610612756,1610612751,99.0,93.0,0.486,0.4379999999999999,1,2006-11-24,12,6,6,0.5,12,5,7,0.417
20600183,1610612760,1610612758,100.0,109.0,0.4629999999999999,0.512,0,2006-11-24,14,6,8,0.429,11,6,5,0.545
20600158,1610612761,1610612739,95.0,87.0,0.457,0.3939999999999999,1,2006-11-22,11,3,8,0.273,12,8,4,0.667
20600159,1610612766,1610612738,92.0,83.0,0.418,0.4,1,2006-11-22,11,3,8,0.273,11,4,7,0.364
20600160,1610612753,1610612754,96.0,91.0,0.493,0.4029999999999999,1,2006-11-22,12,8,4,0.667,12,6,6,0.5
20600161,1610612765,1610612737,103.0,98.0,0.409,0.431,1,2006-11-22,12,7,5,0.583,9,4,5,0.444
20600162,1610612759,1610612748,106.0,86.0,0.494,0.446,1,2006-11-22,12,10,2,0.833,11,4,7,0.364
20600163,1610612749,1610612755,98.0,94.0,0.451,0.436,1,2006-11-22,12,4,8,0.3329999999999999,11,4,7,0.364
20600164,1610612750,1610612752,107.0,89.0,0.528,0.4379999999999999,1,2006-11-22,10,4,6,0.4,13,4,9,0.308
20600165,1610612745,1610612764,86.0,82.0,0.413,0.3329999999999999,1,2006-11-22,12,8,4,0.667,11,4,7,0.364
20600166,1610612756,1610612740,92.0,83.0,0.471,0.4,1,2006-11-22,11,5,6,0.455,12,8,4,0.667
20600167,1610612758,1610612762,101.0,110.0,0.425,0.5479999999999999,0,2006-11-22,10,5,5,0.5,12,11,1,0.917
20600168,1610612757,1610612751,100.0,97.0,0.474,0.539,1,2006-11-22,13,6,7,0.462,11,5,6,0.455
20600169,1610612746,1610612760,85.0,95.0,0.41,0.44,0,2006-11-22,10,6,4,0.6,13,6,7,0.462
20600170,1610612744,1610612743,112.0,115.0,0.447,0.494,0,2006-11-22,12,7,5,0.583,10,6,4,0.6
20600154,1610612740,1610612748,101.0,86.0,0.42,0.368,1,2006-11-21,11,8,3,0.727,10,4,6,0.4
20600151,1610612755,1610612765,87.0,97.0,0.395,0.5,0,2006-11-21,10,4,6,0.4,11,6,5,0.545
20600152,1610612739,1610612763,97.0,94.0,0.5,0.4529999999999999,1,2006-11-21,11,8,3,0.727,11,2,9,0.182
20600153,1610612754,1610612749,93.0,88.0,0.4429999999999999,0.412,1,2006-11-21,11,6,5,0.545,11,3,8,0.273
20600155,1610612742,1610612764,107.0,80.0,0.3979999999999999,0.355,1,2006-11-21,11,7,4,0.636,10,4,6,0.4
20600156,1610612743,1610612741,113.0,109.0,0.461,0.433,1,2006-11-21,9,5,4,0.556,11,3,8,0.273
20600157,1610612747,1610612746,105.0,101.0,0.371,0.482,1,2006-11-21,11,8,3,0.727,9,6,3,0.667
20600144,1610612766,1610612742,85.0,93.0,0.4579999999999999,0.39,0,2006-11-20,10,2,8,0.2,10,6,4,0.6
20600145,1610612752,1610612745,90.0,97.0,0.3720000000000001,0.476,0,2006-11-20,12,4,8,0.3329999999999999,11,7,4,0.636
20600146,1610612763,1610612753,95.0,86.0,0.451,0.436,1,2006-11-20,10,2,8,0.2,11,7,4,0.636
20600147,1610612762,1610612761,101.0,96.0,0.469,0.419,1,2006-11-20,11,10,1,0.909,10,2,8,0.2
20600148,1610612757,1610612759,98.0,107.0,0.5,0.535,0,2006-11-20,12,5,7,0.417,11,9,2,0.818
20600149,1610612760,1610612751,99.0,87.0,0.4270000000000001,0.4579999999999999,1,2006-11-20,12,5,7,0.417,10,5,5,0.5
20600150,1610612744,1610612756,110.0,113.0,0.516,0.489,0,2006-11-20,11,7,4,0.636,10,4,6,0.4
20600142,1610612747,1610612741,82.0,72.0,0.4,0.3379999999999999,1,2006-11-19,10,7,3,0.7,10,3,7,0.3
20600143,1610612758,1610612759,99.0,108.0,0.466,0.442,0,2006-11-19,9,5,4,0.556,10,8,2,0.8
20600129,1610612764,1610612739,111.0,99.0,0.476,0.47,1,2006-11-18,9,4,5,0.444,10,7,3,0.7
20600130,1610612737,1610612748,88.0,93.0,0.371,0.364,0,2006-11-18,8,4,4,0.5,9,4,5,0.444
20600131,1610612753,1610612766,97.0,83.0,0.462,0.397,1,2006-11-18,10,7,3,0.7,9,2,7,0.222
20600132,1610612751,1610612757,68.0,86.0,0.3329999999999999,0.47,0,2006-11-18,9,5,4,0.556,11,5,6,0.455
20600133,1610612752,1610612738,118.0,122.0,0.395,0.429,0,2006-11-18,11,4,7,0.364,10,4,6,0.4
20600134,1610612765,1610612745,104.0,92.0,0.4639999999999999,0.42,1,2006-11-18,10,5,5,0.5,10,6,4,0.6
20600135,1610612750,1610612740,96.0,99.0,0.412,0.481,0,2006-11-18,9,3,6,0.3329999999999999,10,7,3,0.7
20600136,1610612749,1610612754,100.0,102.0,0.462,0.425,0,2006-11-18,10,3,7,0.3,10,5,5,0.5
20600137,1610612742,1610612763,89.0,84.0,0.4629999999999999,0.36,1,2006-11-18,9,5,4,0.556,9,1,8,0.111
20600138,1610612743,1610612761,117.0,109.0,0.451,0.462,1,2006-11-18,8,4,4,0.5,9,2,7,0.222
20600139,1610612762,1610612756,120.0,117.0,0.5,0.488,1,2006-11-18,10,9,1,0.9,9,3,6,0.3329999999999999
20600140,1610612746,1610612755,103.0,97.0,0.467,0.43,1,2006-11-18,8,6,2,0.75,9,4,5,0.444
20600141,1610612744,1610612760,107.0,95.0,0.5,0.446,1,2006-11-18,10,7,3,0.7,11,4,7,0.364
20600119,1610612754,1610612751,91.0,100.0,0.4370000000000001,0.4529999999999999,0,2006-11-17,9,4,5,0.444,8,5,3,0.625
20600120,1610612738,1610612757,118.0,90.0,0.513,0.429,1,2006-11-17,9,3,6,0.3329999999999999,10,4,6,0.4
20600121,1610612748,1610612752,76.0,100.0,0.363,0.519,0,2006-11-17,8,3,5,0.375,10,4,6,0.4
20600122,1610612739,1610612750,92.0,76.0,0.4379999999999999,0.384,1,2006-11-17,9,7,2,0.778,8,3,5,0.375
20600123,1610612765,1610612764,100.0,91.0,0.4320000000000001,0.449,1,2006-11-17,9,4,5,0.444,8,3,5,0.375
20600124,1610612763,1610612742,103.0,115.0,0.507,0.47,0,2006-11-17,8,1,7,0.125,8,4,4,0.5
20600125,1610612759,1610612741,100.0,83.0,0.514,0.4579999999999999,1,2006-11-17,9,7,2,0.778,9,3,6,0.3329999999999999
20600126,1610612756,1610612755,106.0,94.0,0.466,0.446,1,2006-11-17,8,3,5,0.375,8,4,4,0.5
20600127,1610612747,1610612761,107.0,100.0,0.5479999999999999,0.4579999999999999,1,2006-11-17,9,6,3,0.667,8,2,6,0.25
20600128,1610612760,1610612762,109.0,118.0,0.536,0.506,0,2006-11-17,10,4,6,0.4,9,8,1,0.889
20600118,1610612744,1610612758,117.0,105.0,0.5770000000000001,0.4320000000000001,1,2006-11-16,9,6,3,0.667,8,5,3,0.625
20600117,1610612745,1610612741,101.0,100.0,0.436,0.4429999999999999,1,2006-11-16,9,6,3,0.667,8,3,5,0.375
20600108,1610612753,1610612743,108.0,99.0,0.5,0.4270000000000001,1,2006-11-15,9,6,3,0.667,7,3,4,0.429
20600109,1610612739,1610612757,100.0,87.0,0.486,0.405,1,2006-11-15,8,6,2,0.75,9,4,5,0.444
20600110,1610612738,1610612754,114.0,88.0,0.5,0.3829999999999999,1,2006-11-15,8,2,6,0.25,8,4,4,0.5
20600111,1610612751,1610612749,100.0,87.0,0.552,0.408,1,2006-11-15,7,4,3,0.5710000000000001,9,3,6,0.3329999999999999
20600112,1610612752,1610612764,102.0,82.0,0.446,0.315,1,2006-11-15,9,3,6,0.3329999999999999,7,3,4,0.429
20600113,1610612765,1610612740,99.0,100.0,0.521,0.442,0,2006-11-15,8,3,5,0.375,9,6,3,0.667
20600114,1610612759,1610612766,92.0,95.0,0.375,0.435,0,2006-11-15,8,6,2,0.75,8,2,6,0.25
20600115,1610612758,1610612763,115.0,111.0,0.5,0.527,1,2006-11-15,7,5,2,0.7140000000000001,7,1,6,0.143
20600116,1610612760,1610612755,90.0,96.0,0.417,0.466,0,2006-11-15,9,4,5,0.444,7,4,3,0.5710000000000001
20600100,1610612737,1610612749,101.0,103.0,0.475,0.507,0,2006-11-14,7,4,3,0.5710000000000001,8,3,5,0.375
20600101,1610612748,1610612743,105.0,112.0,0.442,0.449,0,2006-11-14,7,3,4,0.429,6,3,3,0.5
20600102,1610612740,1610612766,94.0,85.0,0.407,0.455,1,2006-11-14,8,5,3,0.625,7,1,6,0.143
20600103,1610612750,1610612757,101.0,89.0,0.487,0.425,1,2006-11-14,7,3,4,0.429,8,4,4,0.5
20600104,1610612745,1610612759,84.0,92.0,0.381,0.486,0,2006-11-14,8,5,3,0.625,7,6,1,0.857
20600105,1610612742,1610612741,111.0,99.0,0.5,0.4529999999999999,1,2006-11-14,7,3,4,0.429,7,3,4,0.429
20600106,1610612762,1610612746,112.0,90.0,0.512,0.4629999999999999,1,2006-11-14,8,7,1,0.875,7,5,2,0.7140000000000001
20600107,1610612744,1610612761,110.0,99.0,0.433,0.4,1,2006-11-14,8,5,3,0.625,7,2,5,0.286
20600097,1610612738,1610612753,89.0,92.0,0.3829999999999999,0.535,0,2006-11-13,7,1,6,0.143,8,5,3,0.625
20600098,1610612751,1610612760,113.0,119.0,0.506,0.484,0,2006-11-13,6,3,3,0.5,8,4,4,0.5
20600099,1610612752,1610612739,96.0,102.0,0.488,0.456,0,2006-11-13,8,2,6,0.25,7,5,2,0.7140000000000001
20600090,1610612746,1610612740,92.0,76.0,0.416,0.456,1,2006-11-12,6,5,1,0.833,7,4,3,0.5710000000000001
20600091,1610612764,1610612751,93.0,105.0,0.351,0.488,0,2006-11-12,6,3,3,0.5,5,3,2,0.6
20600092,1610612766,1610612743,101.0,108.0,0.476,0.429,0,2006-11-12,6,1,5,0.1669999999999999,5,2,3,0.4
20600093,1610612748,1610612745,72.0,94.0,0.3939999999999999,0.461,0,2006-11-12,6,3,3,0.5,7,5,2,0.7140000000000001
20600094,1610612758,1610612761,107.0,92.0,0.487,0.417,1,2006-11-12,6,4,2,0.667,6,2,4,0.3329999999999999
20600095,1610612757,1610612742,96.0,103.0,0.461,0.551,0,2006-11-12,7,4,3,0.5710000000000001,6,2,4,0.3329999999999999
20600096,1610612747,1610612763,91.0,81.0,0.45,0.384,1,2006-11-12,8,5,3,0.625,6,1,5,0.1669999999999999
20600082,1610612737,1610612760,112.0,113.0,0.488,0.4679999999999999,0,2006-11-11,6,4,2,0.667,7,3,4,0.429
20600083,1610612739,1610612738,94.0,93.0,0.408,0.41,1,2006-11-11,6,4,2,0.667,6,1,5,0.1669999999999999
20600084,1610612759,1610612752,100.0,92.0,0.507,0.456,1,2006-11-11,6,5,1,0.833,7,2,5,0.286
20600085,1610612750,1610612753,98.0,109.0,0.4429999999999999,0.5,0,2006-11-11,6,2,4,0.3329999999999999,7,4,3,0.5710000000000001
20600086,1610612741,1610612754,89.0,80.0,0.3829999999999999,0.446,1,2006-11-11,6,3,3,0.5,7,4,3,0.5710000000000001
20600087,1610612749,1610612762,111.0,113.0,0.482,0.5379999999999999,0,2006-11-11,7,2,5,0.286,7,6,1,0.857
20600088,1610612756,1610612763,96.0,87.0,0.414,0.408,1,2006-11-11,7,2,5,0.286,5,1,4,0.2
20600089,1610612744,1610612765,111.0,79.0,0.5660000000000001,0.423,1,2006-11-11,7,4,3,0.5710000000000001,7,3,4,0.429
20600080,1610612757,1610612740,92.0,91.0,0.418,0.434,1,2006-11-10,6,4,2,0.667,6,4,2,0.667
20600072,1610612761,1610612737,102.0,111.0,0.466,0.5,0,2006-11-10,5,2,3,0.4,5,4,1,0.8
20600073,1610612755,1610612743,101.0,108.0,0.476,0.46,0,2006-11-10,6,3,3,0.5,4,1,3,0.25
20600074,1610612764,1610612749,116.0,111.0,0.475,0.478,1,2006-11-10,5,3,2,0.6,6,2,4,0.3329999999999999
20600075,1610612766,1610612760,85.0,99.0,0.397,0.474,0,2006-11-10,5,1,4,0.2,6,2,4,0.3329999999999999
20600076,1610612754,1610612753,93.0,83.0,0.392,0.4379999999999999,1,2006-11-10,6,4,2,0.667,6,3,3,0.5
20600077,1610612738,1610612762,100.0,107.0,0.5,0.532,0,2006-11-10,5,1,4,0.2,6,5,1,0.833
20600078,1610612751,1610612748,106.0,113.0,0.48,0.482,0,2006-11-10,4,2,2,0.5,5,3,2,0.6
20600079,1610612745,1610612752,103.0,94.0,0.5479999999999999,0.4320000000000001,1,2006-11-10,6,4,2,0.667,6,2,4,0.3329999999999999
20600081,1610612747,1610612765,83.0,97.0,0.423,0.4579999999999999,0,2006-11-10,7,4,3,0.5710000000000001,6,3,3,0.5
20600069,1610612739,1610612741,113.0,94.0,0.57,0.44,1,2006-11-09,5,3,2,0.6,5,2,3,0.4
20600070,1610612756,1610612742,112.0,119.0,0.547,0.5479999999999999,0,2006-11-09,6,1,5,0.1669999999999999,5,1,4,0.2
20600071,1610612744,1610612740,121.0,116.0,0.513,0.506,1,2006-11-09,6,3,3,0.5,5,4,1,0.8
20600058,1610612761,1610612755,106.0,104.0,0.409,0.494,1,2006-11-08,4,2,2,0.5,5,3,2,0.6
20600059,1610612764,1610612754,117.0,91.0,0.518,0.386,1,2006-11-08,4,2,2,0.5,5,3,2,0.6
20600060,1610612753,1610612760,88.0,87.0,0.54,0.416,1,2006-11-08,5,3,2,0.6,5,1,4,0.2
20600061,1610612738,1610612766,110.0,108.0,0.4529999999999999,0.3929999999999999,1,2006-11-08,4,1,3,0.25,4,1,3,0.25
20600062,1610612751,1610612762,96.0,89.0,0.42,0.423,1,2006-11-08,3,2,1,0.667,5,4,1,0.8
20600063,1610612749,1610612745,93.0,97.0,0.466,0.487,0,2006-11-08,5,2,3,0.4,5,3,2,0.6
20600064,1610612759,1610612756,111.0,106.0,0.42,0.495,1,2006-11-08,5,4,1,0.8,5,1,4,0.2
20600065,1610612743,1610612752,107.0,109.0,0.447,0.5,0,2006-11-08,3,0,3,0.0,5,2,3,0.4
20600066,1610612757,1610612747,101.0,90.0,0.515,0.471,1,2006-11-08,5,3,2,0.6,6,4,2,0.667
20600067,1610612746,1610612742,103.0,85.0,0.482,0.39,1,2006-11-08,5,4,1,0.8,4,0,4,0.0
20600068,1610612758,1610612765,99.0,86.0,0.43,0.3939999999999999,1,2006-11-08,5,3,2,0.6,5,2,3,0.4
20600053,1610612754,1610612755,97.0,86.0,0.451,0.446,1,2006-11-07,4,3,1,0.75,4,3,1,0.75
20600052,1610612739,1610612737,95.0,104.0,0.363,0.519,0,2006-11-07,4,2,2,0.5,4,3,1,0.75
20600054,1610612748,1610612760,90.0,87.0,0.397,0.429,1,2006-11-07,4,2,2,0.5,4,1,3,0.25
20600055,1610612763,1610612745,80.0,86.0,0.4,0.424,0,2006-11-07,4,1,3,0.25,4,2,2,0.5
20600056,1610612740,1610612744,97.0,93.0,0.4270000000000001,0.4629999999999999,1,2006-11-07,4,4,0,1.0,5,2,3,0.4
20600057,1610612747,1610612750,95.0,88.0,0.461,0.42,1,2006-11-07,5,4,1,0.8,5,2,3,0.4
20600051,1610612746,1610612757,102.0,89.0,0.451,0.444,1,2006-11-06,4,3,1,0.75,4,2,2,0.5
20600046,1610612752,1610612759,93.0,105.0,0.444,0.48,0,2006-11-06,4,1,3,0.25,4,3,1,0.75
20600048,1610612742,1610612744,104.0,107.0,0.4579999999999999,0.493,0,2006-11-06,3,0,3,0.0,4,2,2,0.5
20600047,1610612741,1610612749,110.0,85.0,0.541,0.41,1,2006-11-06,4,2,2,0.5,4,2,2,0.5
20600050,1610612758,1610612750,93.0,81.0,0.4529999999999999,0.413,1,2006-11-06,4,2,2,0.5,4,2,2,0.5
20600049,1610612762,1610612765,103.0,101.0,0.482,0.416,1,2006-11-06,4,4,0,1.0,4,2,2,0.5
20600045,1610612753,1610612764,106.0,103.0,0.506,0.456,1,2006-11-06,4,2,2,0.5,3,1,2,0.3329999999999999
20600040,1610612761,1610612759,94.0,103.0,0.421,0.5,0,2006-11-05,3,1,2,0.3329999999999999,3,2,1,0.667
20600041,1610612755,1610612748,107.0,98.0,0.456,0.5,1,2006-11-05,3,3,0,1.0,3,1,2,0.3329999999999999
20600042,1610612737,1610612753,95.0,82.0,0.425,0.419,1,2006-11-05,3,2,1,0.667,3,1,2,0.3329999999999999
20600043,1610612740,1610612745,96.0,90.0,0.471,0.405,1,2006-11-05,3,3,0,1.0,3,1,2,0.3329999999999999
20600044,1610612760,1610612747,117.0,101.0,0.519,0.493,1,2006-11-05,3,1,2,0.3329999999999999,4,3,1,0.75
20600031,1610612764,1610612738,124.0,117.0,0.524,0.529,1,2006-11-04,2,1,1,0.5,3,0,3,0.0
20600032,1610612766,1610612739,92.0,88.0,0.4429999999999999,0.38,1,2006-11-04,3,1,2,0.3329999999999999,3,2,1,0.667
20600033,1610612752,1610612754,95.0,109.0,0.43,0.523,0,2006-11-04,3,1,2,0.3329999999999999,3,2,1,0.667
20600034,1610612765,1610612763,95.0,86.0,0.507,0.3779999999999999,1,2006-11-04,3,2,1,0.667,3,1,2,0.3329999999999999
20600035,1610612749,1610612758,104.0,91.0,0.528,0.4,1,2006-11-04,3,2,1,0.667,3,1,2,0.3329999999999999
20600036,1610612745,1610612742,107.0,76.0,0.536,0.414,1,2006-11-04,2,1,1,0.5,2,0,2,0.0
20600037,1610612762,1610612744,106.0,82.0,0.512,0.384,1,2006-11-04,3,3,0,1.0,3,1,2,0.3329999999999999
20600038,1610612757,1610612750,88.0,86.0,0.4270000000000001,0.479,1,2006-11-04,3,2,1,0.667,3,2,1,0.667
20600039,1610612746,1610612756,114.0,108.0,0.471,0.44,1,2006-11-04,3,2,1,0.667,4,1,3,0.25
20600018,1610612761,1610612749,109.0,92.0,0.534,0.442,1,2006-11-03,2,1,1,0.5,2,1,1,0.5
20600019,1610612753,1610612755,103.0,105.0,0.534,0.561,0,2006-11-03,2,1,1,0.5,2,2,0,1.0
20600020,1610612754,1610612740,91.0,100.0,0.4,0.44,0,2006-11-03,2,1,1,0.5,2,2,0,1.0
20600021,1610612738,1610612765,88.0,101.0,0.4529999999999999,0.42,0,2006-11-03,2,0,2,0.0,2,1,1,0.5
20600022,1610612737,1610612752,102.0,92.0,0.476,0.4579999999999999,1,2006-11-03,2,1,1,0.5,2,1,1,0.5
20600023,1610612748,1610612751,91.0,85.0,0.461,0.39,1,2006-11-03,2,1,1,0.5,2,1,1,0.5
20600024,1610612763,1610612766,96.0,83.0,0.356,0.471,1,2006-11-03,2,1,1,0.5,2,0,2,0.0
20600025,1610612759,1610612739,81.0,88.0,0.42,0.446,0,2006-11-03,2,1,1,0.5,2,2,0,1.0
20600026,1610612741,1610612758,88.0,89.0,0.41,0.37,0,2006-11-03,3,1,2,0.3329999999999999,2,1,1,0.5
20600027,1610612743,1610612750,109.0,112.0,0.506,0.519,0,2006-11-03,2,0,2,0.0,2,2,0,1.0
20600028,1610612756,1610612762,104.0,108.0,0.41,0.469,0,2006-11-03,3,1,2,0.3329999999999999,2,2,0,1.0
20600029,1610612747,1610612760,118.0,112.0,0.5539999999999999,0.449,1,2006-11-03,3,3,0,1.0,2,0,2,0.0
20600030,1610612744,1610612757,102.0,89.0,0.494,0.4320000000000001,1,2006-11-03,2,1,1,0.5,2,1,1,0.5
20600017,1610612746,1610612743,96.0,95.0,0.4270000000000001,0.386,1,2006-11-02,2,1,1,0.5,1,0,1,0.0
20600016,1610612742,1610612759,91.0,97.0,0.4320000000000001,0.493,0,2006-11-02,1,0,1,0.0,1,1,0,1.0
20600004,1610612766,1610612754,99.0,106.0,0.474,0.407,0,2006-11-01,1,0,1,0.0,1,1,0,1.0
20600005,1610612753,1610612741,109.0,94.0,0.593,0.451,1,2006-11-01,1,1,0,1.0,2,1,1,0.5
20600003,1610612755,1610612737,88.0,75.0,0.419,0.3329999999999999,1,2006-11-01,1,1,0,1.0,1,0,1,0.0
20600011,1610612750,1610612758,92.0,83.0,0.486,0.348,1,2006-11-01,1,1,0,1.0,1,0,1,0.0
20600014,1610612756,1610612746,112.0,104.0,0.532,0.4270000000000001,1,2006-11-01,2,1,1,0.5,1,0,1,0.0
20600008,1610612765,1610612749,97.0,105.0,0.431,0.462,0,2006-11-01,1,0,1,0.0,1,1,0,1.0
20600009,1610612739,1610612764,97.0,94.0,0.474,0.4679999999999999,1,2006-11-01,1,1,0,1.0,1,0,1,0.0
20600006,1610612738,1610612740,87.0,91.0,0.4,0.429,0,2006-11-01,1,0,1,0.0,1,1,0,1.0
20600015,1610612744,1610612747,98.0,110.0,0.415,0.4529999999999999,0,2006-11-01,1,0,1,0.0,2,2,0,1.0
20600010,1610612763,1610612752,117.0,118.0,0.4,0.421,0,2006-11-01,1,0,1,0.0,1,1,0,1.0
20600012,1610612762,1610612745,107.0,97.0,0.527,0.4320000000000001,1,2006-11-01,1,1,0,1.0,1,0,1,0.0
20600013,1610612760,1610612757,106.0,110.0,0.456,0.5479999999999999,0,2006-11-01,1,0,1,0.0,1,1,0,1.0
20600007,1610612751,1610612761,102.0,92.0,0.513,0.3939999999999999,1,2006-11-01,1,1,0,1.0,1,0,1,0.0
20600001,1610612748,1610612741,66.0,108.0,0.385,0.494,0,2006-10-31,1,0,1,0.0,1,1,0,1.0
20600002,1610612747,1610612756,114.0,106.0,0.5539999999999999,0.519,1,2006-10-31,1,1,0,1.0,1,0,1,0.0
10600118,1610612751,1610612752,138.0,121.0,0.511,0.506,1,2006-10-27,8,3,5,0.375,6,4,2,0.667
10600116,1610612749,1610612750,76.0,101.0,0.31,0.308,0,2006-10-27,8,3,5,0.375,8,5,3,0.625
10600122,1610612737,1610612766,105.0,94.0,0.478,0.416,1,2006-10-27,8,5,3,0.625,8,2,6,0.25
10600119,1610612741,1610612761,108.0,97.0,0.494,0.408,1,2006-10-27,8,6,2,0.75,8,7,1,0.875
10600120,1610612759,1610612742,100.0,79.0,0.562,0.382,1,2006-10-27,7,4,3,0.5710000000000001,8,3,5,0.375
10600117,1610612758,1610612757,84.0,78.0,0.375,0.4029999999999999,1,2006-10-27,8,5,3,0.625,8,2,6,0.25
10600121,1610612746,1610612743,86.0,112.0,0.297,0.473,0,2006-10-27,8,5,3,0.625,8,5,3,0.625
10600112,1610612749,1610612766,124.0,126.0,0.45,0.456,0,2006-10-26,7,3,4,0.429,7,2,5,0.286
10600111,1610612753,1610612745,94.0,90.0,0.4529999999999999,0.384,1,2006-10-26,8,6,2,0.75,7,5,2,0.7140000000000001
10600113,1610612762,1610612754,122.0,96.0,0.452,0.509,1,2006-10-26,8,4,4,0.5,8,3,5,0.375
10600114,1610612747,1610612743,108.0,126.0,0.32,0.377,0,2006-10-26,8,4,4,0.5,7,4,3,0.5710000000000001
10600115,1610612760,1610612744,111.0,107.0,0.419,0.532,1,2006-10-26,8,4,4,0.5,7,6,1,0.857
10600103,1610612755,1610612751,110.0,88.0,0.506,0.4379999999999999,1,2006-10-25,7,3,4,0.429,7,2,5,0.286
10600108,1610612765,1610612763,82.0,92.0,0.405,0.5,0,2006-10-25,8,5,3,0.625,8,4,4,0.5
10600106,1610612738,1610612761,102.0,106.0,0.487,0.395,0,2006-10-25,8,3,5,0.375,7,7,0,1.0
10600107,1610612739,1610612742,81.0,83.0,0.471,0.4029999999999999,0,2006-10-25,8,2,6,0.25,7,3,4,0.429
10600104,1610612750,1610612741,109.0,105.0,0.466,0.466,1,2006-10-25,7,4,3,0.5710000000000001,7,5,2,0.7140000000000001
10600110,1610612748,1610612745,71.0,96.0,0.422,0.444,0,2006-10-25,7,2,5,0.286,6,5,1,0.833
10600105,1610612760,1610612758,103.0,88.0,0.5379999999999999,0.431,1,2006-10-25,7,3,4,0.429,7,4,3,0.5710000000000001
10600109,1610612746,1610612757,97.0,89.0,0.513,0.596,1,2006-10-25,7,5,2,0.7140000000000001,7,2,5,0.286
10600094,1610612766,1610612754,101.0,89.0,0.3329999999999999,0.28,1,2006-10-24,6,1,5,0.1669999999999999,7,3,4,0.429
10600095,1610612753,1610612748,82.0,92.0,0.375,0.45,0,2006-10-24,7,5,2,0.7140000000000001,6,2,4,0.3329999999999999
10600100,1610612765,1610612764,101.0,94.0,0.486,0.44,1,2006-10-24,7,5,2,0.7140000000000001,8,4,4,0.5
10600098,1610612751,1610612738,109.0,107.0,0.488,0.4589999999999999,1,2006-10-24,6,2,4,0.3329999999999999,7,3,4,0.429
10600099,1610612752,1610612755,113.0,102.0,0.551,0.519,1,2006-10-24,5,4,1,0.8,6,2,4,0.3329999999999999
10600101,1610612741,1610612763,87.0,84.0,0.414,0.423,1,2006-10-24,6,5,1,0.833,7,3,4,0.429
10600096,1610612743,1610612762,107.0,127.0,0.429,0.5429999999999999,0,2006-10-24,6,3,3,0.5,7,3,4,0.429
10600097,1610612758,1610612740,81.0,84.0,0.409,0.4270000000000001,0,2006-10-24,6,4,2,0.667,7,2,5,0.286
10600102,1610612744,1610612757,108.0,96.0,0.537,0.474,1,2006-10-24,6,6,0,1.0,6,2,4,0.3329999999999999
10600091,1610612737,1610612764,105.0,110.0,0.5,0.481,0,2006-10-23,7,4,3,0.5710000000000001,7,4,3,0.5710000000000001
10600092,1610612756,1610612760,102.0,108.0,0.471,0.5,0,2006-10-23,8,4,4,0.5,6,2,4,0.3329999999999999
10600093,1610612757,1610612762,114.0,110.0,0.531,0.47,1,2006-10-23,5,2,3,0.4,6,2,4,0.3329999999999999
10600088,1610612765,1610612743,105.0,124.0,0.47,0.479,0,2006-10-22,6,4,2,0.667,5,3,2,0.6
10600086,1610612761,1610612739,91.0,90.0,0.385,0.407,1,2006-10-22,6,6,0,1.0,7,2,5,0.286
10600087,1610612758,1610612740,117.0,93.0,0.359,0.311,1,2006-10-22,5,4,1,0.8,6,1,5,0.1669999999999999
10600090,1610612745,1610612759,93.0,72.0,0.452,0.354,1,2006-10-22,5,4,1,0.8,6,3,3,0.5
10600089,1610612747,1610612756,94.0,91.0,0.31,0.2789999999999999,1,2006-10-22,7,4,3,0.5710000000000001,7,4,3,0.5710000000000001
10600082,1610612739,1610612737,88.0,90.0,0.384,0.3929999999999999,0,2006-10-21,6,2,4,0.3329999999999999,6,4,2,0.667
10600078,1610612753,1610612763,112.0,89.0,0.479,0.355,1,2006-10-21,6,5,1,0.833,6,3,3,0.5
10600081,1610612738,1610612752,113.0,89.0,0.488,0.435,1,2006-10-21,6,3,3,0.5,4,3,1,0.75
10600079,1610612750,1610612754,91.0,98.0,0.466,0.4429999999999999,0,2006-10-21,6,3,3,0.5,6,3,3,0.5
10600080,1610612759,1610612748,103.0,93.0,0.479,0.366,1,2006-10-21,5,3,2,0.6,5,1,4,0.2
10600083,1610612749,1610612743,119.0,108.0,0.48,0.4529999999999999,1,2006-10-21,6,3,3,0.5,4,2,2,0.5
10600084,1610612742,1610612764,93.0,90.0,0.382,0.435,1,2006-10-21,6,2,4,0.3329999999999999,6,3,3,0.5
10600085,1610612746,1610612760,86.0,82.0,0.447,0.355,1,2006-10-21,6,4,2,0.667,5,1,4,0.2
10600071,1610612746,1610612744,106.0,116.0,0.433,0.544,0,2006-10-20,5,3,2,0.6,5,5,0,1.0
10600074,1610612751,1610612755,102.0,92.0,0.537,0.429,1,2006-10-20,5,1,4,0.2,5,2,3,0.4
10600072,1610612763,1610612748,96.0,95.0,0.5,0.48,1,2006-10-20,5,3,2,0.6,4,1,3,0.25
10600075,1610612741,1610612750,83.0,85.0,0.4029999999999999,0.386,0,2006-10-20,5,4,1,0.8,5,3,2,0.6
10600073,1610612758,1610612762,112.0,96.0,0.472,0.4429999999999999,1,2006-10-20,4,3,1,0.75,5,2,3,0.4
10600076,1610612747,1610612740,113.0,106.0,0.5379999999999999,0.488,1,2006-10-20,6,3,3,0.5,5,1,4,0.2
10600077,1610612760,1610612757,95.0,103.0,0.4679999999999999,0.621,0,2006-10-20,4,1,3,0.25,4,1,3,0.25
10600062,1610612744,1610612740,112.0,103.0,0.513,0.412,1,2006-10-19,4,4,0,1.0,4,1,3,0.25
10600065,1610612754,1610612766,109.0,96.0,0.521,0.402,1,2006-10-19,5,2,3,0.4,5,0,5,0.0
10600064,1610612737,1610612753,88.0,109.0,0.295,0.33,0,2006-10-19,5,3,2,0.6,5,4,1,0.8
10600066,1610612759,1610612741,67.0,99.0,0.3379999999999999,0.477,0,2006-10-19,4,2,2,0.5,4,4,0,1.0
10600070,1610612742,1610612749,88.0,71.0,0.416,0.3379999999999999,1,2006-10-19,5,1,4,0.2,5,2,3,0.4
10600067,1610612762,1610612757,104.0,90.0,0.513,0.405,1,2006-10-19,4,2,2,0.5,3,0,3,0.0
10600068,1610612756,1610612758,111.0,94.0,0.5,0.418,1,2006-10-19,6,4,2,0.667,3,2,1,0.667
10600069,1610612747,1610612746,90.0,91.0,0.424,0.389,0,2006-10-19,5,2,3,0.4,4,3,1,0.75
10600057,1610612765,1610612750,112.0,103.0,0.3389999999999999,0.3329999999999999,1,2006-10-18,5,4,1,0.8,4,2,2,0.5
10600058,1610612743,1610612754,114.0,102.0,0.4579999999999999,0.4629999999999999,1,2006-10-18,3,2,1,0.667,4,1,3,0.25
10600059,1610612738,1610612751,94.0,90.0,0.4579999999999999,0.392,1,2006-10-18,5,2,3,0.4,4,0,4,0.0
10600060,1610612739,1610612761,81.0,103.0,0.314,0.318,0,2006-10-18,5,2,3,0.4,4,4,0,1.0
10600061,1610612745,1610612749,111.0,97.0,0.5,0.494,1,2006-10-18,4,3,1,0.75,4,2,2,0.5
10600049,1610612753,1610612737,96.0,100.0,0.494,0.479,0,2006-10-17,4,3,1,0.75,4,3,1,0.75
10600054,1610612752,1610612738,116.0,108.0,0.481,0.447,1,2006-10-17,3,3,0,1.0,4,1,3,0.25
10600055,1610612748,1610612740,109.0,105.0,0.486,0.435,1,2006-10-17,3,1,2,0.3329999999999999,3,1,2,0.3329999999999999
10600048,1610612766,1610612764,84.0,100.0,0.355,0.42,0,2006-10-17,4,0,4,0.0,5,3,2,0.6
10600056,1610612742,1610612745,69.0,72.0,0.342,0.373,0,2006-10-17,4,0,4,0.0,3,2,1,0.667
10600051,1610612756,1610612746,96.0,107.0,0.4629999999999999,0.4579999999999999,0,2006-10-17,5,3,2,0.6,3,2,1,0.667
10600052,1610612747,1610612758,91.0,96.0,0.283,0.287,0,2006-10-17,4,2,2,0.5,2,2,0,1.0
10600053,1610612757,1610612744,120.0,124.0,0.488,0.457,0,2006-10-17,2,0,2,0.0,3,3,0,1.0
10600045,1610612754,1610612750,87.0,103.0,0.4320000000000001,0.39,0,2006-10-16,3,1,2,0.3329999999999999,3,2,1,0.667
10600047,1610612765,1610612762,90.0,85.0,0.485,0.37,1,2006-10-16,4,3,1,0.75,3,1,2,0.3329999999999999
10600046,1610612763,1610612741,78.0,87.0,0.433,0.569,0,2006-10-16,4,2,2,0.5,3,3,0,1.0
10600044,1610612766,1610612764,91.0,100.0,0.447,0.5539999999999999,0,2006-10-16,3,0,3,0.0,4,2,2,0.5
10600042,1610612761,1610612751,119.0,110.0,0.429,0.487,1,2006-10-15,3,3,0,1.0,3,0,3,0.0
10600041,1610612741,1610612760,110.0,105.0,0.3329999999999999,0.318,1,2006-10-15,2,2,0,1.0,3,1,2,0.3329999999999999
10600043,1610612747,1610612756,91.0,99.0,0.321,0.304,0,2006-10-15,3,2,1,0.667,4,3,1,0.75
10600033,1610612737,1610612748,91.0,81.0,0.395,0.425,1,2006-10-14,3,2,1,0.667,2,0,2,0.0
10600034,1610612755,1610612752,100.0,102.0,0.384,0.407,0,2006-10-14,4,2,2,0.5,2,2,0,1.0
10600035,1610612754,1610612762,84.0,97.0,0.371,0.4379999999999999,0,2006-10-14,2,1,1,0.5,2,1,1,0.5
10600038,1610612739,1610612764,89.0,93.0,0.455,0.4679999999999999,0,2006-10-14,3,1,2,0.3329999999999999,3,1,2,0.3329999999999999
10600036,1610612763,1610612765,101.0,89.0,0.481,0.412,1,2006-10-14,3,2,1,0.667,3,2,1,0.667
10600037,1610612759,1610612753,87.0,92.0,0.515,0.434,0,2006-10-14,3,2,1,0.667,3,3,0,1.0
10600040,1610612743,1610612744,115.0,121.0,0.4270000000000001,0.469,0,2006-10-14,2,1,1,0.5,2,2,0,1.0
10600039,1610612749,1610612742,91.0,78.0,0.4589999999999999,0.312,1,2006-10-14,3,2,1,0.667,3,0,3,0.0
10600027,1610612766,1610612749,100.0,104.0,0.4379999999999999,0.452,0,2006-10-13,2,0,2,0.0,2,1,1,0.5
10600030,1610612738,1610612739,82.0,91.0,0.387,0.48,0,2006-10-13,3,1,2,0.3329999999999999,2,1,1,0.5
10600031,1610612752,1610612751,111.0,97.0,0.47,0.3939999999999999,1,2006-10-13,1,1,0,1.0,2,0,2,0.0
10600028,1610612740,1610612753,85.0,100.0,0.478,0.529,0,2006-10-13,2,1,1,0.5,2,2,0,1.0
10600029,1610612750,1610612765,96.0,101.0,0.551,0.481,0,2006-10-13,2,1,1,0.5,2,2,0,1.0
10600032,1610612745,1610612737,107.0,93.0,0.493,0.42,1,2006-10-13,2,1,1,0.5,2,1,1,0.5
10600025,1610612742,1610612758,90.0,111.0,0.397,0.47,0,2006-10-12,2,0,2,0.0,1,1,0,1.0
10600024,1610612747,1610612760,104.0,101.0,0.344,0.342,1,2006-10-12,2,2,0,1.0,2,1,1,0.5
10600017,1610612761,1610612738,118.0,112.0,0.444,0.4579999999999999,1,2006-10-11,2,2,0,1.0,2,1,1,0.5
10600018,1610612754,1610612751,103.0,89.0,0.47,0.375,1,2006-10-11,1,1,0,1.0,1,0,1,0.0
10600019,1610612763,1610612737,91.0,108.0,0.386,0.5,0,2006-10-11,2,1,1,0.5,1,1,0,1.0
10600020,1610612750,1610612749,98.0,93.0,0.485,0.36,1,2006-10-11,1,1,0,1.0,1,0,1,0.0
10600022,1610612741,1610612764,87.0,86.0,0.413,0.439,1,2006-10-11,1,1,0,1.0,2,0,2,0.0
10600021,1610612757,1610612760,89.0,99.0,0.444,0.457,0,2006-10-11,1,0,1,0.0,1,1,0,1.0
10600008,1610612766,1610612753,90.0,109.0,0.341,0.486,0,2006-10-10,1,0,1,0.0,1,1,0,1.0
10600015,1610612755,1610612756,103.0,100.0,0.488,0.422,1,2006-10-10,2,1,1,0.5,2,1,1,0.5
10600009,1610612739,1610612738,93.0,109.0,0.4589999999999999,0.481,0,2006-10-10,1,0,1,0.0,1,1,0,1.0
10600010,1610612740,1610612742,84.0,81.0,0.411,0.408,1,2006-10-10,1,1,0,1.0,1,0,1,0.0
10600013,1610612745,1610612763,69.0,75.0,0.357,0.391,0,2006-10-10,1,0,1,0.0,1,1,0,1.0
10600014,1610612748,1610612765,64.0,84.0,0.315,0.4370000000000001,0,2006-10-10,1,0,1,0.0,1,1,0,1.0
10600012,1610612747,1610612762,94.0,79.0,0.508,0.412,1,2006-10-10,1,1,0,1.0,1,0,1,0.0
10600007,1610612764,1610612761,88.0,93.0,0.4379999999999999,0.38,0,2006-10-09,1,0,1,0.0,1,1,0,1.0
40500406,1610612742,1610612748,92.0,95.0,0.37,0.449,0,2006-06-20,82,60,22,0.732,82,52,30,0.634
40500405,1610612748,1610612742,101.0,100.0,0.449,0.457,1,2006-06-18,82,52,30,0.634,82,60,22,0.732
40500404,1610612748,1610612742,98.0,74.0,0.515,0.316,1,2006-06-15,82,52,30,0.634,82,60,22,0.732
40500403,1610612748,1610612742,98.0,96.0,0.487,0.48,1,2006-06-13,82,52,30,0.634,82,60,22,0.732
40500402,1610612742,1610612748,99.0,85.0,0.486,0.414,1,2006-06-11,82,60,22,0.732,82,52,30,0.634
40500401,1610612742,1610612748,90.0,80.0,0.444,0.436,1,2006-06-08,82,60,22,0.732,82,52,30,0.634
40500316,1610612756,1610612742,93.0,102.0,0.5,0.474,0,2006-06-03,82,54,28,0.659,82,60,22,0.732
40500306,1610612748,1610612765,95.0,78.0,0.557,0.3329999999999999,1,2006-06-02,82,52,30,0.634,82,64,18,0.78
40500315,1610612742,1610612756,117.0,101.0,0.472,0.456,1,2006-06-01,82,60,22,0.732,82,54,28,0.659
40500305,1610612765,1610612748,91.0,78.0,0.429,0.442,1,2006-05-31,82,64,18,0.78,82,52,30,0.634
40500314,1610612756,1610612742,106.0,86.0,0.544,0.418,1,2006-05-30,82,54,28,0.659,82,60,22,0.732
40500304,1610612748,1610612765,89.0,78.0,0.5489999999999999,0.39,1,2006-05-29,82,52,30,0.634,82,64,18,0.78
40500313,1610612756,1610612742,88.0,95.0,0.4270000000000001,0.411,0,2006-05-28,82,54,28,0.659,82,60,22,0.732
40500303,1610612748,1610612765,98.0,83.0,0.5820000000000001,0.422,1,2006-05-27,82,52,30,0.634,82,64,18,0.78
40500312,1610612742,1610612756,105.0,98.0,0.475,0.449,1,2006-05-26,82,60,22,0.732,82,54,28,0.659
40500302,1610612765,1610612748,92.0,88.0,0.44,0.425,1,2006-05-25,82,64,18,0.78,82,52,30,0.634
40500311,1610612742,1610612756,118.0,121.0,0.505,0.5529999999999999,0,2006-05-24,82,60,22,0.732,82,54,28,0.659
40500301,1610612765,1610612748,86.0,91.0,0.3779999999999999,0.563,0,2006-05-23,82,64,18,0.78,82,52,30,0.634
40500227,1610612759,1610612742,111.0,119.0,0.474,0.519,0,2006-05-22,82,63,19,0.768,82,60,22,0.732
40500237,1610612756,1610612746,127.0,107.0,0.6,0.526,1,2006-05-22,82,54,28,0.659,82,47,35,0.573
40500207,1610612765,1610612739,79.0,61.0,0.426,0.308,1,2006-05-21,82,64,18,0.78,82,50,32,0.61
40500206,1610612739,1610612765,82.0,84.0,0.4479999999999999,0.456,0,2006-05-19,82,50,32,0.61,82,64,18,0.78
40500226,1610612742,1610612759,86.0,91.0,0.386,0.433,0,2006-05-19,82,60,22,0.732,82,63,19,0.768
40500236,1610612746,1610612756,118.0,106.0,0.615,0.4370000000000001,1,2006-05-18,82,47,35,0.573,82,54,28,0.659
40500205,1610612765,1610612739,84.0,86.0,0.4270000000000001,0.3829999999999999,0,2006-05-17,82,64,18,0.78,82,50,32,0.61
40500225,1610612759,1610612742,98.0,97.0,0.536,0.506,1,2006-05-17,82,63,19,0.768,82,60,22,0.732
40500215,1610612748,1610612751,106.0,105.0,0.56,0.541,1,2006-05-16,82,52,30,0.634,82,49,33,0.598
40500235,1610612756,1610612746,125.0,118.0,0.4579999999999999,0.408,1,2006-05-16,82,54,28,0.659,82,47,35,0.573
40500204,1610612739,1610612765,74.0,72.0,0.426,0.3329999999999999,1,2006-05-15,82,50,32,0.61,82,64,18,0.78
40500224,1610612742,1610612759,123.0,118.0,0.5,0.532,1,2006-05-15,82,60,22,0.732,82,63,19,0.768
40500214,1610612751,1610612748,92.0,102.0,0.429,0.529,0,2006-05-14,82,49,33,0.598,82,52,30,0.634
40500234,1610612746,1610612756,114.0,107.0,0.488,0.455,1,2006-05-14,82,47,35,0.573,82,54,28,0.659
40500223,1610612742,1610612759,104.0,103.0,0.485,0.476,1,2006-05-13,82,60,22,0.732,82,63,19,0.768
40500203,1610612739,1610612765,86.0,77.0,0.5,0.3939999999999999,1,2006-05-13,82,50,32,0.61,82,64,18,0.78
40500213,1610612751,1610612748,92.0,103.0,0.435,0.4479999999999999,0,2006-05-12,82,49,33,0.598,82,52,30,0.634
40500233,1610612746,1610612756,91.0,94.0,0.422,0.3720000000000001,0,2006-05-12,82,47,35,0.573,82,54,28,0.659
40500212,1610612748,1610612751,111.0,89.0,0.527,0.4,1,2006-05-10,82,52,30,0.634,82,49,33,0.598
40500232,1610612756,1610612746,97.0,122.0,0.456,0.544,0,2006-05-10,82,54,28,0.659,82,47,35,0.573
40500202,1610612765,1610612739,97.0,91.0,0.412,0.4429999999999999,1,2006-05-09,82,64,18,0.78,82,50,32,0.61
40500222,1610612759,1610612742,91.0,113.0,0.455,0.462,0,2006-05-09,82,63,19,0.768,82,60,22,0.732
40500211,1610612748,1610612751,88.0,100.0,0.391,0.486,0,2006-05-08,82,52,30,0.634,82,49,33,0.598
40500231,1610612756,1610612746,130.0,123.0,0.547,0.593,1,2006-05-08,82,54,28,0.659,82,47,35,0.573
40500221,1610612759,1610612742,87.0,85.0,0.413,0.416,1,2006-05-07,82,63,19,0.768,82,60,22,0.732
40500201,1610612765,1610612739,113.0,86.0,0.519,0.415,1,2006-05-07,82,64,18,0.78,82,50,32,0.61
40500157,1610612756,1610612747,121.0,90.0,0.61,0.352,1,2006-05-06,82,54,28,0.659,82,45,37,0.5489999999999999
40500136,1610612764,1610612739,113.0,114.0,0.456,0.506,0,2006-05-05,82,42,40,0.512,82,50,32,0.61
40500146,1610612758,1610612759,83.0,105.0,0.412,0.506,0,2006-05-05,82,44,38,0.537,82,63,19,0.768
40500126,1610612754,1610612751,90.0,96.0,0.471,0.465,0,2006-05-04,82,41,41,0.5,82,49,33,0.598
40500116,1610612741,1610612748,96.0,113.0,0.413,0.494,0,2006-05-04,82,41,41,0.5,82,52,30,0.634
40500156,1610612747,1610612756,118.0,126.0,0.5529999999999999,0.568,0,2006-05-04,82,45,37,0.5489999999999999,82,54,28,0.659
40500105,1610612765,1610612749,122.0,93.0,0.541,0.439,1,2006-05-03,82,64,18,0.78,82,40,42,0.488
40500135,1610612739,1610612764,121.0,120.0,0.5429999999999999,0.524,1,2006-05-03,82,50,32,0.61,82,42,40,0.512
40500125,1610612751,1610612754,92.0,86.0,0.462,0.42,1,2006-05-02,82,49,33,0.598,82,41,41,0.5
40500115,1610612748,1610612741,92.0,78.0,0.452,0.347,1,2006-05-02,82,52,30,0.634,82,41,41,0.5
40500145,1610612759,1610612758,109.0,98.0,0.574,0.442,1,2006-05-02,82,63,19,0.768,82,44,38,0.537
40500155,1610612756,1610612747,114.0,97.0,0.488,0.514,1,2006-05-02,82,54,28,0.659,82,45,37,0.5489999999999999
40500174,1610612763,1610612742,76.0,102.0,0.418,0.494,0,2006-05-01,82,49,33,0.598,82,60,22,0.732
40500104,1610612749,1610612765,99.0,109.0,0.551,0.473,0,2006-05-01,82,40,42,0.488,82,64,18,0.78
40500165,1610612746,1610612743,101.0,83.0,0.5,0.37,1,2006-05-01,82,47,35,0.573,82,44,38,0.537
40500114,1610612741,1610612748,93.0,87.0,0.456,0.416,1,2006-04-30,82,41,41,0.5,82,52,30,0.634
40500154,1610612747,1610612756,99.0,98.0,0.442,0.4379999999999999,1,2006-04-30,82,45,37,0.5489999999999999,82,54,28,0.659
40500134,1610612764,1610612739,106.0,96.0,0.423,0.5,1,2006-04-30,82,42,40,0.512,82,50,32,0.61
40500144,1610612758,1610612759,102.0,84.0,0.5,0.451,1,2006-04-30,82,44,38,0.537,82,63,19,0.768
40500124,1610612754,1610612751,88.0,97.0,0.444,0.487,0,2006-04-29,82,41,41,0.5,82,49,33,0.598
40500173,1610612763,1610612742,89.0,94.0,0.408,0.412,0,2006-04-29,82,49,33,0.598,82,60,22,0.732
40500103,1610612749,1610612765,124.0,104.0,0.603,0.486,1,2006-04-29,82,40,42,0.488,82,64,18,0.78
40500164,1610612743,1610612746,86.0,100.0,0.424,0.487,0,2006-04-29,82,44,38,0.537,82,47,35,0.573
40500133,1610612764,1610612739,96.0,97.0,0.479,0.412,0,2006-04-28,82,42,40,0.512,82,50,32,0.61
40500143,1610612758,1610612759,94.0,93.0,0.429,0.461,1,2006-04-28,82,44,38,0.537,82,63,19,0.768
40500153,1610612747,1610612756,99.0,92.0,0.415,0.436,1,2006-04-28,82,45,37,0.5489999999999999,82,54,28,0.659
40500123,1610612754,1610612751,107.0,95.0,0.523,0.387,1,2006-04-27,82,41,41,0.5,82,49,33,0.598
40500113,1610612741,1610612748,109.0,90.0,0.462,0.417,1,2006-04-27,82,41,41,0.5,82,52,30,0.634
40500163,1610612743,1610612746,94.0,87.0,0.3779999999999999,0.4029999999999999,1,2006-04-27,82,44,38,0.537,82,47,35,0.573
40500102,1610612765,1610612749,109.0,98.0,0.506,0.435,1,2006-04-26,82,64,18,0.78,82,40,42,0.488
40500172,1610612742,1610612763,94.0,79.0,0.449,0.4589999999999999,1,2006-04-26,82,60,22,0.732,82,49,33,0.598
40500152,1610612756,1610612747,93.0,99.0,0.423,0.507,0,2006-04-26,82,54,28,0.659,82,45,37,0.5489999999999999
40500132,1610612739,1610612764,84.0,89.0,0.361,0.397,0,2006-04-25,82,50,32,0.61,82,42,40,0.512
40500122,1610612751,1610612754,90.0,75.0,0.465,0.354,1,2006-04-25,82,49,33,0.598,82,41,41,0.5
40500142,1610612759,1610612758,128.0,119.0,0.512,0.483,1,2006-04-25,82,63,19,0.768,82,44,38,0.537
40500112,1610612748,1610612741,115.0,108.0,0.524,0.532,1,2006-04-24,82,52,30,0.634,82,41,41,0.5
40500162,1610612746,1610612743,98.0,87.0,0.475,0.342,1,2006-04-24,82,47,35,0.573,82,44,38,0.537
40500121,1610612751,1610612754,88.0,90.0,0.425,0.469,0,2006-04-23,82,49,33,0.598,82,41,41,0.5
40500151,1610612756,1610612747,107.0,102.0,0.452,0.422,1,2006-04-23,82,54,28,0.659,82,45,37,0.5489999999999999
40500101,1610612765,1610612749,92.0,74.0,0.413,0.356,1,2006-04-23,82,64,18,0.78,82,40,42,0.488
40500171,1610612742,1610612763,103.0,93.0,0.4589999999999999,0.532,1,2006-04-23,82,60,22,0.732,82,49,33,0.598
40500131,1610612739,1610612764,97.0,86.0,0.4370000000000001,0.408,1,2006-04-22,82,50,32,0.61,82,42,40,0.512
40500141,1610612759,1610612758,122.0,88.0,0.575,0.3929999999999999,1,2006-04-22,82,63,19,0.768,82,44,38,0.537
40500111,1610612748,1610612741,111.0,106.0,0.481,0.455,1,2006-04-22,82,52,30,0.634,82,41,41,0.5
40500161,1610612746,1610612743,89.0,87.0,0.441,0.385,1,2006-04-22,82,47,35,0.573,82,44,38,0.537
20501224,1610612750,1610612763,92.0,102.0,0.351,0.446,0,2006-04-19,82,33,49,0.402,82,49,33,0.598
20501219,1610612738,1610612748,85.0,78.0,0.36,0.324,1,2006-04-19,82,33,49,0.402,82,52,30,0.634
20501221,1610612766,1610612755,96.0,86.0,0.446,0.525,1,2006-04-19,82,26,56,0.317,82,38,44,0.4629999999999999
20501220,1610612751,1610612752,83.0,90.0,0.395,0.532,0,2006-04-19,82,49,33,0.598,82,23,59,0.28
20501217,1610612739,1610612737,100.0,99.0,0.452,0.425,1,2006-04-19,82,50,32,0.61,82,26,56,0.317
20501218,1610612754,1610612753,89.0,83.0,0.4370000000000001,0.364,1,2006-04-19,82,41,41,0.5,82,36,46,0.439
20501222,1610612765,1610612764,80.0,96.0,0.4029999999999999,0.407,0,2006-04-19,82,64,18,0.78,82,42,40,0.512
20501223,1610612745,1610612759,87.0,89.0,0.447,0.385,0,2006-04-19,82,34,48,0.415,82,63,19,0.768
20501226,1610612742,1610612746,71.0,85.0,0.371,0.472,0,2006-04-19,82,60,22,0.732,82,47,35,0.573
20501225,1610612741,1610612761,127.0,106.0,0.544,0.351,1,2006-04-19,82,41,41,0.5,82,27,55,0.3289999999999999
20501227,1610612762,1610612744,105.0,102.0,0.545,0.4,1,2006-04-19,82,41,41,0.5,82,34,48,0.415
20501228,1610612757,1610612756,96.0,106.0,0.434,0.4629999999999999,0,2006-04-19,82,21,61,0.256,82,54,28,0.659
20501229,1610612747,1610612740,115.0,95.0,0.517,0.476,1,2006-04-19,82,45,37,0.5489999999999999,82,38,44,0.4629999999999999
20501230,1610612760,1610612743,109.0,98.0,0.456,0.4429999999999999,1,2006-04-19,82,35,47,0.4270000000000001,82,44,38,0.537
20501212,1610612755,1610612751,91.0,88.0,0.466,0.42,1,2006-04-18,81,38,43,0.469,81,49,32,0.605
20501213,1610612764,1610612749,116.0,103.0,0.488,0.479,1,2006-04-18,81,41,40,0.506,82,40,42,0.488
20501214,1610612737,1610612748,103.0,100.0,0.446,0.5,1,2006-04-18,81,26,55,0.321,81,52,29,0.642
20501215,1610612763,1610612746,101.0,95.0,0.5,0.5,1,2006-04-18,81,48,33,0.593,81,46,35,0.568
20501216,1610612758,1610612760,111.0,105.0,0.467,0.513,1,2006-04-18,82,44,38,0.537,81,34,47,0.42
20501210,1610612756,1610612740,115.0,78.0,0.5660000000000001,0.337,1,2006-04-17,81,53,28,0.654,81,38,43,0.469
20501203,1610612761,1610612754,95.0,120.0,0.38,0.5660000000000001,0,2006-04-17,81,27,54,0.3329999999999999,81,40,41,0.494
20501204,1610612753,1610612741,112.0,116.0,0.439,0.475,0,2006-04-17,81,36,45,0.444,81,40,41,0.494
20501205,1610612738,1610612739,88.0,93.0,0.514,0.4379999999999999,0,2006-04-17,81,32,49,0.395,81,49,32,0.605
20501206,1610612752,1610612766,91.0,98.0,0.514,0.481,0,2006-04-17,81,22,59,0.272,81,25,56,0.309
20501207,1610612749,1610612765,113.0,93.0,0.563,0.417,1,2006-04-17,81,40,41,0.494,81,64,17,0.79
20501208,1610612759,1610612762,115.0,82.0,0.5710000000000001,0.434,1,2006-04-17,81,62,19,0.765,81,40,41,0.494
20501209,1610612743,1610612745,83.0,86.0,0.413,0.413,0,2006-04-17,81,44,37,0.5429999999999999,81,34,47,0.42
20501211,1610612744,1610612757,93.0,79.0,0.451,0.446,1,2006-04-17,81,34,47,0.42,81,21,60,0.259
20501194,1610612748,1610612741,93.0,117.0,0.421,0.506,0,2006-04-16,80,52,28,0.65,80,39,41,0.488
20501196,1610612747,1610612756,109.0,89.0,0.4320000000000001,0.368,1,2006-04-16,81,44,37,0.5429999999999999,80,52,28,0.65
20501195,1610612750,1610612759,90.0,103.0,0.434,0.513,0,2006-04-16,81,33,48,0.407,80,61,19,0.763
20501197,1610612764,1610612739,104.0,92.0,0.461,0.4589999999999999,1,2006-04-16,80,40,40,0.5,80,48,32,0.6
20501198,1610612765,1610612752,103.0,97.0,0.532,0.513,1,2006-04-16,80,64,16,0.8,80,22,58,0.275
20501199,1610612751,1610612738,95.0,93.0,0.5,0.474,1,2006-04-16,80,49,31,0.613,80,32,48,0.4
20501200,1610612742,1610612762,111.0,95.0,0.426,0.508,1,2006-04-16,81,60,21,0.741,80,40,40,0.5
20501201,1610612746,1610612760,98.0,114.0,0.455,0.541,0,2006-04-16,80,46,34,0.575,80,34,46,0.425
20501202,1610612758,1610612740,96.0,79.0,0.45,0.4379999999999999,1,2006-04-16,81,43,38,0.531,80,38,42,0.475
20501189,1610612766,1610612754,92.0,91.0,0.409,0.419,1,2006-04-15,80,24,56,0.3,80,39,41,0.488
20501192,1610612743,1610612758,82.0,100.0,0.4,0.488,0,2006-04-15,80,44,36,0.55,80,42,38,0.525
20501188,1610612753,1610612755,102.0,97.0,0.469,0.47,1,2006-04-15,80,36,44,0.45,80,37,43,0.4629999999999999
20501190,1610612749,1610612737,114.0,120.0,0.488,0.57,0,2006-04-15,80,39,41,0.488,80,25,55,0.313
20501191,1610612745,1610612763,81.0,93.0,0.4370000000000001,0.5,0,2006-04-15,80,33,47,0.413,80,47,33,0.588
20501193,1610612757,1610612744,81.0,86.0,0.472,0.37,0,2006-04-15,80,21,59,0.263,80,33,47,0.413
20501185,1610612747,1610612757,110.0,99.0,0.482,0.514,1,2006-04-14,80,43,37,0.5379999999999999,79,21,58,0.266
20501184,1610612741,1610612764,103.0,101.0,0.471,0.4479999999999999,1,2006-04-14,79,38,41,0.481,79,39,40,0.494
20501177,1610612761,1610612765,108.0,103.0,0.451,0.513,1,2006-04-14,80,27,53,0.3379999999999999,79,63,16,0.797
20501178,1610612737,1610612766,110.0,116.0,0.519,0.5379999999999999,0,2006-04-14,79,24,55,0.304,79,23,56,0.291
20501179,1610612738,1610612751,74.0,79.0,0.382,0.392,0,2006-04-14,79,32,47,0.405,79,48,31,0.608
20501180,1610612752,1610612749,80.0,97.0,0.4379999999999999,0.5,0,2006-04-14,79,22,57,0.278,79,39,40,0.494
20501181,1610612748,1610612755,104.0,85.0,0.526,0.41,1,2006-04-14,79,52,27,0.6579999999999999,79,37,42,0.4679999999999999
20501182,1610612754,1610612750,89.0,77.0,0.452,0.434,1,2006-04-14,79,39,40,0.494,80,33,47,0.413
20501183,1610612740,1610612762,104.0,105.0,0.47,0.4679999999999999,0,2006-04-14,79,38,41,0.481,79,40,39,0.506
20501186,1610612744,1610612756,110.0,102.0,0.473,0.421,1,2006-04-14,79,32,47,0.405,79,52,27,0.6579999999999999
20501187,1610612760,1610612746,97.0,101.0,0.4320000000000001,0.474,0,2006-04-14,79,33,46,0.418,79,46,33,0.5820000000000001
20501174,1610612739,1610612752,91.0,87.0,0.413,0.444,1,2006-04-13,79,48,31,0.608,78,22,56,0.282
20501175,1610612759,1610612753,80.0,92.0,0.452,0.494,0,2006-04-13,79,60,19,0.759,79,35,44,0.4429999999999999
20501176,1610612756,1610612742,117.0,104.0,0.542,0.442,1,2006-04-13,78,52,26,0.667,80,59,21,0.738
20501162,1610612737,1610612741,90.0,96.0,0.385,0.418,0,2006-04-12,78,24,54,0.308,78,37,41,0.474
20501163,1610612753,1610612761,103.0,96.0,0.475,0.474,1,2006-04-12,78,34,44,0.436,79,26,53,0.3289999999999999
20501164,1610612754,1610612738,117.0,112.0,0.519,0.5920000000000001,1,2006-04-12,78,38,40,0.487,78,32,46,0.41
20501165,1610612751,1610612755,96.0,116.0,0.4379999999999999,0.5,0,2006-04-12,78,47,31,0.603,78,37,41,0.474
20501166,1610612766,1610612763,88.0,96.0,0.4039999999999999,0.408,0,2006-04-12,78,22,56,0.282,79,46,33,0.5820000000000001
20501167,1610612765,1610612739,96.0,73.0,0.4370000000000001,0.351,1,2006-04-12,78,63,15,0.8079999999999999,78,47,31,0.603
20501168,1610612749,1610612764,100.0,97.0,0.507,0.436,1,2006-04-12,78,38,40,0.487,78,39,39,0.5
20501169,1610612740,1610612760,104.0,99.0,0.4629999999999999,0.487,1,2006-04-12,78,38,40,0.487,78,33,45,0.423
20501170,1610612745,1610612750,79.0,82.0,0.38,0.3779999999999999,0,2006-04-12,79,33,46,0.418,79,33,46,0.418
20501171,1610612762,1610612743,104.0,83.0,0.488,0.4370000000000001,1,2006-04-12,78,39,39,0.5,79,44,35,0.557
20501172,1610612746,1610612757,97.0,93.0,0.493,0.456,1,2006-04-12,78,45,33,0.5770000000000001,78,21,57,0.2689999999999999
20501173,1610612744,1610612742,114.0,102.0,0.487,0.442,1,2006-04-12,78,31,47,0.397,79,59,20,0.747
20501157,1610612763,1610612750,92.0,76.0,0.451,0.413,1,2006-04-11,78,45,33,0.5770000000000001,78,32,46,0.41
20501156,1610612748,1610612761,106.0,97.0,0.525,0.426,1,2006-04-11,78,51,27,0.654,78,26,52,0.3329999999999999
20501158,1610612741,1610612751,104.0,101.0,0.416,0.4,1,2006-04-11,77,36,41,0.4679999999999999,77,47,30,0.61
20501159,1610612759,1610612760,104.0,95.0,0.5,0.386,1,2006-04-11,78,60,18,0.769,77,33,44,0.429
20501160,1610612758,1610612756,110.0,123.0,0.536,0.57,0,2006-04-11,79,41,38,0.519,77,51,26,0.662
20501161,1610612747,1610612744,111.0,100.0,0.441,0.415,1,2006-04-11,79,42,37,0.532,77,30,47,0.39
20501149,1610612755,1610612764,105.0,97.0,0.476,0.395,1,2006-04-10,77,36,41,0.4679999999999999,77,39,38,0.506
20501150,1610612753,1610612737,105.0,88.0,0.526,0.43,1,2006-04-10,77,33,44,0.429,77,24,53,0.312
20501151,1610612754,1610612752,101.0,82.0,0.474,0.4429999999999999,1,2006-04-10,77,37,40,0.481,77,22,55,0.286
20501152,1610612740,1610612739,101.0,103.0,0.418,0.536,0,2006-04-10,77,37,40,0.481,77,47,30,0.61
20501153,1610612762,1610612745,85.0,83.0,0.4589999999999999,0.449,1,2006-04-10,77,38,39,0.494,78,33,45,0.423
20501154,1610612757,1610612743,98.0,110.0,0.42,0.5379999999999999,0,2006-04-10,77,21,56,0.273,78,44,34,0.564
20501155,1610612746,1610612742,73.0,75.0,0.352,0.373,0,2006-04-10,77,44,33,0.5710000000000001,78,59,19,0.7559999999999999
20501141,1610612765,1610612754,98.0,73.0,0.457,0.364,1,2006-04-09,77,62,15,0.805,76,36,40,0.474
20501140,1610612761,1610612766,88.0,94.0,0.447,0.455,0,2006-04-09,77,26,51,0.3379999999999999,77,22,55,0.286
20501142,1610612749,1610612751,83.0,95.0,0.375,0.41,0,2006-04-09,77,37,40,0.481,76,47,29,0.618
20501144,1610612750,1610612737,84.0,83.0,0.455,0.39,1,2006-04-09,77,32,45,0.416,76,24,52,0.316
20501139,1610612738,1610612752,86.0,101.0,0.4629999999999999,0.471,0,2006-04-09,77,32,45,0.416,76,22,54,0.289
20501145,1610612748,1610612753,84.0,93.0,0.5,0.515,0,2006-04-09,77,50,27,0.649,76,32,44,0.421
20501143,1610612759,1610612763,83.0,81.0,0.446,0.413,1,2006-04-09,77,59,18,0.7659999999999999,77,44,33,0.5710000000000001
20501146,1610612758,1610612745,86.0,77.0,0.406,0.44,1,2006-04-09,78,41,37,0.526,77,33,44,0.429
20501147,1610612760,1610612756,116.0,114.0,0.529,0.478,1,2006-04-09,76,33,43,0.434,76,50,26,0.6579999999999999
20501148,1610612747,1610612746,100.0,83.0,0.451,0.43,1,2006-04-09,78,41,37,0.526,76,44,32,0.579
20501136,1610612742,1610612740,101.0,77.0,0.494,0.444,1,2006-04-08,77,58,19,0.753,76,37,39,0.487
20501133,1610612751,1610612739,102.0,108.0,0.475,0.5429999999999999,0,2006-04-08,75,46,29,0.613,76,46,30,0.605
20501134,1610612764,1610612748,86.0,99.0,0.397,0.4629999999999999,0,2006-04-08,76,39,37,0.513,76,50,26,0.6579999999999999
20501135,1610612741,1610612755,75.0,89.0,0.326,0.39,0,2006-04-08,76,35,41,0.461,76,35,41,0.461
20501137,1610612743,1610612744,95.0,92.0,0.447,0.3979999999999999,1,2006-04-08,77,43,34,0.5579999999999999,76,30,46,0.395
20501138,1610612762,1610612757,110.0,93.0,0.514,0.446,1,2006-04-08,76,37,39,0.487,76,21,55,0.276
20501127,1610612750,1610612762,95.0,103.0,0.4589999999999999,0.488,0,2006-04-07,76,31,45,0.408,75,36,39,0.48
20501124,1610612752,1610612754,98.0,96.0,0.439,0.474,1,2006-04-07,75,21,54,0.28,75,36,39,0.48
20501122,1610612737,1610612764,114.0,101.0,0.485,0.387,1,2006-04-07,75,24,51,0.32,75,39,36,0.52
20501125,1610612763,1610612749,100.0,90.0,0.528,0.384,1,2006-04-07,76,44,32,0.579,76,37,39,0.487
20501126,1610612740,1610612761,95.0,89.0,0.494,0.3779999999999999,1,2006-04-07,75,37,38,0.493,76,26,50,0.342
20501121,1610612755,1610612738,99.0,109.0,0.4579999999999999,0.527,0,2006-04-07,75,34,41,0.4529999999999999,76,32,44,0.421
20501123,1610612753,1610612765,89.0,87.0,0.529,0.456,1,2006-04-07,75,31,44,0.413,76,61,15,0.8029999999999999
20501128,1610612759,1610612742,86.0,92.0,0.3779999999999999,0.514,0,2006-04-07,76,58,18,0.763,76,57,19,0.75
20501129,1610612757,1610612760,108.0,121.0,0.519,0.56,0,2006-04-07,75,21,54,0.28,75,32,43,0.4270000000000001
20501130,1610612756,1610612747,107.0,96.0,0.495,0.451,1,2006-04-07,75,50,25,0.667,77,40,37,0.519
20501131,1610612746,1610612758,93.0,96.0,0.4370000000000001,0.44,0,2006-04-07,75,44,31,0.5870000000000001,77,40,37,0.519
20501132,1610612744,1610612745,93.0,100.0,0.4029999999999999,0.4679999999999999,0,2006-04-07,75,30,45,0.4,76,33,43,0.434
20501118,1610612751,1610612766,113.0,102.0,0.532,0.4,1,2006-04-06,74,46,28,0.622,76,21,55,0.276
20501119,1610612748,1610612765,82.0,95.0,0.446,0.493,0,2006-04-06,75,49,26,0.653,75,61,14,0.813
20501120,1610612743,1610612747,110.0,108.0,0.418,0.429,1,2006-04-06,76,42,34,0.5529999999999999,76,40,36,0.526
20501108,1610612738,1610612764,91.0,108.0,0.479,0.529,0,2006-04-05,75,31,44,0.413,74,39,35,0.527
20501109,1610612755,1610612741,92.0,99.0,0.4579999999999999,0.4579999999999999,0,2006-04-05,74,34,40,0.4589999999999999,75,35,40,0.467
20501110,1610612737,1610612750,101.0,99.0,0.482,0.506,1,2006-04-05,74,23,51,0.311,75,31,44,0.413
20501111,1610612753,1610612749,108.0,105.0,0.5529999999999999,0.449,1,2006-04-05,74,30,44,0.405,75,37,38,0.493
20501112,1610612754,1610612761,111.0,103.0,0.402,0.409,1,2006-04-05,74,36,38,0.486,75,26,49,0.347
20501113,1610612752,1610612739,96.0,94.0,0.507,0.465,1,2006-04-05,74,20,54,0.27,75,45,30,0.6
20501114,1610612740,1610612744,114.0,109.0,0.4629999999999999,0.488,1,2006-04-05,74,36,38,0.486,74,30,44,0.405
20501115,1610612759,1610612758,87.0,97.0,0.413,0.475,0,2006-04-05,75,58,17,0.773,76,39,37,0.513
20501117,1610612757,1610612745,76.0,75.0,0.418,0.423,1,2006-04-05,74,21,53,0.284,75,32,43,0.4270000000000001
20501116,1610612756,1610612746,105.0,119.0,0.42,0.541,0,2006-04-05,74,49,25,0.662,74,44,30,0.595
20501107,1610612746,1610612743,111.0,109.0,0.524,0.547,1,2006-04-04,73,43,30,0.589,75,41,34,0.547
20501095,1610612761,1610612738,120.0,124.0,0.444,0.537,0,2006-04-04,74,26,48,0.351,74,31,43,0.419
20501096,1610612764,1610612752,105.0,90.0,0.493,0.441,1,2006-04-04,73,38,35,0.521,73,19,54,0.26
20501097,1610612739,1610612755,124.0,91.0,0.5660000000000001,0.4,1,2006-04-04,74,45,29,0.608,73,34,39,0.466
20501098,1610612751,1610612737,96.0,94.0,0.384,0.435,1,2006-04-04,73,45,28,0.616,73,22,51,0.301
20501099,1610612766,1610612750,97.0,92.0,0.446,0.456,1,2006-04-04,75,21,54,0.28,74,31,43,0.419
20501100,1610612748,1610612749,115.0,89.0,0.616,0.423,1,2006-04-04,74,49,25,0.662,74,37,37,0.5
20501101,1610612765,1610612740,101.0,93.0,0.493,0.476,1,2006-04-04,74,60,14,0.8109999999999999,73,35,38,0.479
20501102,1610612763,1610612744,100.0,75.0,0.449,0.342,1,2006-04-04,75,43,32,0.573,73,30,43,0.411
20501103,1610612741,1610612754,102.0,96.0,0.525,0.442,1,2006-04-04,74,34,40,0.4589999999999999,73,35,38,0.479
20501104,1610612742,1610612758,127.0,101.0,0.613,0.4579999999999999,1,2006-04-04,75,56,19,0.747,75,38,37,0.507
20501105,1610612762,1610612759,86.0,95.0,0.423,0.452,0,2006-04-04,74,35,39,0.473,74,58,16,0.784
20501106,1610612760,1610612745,104.0,87.0,0.461,0.43,1,2006-04-04,74,31,43,0.419,74,32,42,0.4320000000000001
20501088,1610612750,1610612744,106.0,104.0,0.444,0.415,1,2006-04-02,73,31,42,0.425,72,30,42,0.417
20501085,1610612755,1610612752,114.0,95.0,0.5489999999999999,0.516,1,2006-04-02,72,34,38,0.472,72,19,53,0.264
20501086,1610612765,1610612756,109.0,102.0,0.5,0.526,1,2006-04-02,73,59,14,0.8079999999999999,73,49,24,0.6709999999999999
20501087,1610612742,1610612743,103.0,79.0,0.521,0.387,1,2006-04-02,74,55,19,0.743,74,41,33,0.5539999999999999
20501089,1610612747,1610612745,104.0,88.0,0.5529999999999999,0.435,1,2006-04-02,75,40,35,0.5329999999999999,73,32,41,0.4379999999999999
20501090,1610612763,1610612737,98.0,87.0,0.452,0.472,1,2006-04-02,74,42,32,0.568,72,22,50,0.306
20501091,1610612751,1610612748,90.0,78.0,0.423,0.413,1,2006-04-02,72,44,28,0.611,73,48,25,0.6579999999999999
20501092,1610612766,1610612739,97.0,101.0,0.4,0.481,0,2006-04-02,74,20,54,0.27,73,44,29,0.603
20501084,1610612761,1610612740,113.0,120.0,0.3979999999999999,0.455,0,2006-04-02,73,26,47,0.356,72,35,37,0.486
20501093,1610612758,1610612746,106.0,96.0,0.488,0.424,1,2006-04-02,74,38,36,0.514,72,42,30,0.583
20501094,1610612760,1610612757,122.0,83.0,0.53,0.39,1,2006-04-02,73,30,43,0.411,73,20,53,0.2739999999999999
20501079,1610612739,1610612748,106.0,99.0,0.506,0.47,1,2006-04-01,72,43,29,0.597,72,48,24,0.667
20501080,1610612741,1610612738,100.0,94.0,0.382,0.422,1,2006-04-01,73,33,40,0.452,73,30,43,0.411
20501081,1610612749,1610612754,96.0,89.0,0.426,0.5,1,2006-04-01,73,37,36,0.507,72,35,37,0.486
20501082,1610612759,1610612764,106.0,99.0,0.461,0.507,1,2006-04-01,73,57,16,0.7809999999999999,72,37,35,0.514
20501083,1610612757,1610612762,89.0,102.0,0.446,0.48,0,2006-04-01,72,20,52,0.278,73,35,38,0.479
20501070,1610612752,1610612755,112.0,117.0,0.529,0.556,0,2006-03-31,71,19,52,0.268,71,33,38,0.465
20501068,1610612737,1610612751,88.0,91.0,0.473,0.347,0,2006-03-31,71,22,49,0.31,71,43,28,0.606
20501072,1610612765,1610612749,112.0,105.0,0.532,0.519,1,2006-03-31,72,58,14,0.8059999999999999,72,36,36,0.5
20501077,1610612744,1610612758,93.0,96.0,0.476,0.493,0,2006-03-31,71,30,41,0.423,73,37,36,0.507
20501071,1610612766,1610612741,107.0,113.0,0.447,0.472,0,2006-03-31,73,20,53,0.2739999999999999,72,32,40,0.444
20501067,1610612761,1610612756,126.0,140.0,0.495,0.58,0,2006-03-31,72,26,46,0.361,72,49,23,0.6809999999999999
20501069,1610612753,1610612742,108.0,99.0,0.557,0.444,1,2006-03-31,73,29,44,0.397,73,54,19,0.74
20501073,1610612740,1610612763,107.0,102.0,0.594,0.493,1,2006-03-31,71,34,37,0.479,73,41,32,0.562
20501074,1610612745,1610612764,105.0,103.0,0.557,0.4529999999999999,1,2006-03-31,72,32,40,0.444,71,37,34,0.521
20501075,1610612743,1610612750,106.0,94.0,0.409,0.488,1,2006-03-31,73,41,32,0.562,72,30,42,0.417
20501076,1610612746,1610612762,106.0,91.0,0.5539999999999999,0.439,1,2006-03-31,71,42,29,0.5920000000000001,72,34,38,0.472
20501078,1610612760,1610612747,93.0,106.0,0.38,0.465,0,2006-03-31,72,29,43,0.4029999999999999,74,39,35,0.527
20501065,1610612754,1610612756,104.0,114.0,0.4629999999999999,0.523,0,2006-03-30,71,35,36,0.493,71,48,23,0.6759999999999999
20501066,1610612747,1610612759,85.0,96.0,0.4029999999999999,0.47,0,2006-03-30,73,38,35,0.521,72,56,16,0.778
20501055,1610612755,1610612765,91.0,101.0,0.507,0.4479999999999999,0,2006-03-29,70,32,38,0.457,71,57,14,0.8029999999999999
20501054,1610612761,1610612748,94.0,98.0,0.446,0.42,0,2006-03-29,71,26,45,0.366,71,48,23,0.6759999999999999
20501056,1610612737,1610612754,94.0,93.0,0.444,0.446,1,2006-03-29,70,22,48,0.314,70,35,35,0.5
20501057,1610612739,1610612742,107.0,94.0,0.4629999999999999,0.433,1,2006-03-29,71,42,29,0.5920000000000001,72,54,18,0.75
20501058,1610612751,1610612763,86.0,74.0,0.444,0.419,1,2006-03-29,70,42,28,0.6,72,41,31,0.569
20501059,1610612752,1610612738,98.0,123.0,0.461,0.5710000000000001,0,2006-03-29,70,19,51,0.271,72,30,42,0.417
20501060,1610612750,1610612753,103.0,91.0,0.5529999999999999,0.473,1,2006-03-29,71,30,41,0.423,72,28,44,0.389
20501061,1610612745,1610612760,115.0,87.0,0.519,0.3379999999999999,1,2006-03-29,71,31,40,0.4370000000000001,71,29,42,0.408
20501062,1610612743,1610612762,104.0,115.0,0.494,0.585,0,2006-03-29,72,40,32,0.556,71,34,37,0.479
20501063,1610612757,1610612758,90.0,106.0,0.4589999999999999,0.513,0,2006-03-29,71,20,51,0.282,72,36,36,0.5
20501064,1610612744,1610612740,85.0,86.0,0.38,0.4,0,2006-03-29,70,30,40,0.429,70,33,37,0.471
20501047,1610612766,1610612737,125.0,117.0,0.568,0.519,1,2006-03-28,72,20,52,0.278,69,21,48,0.304
20501048,1610612765,1610612742,97.0,90.0,0.4379999999999999,0.493,1,2006-03-28,70,56,14,0.8,71,54,17,0.7609999999999999
20501049,1610612749,1610612756,132.0,110.0,0.605,0.494,1,2006-03-28,71,36,35,0.507,70,47,23,0.6709999999999999
20501050,1610612763,1610612760,97.0,98.0,0.506,0.494,0,2006-03-28,71,41,30,0.5770000000000001,70,29,41,0.414
20501051,1610612741,1610612753,93.0,97.0,0.424,0.48,0,2006-03-28,71,31,40,0.4370000000000001,71,28,43,0.3939999999999999
20501052,1610612758,1610612764,84.0,97.0,0.434,0.4320000000000001,0,2006-03-28,71,35,36,0.493,70,37,33,0.529
20501053,1610612746,1610612759,87.0,98.0,0.3779999999999999,0.493,0,2006-03-28,70,41,29,0.586,71,55,16,0.775
20501043,1610612751,1610612756,110.0,72.0,0.47,0.268,1,2006-03-27,69,41,28,0.594,69,47,22,0.6809999999999999
20501044,1610612748,1610612754,96.0,91.0,0.434,0.43,1,2006-03-27,70,47,23,0.6709999999999999,69,35,34,0.507
20501045,1610612762,1610612740,104.0,80.0,0.561,0.411,1,2006-03-27,70,33,37,0.471,69,32,37,0.4639999999999999
20501046,1610612744,1610612764,98.0,116.0,0.4529999999999999,0.483,0,2006-03-27,69,30,39,0.435,69,36,33,0.522
20501039,1610612760,1610612759,106.0,102.0,0.52,0.5,1,2006-03-26,69,28,41,0.406,70,54,16,0.7709999999999999
20501032,1610612754,1610612755,92.0,79.0,0.507,0.3720000000000001,1,2006-03-26,68,35,33,0.515,69,32,37,0.4639999999999999
20501034,1610612750,1610612752,98.0,94.0,0.397,0.412,1,2006-03-26,70,29,41,0.414,69,19,50,0.275
20501036,1610612749,1610612761,125.0,116.0,0.5539999999999999,0.489,1,2006-03-26,70,35,35,0.5,70,26,44,0.371
20501031,1610612738,1610612741,97.0,101.0,0.415,0.447,0,2006-03-26,71,29,42,0.408,70,31,39,0.4429999999999999
20501033,1610612745,1610612739,102.0,104.0,0.486,0.4320000000000001,0,2006-03-26,70,30,40,0.429,70,41,29,0.586
20501037,1610612763,1610612766,102.0,95.0,0.4629999999999999,0.436,1,2006-03-26,70,41,29,0.586,71,19,52,0.268
20501038,1610612753,1610612737,108.0,101.0,0.597,0.4,1,2006-03-26,70,27,43,0.386,68,21,47,0.309
20501035,1610612765,1610612751,74.0,79.0,0.341,0.373,0,2006-03-26,69,55,14,0.797,68,40,28,0.588
20501040,1610612758,1610612744,83.0,90.0,0.357,0.434,0,2006-03-26,70,35,35,0.5,68,30,38,0.441
20501041,1610612757,1610612746,83.0,97.0,0.3429999999999999,0.5,0,2006-03-26,70,20,50,0.286,69,41,28,0.594
20501042,1610612747,1610612740,105.0,94.0,0.508,0.447,1,2006-03-26,72,38,34,0.528,68,32,36,0.471
20501027,1610612746,1610612764,116.0,101.0,0.513,0.411,1,2006-03-25,68,40,28,0.588,68,35,33,0.515
20501028,1610612737,1610612742,83.0,98.0,0.352,0.444,0,2006-03-25,67,21,46,0.313,70,54,16,0.7709999999999999
20501029,1610612762,1610612758,89.0,91.0,0.465,0.431,0,2006-03-25,69,32,37,0.4639999999999999,69,35,34,0.507
20501030,1610612756,1610612743,107.0,96.0,0.433,0.4679999999999999,1,2006-03-25,68,47,21,0.691,71,40,31,0.563
20501017,1610612761,1610612750,97.0,77.0,0.405,0.397,1,2006-03-24,69,26,43,0.377,69,28,41,0.406
20501018,1610612755,1610612753,86.0,102.0,0.3829999999999999,0.563,0,2006-03-24,68,32,36,0.471,69,26,43,0.377
20501019,1610612754,1610612765,72.0,75.0,0.417,0.3879999999999999,0,2006-03-24,67,34,33,0.507,68,55,13,0.809
20501020,1610612752,1610612763,75.0,91.0,0.384,0.417,0,2006-03-24,68,19,49,0.2789999999999999,69,40,29,0.58
20501021,1610612748,1610612766,114.0,93.0,0.5770000000000001,0.447,1,2006-03-24,69,46,23,0.667,70,19,51,0.271
20501022,1610612739,1610612738,94.0,82.0,0.451,0.3720000000000001,1,2006-03-24,69,40,29,0.58,70,29,41,0.414
20501023,1610612741,1610612740,96.0,82.0,0.436,0.351,1,2006-03-24,69,30,39,0.435,67,32,35,0.478
20501024,1610612743,1610612760,117.0,104.0,0.462,0.418,1,2006-03-24,70,40,30,0.5710000000000001,68,27,41,0.397
20501025,1610612757,1610612759,79.0,98.0,0.431,0.5329999999999999,0,2006-03-24,69,20,49,0.29,69,54,15,0.7829999999999999
20501026,1610612747,1610612749,101.0,96.0,0.429,0.42,1,2006-03-24,71,37,34,0.521,69,34,35,0.493
20501011,1610612751,1610612750,86.0,82.0,0.364,0.4,1,2006-03-23,67,39,28,0.5820000000000001,68,28,40,0.412
20501012,1610612763,1610612746,95.0,85.0,0.446,0.4529999999999999,1,2006-03-23,68,39,29,0.574,67,39,28,0.5820000000000001
20501013,1610612740,1610612745,92.0,93.0,0.361,0.493,0,2006-03-23,66,32,34,0.485,69,30,39,0.435
20501014,1610612742,1610612744,121.0,122.0,0.541,0.467,0,2006-03-23,69,53,16,0.768,67,29,38,0.433
20501015,1610612762,1610612764,97.0,109.0,0.4679999999999999,0.481,0,2006-03-23,68,32,36,0.471,67,35,32,0.522
20501016,1610612756,1610612757,125.0,108.0,0.478,0.477,1,2006-03-23,67,46,21,0.687,68,20,48,0.294
20501005,1610612754,1610612741,95.0,85.0,0.4270000000000001,0.402,1,2006-03-22,66,34,32,0.515,68,29,39,0.426
20501004,1610612739,1610612766,120.0,118.0,0.544,0.449,1,2006-03-22,68,39,29,0.574,69,19,50,0.275
20501002,1610612755,1610612737,115.0,106.0,0.506,0.507,1,2006-03-22,67,32,35,0.478,66,21,45,0.318
20501003,1610612753,1610612752,111.0,87.0,0.512,0.476,1,2006-03-22,68,25,43,0.368,67,19,48,0.284
20501006,1610612738,1610612761,110.0,96.0,0.547,0.457,1,2006-03-22,69,29,40,0.42,68,25,43,0.368
20501007,1610612765,1610612748,82.0,73.0,0.349,0.3779999999999999,1,2006-03-22,67,54,13,0.8059999999999999,68,45,23,0.662
20501009,1610612760,1610612749,114.0,105.0,0.466,0.476,1,2006-03-22,67,27,40,0.4029999999999999,68,34,34,0.5
20501008,1610612743,1610612759,104.0,92.0,0.47,0.416,1,2006-03-22,69,39,30,0.565,68,53,15,0.779
20501010,1610612747,1610612758,87.0,80.0,0.43,0.429,1,2006-03-22,70,36,34,0.514,68,34,34,0.5
20500996,1610612740,1610612746,120.0,108.0,0.518,0.5539999999999999,1,2006-03-21,65,32,33,0.4920000000000001,66,39,27,0.591
20500992,1610612764,1610612751,100.0,112.0,0.444,0.5579999999999999,0,2006-03-21,66,34,32,0.515,66,38,28,0.5760000000000001
20500993,1610612752,1610612761,109.0,114.0,0.5329999999999999,0.4639999999999999,0,2006-03-21,66,19,47,0.288,67,25,42,0.373
20500994,1610612766,1610612753,108.0,102.0,0.444,0.5,1,2006-03-21,68,19,49,0.2789999999999999,67,24,43,0.358
20500995,1610612763,1610612754,105.0,75.0,0.513,0.354,1,2006-03-21,67,38,29,0.5670000000000001,65,33,32,0.508
20500997,1610612742,1610612745,88.0,72.0,0.405,0.41,1,2006-03-21,68,53,15,0.779,68,29,39,0.426
20500998,1610612750,1610612748,100.0,96.0,0.487,0.408,1,2006-03-21,67,28,39,0.418,67,45,22,0.672
20500999,1610612759,1610612744,107.0,96.0,0.476,0.419,1,2006-03-21,67,53,14,0.7909999999999999,66,28,38,0.424
20501001,1610612758,1610612760,105.0,96.0,0.425,0.422,1,2006-03-21,67,34,33,0.507,66,26,40,0.3939999999999999
20501000,1610612762,1610612756,107.0,99.0,0.513,0.4039999999999999,1,2006-03-21,67,32,35,0.478,66,45,21,0.682
20500988,1610612738,1610612747,97.0,105.0,0.425,0.478,0,2006-03-20,68,28,40,0.412,69,35,34,0.507
20500989,1610612765,1610612737,91.0,84.0,0.456,0.4629999999999999,1,2006-03-20,66,53,13,0.8029999999999999,65,21,44,0.3229999999999999
20500990,1610612745,1610612746,91.0,99.0,0.429,0.479,0,2006-03-20,67,29,38,0.433,65,39,26,0.6
20500991,1610612757,1610612749,93.0,100.0,0.402,0.514,0,2006-03-20,67,20,47,0.299,67,34,33,0.507
20500986,1610612744,1610612755,98.0,89.0,0.435,0.415,1,2006-03-19,65,28,37,0.431,66,31,35,0.47
20500979,1610612751,1610612742,100.0,89.0,0.451,0.405,1,2006-03-19,65,37,28,0.569,67,52,15,0.7759999999999999
20500981,1610612739,1610612747,96.0,95.0,0.493,0.487,1,2006-03-19,67,38,29,0.5670000000000001,68,34,34,0.5
20500983,1610612737,1610612753,108.0,107.0,0.4679999999999999,0.488,1,2006-03-19,64,21,43,0.3279999999999999,66,24,42,0.364
20500982,1610612754,1610612738,88.0,103.0,0.395,0.534,0,2006-03-19,64,33,31,0.516,67,28,39,0.418
20500980,1610612764,1610612741,113.0,104.0,0.469,0.494,1,2006-03-19,65,34,31,0.523,67,29,38,0.433
20500984,1610612750,1610612758,95.0,89.0,0.481,0.419,1,2006-03-19,66,27,39,0.409,66,33,33,0.5
20500985,1610612763,1610612762,90.0,84.0,0.392,0.4629999999999999,1,2006-03-19,66,37,29,0.561,66,31,35,0.47
20500987,1610612752,1610612748,100.0,111.0,0.488,0.541,0,2006-03-19,65,19,46,0.292,66,45,21,0.682
20500974,1610612741,1610612748,84.0,85.0,0.4270000000000001,0.324,0,2006-03-18,66,29,37,0.439,65,44,21,0.677
20500975,1610612766,1610612765,103.0,108.0,0.506,0.574,0,2006-03-18,67,18,49,0.2689999999999999,65,52,13,0.8
20500976,1610612740,1610612743,94.0,109.0,0.415,0.488,0,2006-03-18,64,31,33,0.484,68,38,30,0.5589999999999999
20500977,1610612749,1610612757,97.0,93.0,0.4529999999999999,0.507,1,2006-03-18,66,33,33,0.5,66,20,46,0.303
20500978,1610612745,1610612759,77.0,92.0,0.441,0.487,0,2006-03-18,66,29,37,0.439,66,52,14,0.7879999999999999
20500968,1610612751,1610612747,92.0,89.0,0.456,0.486,1,2006-03-17,64,36,28,0.563,67,34,33,0.507
20500963,1610612761,1610612749,97.0,96.0,0.39,0.4370000000000001,1,2006-03-17,66,24,42,0.364,65,32,33,0.4920000000000001
20500964,1610612764,1610612742,94.0,104.0,0.4429999999999999,0.5,0,2006-03-17,64,33,31,0.516,66,52,14,0.7879999999999999
20500965,1610612737,1610612762,101.0,111.0,0.449,0.5579999999999999,0,2006-03-17,63,20,43,0.317,65,31,34,0.477
20500966,1610612753,1610612738,84.0,77.0,0.41,0.325,1,2006-03-17,65,24,41,0.369,66,27,39,0.409
20500967,1610612754,1610612758,98.0,93.0,0.462,0.3979999999999999,1,2006-03-17,63,33,30,0.524,65,33,32,0.508
20500969,1610612752,1610612765,105.0,103.0,0.569,0.475,1,2006-03-17,64,19,45,0.297,64,51,13,0.797
20500970,1610612739,1610612757,99.0,84.0,0.494,0.418,1,2006-03-17,66,37,29,0.561,65,20,45,0.308
20500971,1610612763,1610612743,116.0,102.0,0.56,0.551,1,2006-03-17,65,36,29,0.5539999999999999,67,37,30,0.552
20500972,1610612759,1610612756,108.0,102.0,0.489,0.513,1,2006-03-17,65,51,14,0.785,65,45,20,0.6920000000000001
20500973,1610612746,1610612755,99.0,89.0,0.488,0.434,1,2006-03-17,64,38,26,0.594,65,31,34,0.477
20500960,1610612748,1610612738,107.0,104.0,0.547,0.488,1,2006-03-16,64,43,21,0.672,65,27,38,0.415
20500962,1610612760,1610612755,102.0,98.0,0.488,0.494,1,2006-03-16,65,26,39,0.4,64,31,33,0.484
20500961,1610612744,1610612750,105.0,97.0,0.4679999999999999,0.43,1,2006-03-16,64,27,37,0.422,65,26,39,0.4
20500951,1610612764,1610612766,107.0,99.0,0.473,0.4,1,2006-03-15,63,33,30,0.524,66,18,48,0.273
20500955,1610612752,1610612737,121.0,117.0,0.5,0.441,1,2006-03-15,63,18,45,0.286,62,20,42,0.3229999999999999
20500958,1610612756,1610612746,126.0,95.0,0.556,0.3429999999999999,1,2006-03-15,64,45,19,0.703,63,37,26,0.5870000000000001
20500950,1610612761,1610612765,98.0,105.0,0.457,0.506,0,2006-03-15,65,23,42,0.354,63,51,12,0.81
20500952,1610612753,1610612762,114.0,108.0,0.5479999999999999,0.422,1,2006-03-15,64,23,41,0.359,64,30,34,0.469
20500953,1610612754,1610612743,99.0,101.0,0.43,0.513,0,2006-03-15,62,32,30,0.516,66,37,29,0.561
20500954,1610612751,1610612757,78.0,65.0,0.39,0.413,1,2006-03-15,63,35,28,0.556,64,20,44,0.313
20500956,1610612749,1610612741,104.0,88.0,0.479,0.366,1,2006-03-15,64,32,32,0.5,65,29,36,0.446
20500957,1610612745,1610612742,81.0,95.0,0.4379999999999999,0.521,0,2006-03-15,65,29,36,0.446,65,51,14,0.785
20500959,1610612747,1610612750,92.0,89.0,0.488,0.455,1,2006-03-15,66,34,32,0.515,64,26,38,0.406
20500947,1610612759,1610612740,96.0,81.0,0.4579999999999999,0.452,1,2006-03-14,64,50,14,0.7809999999999999,63,31,32,0.4920000000000001
20500942,1610612766,1610612764,114.0,119.0,0.471,0.519,0,2006-03-14,65,18,47,0.2769999999999999,62,32,30,0.516
20500949,1610612760,1610612756,120.0,129.0,0.529,0.563,0,2006-03-14,64,25,39,0.391,63,44,19,0.698
20500941,1610612755,1610612761,97.0,111.0,0.485,0.521,0,2006-03-14,63,31,32,0.4920000000000001,64,23,41,0.359
20500943,1610612748,1610612762,121.0,83.0,0.5710000000000001,0.4039999999999999,1,2006-03-14,63,42,21,0.667,63,30,33,0.476
20500944,1610612763,1610612738,93.0,76.0,0.4920000000000001,0.3779999999999999,1,2006-03-14,64,35,29,0.547,64,27,37,0.422
20500945,1610612741,1610612757,95.0,66.0,0.481,0.351,1,2006-03-14,64,29,35,0.4529999999999999,63,20,43,0.317
20500946,1610612742,1610612739,91.0,87.0,0.424,0.425,1,2006-03-14,64,50,14,0.7809999999999999,65,36,29,0.5539999999999999
20500948,1610612758,1610612747,114.0,98.0,0.542,0.4629999999999999,1,2006-03-14,64,33,31,0.516,65,33,32,0.508
20500936,1610612754,1610612753,97.0,83.0,0.467,0.4429999999999999,1,2006-03-13,61,32,29,0.525,63,22,41,0.349
20500937,1610612752,1610612743,96.0,108.0,0.506,0.506,0,2006-03-13,62,17,45,0.2739999999999999,65,36,29,0.5539999999999999
20500938,1610612749,1610612737,88.0,87.0,0.5,0.452,1,2006-03-13,63,31,32,0.4920000000000001,61,20,41,0.3279999999999999
20500939,1610612745,1610612751,77.0,90.0,0.342,0.4379999999999999,0,2006-03-13,64,29,35,0.4529999999999999,62,34,28,0.5479999999999999
20500940,1610612746,1610612750,95.0,87.0,0.429,0.44,1,2006-03-13,62,37,25,0.597,63,26,37,0.413
20500929,1610612748,1610612739,98.0,92.0,0.436,0.405,1,2006-03-12,62,41,21,0.6609999999999999,64,36,28,0.563
20500928,1610612759,1610612745,88.0,81.0,0.457,0.465,1,2006-03-12,63,49,14,0.778,63,29,34,0.46
20500930,1610612747,1610612760,113.0,120.0,0.462,0.588,0,2006-03-12,64,33,31,0.516,63,25,38,0.397
20500931,1610612763,1610612755,91.0,94.0,0.462,0.472,0,2006-03-12,63,34,29,0.54,62,31,31,0.5
20500926,1610612738,1610612743,106.0,101.0,0.512,0.534,1,2006-03-12,63,27,36,0.429,64,35,29,0.547
20500927,1610612761,1610612754,93.0,89.0,0.4529999999999999,0.4679999999999999,1,2006-03-12,63,22,41,0.349,60,31,29,0.517
20500932,1610612765,1610612766,94.0,78.0,0.488,0.3779999999999999,1,2006-03-12,62,50,12,0.8059999999999999,64,18,46,0.281
20500933,1610612740,1610612751,84.0,95.0,0.407,0.517,0,2006-03-12,62,31,31,0.5,61,33,28,0.541
20500934,1610612758,1610612742,85.0,80.0,0.42,0.364,1,2006-03-12,63,32,31,0.508,63,49,14,0.778
20500935,1610612757,1610612756,111.0,101.0,0.535,0.5,1,2006-03-12,62,20,42,0.3229999999999999,62,43,19,0.6940000000000001
20500919,1610612764,1610612765,110.0,92.0,0.5539999999999999,0.486,1,2006-03-11,61,31,30,0.508,61,49,12,0.8029999999999999
20500920,1610612737,1610612741,90.0,95.0,0.418,0.479,0,2006-03-11,60,20,40,0.3329999999999999,63,28,35,0.444
20500921,1610612753,1610612744,103.0,92.0,0.586,0.4679999999999999,1,2006-03-11,62,22,40,0.355,63,26,37,0.413
20500922,1610612766,1610612752,116.0,109.0,0.471,0.5,1,2006-03-11,63,18,45,0.286,61,17,44,0.2789999999999999
20500923,1610612749,1610612746,98.0,106.0,0.421,0.506,0,2006-03-11,62,30,32,0.484,61,36,25,0.59
20500924,1610612762,1610612742,87.0,90.0,0.451,0.479,0,2006-03-11,62,30,32,0.484,62,49,13,0.79
20500925,1610612756,1610612750,110.0,102.0,0.532,0.471,1,2006-03-11,61,43,18,0.705,62,26,36,0.419
20500914,1610612740,1610612754,90.0,92.0,0.42,0.4,0,2006-03-10,61,31,30,0.508,59,31,28,0.525
20500910,1610612761,1610612743,97.0,108.0,0.405,0.526,0,2006-03-10,62,21,41,0.3389999999999999,63,35,28,0.556
20500911,1610612753,1610612739,102.0,73.0,0.575,0.342,1,2006-03-10,61,21,40,0.344,63,36,27,0.5710000000000001
20500912,1610612738,1610612749,86.0,92.0,0.387,0.434,0,2006-03-10,62,26,36,0.419,61,30,31,0.4920000000000001
20500913,1610612748,1610612744,106.0,111.0,0.519,0.519,0,2006-03-10,61,40,21,0.6559999999999999,62,26,36,0.419
20500915,1610612741,1610612746,96.0,107.0,0.418,0.425,0,2006-03-10,62,27,35,0.435,60,35,25,0.583
20500916,1610612759,1610612747,92.0,100.0,0.457,0.488,0,2006-03-10,62,48,14,0.774,63,33,30,0.524
20500917,1610612758,1610612763,105.0,93.0,0.419,0.474,1,2006-03-10,62,31,31,0.5,62,34,28,0.5479999999999999
20500918,1610612760,1610612750,107.0,96.0,0.481,0.476,1,2006-03-10,62,24,38,0.387,61,26,35,0.426
20500907,1610612755,1610612743,93.0,97.0,0.385,0.456,0,2006-03-09,61,30,31,0.4920000000000001,62,34,28,0.5479999999999999
20500908,1610612757,1610612742,92.0,109.0,0.479,0.5539999999999999,0,2006-03-09,61,19,42,0.311,61,48,13,0.787
20500909,1610612756,1610612759,93.0,117.0,0.477,0.552,0,2006-03-09,60,42,18,0.7,61,48,13,0.787
20500897,1610612761,1610612739,97.0,98.0,0.4379999999999999,0.456,0,2006-03-08,61,21,40,0.344,62,36,26,0.581
20500898,1610612738,1610612755,104.0,101.0,0.434,0.375,1,2006-03-08,61,26,35,0.426,60,30,30,0.5
20500899,1610612766,1610612744,104.0,101.0,0.44,0.4529999999999999,1,2006-03-08,62,17,45,0.2739999999999999,61,25,36,0.41
20500900,1610612748,1610612764,118.0,112.0,0.52,0.47,1,2006-03-08,60,40,20,0.667,60,30,30,0.5
20500901,1610612765,1610612741,106.0,101.0,0.4379999999999999,0.535,1,2006-03-08,60,49,11,0.8170000000000001,61,27,34,0.4429999999999999
20500902,1610612749,1610612758,116.0,123.0,0.541,0.519,0,2006-03-08,60,29,31,0.483,61,30,31,0.4920000000000001
20500903,1610612740,1610612747,107.0,113.0,0.488,0.513,0,2006-03-08,60,31,29,0.517,62,32,30,0.516
20500904,1610612745,1610612754,103.0,99.0,0.528,0.391,1,2006-03-08,62,29,33,0.4679999999999999,58,30,28,0.517
20500905,1610612762,1610612750,96.0,93.0,0.455,0.507,1,2006-03-08,61,30,31,0.4920000000000001,60,26,34,0.433
20500906,1610612760,1610612763,74.0,99.0,0.346,0.469,0,2006-03-08,61,23,38,0.377,61,34,27,0.557
20500892,1610612754,1610612752,92.0,107.0,0.354,0.478,0,2006-03-07,57,30,27,0.526,60,17,43,0.283
20500889,1610612764,1610612738,115.0,116.0,0.471,0.481,0,2006-03-07,59,30,29,0.508,60,25,35,0.417
20500890,1610612737,1610612744,113.0,106.0,0.457,0.442,1,2006-03-07,59,20,39,0.3389999999999999,60,25,35,0.417
20500891,1610612739,1610612761,106.0,99.0,0.487,0.493,1,2006-03-07,61,35,26,0.574,60,21,39,0.35
20500893,1610612750,1610612745,87.0,93.0,0.391,0.397,0,2006-03-07,59,26,33,0.441,61,28,33,0.4589999999999999
20500894,1610612741,1610612751,95.0,87.0,0.422,0.42,1,2006-03-07,60,27,33,0.45,60,32,28,0.5329999999999999
20500895,1610612742,1610612757,93.0,87.0,0.387,0.486,1,2006-03-07,60,47,13,0.7829999999999999,60,19,41,0.317
20500896,1610612746,1610612759,98.0,85.0,0.521,0.442,1,2006-03-07,59,34,25,0.5760000000000001,60,47,13,0.7829999999999999
20500885,1610612740,1610612756,88.0,101.0,0.4429999999999999,0.4479999999999999,0,2006-03-06,59,31,28,0.525,59,42,17,0.7120000000000001
20500883,1610612751,1610612758,84.0,109.0,0.371,0.494,0,2006-03-06,59,32,27,0.542,60,29,31,0.483
20500884,1610612766,1610612748,105.0,106.0,0.442,0.472,0,2006-03-06,61,16,45,0.262,59,39,20,0.6609999999999999
20500886,1610612743,1610612763,115.0,101.0,0.64,0.462,1,2006-03-06,61,33,28,0.541,60,33,27,0.55
20500887,1610612762,1610612753,90.0,85.0,0.4,0.419,1,2006-03-06,60,29,31,0.483,60,20,40,0.3329999999999999
20500888,1610612747,1610612759,96.0,103.0,0.47,0.524,0,2006-03-06,61,31,30,0.508,59,47,12,0.797
20500875,1610612755,1610612754,93.0,94.0,0.4589999999999999,0.475,0,2006-03-05,59,30,29,0.508,56,30,26,0.536
20500876,1610612764,1610612758,117.0,107.0,0.482,0.513,1,2006-03-05,58,30,28,0.517,59,28,31,0.475
20500877,1610612742,1610612756,107.0,115.0,0.523,0.542,0,2006-03-05,59,46,13,0.78,58,41,17,0.7070000000000001
20500878,1610612750,1610612744,103.0,90.0,0.4539999999999999,0.4429999999999999,1,2006-03-05,58,26,32,0.4479999999999999,59,25,34,0.424
20500874,1610612761,1610612738,111.0,105.0,0.54,0.5539999999999999,1,2006-03-05,59,21,38,0.356,59,24,35,0.407
20500879,1610612739,1610612741,91.0,72.0,0.451,0.449,1,2006-03-05,60,34,26,0.5670000000000001,59,26,33,0.441
20500880,1610612745,1610612757,102.0,84.0,0.451,0.419,1,2006-03-05,60,27,33,0.45,59,19,40,0.322
20500881,1610612746,1610612763,86.0,102.0,0.421,0.568,0,2006-03-05,58,33,25,0.569,59,33,26,0.5589999999999999
20500882,1610612760,1610612762,113.0,81.0,0.573,0.389,1,2006-03-05,60,23,37,0.3829999999999999,59,28,31,0.475
20500867,1610612751,1610612761,105.0,100.0,0.4370000000000001,0.4529999999999999,1,2006-03-04,58,32,26,0.552,58,20,38,0.345
20500868,1610612748,1610612737,95.0,93.0,0.508,0.4589999999999999,1,2006-03-04,58,38,20,0.655,58,19,39,0.3279999999999999
20500870,1610612749,1610612752,98.0,103.0,0.481,0.5,0,2006-03-04,59,29,30,0.4920000000000001,59,16,43,0.271
20500871,1610612759,1610612757,101.0,81.0,0.513,0.382,1,2006-03-04,58,46,12,0.7929999999999999,58,19,39,0.3279999999999999
20500872,1610612743,1610612753,110.0,94.0,0.565,0.467,1,2006-03-04,60,32,28,0.5329999999999999,59,20,39,0.3389999999999999
20500873,1610612747,1610612765,105.0,94.0,0.506,0.4320000000000001,1,2006-03-04,60,31,29,0.517,59,48,11,0.8140000000000001
20500858,1610612737,1610612758,93.0,102.0,0.466,0.4679999999999999,0,2006-03-03,57,19,38,0.3329999999999999,58,28,30,0.483
20500857,1610612755,1610612764,119.0,113.0,0.563,0.43,1,2006-03-03,58,30,28,0.517,57,29,28,0.509
20500859,1610612738,1610612754,99.0,98.0,0.481,0.515,1,2006-03-03,58,24,34,0.414,55,29,26,0.527
20500860,1610612752,1610612741,101.0,108.0,0.41,0.3779999999999999,0,2006-03-03,58,15,43,0.259,58,26,32,0.4479999999999999
20500861,1610612745,1610612743,89.0,78.0,0.418,0.3329999999999999,1,2006-03-03,59,26,33,0.441,59,31,28,0.525
20500862,1610612742,1610612766,90.0,76.0,0.462,0.351,1,2006-03-03,58,46,12,0.7929999999999999,60,16,44,0.267
20500864,1610612756,1610612753,123.0,118.0,0.517,0.556,1,2006-03-03,57,40,17,0.7020000000000001,58,20,38,0.345
20500863,1610612762,1610612746,105.0,103.0,0.476,0.486,1,2006-03-03,58,28,30,0.483,57,33,24,0.579
20500865,1610612744,1610612747,94.0,106.0,0.3329999999999999,0.493,0,2006-03-03,58,25,33,0.431,59,30,29,0.508
20500866,1610612760,1610612765,96.0,98.0,0.488,0.4629999999999999,0,2006-03-03,59,22,37,0.373,58,48,10,0.828
20500855,1610612741,1610612739,91.0,92.0,0.3879999999999999,0.423,0,2006-03-02,57,25,32,0.439,59,33,26,0.5589999999999999
20500856,1610612759,1610612742,98.0,89.0,0.486,0.405,1,2006-03-02,57,45,12,0.789,57,45,12,0.789
20500847,1610612750,1610612751,100.0,90.0,0.5589999999999999,0.418,1,2006-03-01,57,25,32,0.439,57,31,26,0.544
20500843,1610612764,1610612754,93.0,99.0,0.419,0.425,0,2006-03-01,56,29,27,0.518,54,29,25,0.537
20500844,1610612739,1610612758,90.0,97.0,0.456,0.507,0,2006-03-01,58,32,26,0.552,57,27,30,0.474
20500845,1610612738,1610612748,96.0,103.0,0.493,0.506,0,2006-03-01,57,23,34,0.4039999999999999,57,37,20,0.649
20500846,1610612763,1610612752,101.0,99.0,0.484,0.557,1,2006-03-01,58,32,26,0.552,57,15,42,0.263
20500842,1610612761,1610612737,111.0,113.0,0.471,0.467,0,2006-03-01,57,20,37,0.351,56,19,37,0.3389999999999999
20500848,1610612745,1610612755,101.0,106.0,0.43,0.519,0,2006-03-01,58,25,33,0.431,57,29,28,0.509
20500849,1610612743,1610612765,98.0,87.0,0.442,0.3929999999999999,1,2006-03-01,58,31,27,0.534,57,47,10,0.825
20500850,1610612762,1610612766,89.0,104.0,0.486,0.522,0,2006-03-01,57,27,30,0.474,59,16,43,0.271
20500851,1610612756,1610612749,123.0,110.0,0.5670000000000001,0.4320000000000001,1,2006-03-01,56,39,17,0.696,58,29,29,0.5
20500852,1610612757,1610612747,99.0,93.0,0.476,0.4589999999999999,1,2006-03-01,57,19,38,0.3329999999999999,58,29,29,0.5
20500853,1610612746,1610612740,89.0,67.0,0.461,0.365,1,2006-03-01,56,33,23,0.589,58,31,27,0.534
20500854,1610612744,1610612753,98.0,94.0,0.4320000000000001,0.467,1,2006-03-01,57,25,32,0.439,57,20,37,0.351
20500839,1610612741,1610612750,111.0,100.0,0.482,0.473,1,2006-02-28,56,25,31,0.446,56,24,32,0.429
20500840,1610612760,1610612740,114.0,104.0,0.597,0.451,1,2006-02-28,58,22,36,0.379,57,31,26,0.544
20500841,1610612747,1610612753,102.0,87.0,0.513,0.527,1,2006-02-28,57,29,28,0.509,56,20,36,0.357
20500828,1610612737,1610612751,104.0,102.0,0.475,0.425,1,2006-02-27,55,18,37,0.327,56,31,25,0.5539999999999999
20500829,1610612739,1610612765,72.0,84.0,0.386,0.379,0,2006-02-27,57,32,25,0.561,56,47,9,0.8390000000000001
20500830,1610612748,1610612761,101.0,94.0,0.603,0.444,1,2006-02-27,56,36,20,0.643,56,20,36,0.357
20500831,1610612763,1610612764,108.0,98.0,0.588,0.4589999999999999,1,2006-02-27,57,31,26,0.544,55,29,26,0.527
20500832,1610612745,1610612756,94.0,111.0,0.418,0.488,0,2006-02-27,57,25,32,0.439,55,38,17,0.691
20500833,1610612742,1610612755,104.0,92.0,0.456,0.5,1,2006-02-27,56,45,11,0.804,56,28,28,0.5
20500834,1610612759,1610612752,121.0,93.0,0.625,0.4370000000000001,1,2006-02-27,56,44,12,0.7859999999999999,56,15,41,0.268
20500835,1610612743,1610612749,89.0,110.0,0.479,0.512,0,2006-02-27,57,30,27,0.526,57,29,28,0.509
20500836,1610612758,1610612757,115.0,91.0,0.5,0.472,1,2006-02-27,56,26,30,0.4639999999999999,56,18,38,0.321
20500837,1610612746,1610612766,95.0,87.0,0.481,0.418,1,2006-02-27,55,32,23,0.5820000000000001,58,15,43,0.259
20500838,1610612744,1610612762,108.0,117.0,0.4429999999999999,0.471,0,2006-02-27,56,24,32,0.429,56,27,29,0.482
20500824,1610612750,1610612763,105.0,99.0,0.507,0.493,1,2006-02-26,55,24,31,0.436,56,30,26,0.536
20500822,1610612765,1610612739,90.0,78.0,0.45,0.431,1,2006-02-26,55,46,9,0.836,56,32,24,0.5710000000000001
20500823,1610612753,1610612745,84.0,89.0,0.418,0.42,0,2006-02-26,55,20,35,0.364,56,25,31,0.446
20500825,1610612751,1610612754,91.0,101.0,0.4320000000000001,0.479,0,2006-02-26,55,31,24,0.564,53,28,25,0.528
20500826,1610612747,1610612738,111.0,112.0,0.474,0.526,0,2006-02-26,56,28,28,0.5,56,23,33,0.411
20500827,1610612757,1610612740,75.0,88.0,0.451,0.4320000000000001,0,2006-02-26,55,18,37,0.327,56,31,25,0.5539999999999999
20500814,1610612742,1610612761,115.0,113.0,0.456,0.4629999999999999,1,2006-02-25,55,44,11,0.8,55,20,35,0.364
20500816,1610612764,1610612752,110.0,89.0,0.507,0.408,1,2006-02-25,54,29,25,0.537,55,15,40,0.273
20500817,1610612737,1610612749,89.0,99.0,0.4429999999999999,0.4320000000000001,0,2006-02-25,54,17,37,0.315,56,28,28,0.5
20500815,1610612755,1610612741,108.0,102.0,0.429,0.475,1,2006-02-25,55,28,27,0.509,55,24,31,0.436
20500818,1610612748,1610612760,115.0,106.0,0.586,0.422,1,2006-02-25,55,35,20,0.636,57,21,36,0.368
20500819,1610612759,1610612744,92.0,75.0,0.407,0.337,1,2006-02-25,55,43,12,0.782,55,24,31,0.436
20500820,1610612762,1610612740,95.0,100.0,0.481,0.5,0,2006-02-25,55,26,29,0.473,55,30,25,0.545
20500821,1610612756,1610612766,136.0,121.0,0.5,0.49,1,2006-02-25,54,37,17,0.685,57,15,42,0.263
20500803,1610612753,1610612760,102.0,89.0,0.525,0.466,1,2006-02-24,54,20,34,0.37,56,21,35,0.375
20500804,1610612754,1610612737,112.0,117.0,0.4629999999999999,0.494,0,2006-02-24,52,27,25,0.519,53,17,36,0.321
20500805,1610612739,1610612764,94.0,102.0,0.5,0.488,0,2006-02-24,55,32,23,0.5820000000000001,53,28,25,0.528
20500806,1610612752,1610612751,90.0,94.0,0.417,0.444,0,2006-02-24,54,15,39,0.278,54,31,23,0.574
20500807,1610612763,1610612759,80.0,83.0,0.4639999999999999,0.358,0,2006-02-24,55,30,25,0.545,54,42,12,0.778
20500808,1610612750,1610612743,101.0,102.0,0.4370000000000001,0.462,0,2006-02-24,54,23,31,0.426,56,30,26,0.536
20500809,1610612741,1610612765,87.0,95.0,0.418,0.405,0,2006-02-24,54,24,30,0.444,54,45,9,0.833
20500810,1610612749,1610612755,111.0,116.0,0.5,0.562,0,2006-02-24,55,27,28,0.491,54,27,27,0.5
20500811,1610612745,1610612744,91.0,88.0,0.425,0.3929999999999999,1,2006-02-24,55,24,31,0.436,54,24,30,0.444
20500812,1610612757,1610612738,96.0,102.0,0.494,0.487,0,2006-02-24,54,18,36,0.3329999999999999,55,22,33,0.4
20500813,1610612746,1610612747,102.0,83.0,0.493,0.364,1,2006-02-24,54,31,23,0.574,55,28,27,0.509
20500800,1610612765,1610612754,88.0,83.0,0.43,0.4,1,2006-02-23,53,44,9,0.83,51,27,24,0.529
20500801,1610612742,1610612763,97.0,87.0,0.494,0.436,1,2006-02-23,54,43,11,0.7959999999999999,54,30,24,0.556
20500802,1610612747,1610612758,106.0,85.0,0.526,0.415,1,2006-02-23,54,28,26,0.519,55,25,30,0.455
20500799,1610612757,1610612766,106.0,110.0,0.557,0.511,0,2006-02-22,53,18,35,0.34,56,15,41,0.268
20500625,1610612740,1610612762,76.0,82.0,0.357,0.397,0,2006-02-22,54,29,25,0.537,54,26,28,0.481
20500791,1610612755,1610612739,116.0,107.0,0.53,0.465,1,2006-02-22,53,26,27,0.491,54,32,22,0.593
20500792,1610612737,1610612760,109.0,114.0,0.5,0.57,0,2006-02-22,52,16,36,0.308,55,21,34,0.382
20500793,1610612751,1610612753,96.0,93.0,0.423,0.529,1,2006-02-22,53,30,23,0.5660000000000001,53,19,34,0.358
20500794,1610612752,1610612748,83.0,103.0,0.4,0.5,0,2006-02-22,53,15,38,0.283,54,34,20,0.63
20500797,1610612745,1610612746,106.0,102.0,0.481,0.4579999999999999,1,2006-02-22,54,23,31,0.426,53,30,23,0.5660000000000001
20500796,1610612741,1610612749,97.0,91.0,0.452,0.385,1,2006-02-22,53,24,29,0.4529999999999999,54,27,27,0.5
20500798,1610612756,1610612738,103.0,94.0,0.4429999999999999,0.407,1,2006-02-22,53,36,17,0.679,54,21,33,0.389
20500781,1610612754,1610612740,97.0,75.0,0.4639999999999999,0.3379999999999999,1,2006-02-21,50,27,23,0.54,53,29,24,0.547
20500785,1610612742,1610612746,93.0,91.0,0.429,0.462,1,2006-02-21,53,42,11,0.792,52,30,22,0.5770000000000001
20500779,1610612764,1610612750,90.0,78.0,0.462,0.43,1,2006-02-21,52,27,25,0.519,53,23,30,0.434
20500780,1610612739,1610612753,105.0,92.0,0.519,0.5,1,2006-02-21,53,32,21,0.604,52,19,33,0.365
20500782,1610612765,1610612737,97.0,87.0,0.44,0.457,1,2006-02-21,52,43,9,0.8270000000000001,51,16,35,0.314
20500783,1610612749,1610612751,85.0,89.0,0.429,0.4479999999999999,0,2006-02-21,53,27,26,0.509,52,29,23,0.5579999999999999
20500784,1610612763,1610612761,94.0,88.0,0.419,0.446,1,2006-02-21,53,30,23,0.5660000000000001,54,20,34,0.37
20500786,1610612759,1610612760,103.0,78.0,0.471,0.356,1,2006-02-21,53,41,12,0.774,54,20,34,0.37
20500787,1610612743,1610612766,100.0,84.0,0.475,0.37,1,2006-02-21,55,29,26,0.527,55,14,41,0.255
20500788,1610612762,1610612738,83.0,103.0,0.3379999999999999,0.581,0,2006-02-21,53,25,28,0.472,53,21,32,0.396
20500789,1610612758,1610612744,102.0,77.0,0.526,0.319,1,2006-02-21,54,25,29,0.4629999999999999,53,24,29,0.4529999999999999
20500790,1610612747,1610612757,99.0,82.0,0.5,0.39,1,2006-02-21,53,27,26,0.509,52,18,34,0.346
20500777,1610612741,1610612755,117.0,84.0,0.523,0.342,1,2006-02-16,52,23,29,0.442,52,25,27,0.481
20500778,1610612756,1610612745,109.0,75.0,0.489,0.353,1,2006-02-16,52,35,17,0.6729999999999999,53,22,31,0.415
20500764,1610612755,1610612759,103.0,100.0,0.456,0.44,1,2006-02-15,51,25,26,0.49,52,40,12,0.769
20500765,1610612753,1610612748,100.0,110.0,0.405,0.541,0,2006-02-15,51,19,32,0.373,53,33,20,0.623
20500766,1610612754,1610612749,88.0,77.0,0.41,0.3720000000000001,1,2006-02-15,49,26,23,0.531,52,27,25,0.519
20500767,1610612738,1610612739,109.0,113.0,0.449,0.446,0,2006-02-15,52,20,32,0.385,52,31,21,0.596
20500768,1610612752,1610612761,98.0,96.0,0.508,0.449,1,2006-02-15,52,15,37,0.288,53,20,33,0.377
20500769,1610612766,1610612751,94.0,95.0,0.467,0.424,0,2006-02-15,54,14,40,0.259,51,28,23,0.5489999999999999
20500770,1610612763,1610612758,84.0,78.0,0.446,0.368,1,2006-02-15,52,29,23,0.5579999999999999,53,24,29,0.4529999999999999
20500771,1610612740,1610612757,102.0,86.0,0.4529999999999999,0.421,1,2006-02-15,52,29,23,0.5579999999999999,51,18,33,0.353
20500772,1610612750,1610612760,102.0,92.0,0.447,0.462,1,2006-02-15,52,23,29,0.442,53,20,33,0.377
20500773,1610612742,1610612764,103.0,97.0,0.476,0.434,1,2006-02-15,52,41,11,0.7879999999999999,51,26,25,0.51
20500774,1610612743,1610612756,101.0,116.0,0.452,0.511,0,2006-02-15,54,28,26,0.519,51,34,17,0.667
20500775,1610612747,1610612737,110.0,114.0,0.5,0.547,0,2006-02-15,52,26,26,0.5,50,16,34,0.32
20500776,1610612744,1610612746,88.0,81.0,0.385,0.402,1,2006-02-15,52,24,28,0.462,51,30,21,0.588
20500759,1610612748,1610612753,107.0,93.0,0.581,0.407,1,2006-02-14,52,32,20,0.615,50,19,31,0.38
20500760,1610612765,1610612751,85.0,71.0,0.386,0.406,1,2006-02-14,51,42,9,0.8240000000000001,50,27,23,0.54
20500761,1610612749,1610612760,106.0,91.0,0.494,0.507,1,2006-02-14,51,27,24,0.529,52,20,32,0.385
20500762,1610612741,1610612758,101.0,105.0,0.412,0.414,0,2006-02-14,51,22,29,0.431,52,24,28,0.462
20500763,1610612746,1610612745,97.0,128.0,0.4429999999999999,0.58,0,2006-02-14,50,30,20,0.6,52,22,30,0.423
20500758,1610612739,1610612759,101.0,87.0,0.489,0.508,1,2006-02-13,51,30,21,0.588,51,40,11,0.784
20500752,1610612766,1610612757,83.0,91.0,0.4029999999999999,0.4629999999999999,0,2006-02-13,53,14,39,0.264,50,18,32,0.36
20500753,1610612740,1610612764,97.0,96.0,0.488,0.4589999999999999,1,2006-02-13,51,28,23,0.5489999999999999,50,26,24,0.52
20500754,1610612750,1610612761,94.0,98.0,0.542,0.507,0,2006-02-13,51,22,29,0.431,52,20,32,0.385
20500755,1610612742,1610612752,100.0,72.0,0.397,0.357,1,2006-02-13,51,40,11,0.784,51,14,37,0.275
20500756,1610612747,1610612762,94.0,88.0,0.4029999999999999,0.406,1,2006-02-13,51,26,25,0.51,52,25,27,0.481
20500757,1610612744,1610612763,79.0,81.0,0.3779999999999999,0.375,0,2006-02-13,51,23,28,0.451,51,28,23,0.5489999999999999
20500743,1610612764,1610612755,107.0,97.0,0.402,0.452,1,2006-02-12,49,26,23,0.531,50,24,26,0.48
20500744,1610612754,1610612759,88.0,92.0,0.4579999999999999,0.436,0,2006-02-12,48,25,23,0.521,50,40,10,0.8
20500745,1610612748,1610612765,100.0,98.0,0.467,0.474,1,2006-02-12,51,31,20,0.608,50,41,9,0.82
20500742,1610612761,1610612757,114.0,81.0,0.585,0.39,1,2006-02-12,51,19,32,0.373,49,17,32,0.347
20500746,1610612738,1610612753,102.0,94.0,0.5,0.5,1,2006-02-12,51,20,31,0.392,49,19,30,0.3879999999999999
20500747,1610612751,1610612749,94.0,79.0,0.5,0.449,1,2006-02-12,49,27,22,0.551,50,26,24,0.52
20500748,1610612745,1610612752,90.0,83.0,0.412,0.375,1,2006-02-12,51,21,30,0.412,50,14,36,0.28
20500749,1610612758,1610612737,109.0,84.0,0.524,0.392,1,2006-02-12,51,23,28,0.451,49,15,34,0.306
20500750,1610612760,1610612743,112.0,120.0,0.4379999999999999,0.488,0,2006-02-12,51,20,31,0.392,53,28,25,0.528
20500751,1610612746,1610612741,91.0,97.0,0.3979999999999999,0.444,0,2006-02-12,49,30,19,0.612,50,22,28,0.44
20500737,1610612739,1610612744,91.0,99.0,0.3979999999999999,0.5,0,2006-02-11,50,29,21,0.58,50,23,27,0.46
20500738,1610612750,1610612740,94.0,100.0,0.413,0.462,0,2006-02-11,50,22,28,0.44,50,27,23,0.54
20500739,1610612749,1610612766,99.0,93.0,0.4679999999999999,0.44,1,2006-02-11,49,26,23,0.531,52,14,38,0.2689999999999999
20500740,1610612745,1610612762,102.0,88.0,0.494,0.466,1,2006-02-11,50,20,30,0.4,51,25,26,0.49
20500741,1610612747,1610612763,99.0,100.0,0.41,0.484,0,2006-02-11,50,25,25,0.5,50,27,23,0.54
20500725,1610612764,1610612739,101.0,89.0,0.493,0.405,1,2006-02-10,48,25,23,0.521,49,29,20,0.5920000000000001
20500726,1610612753,1610612765,73.0,84.0,0.456,0.405,0,2006-02-10,48,19,29,0.396,49,41,8,0.8370000000000001
20500727,1610612738,1610612757,115.0,83.0,0.5489999999999999,0.457,1,2006-02-10,50,19,31,0.38,48,17,31,0.354
20500728,1610612751,1610612759,73.0,83.0,0.413,0.44,0,2006-02-10,48,26,22,0.542,49,39,10,0.7959999999999999
20500729,1610612766,1610612761,73.0,88.0,0.318,0.486,0,2006-02-10,51,14,37,0.275,50,18,32,0.36
20500730,1610612754,1610612744,107.0,95.0,0.522,0.395,1,2006-02-10,47,25,22,0.532,49,22,27,0.449
20500731,1610612740,1610612752,111.0,100.0,0.521,0.48,1,2006-02-10,49,26,23,0.531,49,14,35,0.286
20500732,1610612750,1610612762,80.0,94.0,0.373,0.379,0,2006-02-10,49,22,27,0.449,50,25,25,0.5
20500733,1610612756,1610612758,112.0,104.0,0.513,0.4629999999999999,1,2006-02-10,50,33,17,0.66,50,22,28,0.44
20500734,1610612743,1610612742,113.0,104.0,0.556,0.513,1,2006-02-10,52,27,25,0.519,50,39,11,0.78
20500735,1610612746,1610612763,91.0,87.0,0.479,0.385,1,2006-02-10,48,30,18,0.625,49,26,23,0.531
20500736,1610612760,1610612737,99.0,91.0,0.415,0.4270000000000001,1,2006-02-10,50,20,30,0.4,48,15,33,0.313
20500723,1610612742,1610612748,112.0,76.0,0.563,0.47,1,2006-02-09,49,39,10,0.7959999999999999,50,30,20,0.6
20500724,1610612758,1610612741,98.0,80.0,0.408,0.3329999999999999,1,2006-02-09,49,22,27,0.449,49,21,28,0.429
20500716,1610612765,1610612746,97.0,87.0,0.465,0.4679999999999999,1,2006-02-08,48,40,8,0.833,47,29,18,0.617
20500711,1610612761,1610612759,118.0,125.0,0.494,0.59,0,2006-02-08,49,17,32,0.347,48,38,10,0.792
20500712,1610612764,1610612744,129.0,124.0,0.5,0.561,1,2006-02-08,47,24,23,0.511,48,22,26,0.4579999999999999
20500713,1610612754,1610612757,101.0,69.0,0.433,0.267,1,2006-02-08,46,24,22,0.522,47,17,30,0.362
20500714,1610612751,1610612752,96.0,83.0,0.466,0.415,1,2006-02-08,47,26,21,0.5529999999999999,48,14,34,0.292
20500715,1610612766,1610612755,100.0,92.0,0.4379999999999999,0.4629999999999999,1,2006-02-08,50,14,36,0.28,49,24,25,0.49
20500717,1610612749,1610612753,94.0,89.0,0.3979999999999999,0.356,1,2006-02-08,48,25,23,0.521,47,19,28,0.4039999999999999
20500718,1610612740,1610612760,109.0,102.0,0.52,0.466,1,2006-02-08,48,25,23,0.521,49,19,30,0.3879999999999999
20500719,1610612750,1610612739,91.0,97.0,0.3879999999999999,0.39,0,2006-02-08,48,22,26,0.4579999999999999,48,29,19,0.604
20500720,1610612745,1610612747,78.0,89.0,0.416,0.42,0,2006-02-08,49,19,30,0.3879999999999999,49,25,24,0.51
20500721,1610612756,1610612763,108.0,102.0,0.475,0.409,1,2006-02-08,49,32,17,0.653,48,26,22,0.542
20500722,1610612743,1610612741,107.0,110.0,0.452,0.433,0,2006-02-08,51,26,25,0.51,48,21,27,0.4379999999999999
20500706,1610612737,1610612765,99.0,98.0,0.494,0.465,1,2006-02-07,47,15,32,0.319,47,39,8,0.83
20500708,1610612752,1610612746,82.0,85.0,0.353,0.479,0,2006-02-07,47,14,33,0.298,46,29,17,0.63
20500709,1610612742,1610612747,102.0,87.0,0.493,0.3879999999999999,1,2006-02-07,48,38,10,0.792,48,24,24,0.5
20500710,1610612758,1610612763,104.0,96.0,0.5670000000000001,0.424,1,2006-02-07,48,21,27,0.4379999999999999,47,26,21,0.5529999999999999
20500705,1610612744,1610612743,122.0,114.0,0.489,0.4639999999999999,1,2006-02-06,47,22,25,0.4679999999999999,50,26,24,0.52
20500698,1610612755,1610612745,81.0,87.0,0.3329999999999999,0.421,0,2006-02-06,48,24,24,0.5,48,19,29,0.396
20500699,1610612764,1610612753,94.0,82.0,0.418,0.471,1,2006-02-06,46,23,23,0.5,46,19,27,0.413
20500707,1610612739,1610612749,89.0,86.0,0.493,0.386,1,2006-02-06,47,28,19,0.596,47,24,23,0.511
20500700,1610612751,1610612740,99.0,91.0,0.486,0.4320000000000001,1,2006-02-06,46,25,21,0.5429999999999999,47,24,23,0.511
20500701,1610612766,1610612760,119.0,106.0,0.5660000000000001,0.4629999999999999,1,2006-02-06,49,13,36,0.265,48,19,29,0.396
20500702,1610612748,1610612738,114.0,98.0,0.506,0.411,1,2006-02-06,49,30,19,0.612,49,18,31,0.3670000000000001
20500703,1610612762,1610612741,109.0,107.0,0.42,0.419,1,2006-02-06,49,24,25,0.49,47,20,27,0.426
20500704,1610612756,1610612750,101.0,103.0,0.442,0.569,0,2006-02-06,48,31,17,0.6459999999999999,47,22,25,0.4679999999999999
20500695,1610612752,1610612745,89.0,93.0,0.425,0.421,0,2006-02-05,46,14,32,0.304,47,18,29,0.3829999999999999
20500696,1610612761,1610612746,113.0,115.0,0.435,0.477,0,2006-02-05,48,17,31,0.354,45,28,17,0.622
20500697,1610612758,1610612762,96.0,78.0,0.425,0.392,1,2006-02-05,47,20,27,0.426,48,23,25,0.479
20500689,1610612740,1610612747,106.0,90.0,0.568,0.412,1,2006-02-04,46,24,22,0.522,47,24,23,0.511
20500684,1610612751,1610612748,105.0,92.0,0.532,0.4029999999999999,1,2006-02-04,45,24,21,0.5329999999999999,48,29,19,0.604
20500685,1610612764,1610612737,98.0,85.0,0.413,0.3329999999999999,1,2006-02-04,45,22,23,0.489,46,14,32,0.304
20500686,1610612753,1610612738,100.0,91.0,0.507,0.436,1,2006-02-04,45,19,26,0.422,48,18,30,0.375
20500687,1610612739,1610612755,95.0,100.0,0.436,0.486,0,2006-02-04,46,27,19,0.5870000000000001,47,24,23,0.511
20500688,1610612754,1610612765,93.0,85.0,0.3879999999999999,0.429,1,2006-02-04,45,23,22,0.511,46,39,7,0.848
20500690,1610612749,1610612763,88.0,78.0,0.385,0.3939999999999999,1,2006-02-04,46,24,22,0.522,46,26,20,0.565
20500691,1610612742,1610612760,110.0,91.0,0.473,0.4429999999999999,1,2006-02-04,47,37,10,0.787,47,19,28,0.4039999999999999
20500692,1610612743,1610612757,105.0,104.0,0.481,0.513,1,2006-02-04,49,26,23,0.531,46,17,29,0.37
20500693,1610612756,1610612741,118.0,101.0,0.483,0.444,1,2006-02-04,47,31,16,0.66,46,20,26,0.435
20500694,1610612744,1610612750,109.0,77.0,0.475,0.376,1,2006-02-04,46,21,25,0.457,46,21,25,0.457
20500681,1610612745,1610612760,100.0,77.0,0.441,0.397,1,2006-02-03,46,17,29,0.37,46,19,27,0.413
20500676,1610612761,1610612752,104.0,90.0,0.429,0.4920000000000001,1,2006-02-03,47,17,30,0.362,45,14,31,0.311
20500677,1610612737,1610612753,96.0,94.0,0.417,0.507,1,2006-02-03,45,14,31,0.311,44,18,26,0.409
20500678,1610612738,1610612746,81.0,98.0,0.354,0.542,0,2006-02-03,47,18,29,0.3829999999999999,44,27,17,0.614
20500679,1610612766,1610612747,112.0,102.0,0.481,0.4320000000000001,1,2006-02-03,48,12,36,0.25,46,24,22,0.522
20500680,1610612755,1610612765,80.0,87.0,0.514,0.435,0,2006-02-03,46,23,23,0.5,45,39,6,0.867
20500682,1610612762,1610612758,89.0,79.0,0.397,0.342,1,2006-02-03,47,23,24,0.489,46,19,27,0.413
20500683,1610612757,1610612750,89.0,85.0,0.4320000000000001,0.4589999999999999,1,2006-02-03,45,17,28,0.3779999999999999,45,21,24,0.467
20500674,1610612748,1610612739,101.0,73.0,0.518,0.337,1,2006-02-02,47,29,18,0.617,45,27,18,0.6
20500675,1610612744,1610612759,86.0,89.0,0.4320000000000001,0.466,0,2006-02-02,45,20,25,0.444,47,37,10,0.787
20500673,1610612760,1610612744,111.0,107.0,0.488,0.44,1,2006-02-01,45,19,26,0.422,44,20,24,0.455
20500661,1610612761,1610612764,117.0,112.0,0.5429999999999999,0.519,1,2006-02-01,46,16,30,0.348,44,21,23,0.477
20500662,1610612753,1610612746,94.0,106.0,0.385,0.532,0,2006-02-01,43,18,25,0.419,43,26,17,0.605
20500663,1610612739,1610612751,91.0,85.0,0.457,0.377,1,2006-02-01,44,27,17,0.614,44,23,21,0.523
20500664,1610612754,1610612747,105.0,79.0,0.4629999999999999,0.306,1,2006-02-01,44,22,22,0.5,45,24,21,0.5329999999999999
20500665,1610612738,1610612756,94.0,102.0,0.461,0.4589999999999999,0,2006-02-01,46,18,28,0.391,46,30,16,0.652
20500666,1610612766,1610612737,92.0,102.0,0.42,0.471,0,2006-02-01,47,11,36,0.2339999999999999,44,13,31,0.295
20500667,1610612765,1610612750,90.0,74.0,0.455,0.439,1,2006-02-01,44,38,6,0.8640000000000001,44,21,23,0.477
20500668,1610612763,1610612742,80.0,81.0,0.389,0.423,0,2006-02-01,45,26,19,0.578,46,36,10,0.7829999999999999
20500669,1610612740,1610612741,100.0,95.0,0.439,0.452,1,2006-02-01,45,23,22,0.511,45,20,25,0.444
20500670,1610612745,1610612749,86.0,84.0,0.4270000000000001,0.373,1,2006-02-01,45,16,29,0.356,45,23,22,0.511
20500671,1610612762,1610612743,103.0,90.0,0.552,0.48,1,2006-02-01,46,22,24,0.478,48,25,23,0.521
20500672,1610612757,1610612759,82.0,86.0,0.366,0.397,0,2006-02-01,44,16,28,0.364,46,36,10,0.7829999999999999
20500655,1610612755,1610612756,99.0,123.0,0.442,0.581,0,2006-01-31,45,23,22,0.511,45,29,16,0.644
20500656,1610612764,1610612754,84.0,79.0,0.471,0.355,1,2006-01-31,43,21,22,0.488,43,21,22,0.488
20500657,1610612751,1610612765,91.0,84.0,0.4429999999999999,0.366,1,2006-01-31,43,23,20,0.535,43,37,6,0.86
20500658,1610612752,1610612747,97.0,130.0,0.419,0.574,0,2006-01-31,44,14,30,0.318,44,24,20,0.545
20500659,1610612742,1610612741,98.0,94.0,0.4,0.3929999999999999,1,2006-01-31,45,35,10,0.778,44,20,24,0.455
20500660,1610612758,1610612743,98.0,91.0,0.415,0.4379999999999999,1,2006-01-31,45,19,26,0.422,47,25,22,0.532
20500653,1610612762,1610612759,70.0,79.0,0.324,0.412,0,2006-01-30,45,21,24,0.467,45,35,10,0.778
20500647,1610612737,1610612752,120.0,101.0,0.476,0.515,1,2006-01-30,43,12,31,0.2789999999999999,43,14,29,0.326
20500648,1610612766,1610612739,91.0,103.0,0.435,0.487,0,2006-01-30,46,11,35,0.239,43,26,17,0.605
20500649,1610612748,1610612746,118.0,114.0,0.5479999999999999,0.542,1,2006-01-30,46,28,18,0.609,42,25,17,0.595
20500650,1610612763,1610612745,86.0,77.0,0.451,0.44,1,2006-01-30,44,26,18,0.591,44,15,29,0.341
20500651,1610612740,1610612749,94.0,93.0,0.474,0.4320000000000001,1,2006-01-30,44,22,22,0.5,44,23,21,0.523
20500652,1610612750,1610612738,110.0,85.0,0.569,0.38,1,2006-01-30,43,21,22,0.488,45,18,27,0.4
20500654,1610612760,1610612757,111.0,116.0,0.512,0.518,0,2006-01-30,44,18,26,0.409,43,16,27,0.3720000000000001
20500642,1610612739,1610612756,113.0,106.0,0.46,0.506,1,2006-01-29,42,25,17,0.595,44,28,16,0.636
20500643,1610612749,1610612738,83.0,79.0,0.4029999999999999,0.4029999999999999,1,2006-01-29,43,23,20,0.535,44,18,26,0.409
20500644,1610612745,1610612748,95.0,101.0,0.3720000000000001,0.449,0,2006-01-29,43,15,28,0.349,45,27,18,0.6
20500645,1610612753,1610612755,81.0,89.0,0.431,0.456,0,2006-01-29,42,18,24,0.429,44,23,21,0.523
20500646,1610612765,1610612747,102.0,93.0,0.446,0.42,1,2006-01-29,42,37,5,0.8809999999999999,43,23,20,0.535
20500641,1610612761,1610612758,124.0,123.0,0.4639999999999999,0.494,1,2006-01-29,45,15,30,0.3329999999999999,44,18,26,0.409
20500632,1610612764,1610612766,107.0,97.0,0.4679999999999999,0.435,1,2006-01-28,42,20,22,0.476,45,11,34,0.244
20500633,1610612755,1610612752,91.0,76.0,0.395,0.353,1,2006-01-28,43,22,21,0.512,42,14,28,0.3329999999999999
20500634,1610612763,1610612740,86.0,95.0,0.433,0.447,0,2006-01-28,43,25,18,0.581,43,21,22,0.488
20500635,1610612741,1610612737,111.0,99.0,0.541,0.4,1,2006-01-28,43,20,23,0.465,42,11,31,0.262
20500636,1610612759,1610612750,102.0,88.0,0.47,0.5,1,2006-01-28,44,34,10,0.773,42,20,22,0.476
20500637,1610612742,1610612762,103.0,89.0,0.5539999999999999,0.391,1,2006-01-28,44,34,10,0.773,44,21,23,0.477
20500638,1610612760,1610612751,113.0,104.0,0.532,0.4589999999999999,1,2006-01-28,43,18,25,0.419,42,22,20,0.524
20500639,1610612746,1610612743,112.0,79.0,0.535,0.395,1,2006-01-28,41,25,16,0.61,46,25,21,0.5429999999999999
20500640,1610612744,1610612757,98.0,83.0,0.469,0.408,1,2006-01-28,43,20,23,0.465,42,15,27,0.357
20500619,1610612737,1610612756,106.0,110.0,0.418,0.511,0,2006-01-27,41,11,30,0.268,43,28,15,0.6509999999999999
20500620,1610612754,1610612739,89.0,93.0,0.479,0.451,0,2006-01-27,42,21,21,0.5,41,24,17,0.585
20500621,1610612738,1610612758,84.0,74.0,0.421,0.307,1,2006-01-27,43,18,25,0.419,43,18,25,0.419
20500622,1610612752,1610612753,97.0,94.0,0.421,0.431,1,2006-01-27,41,14,27,0.341,41,18,23,0.439
20500623,1610612766,1610612748,85.0,91.0,0.413,0.474,0,2006-01-27,44,11,33,0.25,44,26,18,0.591
20500624,1610612765,1610612763,95.0,89.0,0.451,0.4379999999999999,1,2006-01-27,41,36,5,0.878,42,25,17,0.595
20500626,1610612741,1610612764,90.0,79.0,0.38,0.36,1,2006-01-27,42,19,23,0.452,41,19,22,0.4629999999999999
20500627,1610612749,1610612761,108.0,87.0,0.584,0.405,1,2006-01-27,42,22,20,0.524,44,14,30,0.318
20500629,1610612745,1610612750,92.0,96.0,0.402,0.493,0,2006-01-27,42,15,27,0.357,41,20,21,0.488
20500628,1610612743,1610612746,87.0,105.0,0.358,0.539,0,2006-01-27,45,25,20,0.556,40,24,16,0.6
20500630,1610612757,1610612751,88.0,83.0,0.516,0.425,1,2006-01-27,41,15,26,0.366,41,22,19,0.537
20500631,1610612747,1610612744,106.0,105.0,0.407,0.396,1,2006-01-27,42,23,19,0.5479999999999999,42,19,23,0.452
20500616,1610612755,1610612753,115.0,119.0,0.489,0.589,0,2006-01-26,42,21,21,0.5,40,18,22,0.45
20500617,1610612748,1610612756,98.0,107.0,0.444,0.451,0,2006-01-26,43,25,18,0.581,42,27,15,0.643
20500618,1610612760,1610612742,97.0,104.0,0.429,0.4320000000000001,0,2006-01-26,42,17,25,0.405,43,33,10,0.767
20500605,1610612737,1610612739,97.0,106.0,0.507,0.4629999999999999,0,2006-01-25,40,11,29,0.275,40,23,17,0.575
20500604,1610612761,1610612741,88.0,104.0,0.3720000000000001,0.506,0,2006-01-25,43,14,29,0.326,41,18,23,0.439
20500606,1610612738,1610612764,87.0,89.0,0.493,0.3979999999999999,0,2006-01-25,42,17,25,0.405,40,19,21,0.475
20500607,1610612752,1610612758,102.0,106.0,0.4429999999999999,0.396,0,2006-01-25,40,13,27,0.325,42,18,24,0.429
20500608,1610612765,1610612749,106.0,102.0,0.476,0.482,1,2006-01-25,40,35,5,0.875,41,21,20,0.512
20500609,1610612740,1610612759,68.0,84.0,0.31,0.3720000000000001,0,2006-01-25,42,20,22,0.476,43,33,10,0.767
20500610,1610612745,1610612766,102.0,78.0,0.4639999999999999,0.415,1,2006-01-25,41,15,26,0.366,43,11,32,0.256
20500611,1610612763,1610612750,107.0,87.0,0.506,0.4320000000000001,1,2006-01-25,41,25,16,0.61,40,19,21,0.475
20500612,1610612762,1610612760,94.0,113.0,0.455,0.528,0,2006-01-25,43,21,22,0.488,41,17,24,0.415
20500613,1610612757,1610612743,94.0,97.0,0.512,0.494,0,2006-01-25,40,14,26,0.35,44,25,19,0.568
20500614,1610612746,1610612751,90.0,77.0,0.48,0.382,1,2006-01-25,39,23,16,0.59,40,22,18,0.55
20500615,1610612744,1610612742,93.0,102.0,0.416,0.425,0,2006-01-25,41,19,22,0.4629999999999999,42,32,10,0.762
20500598,1610612755,1610612758,109.0,103.0,0.488,0.476,1,2006-01-24,41,21,20,0.512,41,17,24,0.415
20500599,1610612753,1610612756,111.0,102.0,0.547,0.461,1,2006-01-24,39,17,22,0.436,41,26,15,0.634
20500600,1610612739,1610612754,96.0,66.0,0.4379999999999999,0.325,1,2006-01-24,39,22,17,0.564,41,21,20,0.512
20500601,1610612748,1610612763,94.0,82.0,0.469,0.4,1,2006-01-24,42,25,17,0.595,40,24,16,0.6
20500602,1610612750,1610612765,83.0,107.0,0.418,0.494,0,2006-01-24,39,19,20,0.487,39,34,5,0.872
20500603,1610612759,1610612766,104.0,76.0,0.564,0.4,1,2006-01-24,42,32,10,0.762,42,11,31,0.262
20500592,1610612737,1610612754,104.0,94.0,0.556,0.487,1,2006-01-23,39,11,28,0.282,40,21,19,0.525
20500593,1610612738,1610612740,91.0,78.0,0.423,0.355,1,2006-01-23,41,17,24,0.415,41,20,21,0.488
20500594,1610612749,1610612745,80.0,97.0,0.37,0.47,0,2006-01-23,40,21,19,0.525,40,14,26,0.35
20500595,1610612743,1610612761,107.0,101.0,0.481,0.4479999999999999,1,2006-01-23,43,24,19,0.5579999999999999,42,14,28,0.3329999999999999
20500596,1610612762,1610612751,89.0,78.0,0.431,0.3329999999999999,1,2006-01-23,42,21,21,0.5,39,22,17,0.564
20500597,1610612744,1610612746,93.0,96.0,0.452,0.4379999999999999,0,2006-01-23,40,19,21,0.475,38,22,16,0.579
20500588,1610612765,1610612745,99.0,97.0,0.405,0.4429999999999999,1,2006-01-22,38,33,5,0.868,39,13,26,0.3329999999999999
20500583,1610612759,1610612743,85.0,89.0,0.417,0.455,0,2006-01-22,41,31,10,0.7559999999999999,42,23,19,0.5479999999999999
20500585,1610612750,1610612755,84.0,86.0,0.462,0.4,0,2006-01-22,38,19,19,0.5,40,20,20,0.5
20500584,1610612764,1610612763,82.0,93.0,0.392,0.434,0,2006-01-22,39,18,21,0.462,39,24,15,0.615
20500586,1610612746,1610612744,105.0,92.0,0.467,0.408,1,2006-01-22,37,21,16,0.568,39,19,20,0.487
20500587,1610612748,1610612758,119.0,99.0,0.595,0.4320000000000001,1,2006-01-22,41,24,17,0.585,40,17,23,0.425
20500589,1610612756,1610612760,149.0,152.0,0.514,0.535,0,2006-01-22,40,26,14,0.65,40,16,24,0.4
20500590,1610612757,1610612742,89.0,95.0,0.407,0.402,0,2006-01-22,39,14,25,0.359,41,31,10,0.7559999999999999
20500591,1610612747,1610612761,122.0,104.0,0.477,0.474,1,2006-01-22,41,22,19,0.537,41,14,27,0.341
20500577,1610612753,1610612758,83.0,78.0,0.337,0.368,1,2006-01-21,38,16,22,0.421,39,17,22,0.436
20500578,1610612752,1610612740,98.0,109.0,0.467,0.487,0,2006-01-21,39,13,26,0.3329999999999999,40,20,20,0.5
20500579,1610612751,1610612738,103.0,83.0,0.467,0.419,1,2006-01-21,38,22,16,0.579,40,16,24,0.4
20500580,1610612754,1610612741,89.0,101.0,0.3879999999999999,0.44,0,2006-01-21,39,21,18,0.5379999999999999,40,17,23,0.425
20500581,1610612749,1610612766,101.0,91.0,0.542,0.3829999999999999,1,2006-01-21,39,21,18,0.5379999999999999,41,11,30,0.268
20500582,1610612762,1610612739,90.0,108.0,0.4679999999999999,0.5429999999999999,0,2006-01-21,41,20,21,0.488,38,21,17,0.5529999999999999
20500564,1610612755,1610612763,89.0,86.0,0.416,0.395,1,2006-01-20,39,19,20,0.487,38,23,15,0.605
20500565,1610612764,1610612740,110.0,99.0,0.518,0.487,1,2006-01-20,38,18,20,0.474,39,19,20,0.487
20500566,1610612737,1610612749,102.0,118.0,0.416,0.513,0,2006-01-20,38,10,28,0.263,38,20,18,0.526
20500567,1610612738,1610612751,99.0,96.0,0.507,0.42,1,2006-01-20,39,16,23,0.41,37,21,16,0.568
20500568,1610612766,1610612753,93.0,104.0,0.395,0.486,0,2006-01-20,40,11,29,0.275,37,15,22,0.405
20500569,1610612748,1610612759,94.0,101.0,0.487,0.493,0,2006-01-20,40,23,17,0.575,40,31,9,0.775
20500570,1610612750,1610612754,90.0,85.0,0.4479999999999999,0.3879999999999999,1,2006-01-20,37,19,18,0.514,38,21,17,0.5529999999999999
20500571,1610612741,1610612745,108.0,109.0,0.406,0.4679999999999999,0,2006-01-20,39,16,23,0.41,38,13,25,0.342
20500572,1610612743,1610612762,113.0,83.0,0.5,0.395,1,2006-01-20,41,22,19,0.537,40,20,20,0.5
20500573,1610612756,1610612747,106.0,93.0,0.487,0.3979999999999999,1,2006-01-20,39,26,13,0.667,40,21,19,0.525
20500574,1610612746,1610612742,81.0,101.0,0.452,0.494,0,2006-01-20,36,20,16,0.556,40,30,10,0.75
20500575,1610612744,1610612739,99.0,79.0,0.474,0.384,1,2006-01-20,38,19,19,0.5,37,20,17,0.541
20500576,1610612760,1610612761,113.0,121.0,0.489,0.481,0,2006-01-20,39,15,24,0.385,40,14,26,0.35
20500562,1610612752,1610612765,79.0,105.0,0.493,0.506,0,2006-01-19,38,13,25,0.342,37,32,5,0.865
20500563,1610612758,1610612747,118.0,109.0,0.466,0.441,1,2006-01-19,38,17,21,0.447,39,21,18,0.5379999999999999
20500550,1610612755,1610612751,90.0,101.0,0.493,0.451,0,2006-01-18,38,18,20,0.474,36,21,15,0.583
20500551,1610612737,1610612765,89.0,117.0,0.341,0.542,0,2006-01-18,37,10,27,0.27,36,31,5,0.861
20500552,1610612753,1610612764,106.0,98.0,0.507,0.4,1,2006-01-18,36,14,22,0.389,37,17,20,0.4589999999999999
20500553,1610612754,1610612766,98.0,92.0,0.5,0.481,1,2006-01-18,37,21,16,0.568,39,11,28,0.282
20500554,1610612738,1610612750,103.0,96.0,0.488,0.451,1,2006-01-18,38,15,23,0.395,36,18,18,0.5
20500555,1610612740,1610612763,87.0,79.0,0.447,0.3779999999999999,1,2006-01-18,38,19,19,0.5,37,23,14,0.622
20500556,1610612741,1610612752,106.0,104.0,0.482,0.455,1,2006-01-18,38,16,22,0.421,37,13,24,0.351
20500557,1610612745,1610612742,76.0,103.0,0.408,0.5,0,2006-01-18,37,12,25,0.324,39,29,10,0.7440000000000001
20500558,1610612759,1610612749,95.0,92.0,0.457,0.5,1,2006-01-18,39,30,9,0.769,37,19,18,0.514
20500559,1610612743,1610612739,90.0,89.0,0.3879999999999999,0.416,1,2006-01-18,40,21,19,0.525,36,20,16,0.556
20500560,1610612757,1610612761,96.0,94.0,0.507,0.5329999999999999,1,2006-01-18,38,14,24,0.368,39,13,26,0.3329999999999999
20500561,1610612746,1610612756,102.0,112.0,0.461,0.467,0,2006-01-18,35,20,15,0.5710000000000001,38,25,13,0.6579999999999999
20500548,1610612762,1610612761,111.0,98.0,0.55,0.456,1,2006-01-17,39,20,19,0.513,38,13,25,0.342
20500549,1610612758,1610612756,119.0,90.0,0.511,0.375,1,2006-01-17,37,16,21,0.4320000000000001,37,24,13,0.649
20500547,1610612747,1610612748,100.0,92.0,0.466,0.41,1,2006-01-16,38,21,17,0.5529999999999999,39,23,16,0.59
20500540,1610612741,1610612743,94.0,97.0,0.451,0.4029999999999999,0,2006-01-16,37,15,22,0.405,39,20,19,0.513
20500544,1610612744,1610612760,109.0,93.0,0.512,0.447,1,2006-01-16,37,18,19,0.486,38,15,23,0.395
20500538,1610612766,1610612740,92.0,107.0,0.377,0.474,0,2006-01-16,38,11,27,0.289,37,18,19,0.486
20500536,1610612752,1610612750,90.0,96.0,0.449,0.455,0,2006-01-16,36,13,23,0.361,35,18,17,0.514
20500537,1610612764,1610612755,104.0,76.0,0.425,0.3329999999999999,1,2006-01-16,36,17,19,0.472,37,18,19,0.486
20500539,1610612737,1610612745,94.0,83.0,0.506,0.475,1,2006-01-16,36,10,26,0.278,36,12,24,0.3329999999999999
20500541,1610612751,1610612754,97.0,92.0,0.452,0.485,1,2006-01-16,35,20,15,0.5710000000000001,36,20,16,0.556
20500542,1610612765,1610612738,94.0,84.0,0.5,0.447,1,2006-01-16,35,30,5,0.857,37,14,23,0.3779999999999999
20500543,1610612746,1610612762,102.0,93.0,0.416,0.3779999999999999,1,2006-01-16,34,20,14,0.588,38,19,19,0.5
20500545,1610612763,1610612759,83.0,93.0,0.411,0.507,0,2006-01-16,36,23,13,0.639,38,29,9,0.763
20500546,1610612742,1610612749,114.0,95.0,0.519,0.493,1,2006-01-16,38,28,10,0.737,36,19,17,0.528
20500533,1610612761,1610612752,129.0,103.0,0.59,0.479,1,2006-01-15,37,13,24,0.351,35,13,22,0.371
20500534,1610612758,1610612753,104.0,100.0,0.477,0.456,1,2006-01-15,36,15,21,0.417,35,13,22,0.371
20500535,1610612757,1610612739,89.0,87.0,0.436,0.4270000000000001,1,2006-01-15,37,13,24,0.351,35,20,15,0.5710000000000001
20500522,1610612737,1610612764,106.0,114.0,0.455,0.4379999999999999,0,2006-01-14,35,9,26,0.257,35,16,19,0.457
20500523,1610612765,1610612766,114.0,91.0,0.5379999999999999,0.493,1,2006-01-14,34,29,5,0.853,37,11,26,0.297
20500524,1610612741,1610612754,89.0,91.0,0.3979999999999999,0.386,0,2006-01-14,36,15,21,0.417,35,20,15,0.5710000000000001
20500525,1610612749,1610612743,93.0,100.0,0.3779999999999999,0.487,0,2006-01-14,35,19,16,0.5429999999999999,38,19,19,0.5
20500526,1610612745,1610612740,80.0,86.0,0.397,0.417,0,2006-01-14,35,12,23,0.3429999999999999,36,17,19,0.472
20500527,1610612742,1610612751,110.0,77.0,0.526,0.414,1,2006-01-14,37,27,10,0.73,34,19,15,0.5589999999999999
20500528,1610612759,1610612763,80.0,79.0,0.433,0.478,1,2006-01-14,37,28,9,0.757,35,23,12,0.657
20500529,1610612762,1610612748,94.0,100.0,0.4589999999999999,0.4429999999999999,0,2006-01-14,37,19,18,0.514,38,23,15,0.605
20500530,1610612756,1610612739,115.0,106.0,0.547,0.483,1,2006-01-14,36,24,12,0.667,34,20,14,0.588
20500531,1610612746,1610612760,98.0,72.0,0.513,0.342,1,2006-01-14,33,19,14,0.5760000000000001,37,15,22,0.405
20500532,1610612744,1610612747,104.0,110.0,0.436,0.512,0,2006-01-14,36,17,19,0.472,37,20,17,0.541
20500513,1610612754,1610612764,85.0,94.0,0.4529999999999999,0.4579999999999999,0,2006-01-13,34,19,15,0.5589999999999999,34,15,19,0.441
20500514,1610612752,1610612737,105.0,94.0,0.556,0.487,1,2006-01-13,34,13,21,0.382,34,9,25,0.265
20500515,1610612766,1610612749,102.0,103.0,0.451,0.481,0,2006-01-13,36,11,25,0.306,34,19,15,0.5589999999999999
20500516,1610612755,1610612738,125.0,124.0,0.414,0.44,1,2006-01-13,36,18,18,0.5,36,14,22,0.389
20500517,1610612763,1610612751,81.0,69.0,0.42,0.347,1,2006-01-13,34,23,11,0.6759999999999999,33,19,14,0.5760000000000001
20500518,1610612740,1610612758,90.0,76.0,0.415,0.364,1,2006-01-13,35,16,19,0.457,35,14,21,0.4
20500519,1610612750,1610612743,103.0,89.0,0.564,0.424,1,2006-01-13,34,17,17,0.5,37,18,19,0.486
20500520,1610612757,1610612753,113.0,108.0,0.5379999999999999,0.506,1,2006-01-13,36,12,24,0.3329999999999999,34,13,21,0.382
20500521,1610612760,1610612748,104.0,117.0,0.4429999999999999,0.5,0,2006-01-13,36,15,21,0.417,37,22,15,0.595
20500510,1610612759,1610612765,68.0,83.0,0.386,0.44,0,2006-01-12,36,27,9,0.75,33,28,5,0.848
20500511,1610612756,1610612744,112.0,99.0,0.518,0.382,1,2006-01-12,35,23,12,0.657,35,17,18,0.486
20500512,1610612747,1610612739,99.0,98.0,0.506,0.542,1,2006-01-12,36,19,17,0.528,33,20,13,0.606
20500500,1610612761,1610612766,95.0,86.0,0.457,0.408,1,2006-01-11,36,12,24,0.3329999999999999,35,11,24,0.314
20500501,1610612755,1610612762,102.0,110.0,0.507,0.588,0,2006-01-11,35,17,18,0.486,36,19,17,0.528
20500502,1610612764,1610612737,103.0,72.0,0.506,0.3939999999999999,1,2006-01-11,33,14,19,0.424,33,9,24,0.273
20500504,1610612754,1610612749,112.0,88.0,0.563,0.434,1,2006-01-11,33,19,14,0.5760000000000001,33,18,15,0.545
20500503,1610612752,1610612742,117.0,115.0,0.412,0.529,1,2006-01-11,33,12,21,0.364,36,26,10,0.722
20500505,1610612750,1610612741,99.0,93.0,0.39,0.436,1,2006-01-11,33,16,17,0.485,35,15,20,0.429
20500506,1610612745,1610612758,80.0,88.0,0.395,0.424,0,2006-01-11,34,12,22,0.353,34,14,20,0.412
20500507,1610612757,1610612747,113.0,103.0,0.524,0.482,1,2006-01-11,35,11,24,0.314,35,18,17,0.514
20500508,1610612760,1610612753,113.0,104.0,0.522,0.522,1,2006-01-11,35,15,20,0.429,33,13,20,0.3939999999999999
20500509,1610612744,1610612748,96.0,110.0,0.384,0.59,0,2006-01-11,34,17,17,0.5,36,21,15,0.583
20500493,1610612766,1610612745,111.0,106.0,0.44,0.4320000000000001,1,2006-01-10,34,11,23,0.324,33,12,21,0.364
20500491,1610612737,1610612738,94.0,98.0,0.45,0.521,0,2006-01-10,32,9,23,0.281,35,14,21,0.4
20500492,1610612739,1610612752,84.0,92.0,0.3720000000000001,0.4429999999999999,0,2006-01-10,32,20,12,0.625,32,11,21,0.344
20500494,1610612749,1610612750,95.0,92.0,0.513,0.529,1,2006-01-10,32,18,14,0.563,32,15,17,0.469
20500495,1610612763,1610612758,99.0,85.0,0.519,0.456,1,2006-01-10,33,22,11,0.667,33,13,20,0.3939999999999999
20500496,1610612740,1610612765,86.0,96.0,0.4529999999999999,0.514,0,2006-01-10,34,15,19,0.441,32,27,5,0.8440000000000001
20500497,1610612759,1610612751,96.0,91.0,0.484,0.451,1,2006-01-10,35,27,8,0.7709999999999999,32,19,13,0.594
20500498,1610612743,1610612756,139.0,137.0,0.49,0.481,1,2006-01-10,36,18,18,0.5,34,22,12,0.647
20500499,1610612746,1610612753,90.0,73.0,0.434,0.389,1,2006-01-10,32,18,14,0.563,32,13,19,0.406
20500486,1610612755,1610612760,107.0,98.0,0.528,0.415,1,2006-01-09,34,17,17,0.5,34,14,20,0.412
20500487,1610612764,1610612762,89.0,97.0,0.4579999999999999,0.487,0,2006-01-09,32,13,19,0.406,35,18,17,0.514
20500488,1610612738,1610612742,102.0,104.0,0.456,0.419,0,2006-01-09,34,13,21,0.382,35,26,9,0.743
20500489,1610612741,1610612761,113.0,104.0,0.521,0.477,1,2006-01-09,34,15,19,0.441,35,11,24,0.314
20500490,1610612747,1610612754,96.0,90.0,0.425,0.373,1,2006-01-09,34,18,16,0.529,32,18,14,0.563
20500481,1610612761,1610612751,104.0,105.0,0.449,0.462,0,2006-01-08,34,11,23,0.324,31,19,12,0.613
20500482,1610612752,1610612760,120.0,116.0,0.519,0.452,1,2006-01-08,31,10,21,0.3229999999999999,33,14,19,0.424
20500483,1610612745,1610612743,90.0,92.0,0.45,0.4429999999999999,0,2006-01-08,32,12,20,0.375,35,17,18,0.486
20500484,1610612758,1610612754,83.0,108.0,0.395,0.462,0,2006-01-08,32,13,19,0.406,31,18,13,0.581
20500485,1610612757,1610612748,89.0,118.0,0.419,0.588,0,2006-01-08,34,10,24,0.294,35,20,15,0.5710000000000001
20500472,1610612764,1610612738,103.0,102.0,0.434,0.494,1,2006-01-07,31,13,18,0.419,33,13,20,0.3939999999999999
20500473,1610612737,1610612740,101.0,93.0,0.528,0.447,1,2006-01-07,31,9,22,0.29,33,15,18,0.455
20500474,1610612753,1610612766,108.0,92.0,0.563,0.373,1,2006-01-07,31,13,18,0.419,33,10,23,0.303
20500475,1610612765,1610612762,90.0,94.0,0.364,0.42,0,2006-01-07,31,26,5,0.8390000000000001,34,17,17,0.5
20500476,1610612739,1610612749,96.0,88.0,0.439,0.415,1,2006-01-07,31,20,11,0.645,31,17,14,0.5479999999999999
20500477,1610612741,1610612763,111.0,82.0,0.621,0.391,1,2006-01-07,33,14,19,0.424,32,21,11,0.6559999999999999
20500478,1610612742,1610612750,83.0,79.0,0.353,0.493,1,2006-01-07,34,25,9,0.735,31,15,16,0.484
20500479,1610612756,1610612759,91.0,86.0,0.485,0.413,1,2006-01-07,33,22,11,0.667,34,26,8,0.765
20500480,1610612746,1610612747,109.0,112.0,0.513,0.429,0,2006-01-07,31,17,14,0.5479999999999999,33,17,16,0.515
20500462,1610612752,1610612764,113.0,92.0,0.544,0.415,1,2006-01-06,30,9,21,0.3,30,12,18,0.4
20500470,1610612756,1610612748,111.0,93.0,0.532,0.391,1,2006-01-06,32,21,11,0.6559999999999999,34,19,15,0.5589999999999999
20500465,1610612740,1610612757,90.0,80.0,0.4320000000000001,0.4579999999999999,1,2006-01-06,32,15,17,0.469,33,10,23,0.303
20500459,1610612761,1610612745,112.0,92.0,0.5,0.446,1,2006-01-06,33,11,22,0.3329999999999999,31,12,19,0.387
20500460,1610612738,1610612737,98.0,103.0,0.475,0.493,0,2006-01-06,32,13,19,0.406,30,8,22,0.267
20500461,1610612751,1610612753,113.0,106.0,0.4679999999999999,0.482,1,2006-01-06,30,18,12,0.6,30,12,18,0.4
20500463,1610612765,1610612760,97.0,85.0,0.42,0.382,1,2006-01-06,30,26,4,0.867,32,14,18,0.4379999999999999
20500464,1610612763,1610612762,87.0,65.0,0.362,0.308,1,2006-01-06,31,21,10,0.677,33,16,17,0.485
20500466,1610612759,1610612750,83.0,77.0,0.461,0.392,1,2006-01-06,33,26,7,0.7879999999999999,30,15,15,0.5
20500467,1610612749,1610612741,91.0,105.0,0.449,0.474,0,2006-01-06,30,17,13,0.5670000000000001,32,13,19,0.406
20500468,1610612743,1610612742,112.0,114.0,0.441,0.488,0,2006-01-06,34,16,18,0.471,33,24,9,0.727
20500469,1610612758,1610612746,118.0,114.0,0.5489999999999999,0.446,1,2006-01-06,31,13,18,0.419,30,17,13,0.5670000000000001
20500471,1610612747,1610612755,119.0,93.0,0.585,0.424,1,2006-01-06,32,16,16,0.5,33,16,17,0.485
20500457,1610612739,1610612745,81.0,90.0,0.434,0.446,0,2006-01-05,30,19,11,0.633,30,12,18,0.4
20500458,1610612744,1610612754,89.0,99.0,0.434,0.4589999999999999,0,2006-01-05,33,17,16,0.515,30,17,13,0.5670000000000001
20500456,1610612756,1610612755,105.0,85.0,0.478,0.384,1,2006-01-04,31,20,11,0.645,32,16,16,0.5
20500449,1610612738,1610612766,109.0,106.0,0.5710000000000001,0.4,1,2006-01-04,31,13,18,0.419,32,10,22,0.313
20500451,1610612740,1610612748,107.0,92.0,0.494,0.447,1,2006-01-04,31,14,17,0.452,33,19,14,0.5760000000000001
20500448,1610612761,1610612753,121.0,97.0,0.63,0.507,1,2006-01-04,32,10,22,0.313,29,12,17,0.414
20500450,1610612749,1610612739,84.0,91.0,0.373,0.415,0,2006-01-04,29,17,12,0.586,29,19,10,0.655
20500452,1610612750,1610612742,91.0,78.0,0.471,0.3720000000000001,1,2006-01-04,29,15,14,0.517,32,23,9,0.7190000000000001
20500453,1610612741,1610612760,97.0,101.0,0.407,0.416,0,2006-01-04,31,12,19,0.387,31,14,17,0.452
20500454,1610612759,1610612757,106.0,75.0,0.5,0.371,1,2006-01-04,32,25,7,0.7809999999999999,32,10,22,0.313
20500455,1610612743,1610612754,106.0,86.0,0.521,0.4,1,2006-01-04,33,16,17,0.485,29,16,13,0.552
20500441,1610612764,1610612745,111.0,123.0,0.424,0.551,0,2006-01-03,29,12,17,0.414,29,11,18,0.379
20500442,1610612737,1610612761,97.0,108.0,0.477,0.486,0,2006-01-03,29,7,22,0.241,31,9,22,0.29
20500443,1610612765,1610612753,108.0,99.0,0.527,0.527,1,2006-01-03,29,25,4,0.862,28,12,16,0.429
20500444,1610612763,1610612744,104.0,94.0,0.486,0.469,1,2006-01-03,30,20,10,0.667,32,17,15,0.531
20500445,1610612742,1610612757,95.0,81.0,0.4679999999999999,0.369,1,2006-01-03,31,23,8,0.742,31,10,21,0.3229999999999999
20500446,1610612762,1610612747,90.0,80.0,0.493,0.408,1,2006-01-03,32,16,16,0.5,31,15,16,0.484
20500447,1610612758,1610612755,98.0,111.0,0.407,0.478,0,2006-01-03,30,12,18,0.4,31,16,15,0.516
20500437,1610612754,1610612760,115.0,96.0,0.521,0.449,1,2006-01-02,28,16,12,0.5710000000000001,30,13,17,0.433
20500438,1610612752,1610612756,140.0,133.0,0.495,0.473,1,2006-01-02,29,8,21,0.276,30,19,11,0.633
20500869,1610612740,1610612766,103.0,86.0,0.474,0.429,1,2006-01-02,30,13,17,0.433,31,10,21,0.3229999999999999
20500439,1610612741,1610612749,92.0,93.0,0.494,0.407,0,2006-01-02,30,12,18,0.4,28,17,11,0.607
20500440,1610612743,1610612738,120.0,110.0,0.526,0.506,1,2006-01-02,32,15,17,0.469,30,12,18,0.4
20500435,1610612757,1610612746,94.0,100.0,0.462,0.494,0,2006-01-01,30,10,20,0.3329999999999999,29,17,12,0.586
20500434,1610612748,1610612750,97.0,70.0,0.52,0.325,1,2006-01-01,32,19,13,0.594,28,14,14,0.5
20500436,1610612747,1610612762,94.0,98.0,0.5,0.472,0,2006-01-01,30,15,15,0.5,31,15,16,0.484
20500431,1610612743,1610612759,88.0,98.0,0.342,0.436,0,2005-12-31,31,14,17,0.452,31,24,7,0.774
20500426,1610612739,1610612765,97.0,84.0,0.4379999999999999,0.358,1,2005-12-31,28,18,10,0.643,28,24,4,0.857
20500427,1610612741,1610612756,98.0,107.0,0.4320000000000001,0.462,0,2005-12-31,29,12,17,0.414,29,19,10,0.655
20500428,1610612740,1610612742,90.0,95.0,0.4579999999999999,0.461,0,2005-12-31,29,12,17,0.414,30,22,8,0.733
20500429,1610612745,1610612744,89.0,94.0,0.41,0.3779999999999999,0,2005-12-31,28,10,18,0.357,31,17,14,0.5479999999999999
20500430,1610612762,1610612755,108.0,102.0,0.4629999999999999,0.529,1,2005-12-31,30,14,16,0.467,30,15,15,0.5
20500432,1610612760,1610612763,96.0,100.0,0.507,0.5539999999999999,0,2005-12-31,29,13,16,0.4479999999999999,29,19,10,0.655
20500433,1610612746,1610612738,92.0,111.0,0.4629999999999999,0.5660000000000001,0,2005-12-31,28,16,12,0.5710000000000001,29,12,17,0.414
20500417,1610612764,1610612748,113.0,128.0,0.38,0.5489999999999999,0,2005-12-30,28,12,16,0.429,31,18,13,0.581
20500418,1610612753,1610612750,107.0,87.0,0.5,0.457,1,2005-12-30,27,12,15,0.444,27,14,13,0.519
20500419,1610612754,1610612761,97.0,99.0,0.425,0.475,0,2005-12-30,27,15,12,0.556,30,8,22,0.267
20500420,1610612751,1610612737,99.0,91.0,0.508,0.4429999999999999,1,2005-12-30,29,17,12,0.586,28,7,21,0.25
20500421,1610612766,1610612756,100.0,110.0,0.457,0.494,0,2005-12-30,30,10,20,0.3329999999999999,28,18,10,0.643
20500422,1610612749,1610612752,113.0,108.0,0.446,0.4589999999999999,1,2005-12-30,27,16,11,0.593,28,7,21,0.25
20500423,1610612742,1610612744,109.0,111.0,0.494,0.471,0,2005-12-30,29,21,8,0.7240000000000001,30,16,14,0.5329999999999999
20500424,1610612758,1610612738,116.0,112.0,0.482,0.517,1,2005-12-30,29,12,17,0.414,28,11,17,0.3929999999999999
20500425,1610612757,1610612763,90.0,93.0,0.473,0.486,0,2005-12-30,29,10,19,0.345,28,18,10,0.643
20500414,1610612765,1610612748,106.0,101.0,0.487,0.525,1,2005-12-29,27,24,3,0.889,30,17,13,0.5670000000000001
20500415,1610612759,1610612740,111.0,84.0,0.589,0.416,1,2005-12-29,30,23,7,0.767,28,12,16,0.429
20500416,1610612743,1610612760,105.0,112.0,0.467,0.456,0,2005-12-29,30,14,16,0.467,28,13,15,0.4639999999999999
20500413,1610612744,1610612738,111.0,109.0,0.537,0.532,1,2005-12-28,29,15,14,0.517,27,11,16,0.407
20500408,1610612766,1610612741,93.0,80.0,0.375,0.461,1,2005-12-28,29,10,19,0.345,28,12,16,0.429
20500405,1610612761,1610612737,108.0,102.0,0.512,0.563,1,2005-12-28,29,7,22,0.241,27,7,20,0.259
20500406,1610612764,1610612756,99.0,104.0,0.488,0.466,0,2005-12-28,27,12,15,0.444,27,17,10,0.63
20500407,1610612753,1610612752,105.0,95.0,0.528,0.356,1,2005-12-28,26,11,15,0.423,27,7,20,0.259
20500409,1610612740,1610612745,92.0,90.0,0.48,0.373,1,2005-12-28,27,12,15,0.444,27,10,17,0.37
20500410,1610612750,1610612760,108.0,95.0,0.581,0.4429999999999999,1,2005-12-28,26,14,12,0.5379999999999999,27,12,15,0.444
20500411,1610612757,1610612755,95.0,91.0,0.361,0.407,1,2005-12-28,28,10,18,0.357,29,15,14,0.517
20500412,1610612747,1610612763,99.0,100.0,0.417,0.422,0,2005-12-28,29,15,14,0.517,27,17,10,0.63
20500397,1610612737,1610612766,90.0,93.0,0.471,0.493,0,2005-12-27,26,7,19,0.2689999999999999,28,9,19,0.321
20500398,1610612751,1610612739,96.0,91.0,0.434,0.474,1,2005-12-27,28,16,12,0.5710000000000001,27,17,10,0.63
20500399,1610612748,1610612749,109.0,98.0,0.481,0.466,1,2005-12-27,29,17,12,0.586,26,15,11,0.5770000000000001
20500400,1610612765,1610612761,113.0,106.0,0.519,0.506,1,2005-12-27,26,23,3,0.885,28,6,22,0.214
20500401,1610612745,1610612762,74.0,82.0,0.342,0.348,0,2005-12-27,26,10,16,0.385,29,13,16,0.4479999999999999
20500402,1610612759,1610612754,99.0,86.0,0.507,0.4589999999999999,1,2005-12-27,29,22,7,0.759,26,15,11,0.5770000000000001
20500403,1610612743,1610612755,106.0,108.0,0.466,0.5,0,2005-12-27,29,14,15,0.483,28,15,13,0.536
20500404,1610612746,1610612758,93.0,110.0,0.4429999999999999,0.442,0,2005-12-27,27,16,11,0.593,28,11,17,0.3929999999999999
20500396,1610612744,1610612743,112.0,118.0,0.482,0.603,0,2005-12-26,28,14,14,0.5,28,14,14,0.5
20500387,1610612764,1610612747,94.0,91.0,0.3829999999999999,0.413,1,2005-12-26,26,12,14,0.462,28,15,13,0.536
20500388,1610612753,1610612749,108.0,93.0,0.5379999999999999,0.436,1,2005-12-26,25,10,15,0.4,25,15,10,0.6
20500389,1610612739,1610612741,102.0,91.0,0.487,0.424,1,2005-12-26,26,17,9,0.654,27,12,15,0.444
20500390,1610612752,1610612751,101.0,109.0,0.4589999999999999,0.5429999999999999,0,2005-12-26,26,7,19,0.2689999999999999,27,15,12,0.556
20500391,1610612750,1610612756,89.0,103.0,0.422,0.519,0,2005-12-26,25,13,12,0.52,26,16,10,0.615
20500392,1610612742,1610612754,102.0,80.0,0.474,0.4029999999999999,1,2005-12-26,28,21,7,0.75,25,15,10,0.6
20500393,1610612762,1610612763,105.0,102.0,0.425,0.433,1,2005-12-26,28,12,16,0.429,26,16,10,0.615
20500394,1610612758,1610612757,92.0,105.0,0.434,0.5379999999999999,0,2005-12-26,27,10,17,0.37,27,9,18,0.3329999999999999
20500395,1610612760,1610612738,118.0,111.0,0.481,0.526,1,2005-12-26,26,12,14,0.462,26,11,15,0.423
20500386,1610612748,1610612747,97.0,92.0,0.45,0.3879999999999999,1,2005-12-25,28,16,12,0.5710000000000001,27,15,12,0.556
20500385,1610612765,1610612759,85.0,70.0,0.415,0.4,1,2005-12-25,25,22,3,0.88,28,21,7,0.75
20500371,1610612737,1610612755,111.0,108.0,0.54,0.465,1,2005-12-23,25,7,18,0.28,27,14,13,0.519
20500374,1610612766,1610612746,88.0,97.0,0.37,0.435,0,2005-12-23,27,8,19,0.296,26,16,10,0.615
20500372,1610612753,1610612747,88.0,104.0,0.395,0.493,0,2005-12-23,24,9,15,0.375,26,15,11,0.5770000000000001
20500373,1610612752,1610612762,98.0,90.0,0.4629999999999999,0.462,1,2005-12-23,25,7,18,0.28,27,11,16,0.407
20500375,1610612748,1610612751,88.0,95.0,0.366,0.39,0,2005-12-23,27,15,12,0.556,26,14,12,0.5379999999999999
20500376,1610612765,1610612744,97.0,85.0,0.481,0.452,1,2005-12-23,24,21,3,0.875,27,14,13,0.519
20500377,1610612739,1610612754,94.0,89.0,0.431,0.425,1,2005-12-23,25,16,9,0.64,24,15,9,0.625
20500378,1610612763,1610612741,95.0,77.0,0.423,0.356,1,2005-12-23,25,16,9,0.64,26,12,14,0.462
20500379,1610612750,1610612757,83.0,91.0,0.421,0.4429999999999999,0,2005-12-23,24,13,11,0.542,26,8,18,0.308
20500380,1610612749,1610612740,101.0,94.0,0.487,0.3829999999999999,1,2005-12-23,24,15,9,0.625,26,11,15,0.423
20500381,1610612759,1610612761,95.0,90.0,0.528,0.479,1,2005-12-23,27,21,6,0.778,27,6,21,0.222
20500382,1610612743,1610612745,108.0,86.0,0.477,0.314,1,2005-12-23,27,13,14,0.481,25,10,15,0.4
20500383,1610612756,1610612764,111.0,112.0,0.488,0.5,0,2005-12-23,25,15,10,0.6,25,11,14,0.44
20500384,1610612760,1610612742,98.0,101.0,0.435,0.446,0,2005-12-23,25,11,14,0.44,27,20,7,0.741
20500369,1610612741,1610612739,100.0,108.0,0.519,0.4320000000000001,0,2005-12-22,25,12,13,0.48,24,15,9,0.625
20500370,1610612758,1610612742,95.0,105.0,0.4320000000000001,0.5,0,2005-12-22,26,10,16,0.385,26,19,7,0.731
20500366,1610612750,1610612740,88.0,69.0,0.473,0.325,1,2005-12-21,23,13,10,0.565,25,11,14,0.44
20500360,1610612755,1610612744,111.0,100.0,0.5,0.451,1,2005-12-21,26,14,12,0.5379999999999999,26,14,12,0.5379999999999999
20500361,1610612753,1610612751,85.0,96.0,0.471,0.447,0,2005-12-21,23,9,14,0.391,25,13,12,0.52
20500362,1610612754,1610612746,97.0,75.0,0.513,0.371,1,2005-12-21,23,15,8,0.652,25,15,10,0.6
20500363,1610612738,1610612762,101.0,89.0,0.4920000000000001,0.429,1,2005-12-21,25,11,14,0.44,26,11,15,0.423
20500364,1610612752,1610612759,96.0,109.0,0.455,0.56,0,2005-12-21,24,6,18,0.25,26,20,6,0.769
20500365,1610612763,1610612757,89.0,79.0,0.415,0.429,1,2005-12-21,24,15,9,0.625,25,7,18,0.28
20500367,1610612745,1610612761,81.0,94.0,0.421,0.485,0,2005-12-21,24,10,14,0.417,26,6,20,0.231
20500368,1610612743,1610612764,110.0,116.0,0.5,0.536,0,2005-12-21,26,12,14,0.462,24,10,14,0.417
20500356,1610612749,1610612759,109.0,107.0,0.461,0.484,1,2005-12-20,23,14,9,0.609,25,19,6,0.76
20500352,1610612739,1610612762,110.0,85.0,0.5710000000000001,0.467,1,2005-12-20,23,14,9,0.609,25,11,14,0.44
20500353,1610612751,1610612746,99.0,85.0,0.514,0.418,1,2005-12-20,24,12,12,0.5,24,15,9,0.625
20500354,1610612748,1610612737,111.0,92.0,0.513,0.418,1,2005-12-20,26,15,11,0.5770000000000001,24,6,18,0.25
20500355,1610612765,1610612757,93.0,89.0,0.3939999999999999,0.5,1,2005-12-20,23,20,3,0.87,24,7,17,0.292
20500357,1610612741,1610612766,92.0,105.0,0.436,0.513,0,2005-12-20,24,12,12,0.5,26,8,18,0.308
20500358,1610612756,1610612760,111.0,83.0,0.524,0.33,1,2005-12-20,24,15,9,0.625,24,11,13,0.4579999999999999
20500359,1610612747,1610612742,112.0,90.0,0.5,0.37,1,2005-12-20,25,14,11,0.56,25,18,7,0.72
20500347,1610612753,1610612761,90.0,92.0,0.493,0.425,0,2005-12-19,22,9,13,0.409,25,5,20,0.2
20500348,1610612738,1610612744,109.0,98.0,0.482,0.411,1,2005-12-19,24,10,14,0.417,25,14,11,0.56
20500349,1610612766,1610612758,106.0,103.0,0.4429999999999999,0.446,1,2005-12-19,25,7,18,0.28,25,10,15,0.4
20500350,1610612763,1610612765,104.0,106.0,0.518,0.414,0,2005-12-19,23,14,9,0.609,22,19,3,0.8640000000000001
20500351,1610612760,1610612764,111.0,101.0,0.487,0.474,1,2005-12-19,23,11,12,0.478,23,9,14,0.391
20500341,1610612761,1610612755,80.0,107.0,0.345,0.488,0,2005-12-18,24,4,20,0.1669999999999999,25,13,12,0.52
20500342,1610612737,1610612743,110.0,107.0,0.4270000000000001,0.4579999999999999,1,2005-12-18,23,6,17,0.261,25,12,13,0.48
20500343,1610612751,1610612744,118.0,90.0,0.575,0.382,1,2005-12-18,23,11,12,0.478,24,14,10,0.583
20500795,1610612740,1610612759,89.0,76.0,0.442,0.4479999999999999,1,2005-12-18,24,11,13,0.4579999999999999,24,19,5,0.792
20500344,1610612742,1610612750,102.0,95.0,0.5,0.4270000000000001,1,2005-12-18,24,18,6,0.75,22,12,10,0.545
20500345,1610612757,1610612764,97.0,92.0,0.455,0.423,1,2005-12-18,23,7,16,0.304,22,9,13,0.409
20500346,1610612747,1610612745,74.0,76.0,0.352,0.392,0,2005-12-18,24,13,11,0.542,23,10,13,0.435
20500335,1610612766,1610612765,78.0,103.0,0.352,0.512,0,2005-12-17,24,6,18,0.25,21,18,3,0.857
20500333,1610612746,1610612745,89.0,81.0,0.487,0.392,1,2005-12-17,23,15,8,0.652,22,9,13,0.409
20500334,1610612752,1610612754,96.0,102.0,0.3720000000000001,0.452,0,2005-12-17,23,6,17,0.261,22,14,8,0.636
20500336,1610612739,1610612748,115.0,107.0,0.513,0.494,1,2005-12-17,22,13,9,0.591,25,14,11,0.56
20500337,1610612763,1610612756,91.0,87.0,0.419,0.375,1,2005-12-17,22,14,8,0.636,23,14,9,0.609
20500338,1610612741,1610612738,118.0,86.0,0.597,0.384,1,2005-12-17,23,12,11,0.522,23,9,14,0.391
20500339,1610612749,1610612762,80.0,88.0,0.3939999999999999,0.493,0,2005-12-17,22,13,9,0.591,24,11,13,0.4579999999999999
20500340,1610612759,1610612758,90.0,89.0,0.456,0.4529999999999999,1,2005-12-17,23,19,4,0.826,24,10,14,0.417
20500332,1610612747,1610612764,97.0,91.0,0.472,0.342,1,2005-12-16,23,13,10,0.565,21,9,12,0.429
20500327,1610612751,1610612743,115.0,106.0,0.471,0.4320000000000001,1,2005-12-16,22,10,12,0.455,24,12,12,0.5
20500322,1610612761,1610612744,98.0,108.0,0.493,0.475,0,2005-12-16,23,4,19,0.174,23,14,9,0.609
20500323,1610612755,1610612748,105.0,112.0,0.455,0.526,0,2005-12-16,24,12,12,0.5,24,14,10,0.583
20500324,1610612737,1610612752,122.0,111.0,0.632,0.483,1,2005-12-16,22,5,17,0.2269999999999999,22,6,16,0.273
20500325,1610612754,1610612762,93.0,83.0,0.412,0.4270000000000001,1,2005-12-16,21,13,8,0.619,23,10,13,0.435
20500326,1610612738,1610612749,96.0,100.0,0.4320000000000001,0.488,0,2005-12-16,22,9,13,0.409,21,13,8,0.619
20500328,1610612765,1610612741,110.0,82.0,0.506,0.4320000000000001,1,2005-12-16,20,17,3,0.85,22,11,11,0.5
20500329,1610612740,1610612756,88.0,101.0,0.452,0.457,0,2005-12-16,23,10,13,0.435,22,14,8,0.636
20500330,1610612742,1610612753,109.0,103.0,0.5,0.494,1,2005-12-16,23,17,6,0.7390000000000001,21,9,12,0.429
20500331,1610612757,1610612760,99.0,111.0,0.591,0.534,0,2005-12-16,22,6,16,0.273,22,10,12,0.455
20500319,1610612739,1610612743,94.0,85.0,0.53,0.3829999999999999,1,2005-12-15,21,12,9,0.5710000000000001,23,12,11,0.522
20500320,1610612750,1610612759,88.0,90.0,0.43,0.461,0,2005-12-15,21,12,9,0.5710000000000001,22,18,4,0.818
20500321,1610612760,1610612745,98.0,104.0,0.42,0.522,0,2005-12-15,21,9,12,0.429,21,9,12,0.429
20500312,1610612765,1610612758,109.0,98.0,0.506,0.5,1,2005-12-14,19,16,3,0.8420000000000001,23,10,13,0.435
20500307,1610612761,1610612741,94.0,105.0,0.413,0.578,0,2005-12-14,22,4,18,0.182,21,11,10,0.524
20500308,1610612755,1610612737,106.0,101.0,0.4320000000000001,0.494,1,2005-12-14,23,12,11,0.522,21,4,17,0.19
20500309,1610612738,1610612754,85.0,71.0,0.451,0.325,1,2005-12-14,21,9,12,0.429,20,12,8,0.6
20500310,1610612751,1610612766,83.0,91.0,0.38,0.43,0,2005-12-14,21,9,12,0.429,23,6,17,0.261
20500311,1610612752,1610612753,90.0,105.0,0.4589999999999999,0.487,0,2005-12-14,21,6,15,0.286,20,9,11,0.45
20500313,1610612749,1610612748,83.0,100.0,0.386,0.4629999999999999,0,2005-12-14,20,12,8,0.6,23,13,10,0.565
20500314,1610612763,1610612747,79.0,94.0,0.429,0.48,0,2005-12-14,21,13,8,0.619,22,12,10,0.545
20500315,1610612740,1610612746,102.0,89.0,0.493,0.465,1,2005-12-14,22,10,12,0.455,22,14,8,0.636
20500316,1610612742,1610612756,102.0,96.0,0.461,0.3979999999999999,1,2005-12-14,22,16,6,0.727,21,13,8,0.619
20500317,1610612762,1610612757,82.0,77.0,0.341,0.375,1,2005-12-14,22,10,12,0.455,21,6,15,0.286
20500318,1610612744,1610612745,105.0,111.0,0.416,0.488,0,2005-12-14,22,13,9,0.591,20,8,12,0.4
20500305,1610612759,1610612746,95.0,87.0,0.447,0.3329999999999999,1,2005-12-13,21,17,4,0.81,21,14,7,0.667
20500300,1610612764,1610612751,94.0,74.0,0.493,0.3939999999999999,1,2005-12-13,20,9,11,0.45,20,9,11,0.45
20500301,1610612739,1610612737,94.0,100.0,0.455,0.436,0,2005-12-13,20,11,9,0.55,20,4,16,0.2
20500302,1610612766,1610612743,85.0,101.0,0.418,0.514,0,2005-12-13,22,5,17,0.2269999999999999,22,12,10,0.545
20500303,1610612750,1610612758,91.0,93.0,0.4320000000000001,0.4579999999999999,0,2005-12-13,20,12,8,0.6,22,10,12,0.455
20500304,1610612741,1610612748,97.0,100.0,0.429,0.4479999999999999,0,2005-12-13,20,10,10,0.5,22,12,10,0.545
20500306,1610612760,1610612744,107.0,110.0,0.374,0.475,0,2005-12-13,20,9,11,0.45,21,13,8,0.619
20500295,1610612755,1610612750,90.0,89.0,0.4429999999999999,0.4270000000000001,1,2005-12-12,22,11,11,0.5,19,12,7,0.632
20500296,1610612752,1610612749,92.0,112.0,0.532,0.5379999999999999,0,2005-12-12,20,6,14,0.3,19,12,7,0.632
20500297,1610612742,1610612747,106.0,109.0,0.466,0.5,0,2005-12-12,21,15,6,0.7140000000000001,21,11,10,0.524
20500298,1610612762,1610612765,92.0,78.0,0.4589999999999999,0.382,1,2005-12-12,21,9,12,0.429,18,15,3,0.833
20500299,1610612756,1610612740,87.0,91.0,0.456,0.429,0,2005-12-12,20,13,7,0.65,21,9,12,0.429
20500291,1610612748,1610612764,104.0,101.0,0.422,0.387,1,2005-12-11,21,11,10,0.524,19,8,11,0.421
20500292,1610612746,1610612765,101.0,109.0,0.494,0.494,0,2005-12-11,20,14,6,0.7,17,15,2,0.882
20500293,1610612758,1610612740,110.0,100.0,0.481,0.4679999999999999,1,2005-12-11,21,9,12,0.429,20,8,12,0.4
20500294,1610612757,1610612745,86.0,100.0,0.38,0.456,0,2005-12-11,20,6,14,0.3,19,7,12,0.368
20500290,1610612746,1610612756,101.0,91.0,0.434,0.422,1,2005-12-10,19,14,5,0.737,19,13,6,0.684
20500280,1610612764,1610612741,111.0,118.0,0.4679999999999999,0.545,0,2005-12-10,18,8,10,0.444,19,10,9,0.526
20500281,1610612737,1610612759,94.0,84.0,0.4679999999999999,0.413,1,2005-12-10,19,3,16,0.158,20,16,4,0.8
20500282,1610612753,1610612743,94.0,83.0,0.4429999999999999,0.406,1,2005-12-10,19,8,11,0.421,21,11,10,0.524
20500283,1610612751,1610612755,95.0,107.0,0.412,0.569,0,2005-12-10,19,9,10,0.474,21,10,11,0.476
20500284,1610612766,1610612761,103.0,111.0,0.4270000000000001,0.447,0,2005-12-10,21,5,16,0.238,21,4,17,0.19
20500285,1610612754,1610612763,80.0,66.0,0.435,0.3379999999999999,1,2005-12-10,19,12,7,0.632,20,13,7,0.65
20500286,1610612750,1610612747,95.0,82.0,0.487,0.4429999999999999,1,2005-12-10,18,12,6,0.667,20,10,10,0.5
20500287,1610612749,1610612739,111.0,106.0,0.4579999999999999,0.544,1,2005-12-10,18,11,7,0.611,19,11,8,0.579
20500288,1610612742,1610612738,103.0,94.0,0.471,0.5329999999999999,1,2005-12-10,20,15,5,0.75,20,8,12,0.4
20500289,1610612760,1610612758,104.0,123.0,0.4370000000000001,0.581,0,2005-12-10,19,9,10,0.474,20,8,12,0.4
20500272,1610612739,1610612751,100.0,109.0,0.43,0.556,0,2005-12-09,18,11,7,0.611,18,9,9,0.5
20500278,1610612757,1610612740,98.0,95.0,0.488,0.486,1,2005-12-09,19,6,13,0.316,19,8,11,0.421
20500270,1610612755,1610612766,119.0,115.0,0.473,0.522,1,2005-12-09,20,9,11,0.45,20,5,15,0.25
20500271,1610612748,1610612743,92.0,100.0,0.421,0.407,0,2005-12-09,20,10,10,0.5,20,11,9,0.55
20500273,1610612763,1610612742,83.0,90.0,0.3429999999999999,0.44,0,2005-12-09,19,13,6,0.684,19,14,5,0.737
20500274,1610612741,1610612747,80.0,93.0,0.3879999999999999,0.452,0,2005-12-09,18,9,9,0.5,19,10,9,0.526
20500275,1610612759,1610612738,101.0,89.0,0.494,0.4589999999999999,1,2005-12-09,19,16,3,0.8420000000000001,19,8,11,0.421
20500276,1610612762,1610612760,90.0,106.0,0.4379999999999999,0.476,0,2005-12-09,20,8,12,0.4,18,9,9,0.5
20500277,1610612756,1610612752,85.0,81.0,0.417,0.436,1,2005-12-09,18,13,5,0.722,19,6,13,0.316
20500279,1610612744,1610612765,103.0,106.0,0.451,0.513,0,2005-12-09,20,12,8,0.6,16,14,2,0.875
20500268,1610612754,1610612764,111.0,87.0,0.59,0.341,1,2005-12-08,18,11,7,0.611,17,8,9,0.471
20500269,1610612758,1610612745,95.0,106.0,0.493,0.486,0,2005-12-08,19,7,12,0.368,18,6,12,0.3329999999999999
20500266,1610612746,1610612752,84.0,79.0,0.392,0.365,1,2005-12-07,18,13,5,0.722,18,6,12,0.3329999999999999
20500262,1610612740,1610612738,87.0,101.0,0.416,0.479,0,2005-12-07,18,8,10,0.444,18,8,10,0.444
20500259,1610612755,1610612749,85.0,88.0,0.425,0.429,0,2005-12-07,19,8,11,0.421,17,10,7,0.588
20500258,1610612761,1610612747,91.0,102.0,0.41,0.5379999999999999,0,2005-12-07,20,3,17,0.15,18,9,9,0.5
20500260,1610612753,1610612741,93.0,102.0,0.4589999999999999,0.474,0,2005-12-07,18,7,11,0.389,17,9,8,0.529
20500261,1610612766,1610612751,84.0,97.0,0.381,0.494,0,2005-12-07,19,5,14,0.263,17,8,9,0.471
20500263,1610612759,1610612748,98.0,84.0,0.469,0.359,1,2005-12-07,18,15,3,0.833,19,10,9,0.526
20500264,1610612762,1610612737,95.0,83.0,0.521,0.4679999999999999,1,2005-12-07,19,8,11,0.421,18,2,16,0.111
20500265,1610612757,1610612750,74.0,84.0,0.384,0.4379999999999999,0,2005-12-07,18,5,13,0.278,17,11,6,0.647
20500267,1610612744,1610612756,110.0,118.0,0.478,0.4429999999999999,0,2005-12-07,19,12,7,0.632,17,12,5,0.706
20500249,1610612764,1610612761,119.0,111.0,0.5,0.476,1,2005-12-06,16,8,8,0.5,19,3,16,0.158
20500250,1610612754,1610612742,75.0,84.0,0.3429999999999999,0.4639999999999999,0,2005-12-06,17,10,7,0.588,18,13,5,0.722
20500251,1610612749,1610612747,92.0,111.0,0.481,0.483,0,2005-12-06,16,9,7,0.563,17,8,9,0.471
20500252,1610612763,1610612740,89.0,73.0,0.455,0.3879999999999999,1,2005-12-06,18,13,5,0.722,17,8,9,0.471
20500253,1610612745,1610612738,91.0,73.0,0.447,0.3429999999999999,1,2005-12-06,17,5,12,0.294,17,7,10,0.412
20500254,1610612743,1610612737,125.0,116.0,0.5870000000000001,0.489,1,2005-12-06,19,10,9,0.526,17,2,15,0.118
20500255,1610612756,1610612757,130.0,85.0,0.556,0.381,1,2005-12-06,16,11,5,0.688,17,5,12,0.294
20500256,1610612758,1610612739,97.0,102.0,0.4679999999999999,0.493,0,2005-12-06,18,7,11,0.389,17,11,6,0.647
20500257,1610612760,1610612752,101.0,104.0,0.425,0.493,0,2005-12-06,17,8,9,0.471,17,6,11,0.353
20500246,1610612741,1610612742,94.0,102.0,0.4589999999999999,0.481,0,2005-12-05,16,8,8,0.5,17,12,5,0.706
20500245,1610612753,1610612759,85.0,110.0,0.357,0.5489999999999999,0,2005-12-05,17,7,10,0.412,17,14,3,0.8240000000000001
20500247,1610612762,1610612750,77.0,91.0,0.377,0.447,0,2005-12-05,18,7,11,0.389,16,10,6,0.625
20500248,1610612746,1610612748,99.0,89.0,0.494,0.402,1,2005-12-05,17,12,5,0.706,18,10,8,0.556
20500239,1610612752,1610612738,99.0,102.0,0.4370000000000001,0.429,0,2005-12-04,16,5,11,0.313,16,7,9,0.4379999999999999
20500240,1610612756,1610612737,112.0,94.0,0.476,0.368,1,2005-12-04,15,10,5,0.667,16,2,14,0.125
20500243,1610612760,1610612754,107.0,102.0,0.4679999999999999,0.5329999999999999,1,2005-12-04,16,8,8,0.5,16,10,6,0.625
20500241,1610612758,1610612750,77.0,85.0,0.421,0.4320000000000001,0,2005-12-04,17,7,10,0.412,15,9,6,0.6
20500242,1610612757,1610612762,93.0,98.0,0.4270000000000001,0.53,0,2005-12-04,16,5,11,0.313,17,7,10,0.412
20500244,1610612747,1610612766,99.0,98.0,0.424,0.494,1,2005-12-04,16,7,9,0.4379999999999999,18,5,13,0.278
20500234,1610612745,1610612763,75.0,90.0,0.456,0.4579999999999999,0,2005-12-03,16,4,12,0.25,17,12,5,0.706
20500231,1610612751,1610612761,82.0,95.0,0.408,0.433,0,2005-12-03,16,7,9,0.4379999999999999,18,3,15,0.1669999999999999
20500232,1610612741,1610612765,79.0,92.0,0.39,0.423,0,2005-12-03,15,8,7,0.5329999999999999,15,13,2,0.867
20500233,1610612749,1610612753,104.0,84.0,0.5660000000000001,0.435,1,2005-12-03,15,9,6,0.6,16,7,9,0.4379999999999999
20500235,1610612742,1610612740,97.0,88.0,0.486,0.44,1,2005-12-03,16,11,5,0.688,16,8,8,0.5
20500236,1610612759,1610612755,100.0,91.0,0.482,0.408,1,2005-12-03,16,13,3,0.813,18,8,10,0.444
20500237,1610612743,1610612748,101.0,99.0,0.461,0.456,1,2005-12-03,18,9,9,0.5,17,10,7,0.588
20500238,1610612746,1610612739,102.0,90.0,0.519,0.348,1,2005-12-03,16,11,5,0.688,16,10,6,0.625
20500224,1610612740,1610612755,88.0,86.0,0.4320000000000001,0.41,1,2005-12-02,15,8,7,0.5329999999999999,17,8,9,0.471
20500219,1610612764,1610612749,102.0,105.0,0.513,0.494,0,2005-12-02,15,7,8,0.467,14,8,6,0.5710000000000001
20500220,1610612737,1610612761,101.0,102.0,0.551,0.488,0,2005-12-02,15,2,13,0.133,17,2,15,0.118
20500221,1610612738,1610612741,102.0,106.0,0.471,0.412,0,2005-12-02,15,6,9,0.4,14,8,6,0.5710000000000001
20500222,1610612765,1610612752,106.0,98.0,0.544,0.451,1,2005-12-02,14,12,2,0.857,15,5,10,0.3329999999999999
20500223,1610612763,1610612753,91.0,69.0,0.525,0.3779999999999999,1,2005-12-02,16,11,5,0.688,15,7,8,0.467
20500225,1610612756,1610612743,102.0,97.0,0.452,0.43,1,2005-12-02,14,9,5,0.643,17,8,9,0.471
20500226,1610612758,1610612748,87.0,98.0,0.422,0.486,0,2005-12-02,16,7,9,0.4379999999999999,16,10,6,0.625
20500227,1610612757,1610612754,78.0,98.0,0.4029999999999999,0.48,0,2005-12-02,15,5,10,0.3329999999999999,15,10,5,0.667
20500228,1610612747,1610612750,108.0,113.0,0.5429999999999999,0.5529999999999999,0,2005-12-02,15,6,9,0.4,14,8,6,0.5710000000000001
20500229,1610612744,1610612766,107.0,100.0,0.416,0.3329999999999999,1,2005-12-02,18,12,6,0.667,17,5,12,0.294
20500230,1610612760,1610612739,115.0,108.0,0.518,0.481,1,2005-12-02,15,7,8,0.467,15,10,5,0.667
20500217,1610612742,1610612759,90.0,92.0,0.4029999999999999,0.467,0,2005-12-01,15,10,5,0.667,15,12,3,0.8
20500218,1610612762,1610612747,101.0,105.0,0.36,0.425,0,2005-12-01,16,6,10,0.375,14,6,8,0.429
20500214,1610612756,1610612754,109.0,91.0,0.467,0.429,1,2005-11-30,13,8,5,0.615,14,9,5,0.643
20500216,1610612744,1610612758,113.0,106.0,0.446,0.5,1,2005-11-30,17,11,6,0.647,15,7,8,0.467
20500206,1610612761,1610612763,66.0,92.0,0.347,0.507,0,2005-11-30,16,1,15,0.063,15,10,5,0.667
20500207,1610612764,1610612757,96.0,89.0,0.375,0.4579999999999999,1,2005-11-30,14,7,7,0.5,14,5,9,0.357
20500208,1610612737,1610612748,74.0,96.0,0.4,0.5329999999999999,0,2005-11-30,14,2,12,0.143,15,9,6,0.6
20500209,1610612739,1610612746,112.0,105.0,0.407,0.407,1,2005-11-30,14,10,4,0.7140000000000001,15,10,5,0.667
20500210,1610612738,1610612755,110.0,103.0,0.4479999999999999,0.409,1,2005-11-30,14,6,8,0.429,16,8,8,0.5
20500211,1610612751,1610612765,83.0,93.0,0.407,0.452,0,2005-11-30,15,7,8,0.467,13,11,2,0.846
20500212,1610612752,1610612741,109.0,101.0,0.462,0.461,1,2005-11-30,14,5,9,0.357,13,7,6,0.5379999999999999
20500213,1610612743,1610612740,95.0,102.0,0.4370000000000001,0.419,0,2005-11-30,16,8,8,0.5,14,7,7,0.5
20500215,1610612760,1610612766,104.0,94.0,0.471,0.44,1,2005-11-30,14,6,8,0.429,16,5,11,0.313
20500198,1610612755,1610612757,107.0,83.0,0.447,0.444,1,2005-11-29,15,8,7,0.5329999999999999,13,5,8,0.385
20500199,1610612749,1610612742,113.0,111.0,0.488,0.477,1,2005-11-29,13,7,6,0.5379999999999999,14,10,4,0.7140000000000001
20500200,1610612750,1610612746,84.0,93.0,0.392,0.482,0,2005-11-29,13,7,6,0.5379999999999999,14,10,4,0.7140000000000001
20500201,1610612741,1610612753,85.0,76.0,0.43,0.413,1,2005-11-29,12,7,5,0.583,14,7,7,0.5
20500202,1610612745,1610612737,100.0,85.0,0.449,0.395,1,2005-11-29,15,4,11,0.267,13,2,11,0.154
20500203,1610612759,1610612747,90.0,84.0,0.474,0.351,1,2005-11-29,14,11,3,0.7859999999999999,13,5,8,0.385
20500204,1610612762,1610612754,60.0,84.0,0.3329999999999999,0.405,0,2005-11-29,15,6,9,0.4,13,9,4,0.6920000000000001
20500205,1610612758,1610612766,110.0,92.0,0.5,0.406,1,2005-11-29,14,7,7,0.5,15,5,10,0.3329999999999999
20500193,1610612761,1610612742,91.0,93.0,0.43,0.4429999999999999,0,2005-11-28,15,1,14,0.067,13,10,3,0.769
20500194,1610612738,1610612753,83.0,87.0,0.429,0.449,0,2005-11-28,13,5,8,0.385,13,7,6,0.5379999999999999
20500195,1610612748,1610612752,107.0,94.0,0.473,0.476,1,2005-11-28,14,8,6,0.5710000000000001,13,4,9,0.308
20500196,1610612743,1610612751,92.0,101.0,0.377,0.4589999999999999,0,2005-11-28,15,8,7,0.5329999999999999,14,7,7,0.5
20500197,1610612744,1610612740,99.0,83.0,0.4429999999999999,0.419,1,2005-11-28,16,10,6,0.625,13,6,7,0.462
20500191,1610612746,1610612754,92.0,97.0,0.457,0.405,0,2005-11-27,13,9,4,0.6920000000000001,12,8,4,0.667
20500190,1610612737,1610612757,75.0,77.0,0.4,0.444,0,2005-11-27,12,2,10,0.1669999999999999,12,5,7,0.417
20500192,1610612747,1610612751,96.0,102.0,0.337,0.442,0,2005-11-27,12,5,7,0.417,13,6,7,0.462
20500189,1610612744,1610612761,117.0,91.0,0.5660000000000001,0.43,1,2005-11-26,15,9,6,0.6,14,1,13,0.071
20500182,1610612752,1610612755,105.0,102.0,0.4,0.4320000000000001,1,2005-11-26,12,4,8,0.3329999999999999,14,7,7,0.5
20500181,1610612760,1610612740,99.0,105.0,0.419,0.465,0,2005-11-26,13,5,8,0.385,12,6,6,0.5
20500183,1610612753,1610612748,80.0,77.0,0.351,0.321,1,2005-11-26,12,6,6,0.5,13,7,6,0.5379999999999999
20500184,1610612766,1610612764,100.0,82.0,0.455,0.395,1,2005-11-26,14,5,9,0.357,13,6,7,0.462
20500185,1610612739,1610612750,85.0,89.0,0.318,0.493,0,2005-11-26,13,9,4,0.6920000000000001,12,7,5,0.583
20500186,1610612745,1610612741,89.0,94.0,0.368,0.479,0,2005-11-26,14,3,11,0.214,11,6,5,0.545
20500187,1610612742,1610612763,92.0,112.0,0.4370000000000001,0.5539999999999999,0,2005-11-26,12,9,3,0.75,14,9,5,0.643
20500188,1610612749,1610612765,76.0,85.0,0.395,0.371,0,2005-11-26,12,6,6,0.5,12,10,2,0.833
20500179,1610612758,1610612761,106.0,104.0,0.5,0.512,1,2005-11-25,13,6,7,0.462,13,1,12,0.077
20500169,1610612753,1610612757,104.0,89.0,0.529,0.447,1,2005-11-25,11,5,6,0.455,11,4,7,0.364
20500171,1610612738,1610612766,90.0,89.0,0.456,0.439,1,2005-11-25,12,5,7,0.417,13,4,9,0.308
20500170,1610612754,1610612737,85.0,87.0,0.407,0.356,0,2005-11-25,11,7,4,0.636,11,2,9,0.182
20500172,1610612748,1610612742,90.0,103.0,0.4379999999999999,0.5,0,2005-11-25,12,7,5,0.583,11,9,2,0.818
20500173,1610612765,1610612764,114.0,120.0,0.37,0.36,0,2005-11-25,11,9,2,0.818,12,6,6,0.5
20500174,1610612763,1610612745,86.0,81.0,0.41,0.4,1,2005-11-25,13,8,5,0.615,13,3,10,0.231
20500175,1610612750,1610612749,99.0,91.0,0.529,0.434,1,2005-11-25,11,6,5,0.545,11,6,5,0.545
20500176,1610612759,1610612741,99.0,106.0,0.45,0.489,0,2005-11-25,13,10,3,0.769,10,5,5,0.5
20500177,1610612743,1610612746,105.0,95.0,0.461,0.434,1,2005-11-25,14,8,6,0.5710000000000001,12,9,3,0.75
20500178,1610612762,1610612744,90.0,94.0,0.455,0.392,0,2005-11-25,14,6,8,0.429,14,8,6,0.5710000000000001
20500180,1610612756,1610612751,92.0,81.0,0.422,0.395,1,2005-11-25,12,7,5,0.583,12,5,7,0.417
20500167,1610612754,1610612739,98.0,76.0,0.494,0.377,1,2005-11-24,10,7,3,0.7,12,9,3,0.75
20500168,1610612747,1610612760,108.0,96.0,0.44,0.418,1,2005-11-24,11,5,6,0.455,12,5,7,0.417
20500156,1610612737,1610612738,120.0,117.0,0.556,0.5479999999999999,1,2005-11-23,10,1,9,0.1,11,4,7,0.364
20500157,1610612753,1610612764,91.0,83.0,0.474,0.392,1,2005-11-23,10,4,6,0.4,11,5,6,0.455
20500158,1610612766,1610612752,108.0,95.0,0.4429999999999999,0.484,1,2005-11-23,12,4,8,0.3329999999999999,11,3,8,0.273
20500159,1610612748,1610612757,100.0,79.0,0.494,0.4379999999999999,1,2005-11-23,11,7,4,0.636,10,4,6,0.4
20500160,1610612765,1610612743,114.0,89.0,0.531,0.4,1,2005-11-23,10,9,1,0.9,13,7,6,0.5379999999999999
20500161,1610612745,1610612756,88.0,100.0,0.413,0.452,0,2005-11-23,12,3,9,0.25,11,6,5,0.545
20500162,1610612749,1610612755,108.0,97.0,0.407,0.444,1,2005-11-23,10,6,4,0.6,13,7,6,0.5379999999999999
20500163,1610612740,1610612750,84.0,80.0,0.363,0.392,1,2005-11-23,11,5,6,0.455,10,5,5,0.5
20500164,1610612758,1610612751,114.0,105.0,0.514,0.5379999999999999,1,2005-11-23,12,5,7,0.417,11,5,6,0.455
20500165,1610612746,1610612761,103.0,100.0,0.574,0.379,1,2005-11-23,11,9,2,0.818,12,1,11,0.083
20500166,1610612744,1610612759,89.0,113.0,0.377,0.5489999999999999,0,2005-11-23,13,7,6,0.5379999999999999,12,10,2,0.833
20500154,1610612756,1610612761,90.0,82.0,0.425,0.3979999999999999,1,2005-11-22,10,5,5,0.5,11,1,10,0.091
20500150,1610612764,1610612743,105.0,108.0,0.407,0.457,0,2005-11-22,10,5,5,0.5,12,7,5,0.583
20500151,1610612739,1610612738,115.0,93.0,0.447,0.412,1,2005-11-22,11,9,2,0.818,10,4,6,0.4
20500152,1610612763,1610612757,87.0,95.0,0.389,0.466,0,2005-11-22,12,7,5,0.583,9,4,5,0.444
20500153,1610612742,1610612745,102.0,93.0,0.472,0.449,1,2005-11-22,10,8,2,0.8,11,3,8,0.273
20500155,1610612760,1610612762,87.0,93.0,0.382,0.471,0,2005-11-22,11,5,6,0.455,13,6,7,0.462
20500146,1610612755,1610612740,103.0,91.0,0.481,0.397,1,2005-11-21,12,7,5,0.583,10,4,6,0.4
20500147,1610612762,1610612749,100.0,80.0,0.409,0.406,1,2005-11-21,12,5,7,0.417,9,5,4,0.556
20500148,1610612758,1610612759,93.0,96.0,0.3929999999999999,0.4589999999999999,0,2005-11-21,11,4,7,0.364,11,9,2,0.818
20500149,1610612744,1610612751,100.0,97.0,0.4579999999999999,0.4270000000000001,1,2005-11-21,12,7,5,0.583,10,5,5,0.5
20500139,1610612752,1610612757,103.0,92.0,0.493,0.55,1,2005-11-20,10,3,7,0.3,8,3,5,0.375
20500140,1610612761,1610612748,107.0,94.0,0.451,0.446,1,2005-11-20,10,1,9,0.1,10,6,4,0.6
20500141,1610612746,1610612744,113.0,101.0,0.513,0.389,1,2005-11-20,10,8,2,0.8,11,6,5,0.545
20500142,1610612754,1610612745,85.0,74.0,0.417,0.408,1,2005-11-20,9,6,3,0.667,10,3,7,0.3
20500143,1610612743,1610612763,99.0,83.0,0.4479999999999999,0.3720000000000001,1,2005-11-20,11,6,5,0.545,11,7,4,0.636
20500144,1610612760,1610612758,106.0,104.0,0.476,0.556,1,2005-11-20,10,5,5,0.5,10,4,6,0.4
20500145,1610612747,1610612741,93.0,96.0,0.423,0.4270000000000001,0,2005-11-20,10,4,6,0.4,9,4,5,0.444
20500132,1610612755,1610612739,120.0,123.0,0.527,0.494,0,2005-11-19,11,6,5,0.545,10,8,2,0.8
20500133,1610612753,1610612740,95.0,98.0,0.507,0.547,0,2005-11-19,9,3,6,0.3329999999999999,9,4,5,0.444
20500134,1610612751,1610612764,89.0,83.0,0.442,0.3779999999999999,1,2005-11-19,9,5,4,0.556,9,5,4,0.556
20500135,1610612750,1610612766,102.0,89.0,0.519,0.37,1,2005-11-19,9,5,4,0.556,11,3,8,0.273
20500136,1610612742,1610612765,119.0,82.0,0.5920000000000001,0.413,1,2005-11-19,9,7,2,0.778,9,8,1,0.889
20500137,1610612759,1610612756,97.0,91.0,0.407,0.451,1,2005-11-19,10,8,2,0.8,9,4,5,0.444
20500138,1610612762,1610612763,72.0,80.0,0.37,0.409,0,2005-11-19,11,4,7,0.364,10,7,3,0.7
20500130,1610612747,1610612746,91.0,97.0,0.3879999999999999,0.444,0,2005-11-18,9,4,5,0.444,9,7,2,0.778
20500120,1610612739,1610612753,102.0,84.0,0.422,0.435,1,2005-11-18,9,7,2,0.778,8,3,5,0.375
20500121,1610612754,1610612766,93.0,85.0,0.418,0.376,1,2005-11-18,8,5,3,0.625,10,3,7,0.3
20500122,1610612738,1610612761,100.0,93.0,0.486,0.3929999999999999,1,2005-11-18,9,4,5,0.444,9,0,9,0.0
20500123,1610612748,1610612755,106.0,96.0,0.5,0.436,1,2005-11-18,9,6,3,0.667,10,6,4,0.6
20500124,1610612740,1610612737,95.0,92.0,0.3979999999999999,0.473,1,2005-11-18,8,3,5,0.375,9,0,9,0.0
20500125,1610612743,1610612752,95.0,86.0,0.461,0.376,1,2005-11-18,10,5,5,0.5,9,2,7,0.222
20500126,1610612756,1610612762,102.0,94.0,0.488,0.42,1,2005-11-18,8,4,4,0.5,10,4,6,0.4
20500127,1610612745,1610612765,70.0,78.0,0.386,0.3879999999999999,0,2005-11-18,9,3,6,0.3329999999999999,8,8,0,1.0
20500128,1610612758,1610612749,103.0,82.0,0.513,0.369,1,2005-11-18,9,4,5,0.444,8,5,3,0.625
20500129,1610612757,1610612744,80.0,91.0,0.424,0.424,0,2005-11-18,7,3,4,0.429,10,6,4,0.6
20500131,1610612760,1610612741,98.0,84.0,0.481,0.376,1,2005-11-18,9,4,5,0.444,8,3,5,0.375
20500118,1610612742,1610612737,87.0,78.0,0.395,0.382,1,2005-11-17,8,6,2,0.75,8,0,8,0.0
20500119,1610612750,1610612764,109.0,98.0,0.535,0.4629999999999999,1,2005-11-17,8,4,4,0.5,8,5,3,0.625
20500117,1610612759,1610612745,86.0,80.0,0.461,0.389,1,2005-11-17,9,7,2,0.778,8,3,5,0.375
20500109,1610612761,1610612755,115.0,121.0,0.542,0.544,0,2005-11-16,8,0,8,0.0,9,6,3,0.667
20500110,1610612738,1610612760,100.0,113.0,0.519,0.506,0,2005-11-16,8,3,5,0.375,8,3,5,0.375
20500111,1610612766,1610612754,122.0,90.0,0.526,0.5,1,2005-11-16,9,3,6,0.3329999999999999,7,4,3,0.5710000000000001
20500112,1610612740,1610612743,81.0,91.0,0.3670000000000001,0.479,0,2005-11-16,7,2,5,0.286,9,4,5,0.444
20500113,1610612756,1610612763,103.0,115.0,0.476,0.524,0,2005-11-16,7,3,4,0.429,9,6,3,0.667
20500114,1610612747,1610612752,97.0,92.0,0.447,0.449,1,2005-11-16,8,4,4,0.5,8,2,6,0.25
20500115,1610612757,1610612741,96.0,93.0,0.515,0.391,1,2005-11-16,6,3,3,0.5,7,3,4,0.429
20500116,1610612744,1610612749,87.0,90.0,0.3670000000000001,0.3929999999999999,0,2005-11-16,9,5,4,0.556,7,5,2,0.7140000000000001
20500098,1610612755,1610612761,104.0,92.0,0.46,0.419,1,2005-11-15,8,5,3,0.625,7,0,7,0.0
20500099,1610612753,1610612766,85.0,77.0,0.417,0.38,1,2005-11-15,7,3,4,0.429,8,2,6,0.25
20500100,1610612739,1610612764,114.0,99.0,0.494,0.423,1,2005-11-15,8,6,2,0.75,7,5,2,0.7140000000000001
20500101,1610612751,1610612760,109.0,99.0,0.479,0.4270000000000001,1,2005-11-15,8,4,4,0.5,7,2,5,0.286
20500102,1610612748,1610612740,109.0,102.0,0.44,0.441,1,2005-11-15,8,5,3,0.625,6,2,4,0.3329999999999999
20500103,1610612765,1610612738,115.0,100.0,0.505,0.531,1,2005-11-15,7,7,0,1.0,7,3,4,0.429
20500104,1610612750,1610612745,89.0,94.0,0.423,0.4639999999999999,0,2005-11-15,7,3,4,0.429,7,3,4,0.429
20500105,1610612742,1610612743,83.0,80.0,0.446,0.381,1,2005-11-15,7,5,2,0.7140000000000001,8,3,5,0.375
20500106,1610612759,1610612737,103.0,79.0,0.524,0.411,1,2005-11-15,8,6,2,0.75,7,0,7,0.0
20500107,1610612758,1610612762,119.0,83.0,0.547,0.392,1,2005-11-15,8,3,5,0.375,9,4,5,0.444
20500108,1610612746,1610612749,109.0,85.0,0.479,0.39,1,2005-11-15,8,6,2,0.75,6,4,2,0.667
20500095,1610612763,1610612747,85.0,73.0,0.3779999999999999,0.325,1,2005-11-14,8,5,3,0.625,7,3,4,0.429
20500096,1610612762,1610612752,62.0,73.0,0.293,0.422,0,2005-11-14,8,4,4,0.5,7,2,5,0.286
20500097,1610612744,1610612741,100.0,82.0,0.467,0.337,1,2005-11-14,8,5,3,0.625,6,3,3,0.5
20500090,1610612738,1610612745,102.0,82.0,0.4589999999999999,0.375,1,2005-11-13,6,3,3,0.5,6,2,4,0.3329999999999999
20500089,1610612761,1610612760,121.0,126.0,0.469,0.506,0,2005-11-13,6,0,6,0.0,6,2,4,0.3329999999999999
20500091,1610612755,1610612746,113.0,108.0,0.476,0.4679999999999999,1,2005-11-13,7,4,3,0.5710000000000001,7,5,2,0.7140000000000001
20500092,1610612753,1610612739,100.0,108.0,0.4529999999999999,0.512,0,2005-11-13,6,2,4,0.3329999999999999,7,5,2,0.7140000000000001
20500093,1610612743,1610612750,102.0,91.0,0.481,0.4320000000000001,1,2005-11-13,7,3,4,0.429,6,3,3,0.5
20500094,1610612758,1610612752,95.0,105.0,0.418,0.539,0,2005-11-13,7,2,5,0.286,6,1,5,0.1669999999999999
20500081,1610612764,1610612759,110.0,95.0,0.551,0.41,1,2005-11-12,6,5,1,0.833,7,5,2,0.7140000000000001
20500082,1610612737,1610612763,84.0,85.0,0.3979999999999999,0.4029999999999999,0,2005-11-12,6,0,6,0.0,7,4,3,0.5710000000000001
20500083,1610612748,1610612766,108.0,99.0,0.568,0.391,1,2005-11-12,7,4,3,0.5710000000000001,7,2,5,0.286
20500084,1610612751,1610612745,91.0,99.0,0.3720000000000001,0.465,0,2005-11-12,7,3,4,0.429,5,2,3,0.4
20500085,1610612740,1610612742,103.0,109.0,0.557,0.514,0,2005-11-12,5,2,3,0.4,6,4,2,0.667
20500086,1610612741,1610612762,103.0,98.0,0.544,0.461,1,2005-11-12,5,3,2,0.6,7,4,3,0.5710000000000001
20500087,1610612749,1610612754,103.0,102.0,0.3929999999999999,0.452,1,2005-11-12,5,4,1,0.8,6,4,2,0.667
20500088,1610612756,1610612744,101.0,86.0,0.424,0.36,1,2005-11-12,6,3,3,0.5,7,4,3,0.5710000000000001
20500072,1610612764,1610612760,137.0,96.0,0.585,0.397,1,2005-11-11,5,4,1,0.8,5,1,4,0.2
20500079,1610612744,1610612752,86.0,84.0,0.387,0.434,1,2005-11-11,6,4,2,0.667,5,0,5,0.0
20500071,1610612761,1610612762,84.0,99.0,0.426,0.507,0,2005-11-11,5,0,5,0.0,6,4,2,0.667
20500073,1610612754,1610612751,102.0,90.0,0.522,0.4270000000000001,1,2005-11-11,5,4,1,0.8,6,3,3,0.5
20500074,1610612738,1610612759,82.0,103.0,0.4429999999999999,0.563,0,2005-11-11,5,2,3,0.4,6,5,1,0.833
20500075,1610612766,1610612742,88.0,98.0,0.358,0.4529999999999999,0,2005-11-11,6,2,4,0.3329999999999999,5,3,2,0.6
20500076,1610612739,1610612763,89.0,70.0,0.466,0.36,1,2005-11-11,6,4,2,0.667,6,3,3,0.5
20500077,1610612755,1610612747,85.0,81.0,0.429,0.381,1,2005-11-11,6,3,3,0.5,6,3,3,0.5
20500078,1610612758,1610612743,101.0,85.0,0.522,0.356,1,2005-11-11,6,2,4,0.3329999999999999,6,2,4,0.3329999999999999
20500080,1610612757,1610612765,81.0,84.0,0.4920000000000001,0.4320000000000001,0,2005-11-11,5,2,3,0.4,6,6,0,1.0
20500069,1610612748,1610612745,88.0,84.0,0.436,0.421,1,2005-11-10,6,3,3,0.5,4,1,3,0.25
20500068,1610612737,1610612746,95.0,102.0,0.407,0.48,0,2005-11-10,5,0,5,0.0,6,5,1,0.833
20500070,1610612756,1610612765,104.0,111.0,0.477,0.5379999999999999,0,2005-11-10,5,2,3,0.4,5,5,0,1.0
20500056,1610612755,1610612742,112.0,97.0,0.518,0.474,1,2005-11-09,5,2,3,0.4,4,2,2,0.5
20500057,1610612764,1610612746,97.0,102.0,0.3720000000000001,0.5,0,2005-11-09,4,3,1,0.75,5,4,1,0.8
20500058,1610612739,1610612760,112.0,85.0,0.5,0.41,1,2005-11-09,5,3,2,0.6,4,1,3,0.25
20500059,1610612738,1610612763,99.0,98.0,0.59,0.514,1,2005-11-09,4,2,2,0.5,5,3,2,0.6
20500060,1610612751,1610612762,91.0,83.0,0.493,0.3779999999999999,1,2005-11-09,5,3,2,0.6,5,3,2,0.6
20500061,1610612766,1610612759,86.0,94.0,0.411,0.493,0,2005-11-09,5,2,3,0.4,5,4,1,0.8
20500062,1610612754,1610612748,95.0,90.0,0.4270000000000001,0.4589999999999999,1,2005-11-09,4,3,1,0.75,5,2,3,0.4
20500063,1610612740,1610612753,83.0,88.0,0.442,0.444,0,2005-11-09,4,2,2,0.5,5,2,3,0.4
20500064,1610612750,1610612747,88.0,74.0,0.447,0.41,1,2005-11-09,5,3,2,0.6,5,3,2,0.6
20500065,1610612741,1610612744,85.0,84.0,0.4629999999999999,0.337,1,2005-11-09,4,2,2,0.5,5,3,2,0.6
20500066,1610612757,1610612752,95.0,83.0,0.446,0.3939999999999999,1,2005-11-09,4,2,2,0.5,4,0,4,0.0
20500067,1610612743,1610612758,107.0,91.0,0.477,0.3829999999999999,1,2005-11-09,5,2,3,0.4,5,1,4,0.2
20500051,1610612737,1610612747,97.0,103.0,0.493,0.521,0,2005-11-08,4,0,4,0.0,4,3,1,0.75
20500052,1610612749,1610612744,103.0,110.0,0.479,0.5,0,2005-11-08,4,3,1,0.75,4,3,1,0.75
20500053,1610612763,1610612760,94.0,69.0,0.493,0.3289999999999999,1,2005-11-08,4,3,1,0.75,3,1,2,0.3329999999999999
20500054,1610612745,1610612753,74.0,76.0,0.371,0.3779999999999999,0,2005-11-08,3,1,2,0.3329999999999999,4,1,3,0.25
20500055,1610612758,1610612765,88.0,102.0,0.462,0.506,0,2005-11-08,4,1,3,0.25,4,4,0,1.0
20500050,1610612741,1610612759,95.0,104.0,0.396,0.4529999999999999,0,2005-11-07,3,1,2,0.3329999999999999,4,3,1,0.75
20500046,1610612761,1610612739,93.0,105.0,0.494,0.486,0,2005-11-07,4,0,4,0.0,4,2,2,0.5
20500047,1610612766,1610612762,91.0,95.0,0.348,0.447,0,2005-11-07,4,2,2,0.5,4,3,1,0.75
20500048,1610612748,1610612751,90.0,89.0,0.486,0.447,1,2005-11-07,4,2,2,0.5,4,2,2,0.5
20500049,1610612750,1610612746,93.0,78.0,0.528,0.4,1,2005-11-07,4,2,2,0.5,4,3,1,0.75
20500043,1610612752,1610612744,81.0,83.0,0.4,0.397,0,2005-11-06,3,0,3,0.0,3,2,1,0.667
20500044,1610612756,1610612758,117.0,118.0,0.5579999999999999,0.444,0,2005-11-06,4,2,2,0.5,3,1,2,0.3329999999999999
20500045,1610612747,1610612743,112.0,92.0,0.512,0.423,1,2005-11-06,3,2,1,0.667,4,1,3,0.25
20500031,1610612764,1610612753,87.0,79.0,0.408,0.313,1,2005-11-05,3,3,0,1.0,3,0,3,0.0
20500032,1610612751,1610612741,100.0,99.0,0.405,0.422,1,2005-11-05,3,2,1,0.667,2,1,1,0.5
20500033,1610612766,1610612738,107.0,105.0,0.43,0.4529999999999999,1,2005-11-05,3,2,1,0.667,3,1,2,0.3329999999999999
20500034,1610612765,1610612761,117.0,84.0,0.483,0.416,1,2005-11-05,3,3,0,1.0,3,0,3,0.0
20500035,1610612754,1610612755,109.0,111.0,0.506,0.5539999999999999,0,2005-11-05,3,2,1,0.667,4,1,3,0.25
20500036,1610612763,1610612739,113.0,106.0,0.5760000000000001,0.46,1,2005-11-05,3,2,1,0.667,3,1,2,0.3329999999999999
20500037,1610612749,1610612748,105.0,100.0,0.494,0.487,1,2005-11-05,3,3,0,1.0,3,1,2,0.3329999999999999
20500038,1610612745,1610612740,84.0,91.0,0.351,0.395,0,2005-11-05,2,1,1,0.5,3,2,1,0.667
20500039,1610612742,1610612759,103.0,84.0,0.506,0.408,1,2005-11-05,3,2,1,0.667,3,2,1,0.667
20500040,1610612762,1610612756,88.0,97.0,0.395,0.4320000000000001,0,2005-11-05,3,2,1,0.667,3,2,1,0.667
20500041,1610612757,1610612737,94.0,93.0,0.429,0.473,1,2005-11-05,3,1,2,0.3329999999999999,3,0,3,0.0
20500042,1610612746,1610612750,100.0,99.0,0.4379999999999999,0.4579999999999999,1,2005-11-05,3,3,0,1.0,3,1,2,0.3329999999999999
20500020,1610612761,1610612751,92.0,102.0,0.4,0.48,0,2005-11-04,2,0,2,0.0,2,1,1,0.5
20500021,1610612755,1610612766,93.0,110.0,0.43,0.466,0,2005-11-04,3,0,3,0.0,2,1,1,0.5
20500022,1610612753,1610612763,85.0,94.0,0.465,0.471,0,2005-11-04,2,0,2,0.0,2,1,1,0.5
20500023,1610612738,1610612765,81.0,82.0,0.395,0.395,0,2005-11-04,2,1,1,0.5,2,2,0,1.0
20500024,1610612752,1610612764,75.0,86.0,0.3289999999999999,0.447,0,2005-11-04,2,0,2,0.0,2,2,0,1.0
20500026,1610612759,1610612739,102.0,76.0,0.55,0.341,1,2005-11-04,2,2,0,1.0,2,1,1,0.5
20500027,1610612743,1610612757,107.0,68.0,0.505,0.3329999999999999,1,2005-11-04,3,1,2,0.3329999999999999,2,0,2,0.0
20500028,1610612746,1610612737,92.0,77.0,0.442,0.348,1,2005-11-04,2,2,0,1.0,2,0,2,0.0
20500029,1610612744,1610612762,85.0,91.0,0.3720000000000001,0.4029999999999999,0,2005-11-04,2,1,1,0.5,2,2,0,1.0
20500030,1610612760,1610612750,107.0,102.0,0.422,0.477,1,2005-11-04,2,1,1,0.5,2,1,1,0.5
20500018,1610612748,1610612754,102.0,105.0,0.48,0.481,0,2005-11-03,2,1,1,0.5,2,2,0,1.0
20500019,1610612747,1610612756,112.0,122.0,0.471,0.506,0,2005-11-03,2,1,1,0.5,2,1,1,0.5
20500008,1610612751,1610612749,96.0,110.0,0.4029999999999999,0.38,0,2005-11-02,1,0,1,0.0,2,2,0,1.0
20500009,1610612765,1610612755,108.0,88.0,0.5579999999999999,0.434,1,2005-11-02,1,1,0,1.0,2,0,2,0.0
20500004,1610612761,1610612764,96.0,99.0,0.3979999999999999,0.482,0,2005-11-02,1,0,1,0.0,1,1,0,1.0
20500005,1610612753,1610612754,78.0,90.0,0.4370000000000001,0.471,0,2005-11-02,1,0,1,0.0,1,1,0,1.0
20500006,1610612739,1610612740,109.0,87.0,0.536,0.41,1,2005-11-02,1,1,0,1.0,2,1,1,0.5
20500007,1610612738,1610612752,114.0,100.0,0.42,0.452,1,2005-11-02,1,1,0,1.0,1,0,1,0.0
20500010,1610612763,1610612748,78.0,97.0,0.341,0.474,0,2005-11-02,1,0,1,0.0,1,1,0,1.0
20500011,1610612750,1610612757,90.0,86.0,0.457,0.439,1,2005-11-02,1,1,0,1.0,1,0,1,0.0
20500012,1610612741,1610612766,109.0,105.0,0.429,0.409,1,2005-11-02,1,1,0,1.0,1,0,1,0.0
20500013,1610612745,1610612758,98.0,89.0,0.434,0.41,1,2005-11-02,1,1,0,1.0,2,0,2,0.0
20500014,1610612762,1610612742,93.0,82.0,0.4320000000000001,0.377,1,2005-11-02,1,1,0,1.0,2,1,1,0.5
20500015,1610612760,1610612746,93.0,101.0,0.413,0.5,0,2005-11-02,1,0,1,0.0,1,1,0,1.0
20500016,1610612743,1610612747,97.0,99.0,0.43,0.439,0,2005-11-02,2,0,2,0.0,1,1,0,1.0
20500017,1610612744,1610612737,122.0,97.0,0.581,0.419,1,2005-11-02,1,1,0,1.0,1,0,1,0.0
20500001,1610612755,1610612749,108.0,117.0,0.4320000000000001,0.494,0,2005-11-01,1,0,1,0.0,1,1,0,1.0
20500025,1610612740,1610612758,93.0,67.0,0.479,0.313,1,2005-11-01,1,1,0,1.0,1,0,1,0.0
20500002,1610612759,1610612743,102.0,91.0,0.5,0.488,1,2005-11-01,1,1,0,1.0,1,0,1,0.0
20500003,1610612756,1610612742,108.0,111.0,0.4379999999999999,0.447,0,2005-11-01,1,0,1,0.0,1,1,0,1.0
10500118,1610612752,1610612751,86.0,91.0,0.456,0.4579999999999999,0,2005-10-28,7,3,4,0.429,8,5,3,0.625
10500114,1610612754,1610612764,77.0,85.0,0.425,0.442,0,2005-10-28,8,5,3,0.625,8,3,5,0.375
10500116,1610612762,1610612743,83.0,89.0,0.406,0.471,0,2005-10-28,7,2,5,0.286,8,7,1,0.875
10500119,1610612747,1610612758,105.0,103.0,0.434,0.447,1,2005-10-28,8,6,2,0.75,8,3,5,0.375
10500121,1610612750,1610612765,96.0,92.0,0.429,0.3670000000000001,1,2005-10-28,8,4,4,0.5,8,4,4,0.5
10500117,1610612760,1610612757,96.0,85.0,0.494,0.471,1,2005-10-28,7,3,4,0.429,8,2,6,0.25
10500113,1610612737,1610612740,104.0,90.0,0.5770000000000001,0.4320000000000001,1,2005-10-28,8,3,5,0.375,7,2,5,0.286
10500109,1610612742,1610612765,103.0,97.0,0.493,0.46,1,2005-10-27,8,6,2,0.75,7,4,3,0.5710000000000001
10500106,1610612756,1610612744,97.0,92.0,0.391,0.429,1,2005-10-27,8,6,2,0.75,7,2,5,0.286
10500103,1610612738,1610612739,101.0,100.0,0.522,0.478,1,2005-10-26,8,3,5,0.375,8,5,3,0.625
10500104,1610612766,1610612754,109.0,103.0,0.482,0.4629999999999999,1,2005-10-26,8,3,5,0.375,7,5,2,0.7140000000000001
10500099,1610612750,1610612741,100.0,92.0,0.514,0.402,1,2005-10-26,7,3,4,0.429,8,3,5,0.375
10500105,1610612745,1610612762,88.0,80.0,0.433,0.4029999999999999,1,2005-10-26,7,6,1,0.857,6,2,4,0.3329999999999999
10500100,1610612743,1610612749,118.0,115.0,0.5329999999999999,0.471,1,2005-10-26,7,6,1,0.857,8,3,5,0.375
10500101,1610612756,1610612758,112.0,102.0,0.477,0.41,1,2005-10-26,7,5,2,0.7140000000000001,7,3,4,0.429
10500102,1610612757,1610612761,78.0,100.0,0.429,0.476,0,2005-10-26,7,2,5,0.286,7,3,4,0.429
10500097,1610612759,1610612754,86.0,97.0,0.471,0.507,0,2005-10-25,8,1,7,0.125,6,5,1,0.833
10500096,1610612742,1610612749,94.0,86.0,0.436,0.373,1,2005-10-25,7,5,2,0.7140000000000001,7,3,4,0.429
10500094,1610612741,1610612763,88.0,95.0,0.4639999999999999,0.456,0,2005-10-25,7,3,4,0.429,7,5,2,0.7140000000000001
10500092,1610612755,1610612752,71.0,80.0,0.2769999999999999,0.478,0,2005-10-25,7,3,4,0.429,6,3,3,0.5
10500093,1610612751,1610612738,118.0,116.0,0.457,0.506,1,2005-10-25,7,4,3,0.5710000000000001,7,2,5,0.286
10500095,1610612740,1610612748,111.0,91.0,0.5,0.4,1,2005-10-25,6,2,4,0.3329999999999999,7,3,4,0.429
10500098,1610612747,1610612762,95.0,71.0,0.421,0.466,1,2005-10-25,7,5,2,0.7140000000000001,5,2,3,0.4
10500087,1610612761,1610612757,98.0,105.0,0.446,0.594,0,2005-10-24,6,2,4,0.3329999999999999,6,2,4,0.3329999999999999
10500088,1610612748,1610612737,84.0,83.0,0.3879999999999999,0.44,1,2005-10-24,6,3,3,0.5,6,2,4,0.3329999999999999
10500089,1610612763,1610612753,65.0,67.0,0.303,0.306,0,2005-10-24,6,4,2,0.667,6,4,2,0.667
10500091,1610612744,1610612746,82.0,112.0,0.373,0.5,0,2005-10-24,6,2,4,0.3329999999999999,7,5,2,0.7140000000000001
10500086,1610612745,1610612764,75.0,71.0,0.4529999999999999,0.361,1,2005-10-23,6,5,1,0.833,7,2,5,0.286
10500083,1610612742,1610612746,80.0,99.0,0.3879999999999999,0.481,0,2005-10-23,6,4,2,0.667,6,4,2,0.667
10500090,1610612740,1610612743,93.0,97.0,0.382,0.486,0,2005-10-23,5,1,4,0.2,6,5,1,0.833
10500082,1610612739,1610612761,87.0,83.0,0.412,0.37,1,2005-10-23,7,5,2,0.7140000000000001,5,2,3,0.4
10500084,1610612747,1610612766,98.0,97.0,0.434,0.386,1,2005-10-23,6,4,2,0.667,7,2,5,0.286
10500085,1610612758,1610612756,88.0,100.0,0.423,0.527,0,2005-10-23,6,3,3,0.5,6,4,2,0.667
10500074,1610612753,1610612737,105.0,100.0,0.4579999999999999,0.493,1,2005-10-22,5,3,2,0.6,5,2,3,0.4
10500077,1610612738,1610612751,90.0,69.0,0.478,0.353,1,2005-10-22,6,2,4,0.3329999999999999,6,3,3,0.5
10500078,1610612765,1610612748,87.0,66.0,0.422,0.362,1,2005-10-22,6,4,2,0.667,5,2,3,0.4
10500075,1610612763,1610612745,82.0,78.0,0.375,0.365,1,2005-10-22,5,4,1,0.8,5,4,1,0.8
10500079,1610612749,1610612750,85.0,89.0,0.3939999999999999,0.4379999999999999,0,2005-10-22,6,3,3,0.5,6,2,4,0.3329999999999999
10500080,1610612759,1610612752,90.0,96.0,0.4029999999999999,0.444,0,2005-10-22,7,1,6,0.143,5,2,3,0.4
10500076,1610612757,1610612758,80.0,100.0,0.366,0.4320000000000001,0,2005-10-22,5,1,4,0.2,5,3,2,0.6
10500081,1610612744,1610612760,95.0,108.0,0.375,0.4679999999999999,0,2005-10-22,5,2,3,0.4,6,2,4,0.3329999999999999
10500067,1610612743,1610612764,97.0,91.0,0.418,0.352,1,2005-10-21,5,4,1,0.8,6,2,4,0.3329999999999999
10500068,1610612761,1610612738,93.0,83.0,0.43,0.5,1,2005-10-21,4,2,2,0.5,5,1,4,0.2
10500070,1610612751,1610612755,93.0,91.0,0.435,0.411,1,2005-10-21,5,3,2,0.6,6,3,3,0.5
10500071,1610612741,1610612749,107.0,105.0,0.417,0.402,1,2005-10-21,6,3,3,0.5,5,3,2,0.6
10500072,1610612742,1610612752,86.0,85.0,0.4370000000000001,0.517,1,2005-10-21,5,4,1,0.8,4,1,3,0.25
10500069,1610612756,1610612760,113.0,81.0,0.53,0.337,1,2005-10-21,5,3,2,0.6,5,1,4,0.2
10500073,1610612747,1610612766,109.0,93.0,0.507,0.418,1,2005-10-21,5,3,2,0.6,6,2,4,0.3329999999999999
10500062,1610612755,1610612739,102.0,106.0,0.489,0.506,0,2005-10-20,5,3,2,0.6,6,4,2,0.667
10500061,1610612764,1610612766,96.0,89.0,0.3829999999999999,0.396,1,2005-10-20,5,2,3,0.4,5,2,3,0.4
10500063,1610612750,1610612754,76.0,93.0,0.385,0.46,0,2005-10-20,5,1,4,0.2,5,4,1,0.8
10500064,1610612740,1610612759,90.0,97.0,0.434,0.466,0,2005-10-20,4,1,3,0.25,6,1,5,0.1669999999999999
10500065,1610612757,1610612762,73.0,92.0,0.29,0.474,0,2005-10-20,4,1,3,0.25,4,2,2,0.5
10500066,1610612747,1610612743,94.0,105.0,0.425,0.528,0,2005-10-20,4,2,2,0.5,4,3,1,0.75
10500055,1610612739,1610612763,88.0,84.0,0.391,0.395,1,2005-10-19,5,3,2,0.6,4,3,1,0.75
10500058,1610612738,1610612741,82.0,98.0,0.381,0.48,0,2005-10-19,4,1,3,0.25,5,2,3,0.4
10500060,1610612744,1610612756,108.0,96.0,0.455,0.446,1,2005-10-19,4,2,2,0.5,4,2,2,0.5
10500054,1610612761,1610612751,107.0,105.0,0.435,0.476,1,2005-10-19,3,1,2,0.3329999999999999,4,2,2,0.5
10500057,1610612760,1610612746,99.0,93.0,0.5,0.449,1,2005-10-19,4,1,3,0.25,5,3,2,0.6
10500056,1610612749,1610612765,104.0,94.0,0.446,0.444,1,2005-10-19,4,3,1,0.75,5,3,2,0.6
10500046,1610612754,1610612759,94.0,81.0,0.3929999999999999,0.442,1,2005-10-18,4,3,1,0.75,5,0,5,0.0
10500050,1610612752,1610612755,99.0,114.0,0.405,0.493,0,2005-10-18,3,1,2,0.3329999999999999,4,3,1,0.75
10500052,1610612765,1610612742,88.0,94.0,0.417,0.434,0,2005-10-18,4,3,1,0.75,4,3,1,0.75
10500051,1610612748,1610612753,95.0,91.0,0.479,0.397,1,2005-10-18,4,2,2,0.5,4,2,2,0.5
10500049,1610612757,1610612746,85.0,99.0,0.326,0.526,0,2005-10-18,3,1,2,0.3329999999999999,4,3,1,0.75
10500048,1610612758,1610612743,99.0,102.0,0.41,0.493,0,2005-10-18,4,2,2,0.5,3,2,1,0.667
10500053,1610612747,1610612764,111.0,108.0,0.489,0.5,1,2005-10-18,3,2,1,0.667,4,1,3,0.25
10500047,1610612740,1610612737,94.0,97.0,0.479,0.5770000000000001,0,2005-10-18,3,1,2,0.3329999999999999,4,2,2,0.5
10500044,1610612741,1610612750,89.0,97.0,0.429,0.486,0,2005-10-17,4,1,3,0.25,4,1,3,0.25
10500042,1610612766,1610612737,94.0,88.0,0.481,0.493,1,2005-10-17,4,2,2,0.5,3,1,2,0.3329999999999999
10500043,1610612762,1610612756,95.0,106.0,0.452,0.4639999999999999,0,2005-10-17,3,1,2,0.3329999999999999,3,2,1,0.667
10500045,1610612745,1610612760,93.0,85.0,0.444,0.37,1,2005-10-17,4,4,0,1.0,3,0,3,0.0
10500039,1610612752,1610612742,102.0,104.0,0.425,0.526,0,2005-10-16,2,1,1,0.5,3,2,1,0.667
10500040,1610612765,1610612750,91.0,80.0,0.419,0.37,1,2005-10-16,3,3,0,1.0,3,0,3,0.0
10500041,1610612758,1610612744,114.0,99.0,0.514,0.416,1,2005-10-16,3,2,1,0.667,3,1,2,0.3329999999999999
10500037,1610612759,1610612745,87.0,95.0,0.4,0.4629999999999999,0,2005-10-15,4,0,4,0.0,3,3,0,1.0
10500032,1610612756,1610612746,87.0,90.0,0.45,0.395,0,2005-10-15,2,1,1,0.5,3,2,1,0.667
10500034,1610612748,1610612766,72.0,82.0,0.375,0.3779999999999999,0,2005-10-15,3,1,2,0.3329999999999999,3,1,2,0.3329999999999999
10500035,1610612741,1610612738,116.0,97.0,0.506,0.472,1,2005-10-15,3,1,2,0.3329999999999999,3,1,2,0.3329999999999999
10500030,1610612763,1610612764,104.0,79.0,0.606,0.355,1,2005-10-15,3,3,0,1.0,3,1,2,0.3329999999999999
10500036,1610612749,1610612739,91.0,89.0,0.409,0.39,1,2005-10-15,3,2,1,0.667,4,2,2,0.5
10500029,1610612753,1610612740,101.0,83.0,0.557,0.449,1,2005-10-15,3,2,1,0.667,2,1,1,0.5
10500031,1610612743,1610612757,112.0,85.0,0.532,0.47,1,2005-10-15,2,1,1,0.5,2,1,1,0.5
10500033,1610612751,1610612752,84.0,93.0,0.446,0.456,0,2005-10-15,3,2,1,0.667,1,1,0,1.0
10500027,1610612746,1610612758,84.0,90.0,0.411,0.423,0,2005-10-14,2,1,1,0.5,2,1,1,0.5
10500023,1610612754,1610612750,93.0,84.0,0.462,0.424,1,2005-10-14,3,2,1,0.667,2,0,2,0.0
10500026,1610612739,1610612755,98.0,100.0,0.3929999999999999,0.455,0,2005-10-14,3,2,1,0.667,3,2,1,0.667
10500024,1610612760,1610612756,113.0,114.0,0.482,0.488,0,2005-10-14,2,0,2,0.0,1,1,0,1.0
10500025,1610612738,1610612761,107.0,100.0,0.483,0.422,1,2005-10-14,2,1,1,0.5,2,0,2,0.0
10500028,1610612748,1610612763,91.0,101.0,0.4920000000000001,0.405,0,2005-10-14,2,1,1,0.5,2,2,0,1.0
10500018,1610612754,1610612762,99.0,92.0,0.426,0.4679999999999999,1,2005-10-13,2,1,1,0.5,2,1,1,0.5
10500021,1610612765,1610612749,95.0,88.0,0.456,0.39,1,2005-10-13,2,2,0,1.0,2,1,1,0.5
10500020,1610612766,1610612751,76.0,95.0,0.308,0.47,0,2005-10-13,2,0,2,0.0,2,2,0,1.0
10500019,1610612743,1610612740,90.0,100.0,0.397,0.48,0,2005-10-13,1,0,1,0.0,1,1,0,1.0
10500022,1610612759,1610612764,91.0,95.0,0.414,0.429,0,2005-10-13,3,0,3,0.0,2,1,1,0.5
10500017,1610612746,1610612742,95.0,80.0,0.405,0.429,1,2005-10-12,1,1,0,1.0,2,1,1,0.5
10500011,1610612750,1610612749,89.0,92.0,0.5,0.474,0,2005-10-12,1,0,1,0.0,1,1,0,1.0
10500016,1610612745,1610612753,84.0,80.0,0.407,0.412,1,2005-10-12,2,2,0,1.0,2,1,1,0.5
10500013,1610612757,1610612760,82.0,75.0,0.31,0.391,1,2005-10-12,1,1,0,1.0,1,0,1,0.0
10500009,1610612761,1610612762,101.0,102.0,0.415,0.429,0,2005-10-12,1,0,1,0.0,1,1,0,1.0
10500010,1610612763,1610612741,86.0,82.0,0.444,0.37,1,2005-10-12,1,1,0,1.0,2,0,2,0.0
10500012,1610612747,1610612744,81.0,112.0,0.385,0.434,0,2005-10-12,2,1,1,0.5,2,1,1,0.5
10500014,1610612755,1610612759,100.0,88.0,0.493,0.3979999999999999,1,2005-10-12,2,1,1,0.5,2,0,2,0.0
10500015,1610612737,1610612766,109.0,105.0,0.487,0.479,1,2005-10-12,2,1,1,0.5,1,0,1,0.0
10500002,1610612755,1610612745,91.0,105.0,0.486,0.481,0,2005-10-11,1,0,1,0.0,1,1,0,1.0
10500003,1610612737,1610612753,93.0,104.0,0.429,0.506,0,2005-10-11,1,0,1,0.0,1,1,0,1.0
10500005,1610612758,1610612742,83.0,96.0,0.4370000000000001,0.556,0,2005-10-11,1,0,1,0.0,1,1,0,1.0
10500007,1610612751,1610612754,105.0,103.0,0.5,0.425,1,2005-10-11,1,1,0,1.0,1,0,1,0.0
10500008,1610612739,1610612738,96.0,86.0,0.435,0.4,1,2005-10-11,2,2,0,1.0,1,0,1,0.0
10500004,1610612765,1610612741,87.0,76.0,0.447,0.3379999999999999,1,2005-10-11,1,1,0,1.0,1,0,1,0.0
10500006,1610612747,1610612744,101.0,93.0,0.4,0.357,1,2005-10-11,1,1,0,1.0,1,0,1,0.0
10500001,1610612764,1610612739,94.0,116.0,0.4320000000000001,0.507,0,2005-10-10,1,0,1,0.0,1,1,0,1.0
10500120,1610612748,1610612759,103.0,101.0,0.522,0.506,1,2005-10-10,1,1,0,1.0,1,0,1,0.0
40400407,1610612759,1610612765,81.0,74.0,0.426,0.419,1,2005-06-23,82,59,23,0.72,82,54,28,0.659
40400406,1610612759,1610612765,86.0,95.0,0.413,0.4679999999999999,0,2005-06-21,82,59,23,0.72,82,54,28,0.659
40400405,1610612765,1610612759,95.0,96.0,0.44,0.4629999999999999,0,2005-06-19,82,54,28,0.659,82,59,23,0.72
40400404,1610612765,1610612759,102.0,71.0,0.456,0.371,1,2005-06-16,82,54,28,0.659,82,59,23,0.72
40400403,1610612765,1610612759,96.0,79.0,0.471,0.433,1,2005-06-14,82,54,28,0.659,82,59,23,0.72
40400402,1610612759,1610612765,97.0,76.0,0.4679999999999999,0.402,1,2005-06-12,82,59,23,0.72,82,54,28,0.659
40400401,1610612759,1610612765,84.0,69.0,0.43,0.377,1,2005-06-09,82,59,23,0.72,82,54,28,0.659
40400307,1610612748,1610612765,82.0,88.0,0.4639999999999999,0.456,0,2005-06-06,82,59,23,0.72,82,54,28,0.659
40400306,1610612765,1610612748,91.0,66.0,0.419,0.406,1,2005-06-04,82,54,28,0.659,82,59,23,0.72
40400305,1610612748,1610612765,88.0,76.0,0.522,0.385,1,2005-06-02,82,59,23,0.72,82,54,28,0.659
40400315,1610612756,1610612759,95.0,101.0,0.4370000000000001,0.46,0,2005-06-01,82,62,20,0.7559999999999999,82,59,23,0.72
40400304,1610612765,1610612748,106.0,96.0,0.481,0.444,1,2005-05-31,82,54,28,0.659,82,59,23,0.72
40400314,1610612759,1610612756,106.0,111.0,0.442,0.5710000000000001,0,2005-05-30,82,59,23,0.72,82,62,20,0.7559999999999999
40400303,1610612765,1610612748,104.0,113.0,0.439,0.523,0,2005-05-29,82,54,28,0.659,82,59,23,0.72
40400313,1610612759,1610612756,102.0,92.0,0.461,0.442,1,2005-05-28,82,59,23,0.72,82,62,20,0.7559999999999999
40400302,1610612748,1610612765,92.0,86.0,0.462,0.3829999999999999,1,2005-05-25,82,59,23,0.72,82,54,28,0.659
40400312,1610612756,1610612759,108.0,111.0,0.557,0.512,0,2005-05-24,82,62,20,0.7559999999999999,82,59,23,0.72
40400301,1610612748,1610612765,81.0,90.0,0.4679999999999999,0.457,0,2005-05-23,82,59,23,0.72,82,54,28,0.659
40400311,1610612756,1610612759,114.0,121.0,0.488,0.517,0,2005-05-22,82,62,20,0.7559999999999999,82,59,23,0.72
40400226,1610612742,1610612756,126.0,130.0,0.433,0.495,0,2005-05-20,82,58,24,0.7070000000000001,82,62,20,0.7559999999999999
40400216,1610612754,1610612765,79.0,88.0,0.48,0.4370000000000001,0,2005-05-19,82,44,38,0.537,82,54,28,0.659
40400236,1610612760,1610612759,96.0,98.0,0.48,0.4579999999999999,0,2005-05-19,82,52,30,0.634,82,59,23,0.72
40400225,1610612756,1610612742,114.0,108.0,0.4479999999999999,0.436,1,2005-05-18,82,62,20,0.7559999999999999,82,58,24,0.7070000000000001
40400235,1610612759,1610612760,103.0,90.0,0.462,0.4589999999999999,1,2005-05-17,82,59,23,0.72,82,52,30,0.634
40400215,1610612765,1610612754,86.0,67.0,0.429,0.369,1,2005-05-17,82,54,28,0.659,82,44,38,0.537
40400214,1610612754,1610612765,76.0,89.0,0.371,0.405,0,2005-05-15,82,44,38,0.537,82,54,28,0.659
40400224,1610612742,1610612756,119.0,109.0,0.5539999999999999,0.512,1,2005-05-15,82,58,24,0.7070000000000001,82,62,20,0.7559999999999999
40400234,1610612760,1610612759,101.0,89.0,0.5,0.417,1,2005-05-15,82,52,30,0.634,82,59,23,0.72
40400204,1610612764,1610612748,95.0,99.0,0.366,0.421,0,2005-05-14,82,45,37,0.5489999999999999,82,59,23,0.72
40400213,1610612754,1610612765,79.0,74.0,0.361,0.369,1,2005-05-13,82,44,38,0.537,82,54,28,0.659
40400223,1610612742,1610612756,102.0,119.0,0.39,0.517,0,2005-05-13,82,58,24,0.7070000000000001,82,62,20,0.7559999999999999
40400203,1610612764,1610612748,95.0,102.0,0.4579999999999999,0.513,0,2005-05-12,82,45,37,0.5489999999999999,82,59,23,0.72
40400233,1610612760,1610612759,92.0,91.0,0.408,0.4379999999999999,1,2005-05-12,82,52,30,0.634,82,59,23,0.72
40400212,1610612765,1610612754,83.0,92.0,0.416,0.389,0,2005-05-11,82,54,28,0.659,82,44,38,0.537
40400222,1610612756,1610612742,106.0,108.0,0.416,0.494,0,2005-05-11,82,62,20,0.7559999999999999,82,58,24,0.7070000000000001
40400232,1610612759,1610612760,108.0,91.0,0.528,0.423,1,2005-05-10,82,59,23,0.72,82,52,30,0.634
40400202,1610612748,1610612764,108.0,102.0,0.5760000000000001,0.411,1,2005-05-10,82,59,23,0.72,82,45,37,0.5489999999999999
40400221,1610612756,1610612742,127.0,102.0,0.523,0.449,1,2005-05-09,82,62,20,0.7559999999999999,82,58,24,0.7070000000000001
40400211,1610612765,1610612754,96.0,81.0,0.466,0.395,1,2005-05-09,82,54,28,0.659,82,44,38,0.537
40400201,1610612748,1610612764,105.0,86.0,0.524,0.368,1,2005-05-08,82,59,23,0.72,82,45,37,0.5489999999999999
40400231,1610612759,1610612760,103.0,81.0,0.507,0.429,1,2005-05-08,82,59,23,0.72,82,52,30,0.634
40400127,1610612738,1610612754,70.0,97.0,0.37,0.4639999999999999,0,2005-05-07,82,45,37,0.5489999999999999,82,44,38,0.537
40400177,1610612742,1610612745,116.0,76.0,0.513,0.354,1,2005-05-07,82,58,24,0.7070000000000001,82,51,31,0.622
40400136,1610612764,1610612741,94.0,91.0,0.4,0.4029999999999999,1,2005-05-06,82,45,37,0.5489999999999999,82,47,35,0.573
40400126,1610612754,1610612738,89.0,92.0,0.36,0.411,0,2005-05-05,82,44,38,0.537,82,45,37,0.5489999999999999
40400176,1610612745,1610612742,101.0,83.0,0.486,0.36,1,2005-05-05,82,51,31,0.622,82,58,24,0.7070000000000001
40400155,1610612759,1610612743,99.0,89.0,0.452,0.439,1,2005-05-04,82,59,23,0.72,82,49,33,0.598
40400135,1610612741,1610612764,110.0,112.0,0.471,0.561,0,2005-05-04,82,47,35,0.573,82,45,37,0.5489999999999999
40400115,1610612765,1610612755,88.0,78.0,0.4,0.444,1,2005-05-03,82,54,28,0.659,82,43,39,0.524
40400125,1610612738,1610612754,85.0,90.0,0.4529999999999999,0.457,0,2005-05-03,82,45,37,0.5489999999999999,82,44,38,0.537
40400165,1610612760,1610612758,122.0,118.0,0.56,0.512,1,2005-05-03,82,52,30,0.634,82,50,32,0.61
40400134,1610612764,1610612741,106.0,99.0,0.447,0.337,1,2005-05-02,82,45,37,0.5489999999999999,82,47,35,0.573
40400175,1610612742,1610612745,103.0,100.0,0.4679999999999999,0.493,1,2005-05-02,82,58,24,0.7070000000000001,82,51,31,0.622
40400154,1610612743,1610612759,115.0,126.0,0.4579999999999999,0.482,0,2005-05-02,82,49,33,0.598,82,59,23,0.72
40400164,1610612758,1610612760,102.0,115.0,0.42,0.534,0,2005-05-01,82,50,32,0.61,82,52,30,0.634
40400144,1610612763,1610612756,115.0,123.0,0.506,0.603,0,2005-05-01,82,45,37,0.5489999999999999,82,62,20,0.7559999999999999
40400104,1610612751,1610612748,97.0,110.0,0.395,0.5489999999999999,0,2005-05-01,82,42,40,0.512,82,59,23,0.72
40400114,1610612755,1610612765,92.0,97.0,0.429,0.43,0,2005-05-01,82,43,39,0.524,82,54,28,0.659
40400124,1610612754,1610612738,79.0,110.0,0.2689999999999999,0.568,0,2005-04-30,82,44,38,0.537,82,45,37,0.5489999999999999
40400133,1610612764,1610612741,117.0,99.0,0.43,0.3929999999999999,1,2005-04-30,82,45,37,0.5489999999999999,82,47,35,0.573
40400174,1610612745,1610612742,93.0,97.0,0.472,0.4579999999999999,0,2005-04-30,82,51,31,0.622,82,58,24,0.7070000000000001
40400153,1610612743,1610612759,78.0,86.0,0.408,0.3829999999999999,0,2005-04-30,82,49,33,0.598,82,59,23,0.72
40400163,1610612758,1610612760,116.0,104.0,0.494,0.42,1,2005-04-29,82,50,32,0.61,82,52,30,0.634
40400143,1610612763,1610612756,90.0,110.0,0.4629999999999999,0.524,0,2005-04-29,82,45,37,0.5489999999999999,82,62,20,0.7559999999999999
40400113,1610612755,1610612765,115.0,104.0,0.551,0.507,1,2005-04-29,82,43,39,0.524,82,54,28,0.659
40400123,1610612754,1610612738,99.0,76.0,0.471,0.397,1,2005-04-28,82,44,38,0.537,82,45,37,0.5489999999999999
40400173,1610612745,1610612742,102.0,106.0,0.45,0.485,0,2005-04-28,82,51,31,0.622,82,58,24,0.7070000000000001
40400103,1610612751,1610612748,105.0,108.0,0.3929999999999999,0.452,0,2005-04-28,82,42,40,0.512,82,59,23,0.72
40400152,1610612759,1610612743,104.0,76.0,0.479,0.36,1,2005-04-27,82,59,23,0.72,82,49,33,0.598
40400142,1610612756,1610612763,108.0,103.0,0.462,0.457,1,2005-04-27,82,62,20,0.7559999999999999,82,45,37,0.5489999999999999
40400132,1610612741,1610612764,113.0,103.0,0.488,0.425,1,2005-04-27,82,47,35,0.573,82,45,37,0.5489999999999999
40400112,1610612765,1610612755,99.0,84.0,0.5,0.368,1,2005-04-26,82,54,28,0.659,82,43,39,0.524
40400102,1610612748,1610612751,104.0,87.0,0.48,0.359,1,2005-04-26,82,59,23,0.72,82,42,40,0.512
40400162,1610612760,1610612758,105.0,93.0,0.475,0.422,1,2005-04-26,82,52,30,0.634,82,50,32,0.61
40400122,1610612738,1610612754,79.0,82.0,0.3879999999999999,0.414,0,2005-04-25,82,45,37,0.5489999999999999,82,44,38,0.537
40400172,1610612742,1610612745,111.0,113.0,0.5,0.5479999999999999,0,2005-04-25,82,58,24,0.7070000000000001,82,51,31,0.622
40400151,1610612759,1610612743,87.0,93.0,0.42,0.415,0,2005-04-24,82,59,23,0.72,82,49,33,0.598
40400141,1610612756,1610612763,114.0,103.0,0.452,0.466,1,2005-04-24,82,62,20,0.7559999999999999,82,45,37,0.5489999999999999
40400101,1610612748,1610612751,116.0,98.0,0.5920000000000001,0.436,1,2005-04-24,82,59,23,0.72,82,42,40,0.512
40400131,1610612741,1610612764,103.0,94.0,0.426,0.384,1,2005-04-24,82,47,35,0.573,82,45,37,0.5489999999999999
40400111,1610612765,1610612755,106.0,85.0,0.519,0.4029999999999999,1,2005-04-23,82,54,28,0.659,82,43,39,0.524
40400171,1610612742,1610612745,86.0,98.0,0.353,0.474,0,2005-04-23,82,58,24,0.7070000000000001,82,51,31,0.622
40400121,1610612738,1610612754,102.0,82.0,0.514,0.348,1,2005-04-23,82,45,37,0.5489999999999999,82,44,38,0.537
40400161,1610612760,1610612758,87.0,82.0,0.365,0.386,1,2005-04-23,82,52,30,0.634,82,50,32,0.61
20401223,1610612754,1610612741,85.0,83.0,0.4029999999999999,0.442,1,2005-04-20,82,44,38,0.537,82,47,35,0.573
20401226,1610612750,1610612759,95.0,73.0,0.419,0.356,1,2005-04-20,82,44,38,0.537,82,59,23,0.72
20401222,1610612752,1610612764,113.0,105.0,0.494,0.483,1,2005-04-20,82,33,49,0.402,82,45,37,0.5489999999999999
20401227,1610612745,1610612760,106.0,78.0,0.537,0.431,1,2005-04-20,82,51,31,0.622,82,52,30,0.634
20401217,1610612738,1610612751,93.0,102.0,0.461,0.38,0,2005-04-20,82,45,37,0.5489999999999999,82,42,40,0.512
20401229,1610612744,1610612762,106.0,89.0,0.4529999999999999,0.381,1,2005-04-20,82,34,48,0.415,82,26,56,0.317
20401220,1610612766,1610612765,97.0,86.0,0.48,0.43,1,2005-04-20,82,18,64,0.22,82,54,28,0.659
20401228,1610612757,1610612747,106.0,103.0,0.5529999999999999,0.429,1,2005-04-20,82,27,55,0.3289999999999999,82,34,48,0.415
20401230,1610612758,1610612756,132.0,107.0,0.52,0.4320000000000001,1,2005-04-20,82,50,32,0.61,82,62,20,0.7559999999999999
20401224,1610612763,1610612742,88.0,108.0,0.449,0.521,0,2005-04-20,82,45,37,0.5489999999999999,82,58,24,0.7070000000000001
20401218,1610612761,1610612739,95.0,104.0,0.456,0.4579999999999999,0,2005-04-20,82,33,49,0.402,82,42,40,0.512
20401225,1610612740,1610612746,75.0,86.0,0.337,0.41,0,2005-04-20,82,18,64,0.22,82,37,45,0.451
20401219,1610612755,1610612737,110.0,86.0,0.513,0.405,1,2005-04-20,82,43,39,0.524,82,13,69,0.159
20401221,1610612753,1610612748,93.0,98.0,0.4320000000000001,0.536,0,2005-04-20,82,36,46,0.439,82,59,23,0.72
20401211,1610612737,1610612765,68.0,95.0,0.3289999999999999,0.556,0,2005-04-19,81,13,68,0.16,81,54,27,0.667
20401209,1610612739,1610612738,100.0,86.0,0.506,0.434,1,2005-04-19,81,41,40,0.506,81,45,36,0.556
20401212,1610612748,1610612766,99.0,80.0,0.44,0.4,1,2005-04-19,81,58,23,0.716,81,17,64,0.21
20401214,1610612741,1610612752,92.0,91.0,0.402,0.4629999999999999,1,2005-04-19,81,47,34,0.58,81,32,49,0.395
20401215,1610612742,1610612760,101.0,96.0,0.506,0.452,1,2005-04-19,81,57,24,0.7040000000000001,81,52,29,0.642
20401216,1610612743,1610612757,119.0,115.0,0.484,0.506,1,2005-04-19,82,49,33,0.598,81,26,55,0.321
20401213,1610612749,1610612761,109.0,127.0,0.455,0.523,0,2005-04-19,82,30,52,0.366,81,33,48,0.407
20401210,1610612751,1610612764,109.0,101.0,0.488,0.4679999999999999,1,2005-04-19,81,41,40,0.506,81,45,36,0.556
20401207,1610612756,1610612743,128.0,114.0,0.568,0.433,1,2005-04-18,81,62,19,0.765,81,48,33,0.593
20401205,1610612745,1610612746,115.0,90.0,0.526,0.479,1,2005-04-18,81,50,31,0.617,81,36,45,0.444
20401208,1610612744,1610612747,126.0,99.0,0.517,0.373,1,2005-04-18,81,33,48,0.407,81,34,47,0.42
20401203,1610612763,1610612759,94.0,92.0,0.466,0.417,1,2005-04-18,81,45,36,0.556,81,59,22,0.728
20401204,1610612740,1610612750,99.0,102.0,0.481,0.5,0,2005-04-18,81,18,63,0.222,81,43,38,0.531
20401206,1610612762,1610612758,92.0,82.0,0.466,0.361,1,2005-04-18,81,26,55,0.321,81,49,32,0.605
20401201,1610612755,1610612749,122.0,106.0,0.539,0.4589999999999999,1,2005-04-18,81,42,39,0.519,81,30,51,0.37
20401202,1610612753,1610612754,92.0,88.0,0.479,0.413,1,2005-04-18,81,36,45,0.444,81,43,38,0.531
20401196,1610612747,1610612742,112.0,114.0,0.442,0.494,0,2005-04-17,80,34,46,0.425,80,56,24,0.7
20401195,1610612750,1610612760,94.0,109.0,0.451,0.528,0,2005-04-17,80,42,38,0.525,80,52,28,0.65
20401192,1610612764,1610612766,106.0,104.0,0.466,0.506,1,2005-04-17,80,45,35,0.563,80,17,63,0.213
20401199,1610612752,1610612737,135.0,139.0,0.511,0.5539999999999999,0,2005-04-17,80,32,48,0.4,80,13,67,0.163
20401194,1610612765,1610612739,90.0,87.0,0.4679999999999999,0.371,1,2005-04-17,80,53,27,0.6629999999999999,80,40,40,0.5
20401193,1610612748,1610612754,84.0,80.0,0.441,0.351,1,2005-04-17,80,57,23,0.713,80,43,37,0.5379999999999999
20401200,1610612757,1610612762,100.0,82.0,0.542,0.386,1,2005-04-17,80,26,54,0.325,80,25,55,0.313
20401197,1610612761,1610612738,98.0,103.0,0.452,0.537,0,2005-04-17,80,32,48,0.4,80,45,35,0.563
20401198,1610612751,1610612755,104.0,83.0,0.4579999999999999,0.38,1,2005-04-17,80,40,40,0.5,80,41,39,0.513
20401191,1610612746,1610612740,94.0,89.0,0.535,0.397,1,2005-04-16,80,36,44,0.45,80,18,62,0.225
20401189,1610612759,1610612763,97.0,75.0,0.493,0.3289999999999999,1,2005-04-16,80,59,21,0.738,80,44,36,0.55
20401186,1610612737,1610612741,105.0,114.0,0.47,0.487,0,2005-04-16,79,12,67,0.152,80,46,34,0.575
20401190,1610612756,1610612758,116.0,98.0,0.494,0.381,1,2005-04-16,80,61,19,0.763,80,49,31,0.613
20401187,1610612745,1610612743,115.0,87.0,0.519,0.413,1,2005-04-16,80,49,31,0.613,80,48,32,0.6
20401185,1610612766,1610612752,98.0,100.0,0.4529999999999999,0.493,0,2005-04-16,79,17,62,0.215,79,32,47,0.405
20401188,1610612749,1610612753,113.0,103.0,0.494,0.473,1,2005-04-16,80,30,50,0.375,80,35,45,0.4379999999999999
20401182,1610612747,1610612758,106.0,115.0,0.449,0.47,0,2005-04-15,79,34,45,0.43,79,49,30,0.62
20401177,1610612754,1610612755,86.0,90.0,0.341,0.4270000000000001,0,2005-04-15,79,43,36,0.544,79,41,38,0.519
20401174,1610612764,1610612739,119.0,111.0,0.59,0.447,1,2005-04-15,79,44,35,0.557,79,40,39,0.506
20401181,1610612756,1610612746,98.0,91.0,0.3779999999999999,0.483,1,2005-04-15,79,60,19,0.759,79,35,44,0.4429999999999999
20401176,1610612765,1610612749,99.0,73.0,0.5,0.382,1,2005-04-15,79,52,27,0.6579999999999999,79,29,50,0.3670000000000001
20401175,1610612738,1610612748,101.0,99.0,0.4629999999999999,0.507,1,2005-04-15,79,44,35,0.557,79,56,23,0.7090000000000001
20401178,1610612741,1610612753,117.0,77.0,0.539,0.341,1,2005-04-15,79,45,34,0.57,79,35,44,0.4429999999999999
20401183,1610612744,1610612757,108.0,88.0,0.422,0.348,1,2005-04-15,80,32,48,0.4,79,25,54,0.316
20401179,1610612743,1610612763,111.0,102.0,0.481,0.471,1,2005-04-15,79,48,31,0.608,79,44,35,0.557
20401173,1610612761,1610612751,90.0,101.0,0.477,0.461,0,2005-04-15,79,32,47,0.405,79,39,40,0.494
20401180,1610612762,1610612750,84.0,100.0,0.409,0.4679999999999999,0,2005-04-15,79,25,54,0.316,79,42,37,0.532
20401184,1610612760,1610612740,97.0,72.0,0.436,0.371,1,2005-04-15,79,51,28,0.6459999999999999,79,18,61,0.228
20401171,1610612739,1610612752,89.0,95.0,0.414,0.507,0,2005-04-14,78,40,38,0.513,78,31,47,0.397
20401172,1610612757,1610612742,90.0,102.0,0.5,0.4529999999999999,0,2005-04-14,78,25,53,0.321,79,55,24,0.696
20401170,1610612755,1610612748,126.0,119.0,0.441,0.511,1,2005-04-14,78,40,38,0.513,78,56,22,0.718
20401163,1610612754,1610612751,90.0,86.0,0.3670000000000001,0.431,1,2005-04-13,78,43,35,0.551,78,38,40,0.487
20401165,1610612750,1610612744,116.0,100.0,0.568,0.429,1,2005-04-13,78,41,37,0.526,79,31,48,0.392
20401160,1610612764,1610612741,93.0,82.0,0.414,0.337,1,2005-04-13,78,43,35,0.551,78,44,34,0.564
20401162,1610612765,1610612753,103.0,94.0,0.4679999999999999,0.412,1,2005-04-13,78,51,27,0.654,78,35,43,0.449
20401166,1610612745,1610612763,100.0,92.0,0.434,0.435,1,2005-04-13,79,48,31,0.608,78,44,34,0.564
20401161,1610612766,1610612737,105.0,84.0,0.536,0.405,1,2005-04-13,78,17,61,0.218,78,12,66,0.154
20401167,1610612743,1610612740,116.0,102.0,0.505,0.451,1,2005-04-13,78,47,31,0.603,78,18,60,0.231
20401164,1610612749,1610612738,108.0,111.0,0.494,0.575,0,2005-04-13,78,29,49,0.3720000000000001,78,43,35,0.551
20401169,1610612762,1610612759,93.0,91.0,0.4429999999999999,0.414,1,2005-04-13,78,25,53,0.321,79,58,21,0.7340000000000001
20401168,1610612760,1610612742,90.0,95.0,0.407,0.514,0,2005-04-13,78,50,28,0.6409999999999999,78,54,24,0.6920000000000001
20401159,1610612746,1610612762,94.0,85.0,0.4579999999999999,0.407,1,2005-04-12,78,35,43,0.449,77,24,53,0.312
20401157,1610612759,1610612757,95.0,89.0,0.419,0.45,1,2005-04-12,78,58,20,0.7440000000000001,77,25,52,0.325
20401156,1610612752,1610612761,93.0,105.0,0.429,0.493,0,2005-04-12,77,30,47,0.39,78,32,46,0.41
20401158,1610612756,1610612740,99.0,85.0,0.418,0.379,1,2005-04-12,78,59,19,0.7559999999999999,77,18,59,0.2339999999999999
20401155,1610612755,1610612738,98.0,105.0,0.449,0.456,0,2005-04-12,77,39,38,0.506,77,42,35,0.545
20401154,1610612747,1610612756,97.0,108.0,0.4479999999999999,0.488,0,2005-04-11,78,34,44,0.436,77,58,19,0.753
20401147,1610612764,1610612749,119.0,112.0,0.536,0.506,1,2005-04-11,77,42,35,0.545,77,29,48,0.377
20401149,1610612737,1610612766,105.0,110.0,0.462,0.478,0,2005-04-11,77,12,65,0.156,77,16,61,0.208
20401151,1610612742,1610612763,110.0,89.0,0.488,0.415,1,2005-04-11,77,53,24,0.688,77,44,33,0.5710000000000001
20401150,1610612741,1610612765,84.0,85.0,0.351,0.391,0,2005-04-11,77,44,33,0.5710000000000001,77,50,27,0.649
20401152,1610612743,1610612744,122.0,106.0,0.529,0.4320000000000001,1,2005-04-11,77,46,31,0.597,78,31,47,0.397
20401146,1610612761,1610612754,90.0,94.0,0.456,0.429,0,2005-04-11,77,31,46,0.4029999999999999,77,42,35,0.545
20401153,1610612760,1610612745,78.0,90.0,0.341,0.433,0,2005-04-11,77,50,27,0.649,78,47,31,0.603
20401148,1610612753,1610612739,106.0,114.0,0.5539999999999999,0.484,0,2005-04-11,77,35,42,0.455,77,40,37,0.519
20401141,1610612754,1610612752,112.0,113.0,0.471,0.534,0,2005-04-10,76,41,35,0.539,76,30,46,0.395
20401140,1610612748,1610612765,72.0,80.0,0.346,0.377,0,2005-04-10,77,56,21,0.727,76,49,27,0.645
20401145,1610612744,1610612759,134.0,136.0,0.467,0.4379999999999999,0,2005-04-10,77,31,46,0.4029999999999999,77,57,20,0.74
20401142,1610612758,1610612747,124.0,105.0,0.51,0.42,1,2005-04-10,78,48,30,0.615,77,34,43,0.442
20401144,1610612763,1610612766,102.0,95.0,0.472,0.424,1,2005-04-10,76,44,32,0.579,76,15,61,0.1969999999999999
20401143,1610612740,1610612757,81.0,90.0,0.413,0.422,0,2005-04-10,76,18,58,0.237,76,25,51,0.3289999999999999
20401139,1610612746,1610612759,124.0,125.0,0.5770000000000001,0.414,0,2005-04-09,77,34,43,0.442,76,56,20,0.737
20401132,1610612764,1610612755,106.0,112.0,0.451,0.506,0,2005-04-09,76,41,35,0.539,76,39,37,0.513
20401133,1610612737,1610612750,105.0,98.0,0.494,0.456,1,2005-04-09,76,12,64,0.158,77,40,37,0.519
20401138,1610612756,1610612745,97.0,98.0,0.418,0.4,0,2005-04-09,76,57,19,0.75,77,46,31,0.597
20401134,1610612739,1610612749,98.0,81.0,0.478,0.414,1,2005-04-09,76,39,37,0.513,76,29,47,0.382
20401136,1610612742,1610612762,88.0,81.0,0.418,0.373,1,2005-04-09,76,52,24,0.684,76,24,52,0.316
20401135,1610612741,1610612761,110.0,97.0,0.435,0.48,1,2005-04-09,76,44,32,0.579,76,31,45,0.408
20401137,1610612743,1610612760,121.0,105.0,0.5710000000000001,0.444,1,2005-04-09,76,45,31,0.5920000000000001,76,50,26,0.6579999999999999
20401131,1610612751,1610612738,99.0,86.0,0.471,0.452,1,2005-04-09,77,38,39,0.494,76,41,35,0.539
20401123,1610612754,1610612764,93.0,83.0,0.414,0.392,1,2005-04-08,75,41,34,0.547,75,41,34,0.547
20401127,1610612750,1610612743,104.0,107.0,0.386,0.489,0,2005-04-08,76,40,36,0.526,75,44,31,0.5870000000000001
20401122,1610612752,1610612741,94.0,102.0,0.42,0.522,0,2005-04-08,75,29,46,0.387,75,43,32,0.573
20401129,1610612744,1610612756,127.0,119.0,0.457,0.4429999999999999,1,2005-04-08,76,31,45,0.408,75,57,18,0.76
20401128,1610612757,1610612758,115.0,119.0,0.547,0.462,0,2005-04-08,75,24,51,0.32,77,47,30,0.61
20401124,1610612763,1610612748,97.0,81.0,0.493,0.387,1,2005-04-08,75,43,32,0.573,76,56,20,0.737
20401119,1610612761,1610612737,109.0,101.0,0.414,0.42,1,2005-04-08,75,31,44,0.413,75,11,64,0.147
20401125,1610612740,1610612762,87.0,98.0,0.416,0.5479999999999999,0,2005-04-08,75,18,57,0.24,75,24,51,0.32
20401126,1610612749,1610612766,93.0,75.0,0.493,0.322,1,2005-04-08,75,29,46,0.387,75,15,60,0.2
20401130,1610612760,1610612747,94.0,117.0,0.413,0.512,0,2005-04-08,75,50,25,0.667,76,34,42,0.447
20401120,1610612755,1610612739,103.0,98.0,0.477,0.407,1,2005-04-08,75,38,37,0.507,75,38,37,0.507
20401121,1610612753,1610612765,102.0,114.0,0.494,0.545,0,2005-04-08,76,35,41,0.461,75,48,27,0.64
20401118,1610612747,1610612745,100.0,114.0,0.379,0.489,0,2005-04-07,75,33,42,0.44,76,45,31,0.5920000000000001
20401117,1610612742,1610612759,104.0,68.0,0.532,0.346,1,2005-04-07,75,51,24,0.68,75,55,20,0.733
20401116,1610612751,1610612752,110.0,98.0,0.506,0.466,1,2005-04-07,76,37,39,0.487,74,29,45,0.392
20401113,1610612759,1610612746,91.0,82.0,0.44,0.387,1,2005-04-06,74,55,19,0.743,76,34,42,0.447
20401110,1610612754,1610612739,98.0,77.0,0.471,0.361,1,2005-04-06,74,40,34,0.541,74,38,36,0.514
20401114,1610612750,1610612762,111.0,86.0,0.532,0.4320000000000001,1,2005-04-06,75,40,35,0.5329999999999999,74,23,51,0.311
20401111,1610612765,1610612764,105.0,93.0,0.488,0.444,1,2005-04-06,74,47,27,0.635,74,41,33,0.5539999999999999
20401106,1610612738,1610612749,103.0,97.0,0.514,0.452,1,2005-04-06,75,41,34,0.547,74,28,46,0.3779999999999999
20401115,1610612757,1610612744,102.0,104.0,0.487,0.406,0,2005-04-06,74,24,50,0.324,75,30,45,0.4
20401107,1610612761,1610612763,74.0,104.0,0.346,0.5479999999999999,0,2005-04-06,74,30,44,0.405,74,42,32,0.568
20401112,1610612740,1610612743,83.0,94.0,0.376,0.434,0,2005-04-06,74,18,56,0.243,74,43,31,0.581
20401109,1610612753,1610612741,101.0,102.0,0.4429999999999999,0.3429999999999999,0,2005-04-06,75,35,40,0.467,74,42,32,0.568
20401108,1610612755,1610612766,106.0,103.0,0.457,0.481,1,2005-04-06,74,37,37,0.5,74,15,59,0.203
20401094,1610612764,1610612738,108.0,116.0,0.3779999999999999,0.506,0,2005-04-05,73,41,32,0.562,74,40,34,0.541
20401097,1610612752,1610612754,79.0,97.0,0.408,0.435,0,2005-04-05,73,29,44,0.397,73,39,34,0.534
20401098,1610612737,1610612740,86.0,96.0,0.449,0.462,0,2005-04-05,74,11,63,0.149,73,18,55,0.247
20401103,1610612756,1610612747,125.0,99.0,0.557,0.412,1,2005-04-05,74,57,17,0.77,74,33,41,0.446
20401096,1610612739,1610612751,80.0,111.0,0.425,0.573,0,2005-04-05,73,38,35,0.521,75,36,39,0.48
20401099,1610612748,1610612741,104.0,86.0,0.544,0.364,1,2005-04-05,75,56,19,0.747,73,41,32,0.562
20401101,1610612742,1610612753,114.0,105.0,0.526,0.532,1,2005-04-05,74,50,24,0.6759999999999999,74,35,39,0.473
20401105,1610612744,1610612745,122.0,117.0,0.488,0.495,1,2005-04-05,74,29,45,0.392,75,44,31,0.5870000000000001
20401095,1610612766,1610612746,102.0,104.0,0.444,0.42,0,2005-04-05,73,15,58,0.205,75,34,41,0.4529999999999999
20401104,1610612758,1610612760,122.0,101.0,0.588,0.476,1,2005-04-05,76,46,30,0.605,74,50,24,0.6759999999999999
20401100,1610612763,1610612743,91.0,94.0,0.447,0.506,0,2005-04-05,73,41,32,0.562,73,42,31,0.575
20401102,1610612762,1610612757,90.0,79.0,0.465,0.456,1,2005-04-05,73,23,50,0.315,73,24,49,0.3289999999999999
20401084,1610612764,1610612754,76.0,79.0,0.356,0.355,0,2005-04-03,72,41,31,0.569,72,38,34,0.528
20401090,1610612737,1610612746,91.0,111.0,0.43,0.573,0,2005-04-03,73,11,62,0.151,74,33,41,0.446
20401085,1610612739,1610612742,100.0,80.0,0.415,0.354,1,2005-04-03,72,38,34,0.528,73,49,24,0.6709999999999999
20401093,1610612745,1610612756,78.0,91.0,0.34,0.444,0,2005-04-03,74,44,30,0.595,73,56,17,0.767
20401088,1610612738,1610612755,93.0,97.0,0.392,0.365,0,2005-04-03,73,39,34,0.534,73,36,37,0.493
20401091,1610612744,1610612760,101.0,92.0,0.5,0.345,1,2005-04-03,73,28,45,0.384,73,50,23,0.685
20401087,1610612758,1610612750,100.0,112.0,0.384,0.53,0,2005-04-03,75,45,30,0.6,74,39,35,0.527
20401092,1610612763,1610612747,102.0,82.0,0.4589999999999999,0.379,1,2005-04-03,72,41,31,0.569,73,33,40,0.452
20401089,1610612761,1610612765,103.0,113.0,0.425,0.579,0,2005-04-03,73,30,43,0.411,73,46,27,0.63
20401086,1610612749,1610612752,106.0,102.0,0.545,0.422,1,2005-04-03,73,28,45,0.384,72,29,43,0.4029999999999999
20401082,1610612759,1610612747,95.0,94.0,0.4639999999999999,0.4379999999999999,1,2005-04-02,73,54,19,0.74,72,33,39,0.4579999999999999
20401081,1610612741,1610612766,112.0,97.0,0.488,0.436,1,2005-04-02,72,41,31,0.569,72,15,57,0.208
20401083,1610612757,1610612743,97.0,103.0,0.447,0.532,0,2005-04-02,72,24,48,0.3329999999999999,72,41,31,0.569
20401080,1610612740,1610612748,99.0,111.0,0.5,0.55,0,2005-04-02,72,17,55,0.236,74,55,19,0.743
20401079,1610612751,1610612753,102.0,103.0,0.44,0.4639999999999999,0,2005-04-02,74,35,39,0.473,73,35,38,0.479
20401070,1610612752,1610612751,91.0,93.0,0.384,0.473,0,2005-04-01,71,29,42,0.408,73,35,38,0.479
20401069,1610612737,1610612738,100.0,116.0,0.417,0.6,0,2005-04-01,72,11,61,0.153,72,39,33,0.542
20401076,1610612756,1610612750,107.0,98.0,0.415,0.4320000000000001,1,2005-04-01,72,55,17,0.764,73,38,35,0.521
20401072,1610612739,1610612758,109.0,128.0,0.514,0.5710000000000001,0,2005-04-01,71,37,34,0.521,74,45,29,0.608
20401071,1610612765,1610612746,97.0,84.0,0.494,0.449,1,2005-04-01,72,45,27,0.625,73,32,41,0.4379999999999999
20401074,1610612745,1610612740,73.0,76.0,0.308,0.306,0,2005-04-01,73,44,29,0.603,71,17,54,0.239
20401067,1610612766,1610612761,107.0,119.0,0.514,0.506,0,2005-04-01,71,15,56,0.211,72,30,42,0.417
20401077,1610612743,1610612759,102.0,84.0,0.436,0.318,1,2005-04-01,71,40,31,0.563,72,53,19,0.736
20401073,1610612749,1610612763,82.0,93.0,0.352,0.4579999999999999,0,2005-04-01,72,27,45,0.375,71,40,31,0.563
20401078,1610612760,1610612757,89.0,87.0,0.43,0.472,1,2005-04-01,72,50,22,0.6940000000000001,71,24,47,0.3379999999999999
20401075,1610612762,1610612744,91.0,108.0,0.345,0.462,0,2005-04-01,72,22,50,0.306,72,27,45,0.375
20401068,1610612753,1610612764,102.0,111.0,0.4270000000000001,0.4579999999999999,0,2005-04-01,72,34,38,0.472,71,41,30,0.5770000000000001
20401066,1610612755,1610612742,83.0,100.0,0.3779999999999999,0.446,0,2005-04-01,72,35,37,0.486,72,49,23,0.6809999999999999
20401065,1610612747,1610612750,96.0,105.0,0.415,0.526,0,2005-03-31,71,33,38,0.465,72,38,34,0.528
20401063,1610612754,1610612748,114.0,108.0,0.4589999999999999,0.518,1,2005-03-31,71,37,34,0.521,73,54,19,0.74
20401064,1610612741,1610612739,102.0,90.0,0.469,0.3929999999999999,1,2005-03-31,71,40,31,0.563,70,37,33,0.529
20401059,1610612759,1610612760,89.0,76.0,0.44,0.39,1,2005-03-30,71,53,18,0.746,71,49,22,0.69
20401053,1610612764,1610612737,102.0,99.0,0.493,0.506,1,2005-03-30,70,40,30,0.5710000000000001,71,11,60,0.155
20401061,1610612756,1610612755,116.0,87.0,0.494,0.351,1,2005-03-30,71,54,17,0.7609999999999999,71,35,36,0.493
20401057,1610612765,1610612758,99.0,82.0,0.488,0.391,1,2005-03-30,71,44,27,0.62,73,44,29,0.603
20401052,1610612738,1610612742,100.0,112.0,0.447,0.513,0,2005-03-30,71,38,33,0.535,71,48,23,0.6759999999999999
20401062,1610612757,1610612745,84.0,100.0,0.478,0.4589999999999999,0,2005-03-30,70,24,46,0.3429999999999999,72,44,28,0.611
20401054,1610612766,1610612741,99.0,102.0,0.424,0.452,0,2005-03-30,70,15,55,0.214,70,39,31,0.557
20401058,1610612749,1610612744,109.0,113.0,0.466,0.456,0,2005-03-30,71,27,44,0.38,71,26,45,0.366
20401060,1610612762,1610612743,98.0,109.0,0.494,0.5489999999999999,0,2005-03-30,71,22,49,0.31,70,39,31,0.557
20401056,1610612751,1610612746,95.0,78.0,0.477,0.422,1,2005-03-30,72,34,38,0.472,72,32,40,0.444
20401055,1610612753,1610612761,108.0,96.0,0.467,0.493,1,2005-03-30,71,34,37,0.479,71,29,42,0.408
20401051,1610612747,1610612752,117.0,107.0,0.534,0.461,1,2005-03-29,70,33,37,0.471,70,29,41,0.414
20401048,1610612739,1610612746,94.0,84.0,0.436,0.429,1,2005-03-29,69,37,32,0.536,71,32,39,0.451
20401049,1610612748,1610612761,103.0,91.0,0.487,0.4320000000000001,1,2005-03-29,72,54,18,0.75,70,29,41,0.414
20401050,1610612763,1610612760,99.0,102.0,0.5479999999999999,0.456,0,2005-03-29,70,39,31,0.557,70,49,21,0.7
20401044,1610612756,1610612743,123.0,114.0,0.55,0.478,1,2005-03-28,70,53,17,0.757,69,38,31,0.551
20401039,1610612765,1610612742,88.0,95.0,0.439,0.4589999999999999,0,2005-03-28,70,43,27,0.614,70,47,23,0.6709999999999999
20401042,1610612741,1610612763,94.0,86.0,0.455,0.436,1,2005-03-28,69,38,31,0.551,69,39,30,0.565
20401047,1610612744,1610612752,108.0,100.0,0.435,0.4379999999999999,1,2005-03-28,70,25,45,0.357,69,29,40,0.42
20401037,1610612766,1610612751,91.0,95.0,0.42,0.422,0,2005-03-28,69,15,54,0.217,71,33,38,0.465
20401046,1610612757,1610612764,106.0,114.0,0.524,0.477,0,2005-03-28,69,24,45,0.348,69,39,30,0.565
20401045,1610612758,1610612755,118.0,109.0,0.5,0.479,1,2005-03-28,72,44,28,0.611,70,35,35,0.5
20401040,1610612749,1610612754,76.0,90.0,0.4,0.444,0,2005-03-28,70,27,43,0.386,70,36,34,0.514
20401041,1610612740,1610612739,108.0,109.0,0.494,0.4679999999999999,0,2005-03-28,70,16,54,0.2289999999999999,68,36,32,0.529
20401043,1610612762,1610612745,85.0,99.0,0.478,0.531,0,2005-03-28,70,22,48,0.314,71,43,28,0.606
20401038,1610612753,1610612737,109.0,102.0,0.4629999999999999,0.409,1,2005-03-28,70,33,37,0.471,70,11,59,0.157
20401035,1610612747,1610612755,89.0,96.0,0.425,0.396,0,2005-03-27,69,32,37,0.4639999999999999,69,35,34,0.507
20401033,1610612759,1610612745,83.0,70.0,0.363,0.426,1,2005-03-27,70,52,18,0.743,70,42,28,0.6
20401034,1610612750,1610612746,89.0,85.0,0.42,0.4320000000000001,1,2005-03-27,71,37,34,0.521,70,32,38,0.457
20401036,1610612760,1610612764,94.0,95.0,0.39,0.439,0,2005-03-27,69,48,21,0.696,68,38,30,0.5589999999999999
20401024,1610612737,1610612761,104.0,109.0,0.532,0.493,0,2005-03-26,69,11,58,0.159,69,29,40,0.42
20401026,1610612765,1610612738,105.0,99.0,0.429,0.461,1,2005-03-26,69,43,26,0.623,70,38,32,0.5429999999999999
20401029,1610612742,1610612739,117.0,86.0,0.55,0.421,1,2005-03-26,69,46,23,0.667,67,35,32,0.522
20401028,1610612741,1610612754,100.0,96.0,0.4,0.413,1,2005-03-26,68,37,31,0.544,69,35,34,0.507
20401023,1610612766,1610612748,94.0,92.0,0.4579999999999999,0.44,1,2005-03-26,68,15,53,0.221,71,53,18,0.746
20401032,1610612757,1610612752,103.0,96.0,0.52,0.45,1,2005-03-26,68,24,44,0.353,68,29,39,0.426
20401027,1610612763,1610612740,85.0,96.0,0.397,0.474,0,2005-03-26,68,39,29,0.574,69,16,53,0.2319999999999999
20401030,1610612743,1610612758,113.0,99.0,0.542,0.425,1,2005-03-26,68,38,30,0.5589999999999999,71,43,28,0.606
20401031,1610612762,1610612749,94.0,89.0,0.471,0.4379999999999999,1,2005-03-26,69,22,47,0.319,69,27,42,0.391
20401022,1610612751,1610612750,75.0,96.0,0.356,0.469,0,2005-03-26,70,32,38,0.457,70,36,34,0.514
20401025,1610612753,1610612756,116.0,118.0,0.483,0.532,0,2005-03-26,69,32,37,0.4639999999999999,69,52,17,0.754
20401019,1610612746,1610612764,98.0,94.0,0.462,0.446,1,2005-03-25,69,32,37,0.4639999999999999,67,37,30,0.552
20401018,1610612759,1610612737,111.0,95.0,0.521,0.452,1,2005-03-25,69,51,18,0.7390000000000001,68,11,57,0.162
20401016,1610612765,1610612754,81.0,94.0,0.4,0.457,0,2005-03-25,68,42,26,0.618,68,35,33,0.515
20401015,1610612748,1610612756,125.0,115.0,0.551,0.494,1,2005-03-25,70,53,17,0.757,68,51,17,0.75
20401014,1610612738,1610612741,86.0,94.0,0.373,0.436,0,2005-03-25,69,38,31,0.551,67,36,31,0.537
20401020,1610612744,1610612749,118.0,117.0,0.489,0.506,1,2005-03-25,69,24,45,0.348,68,27,41,0.397
20401017,1610612740,1610612745,68.0,81.0,0.351,0.366,0,2005-03-25,68,15,53,0.221,69,42,27,0.609
20401021,1610612760,1610612752,109.0,101.0,0.444,0.417,1,2005-03-25,68,48,20,0.706,67,29,38,0.433
20401013,1610612755,1610612761,103.0,101.0,0.47,0.434,1,2005-03-25,68,34,34,0.5,68,28,40,0.412
20401008,1610612745,1610612739,99.0,80.0,0.478,0.39,1,2005-03-24,68,41,27,0.603,66,35,31,0.53
20401012,1610612757,1610612760,91.0,96.0,0.473,0.434,0,2005-03-24,67,23,44,0.3429999999999999,67,47,20,0.701
20401011,1610612758,1610612742,109.0,101.0,0.462,0.435,1,2005-03-24,70,43,27,0.614,68,45,23,0.662
20401009,1610612743,1610612747,117.0,96.0,0.483,0.395,1,2005-03-24,67,37,30,0.552,68,32,36,0.471
20401010,1610612762,1610612764,84.0,85.0,0.422,0.3939999999999999,0,2005-03-24,68,21,47,0.309,66,37,29,0.561
20401007,1610612751,1610612763,96.0,105.0,0.4029999999999999,0.569,0,2005-03-24,69,32,37,0.4639999999999999,67,39,28,0.5820000000000001
20401006,1610612753,1610612766,94.0,108.0,0.4039999999999999,0.4529999999999999,0,2005-03-24,68,32,36,0.471,67,14,53,0.209
20401004,1610612746,1610612749,116.0,108.0,0.584,0.418,1,2005-03-23,68,31,37,0.456,67,27,40,0.4029999999999999
20401000,1610612754,1610612759,100.0,93.0,0.493,0.384,1,2005-03-23,67,34,33,0.507,68,50,18,0.735
20401003,1610612750,1610612740,107.0,102.0,0.514,0.429,1,2005-03-23,69,35,34,0.507,67,15,52,0.2239999999999999
20401001,1610612752,1610612738,107.0,82.0,0.521,0.3829999999999999,1,2005-03-23,66,29,37,0.439,68,38,30,0.5589999999999999
20401005,1610612744,1610612742,97.0,109.0,0.4,0.4679999999999999,0,2005-03-23,68,23,45,0.3379999999999999,67,45,22,0.672
20400999,1610612766,1610612756,105.0,120.0,0.413,0.478,0,2005-03-23,66,13,53,0.1969999999999999,67,51,16,0.7609999999999999
20400998,1610612761,1610612741,85.0,94.0,0.318,0.4679999999999999,0,2005-03-23,67,28,39,0.418,66,35,31,0.53
20401002,1610612755,1610612765,107.0,84.0,0.539,0.3779999999999999,1,2005-03-23,67,33,34,0.493,67,42,25,0.627
20400992,1610612737,1610612756,94.0,105.0,0.47,0.44,0,2005-03-22,67,11,56,0.1639999999999999,66,50,16,0.758
20400990,1610612739,1610612765,91.0,76.0,0.487,0.37,1,2005-03-22,65,35,30,0.5379999999999999,66,42,24,0.636
20400995,1610612745,1610612748,84.0,82.0,0.354,0.4,1,2005-03-22,67,40,27,0.597,69,52,17,0.754
20400996,1610612758,1610612757,112.0,93.0,0.446,0.4679999999999999,1,2005-03-22,69,42,27,0.609,66,23,43,0.348
20400993,1610612743,1610612764,127.0,98.0,0.556,0.397,1,2005-03-22,66,36,30,0.545,65,36,29,0.5539999999999999
20400994,1610612762,1610612747,115.0,107.0,0.5920000000000001,0.5,1,2005-03-22,67,21,46,0.313,67,32,35,0.478
20400997,1610612760,1610612749,92.0,84.0,0.405,0.41,1,2005-03-22,66,46,20,0.6970000000000001,66,27,39,0.409
20400991,1610612751,1610612754,98.0,91.0,0.507,0.377,1,2005-03-22,68,32,36,0.471,66,33,33,0.5
20400989,1610612746,1610612757,96.0,89.0,0.48,0.341,1,2005-03-21,67,30,37,0.4479999999999999,65,23,42,0.354
20400986,1610612752,1610612759,88.0,75.0,0.39,0.384,1,2005-03-21,65,28,37,0.431,67,50,17,0.746
20400988,1610612742,1610612740,103.0,86.0,0.418,0.3939999999999999,1,2005-03-21,66,44,22,0.667,66,15,51,0.2269999999999999
20400987,1610612741,1610612737,105.0,91.0,0.475,0.436,1,2005-03-21,65,34,31,0.523,66,11,55,0.1669999999999999
20400985,1610612766,1610612753,102.0,97.0,0.446,0.4429999999999999,1,2005-03-21,65,13,52,0.2,67,32,35,0.478
20400984,1610612747,1610612760,100.0,102.0,0.4589999999999999,0.472,0,2005-03-20,66,32,34,0.485,65,45,20,0.6920000000000001
20400979,1610612754,1610612751,85.0,94.0,0.449,0.444,0,2005-03-20,65,33,32,0.508,67,31,36,0.4629999999999999
20400981,1610612750,1610612745,94.0,86.0,0.434,0.352,1,2005-03-20,68,34,34,0.5,66,39,27,0.591
20400978,1610612765,1610612759,110.0,101.0,0.514,0.476,1,2005-03-20,65,42,23,0.6459999999999999,66,50,16,0.758
20400983,1610612758,1610612744,94.0,104.0,0.3979999999999999,0.447,0,2005-03-20,68,41,27,0.603,67,23,44,0.3429999999999999
20400980,1610612763,1610612756,91.0,97.0,0.451,0.487,0,2005-03-20,66,38,28,0.5760000000000001,65,49,16,0.754
20400982,1610612743,1610612749,114.0,103.0,0.562,0.435,1,2005-03-20,65,35,30,0.5379999999999999,65,27,38,0.415
20400977,1610612761,1610612739,105.0,98.0,0.462,0.4320000000000001,1,2005-03-20,66,28,38,0.424,64,34,30,0.531
20400976,1610612746,1610612758,107.0,111.0,0.442,0.412,0,2005-03-19,66,29,37,0.439,67,41,26,0.612
20400971,1610612764,1610612762,96.0,95.0,0.4370000000000001,0.524,1,2005-03-19,64,36,28,0.563,66,20,46,0.303
20400972,1610612748,1610612752,97.0,82.0,0.4629999999999999,0.3879999999999999,1,2005-03-19,68,52,16,0.765,64,27,37,0.422
20400974,1610612742,1610612766,104.0,93.0,0.452,0.416,1,2005-03-19,65,43,22,0.662,64,12,52,0.188
20400975,1610612757,1610612753,92.0,97.0,0.471,0.418,0,2005-03-19,64,23,41,0.359,66,32,34,0.485
20400973,1610612740,1610612738,100.0,113.0,0.476,0.521,0,2005-03-19,65,15,50,0.231,67,38,29,0.5670000000000001
20400970,1610612755,1610612741,88.0,94.0,0.355,0.374,0,2005-03-19,66,32,34,0.485,64,33,31,0.516
20400966,1610612759,1610612766,93.0,76.0,0.4429999999999999,0.373,1,2005-03-18,65,50,15,0.769,63,12,51,0.19
20400960,1610612754,1610612747,103.0,97.0,0.519,0.418,1,2005-03-18,64,33,31,0.516,65,32,33,0.4920000000000001
20400958,1610612737,1610612752,92.0,106.0,0.384,0.526,0,2005-03-18,65,11,54,0.1689999999999999,63,27,36,0.429
20400968,1610612756,1610612744,100.0,110.0,0.412,0.457,0,2005-03-18,64,48,16,0.75,66,22,44,0.3329999999999999
20400959,1610612739,1610612755,81.0,93.0,0.319,0.39,0,2005-03-18,63,34,29,0.54,65,32,33,0.4920000000000001
20400961,1610612765,1610612761,103.0,92.0,0.4629999999999999,0.402,1,2005-03-18,64,41,23,0.6409999999999999,65,27,38,0.415
20400965,1610612745,1610612738,92.0,103.0,0.4270000000000001,0.493,0,2005-03-18,65,39,26,0.6,66,37,29,0.561
20400963,1610612741,1610612740,90.0,94.0,0.377,0.389,0,2005-03-18,63,32,31,0.508,64,15,49,0.2339999999999999
20400962,1610612763,1610612750,88.0,83.0,0.4320000000000001,0.473,1,2005-03-18,65,38,27,0.585,67,33,34,0.493
20400967,1610612743,1610612746,115.0,96.0,0.5710000000000001,0.395,1,2005-03-18,64,34,30,0.531,65,29,36,0.446
20400964,1610612749,1610612764,99.0,90.0,0.461,0.395,1,2005-03-18,64,27,37,0.422,63,35,28,0.556
20400969,1610612760,1610612753,98.0,90.0,0.457,0.506,1,2005-03-18,64,44,20,0.688,65,31,34,0.477
20400957,1610612751,1610612762,94.0,80.0,0.493,0.47,1,2005-03-18,66,30,36,0.455,65,20,45,0.308
20400954,1610612748,1610612747,102.0,89.0,0.475,0.379,1,2005-03-17,67,51,16,0.7609999999999999,64,32,32,0.5
20400955,1610612742,1610612757,98.0,94.0,0.412,0.4270000000000001,1,2005-03-17,64,42,22,0.6559999999999999,63,23,40,0.365
20400956,1610612744,1610612758,100.0,97.0,0.444,0.429,1,2005-03-17,65,21,44,0.3229999999999999,66,40,26,0.606
20400953,1610612746,1610612753,110.0,102.0,0.481,0.506,1,2005-03-16,64,29,35,0.4529999999999999,64,31,33,0.484
20400951,1610612759,1610612750,89.0,73.0,0.439,0.391,1,2005-03-16,64,49,15,0.7659999999999999,66,33,33,0.5
20400944,1610612754,1610612762,103.0,84.0,0.439,0.484,1,2005-03-16,63,32,31,0.508,64,20,44,0.313
20400946,1610612737,1610612764,93.0,122.0,0.439,0.597,0,2005-03-16,64,11,53,0.172,62,35,27,0.565
20400947,1610612765,1610612760,102.0,95.0,0.451,0.494,1,2005-03-16,63,40,23,0.635,63,43,20,0.6829999999999999
20400950,1610612745,1610612757,108.0,77.0,0.507,0.351,1,2005-03-16,64,39,25,0.609,62,23,39,0.371
20400943,1610612738,1610612761,110.0,109.0,0.545,0.5,1,2005-03-16,65,36,29,0.5539999999999999,64,27,37,0.422
20400952,1610612743,1610612766,120.0,101.0,0.541,0.4370000000000001,1,2005-03-16,63,33,30,0.524,62,12,50,0.1939999999999999
20400948,1610612749,1610612739,96.0,88.0,0.4579999999999999,0.42,1,2005-03-16,63,26,37,0.413,62,34,28,0.5479999999999999
20400949,1610612740,1610612763,82.0,88.0,0.377,0.479,0,2005-03-16,63,14,49,0.222,64,37,27,0.578
20400945,1610612751,1610612741,100.0,84.0,0.476,0.387,1,2005-03-16,65,29,36,0.446,62,32,30,0.516
20400939,1610612752,1610612748,96.0,98.0,0.5,0.5760000000000001,0,2005-03-15,62,26,36,0.419,66,50,16,0.758
20400938,1610612739,1610612762,92.0,73.0,0.439,0.3329999999999999,1,2005-03-15,61,34,27,0.557,63,20,43,0.317
20400941,1610612742,1610612750,91.0,100.0,0.3879999999999999,0.414,0,2005-03-15,63,41,22,0.6509999999999999,65,33,32,0.508
20400940,1610612741,1610612760,93.0,99.0,0.3929999999999999,0.478,0,2005-03-15,61,32,29,0.525,62,43,19,0.6940000000000001
20400942,1610612758,1610612753,105.0,94.0,0.524,0.4320000000000001,1,2005-03-15,65,40,25,0.615,63,31,32,0.4920000000000001
20400937,1610612755,1610612747,108.0,91.0,0.449,0.3670000000000001,1,2005-03-15,64,31,33,0.484,63,32,31,0.508
20400935,1610612759,1610612740,112.0,89.0,0.547,0.433,1,2005-03-14,63,48,15,0.762,62,14,48,0.226
20400930,1610612764,1610612747,95.0,81.0,0.444,0.352,1,2005-03-14,61,34,27,0.557,62,32,30,0.516
20400932,1610612737,1610612765,108.0,114.0,0.517,0.494,0,2005-03-14,63,11,52,0.175,62,39,23,0.629
20400933,1610612748,1610612749,110.0,71.0,0.5539999999999999,0.321,1,2005-03-14,65,49,16,0.754,62,25,37,0.4029999999999999
20400936,1610612744,1610612745,94.0,97.0,0.36,0.4,0,2005-03-14,64,20,44,0.313,63,38,25,0.603
20400931,1610612766,1610612738,110.0,119.0,0.449,0.58,0,2005-03-14,61,12,49,0.1969999999999999,64,35,29,0.547
20400934,1610612763,1610612757,104.0,83.0,0.521,0.465,1,2005-03-14,63,36,27,0.5710000000000001,61,23,38,0.377
20400921,1610612746,1610612741,83.0,78.0,0.423,0.344,1,2005-03-13,63,28,35,0.444,60,32,28,0.5329999999999999
20400920,1610612750,1610612742,93.0,102.0,0.4579999999999999,0.4479999999999999,0,2005-03-13,64,32,32,0.5,62,41,21,0.6609999999999999
20400925,1610612752,1610612760,80.0,90.0,0.312,0.452,0,2005-03-13,61,26,35,0.426,61,42,19,0.6890000000000001
20400928,1610612739,1610612754,98.0,86.0,0.419,0.382,1,2005-03-13,60,33,27,0.55,62,31,31,0.5
20400927,1610612765,1610612762,64.0,62.0,0.315,0.324,1,2005-03-13,61,38,23,0.623,62,20,42,0.3229999999999999
20400923,1610612738,1610612764,105.0,101.0,0.442,0.4320000000000001,1,2005-03-13,63,34,29,0.54,60,33,27,0.55
20400922,1610612758,1610612745,96.0,111.0,0.4039999999999999,0.531,0,2005-03-13,64,39,25,0.609,62,37,25,0.597
20400929,1610612743,1610612756,101.0,106.0,0.3979999999999999,0.461,0,2005-03-13,62,32,30,0.516,63,48,15,0.762
20400924,1610612761,1610612755,128.0,110.0,0.495,0.516,1,2005-03-13,63,27,36,0.429,63,30,33,0.476
20400926,1610612753,1610612751,82.0,98.0,0.3829999999999999,0.479,0,2005-03-13,62,31,31,0.5,64,28,36,0.4379999999999999
20400918,1610612759,1610612743,87.0,90.0,0.423,0.39,0,2005-03-12,62,47,15,0.758,61,32,29,0.525
20400916,1610612737,1610612744,92.0,105.0,0.4479999999999999,0.426,0,2005-03-12,62,11,51,0.177,63,20,43,0.317
20400914,1610612748,1610612751,90.0,65.0,0.478,0.297,1,2005-03-12,64,48,16,0.75,63,27,36,0.429
20400919,1610612757,1610612763,80.0,66.0,0.4429999999999999,0.365,1,2005-03-12,60,23,37,0.3829999999999999,62,35,27,0.565
20400915,1610612766,1610612747,116.0,117.0,0.542,0.544,0,2005-03-12,60,12,48,0.2,61,32,29,0.525
20400917,1610612740,1610612749,111.0,107.0,0.488,0.494,1,2005-03-12,61,14,47,0.23,61,25,36,0.41
20400907,1610612754,1610612744,101.0,83.0,0.4479999999999999,0.389,1,2005-03-11,61,31,30,0.508,62,19,43,0.306
20400911,1610612756,1610612745,107.0,127.0,0.414,0.495,0,2005-03-11,62,47,15,0.758,61,36,25,0.59
20400908,1610612738,1610612765,115.0,113.0,0.43,0.422,1,2005-03-11,62,33,29,0.532,60,37,23,0.617
20400912,1610612758,1610612746,113.0,112.0,0.529,0.5579999999999999,1,2005-03-11,63,39,24,0.619,62,27,35,0.435
20400904,1610612761,1610612737,112.0,116.0,0.4379999999999999,0.505,0,2005-03-11,62,26,36,0.419,61,11,50,0.18
20400909,1610612749,1610612742,110.0,112.0,0.4589999999999999,0.506,0,2005-03-11,60,25,35,0.417,61,40,21,0.6559999999999999
20400910,1610612762,1610612763,82.0,94.0,0.37,0.4920000000000001,0,2005-03-11,61,20,41,0.3279999999999999,61,35,26,0.574
20400913,1610612760,1610612741,97.0,100.0,0.415,0.422,0,2005-03-11,60,41,19,0.6829999999999999,59,32,27,0.542
20400905,1610612755,1610612766,112.0,80.0,0.477,0.402,1,2005-03-11,62,30,32,0.484,59,12,47,0.203
20400906,1610612753,1610612750,96.0,101.0,0.429,0.425,0,2005-03-11,61,31,30,0.508,63,32,31,0.508
20400902,1610612748,1610612750,107.0,90.0,0.48,0.469,1,2005-03-10,63,47,16,0.746,62,31,31,0.5
20400903,1610612742,1610612747,95.0,100.0,0.3670000000000001,0.4529999999999999,0,2005-03-10,60,39,21,0.65,60,31,29,0.517
20400900,1610612756,1610612759,107.0,101.0,0.524,0.4379999999999999,1,2005-03-09,61,47,14,0.77,61,47,14,0.77
20400898,1610612765,1610612744,92.0,88.0,0.377,0.429,1,2005-03-09,59,37,22,0.627,61,19,42,0.311
20400896,1610612738,1610612737,95.0,91.0,0.462,0.419,1,2005-03-09,61,32,29,0.525,60,10,50,0.1669999999999999
20400901,1610612757,1610612741,84.0,97.0,0.4379999999999999,0.429,0,2005-03-09,59,22,37,0.373,58,31,27,0.534
20400897,1610612761,1610612753,106.0,96.0,0.4529999999999999,0.39,1,2005-03-09,61,26,35,0.426,60,31,29,0.517
20400899,1610612740,1610612751,85.0,86.0,0.374,0.369,0,2005-03-09,60,13,47,0.217,62,27,35,0.435
20400895,1610612747,1610612746,101.0,110.0,0.4679999999999999,0.519,0,2005-03-08,59,30,29,0.508,61,27,34,0.4429999999999999
20400891,1610612759,1610612751,90.0,74.0,0.4579999999999999,0.321,1,2005-03-08,60,47,13,0.7829999999999999,61,26,35,0.426
20400890,1610612750,1610612766,102.0,97.0,0.457,0.442,1,2005-03-08,61,31,30,0.508,58,12,46,0.207
20400888,1610612752,1610612764,93.0,83.0,0.395,0.325,1,2005-03-08,60,26,34,0.433,59,33,26,0.5589999999999999
20400887,1610612739,1610612753,111.0,92.0,0.523,0.42,1,2005-03-08,59,32,27,0.542,59,31,28,0.525
20400893,1610612758,1610612763,85.0,82.0,0.361,0.4429999999999999,1,2005-03-08,62,38,24,0.613,60,34,26,0.5670000000000001
20400889,1610612749,1610612737,105.0,101.0,0.474,0.518,1,2005-03-08,59,25,34,0.424,59,10,49,0.1689999999999999
20400892,1610612762,1610612754,83.0,89.0,0.37,0.4529999999999999,0,2005-03-08,60,20,40,0.3329999999999999,60,30,30,0.5
20400894,1610612760,1610612745,95.0,97.0,0.473,0.487,0,2005-03-08,59,41,18,0.695,60,35,25,0.583
20400886,1610612755,1610612744,85.0,104.0,0.375,0.447,0,2005-03-08,61,29,32,0.475,60,19,41,0.317
20400885,1610612746,1610612763,102.0,105.0,0.526,0.471,0,2005-03-07,60,26,34,0.433,59,34,25,0.5760000000000001
20400881,1610612748,1610612755,108.0,100.0,0.5489999999999999,0.461,1,2005-03-07,62,46,16,0.742,60,29,31,0.483
20400883,1610612742,1610612761,113.0,105.0,0.511,0.519,1,2005-03-07,59,39,20,0.6609999999999999,60,25,35,0.417
20400882,1610612741,1610612749,90.0,85.0,0.452,0.4579999999999999,1,2005-03-07,57,30,27,0.526,58,24,34,0.414
20400884,1610612743,1610612757,111.0,98.0,0.43,0.469,1,2005-03-07,60,31,29,0.517,58,22,36,0.379
20400880,1610612747,1610612754,103.0,94.0,0.465,0.417,1,2005-03-06,58,30,28,0.517,59,29,30,0.4920000000000001
20400876,1610612759,1610612762,101.0,94.0,0.471,0.462,1,2005-03-06,59,46,13,0.78,59,20,39,0.3389999999999999
20400877,1610612752,1610612744,115.0,99.0,0.618,0.462,1,2005-03-06,59,25,34,0.424,59,18,41,0.305
20400878,1610612739,1610612748,82.0,102.0,0.4,0.446,0,2005-03-06,58,31,27,0.534,61,45,16,0.738
20400872,1610612745,1610612742,90.0,69.0,0.425,0.3720000000000001,1,2005-03-06,59,34,25,0.5760000000000001,58,38,20,0.655
20400874,1610612738,1610612750,97.0,99.0,0.544,0.5379999999999999,0,2005-03-06,60,31,29,0.517,60,30,30,0.5
20400873,1610612758,1610612765,100.0,85.0,0.494,0.391,1,2005-03-06,61,37,24,0.607,58,36,22,0.621
20400875,1610612740,1610612761,84.0,95.0,0.381,0.466,0,2005-03-06,59,13,46,0.22,59,25,34,0.424
20400879,1610612760,1610612756,99.0,110.0,0.418,0.465,0,2005-03-06,58,41,17,0.7070000000000001,60,46,14,0.767
20400866,1610612746,1610612743,89.0,105.0,0.43,0.494,0,2005-03-05,59,26,33,0.441,59,30,29,0.508
20400868,1610612737,1610612755,97.0,98.0,0.45,0.423,0,2005-03-05,58,10,48,0.172,59,29,30,0.4920000000000001
20400871,1610612756,1610612757,129.0,116.0,0.565,0.511,1,2005-03-05,59,45,14,0.763,57,22,35,0.386
20400867,1610612766,1610612764,84.0,86.0,0.3929999999999999,0.373,0,2005-03-05,57,12,45,0.211,58,33,25,0.569
20400870,1610612749,1610612741,95.0,87.0,0.407,0.439,1,2005-03-05,57,24,33,0.421,56,29,27,0.518
20400869,1610612751,1610612753,81.0,105.0,0.361,0.6,0,2005-03-05,60,26,34,0.433,58,31,27,0.534
20400864,1610612747,1610612742,108.0,103.0,0.519,0.3879999999999999,1,2005-03-04,57,29,28,0.509,57,38,19,0.667
20400862,1610612759,1610612741,102.0,99.0,0.446,0.535,1,2005-03-04,58,45,13,0.7759999999999999,55,29,26,0.527
20400861,1610612750,1610612749,103.0,97.0,0.494,0.488,1,2005-03-04,59,29,30,0.4920000000000001,56,23,33,0.411
20400855,1610612764,1610612744,90.0,103.0,0.408,0.416,0,2005-03-04,57,32,25,0.561,58,18,40,0.31
20400858,1610612748,1610612758,104.0,83.0,0.506,0.4270000000000001,1,2005-03-04,60,44,16,0.733,60,36,24,0.6
20400857,1610612738,1610612766,104.0,84.0,0.4589999999999999,0.3879999999999999,1,2005-03-04,59,31,28,0.525,56,12,44,0.214
20400863,1610612757,1610612754,97.0,106.0,0.5479999999999999,0.452,0,2005-03-04,56,22,34,0.3929999999999999,58,29,29,0.5
20400859,1610612763,1610612761,86.0,75.0,0.431,0.4,1,2005-03-04,58,33,25,0.569,58,24,34,0.414
20400860,1610612740,1610612762,92.0,85.0,0.452,0.337,1,2005-03-04,58,13,45,0.2239999999999999,58,20,38,0.345
20400865,1610612760,1610612765,95.0,87.0,0.4270000000000001,0.422,1,2005-03-04,57,41,16,0.7190000000000001,57,36,21,0.632
20400854,1610612755,1610612739,98.0,89.0,0.433,0.457,1,2005-03-04,58,28,30,0.483,57,31,26,0.544
20400856,1610612753,1610612752,111.0,89.0,0.512,0.416,1,2005-03-04,57,30,27,0.526,58,24,34,0.414
20400853,1610612756,1610612765,100.0,97.0,0.46,0.446,1,2005-03-03,58,44,14,0.759,56,36,20,0.643
20400852,1610612743,1610612754,96.0,87.0,0.431,0.341,1,2005-03-03,58,29,29,0.5,57,28,29,0.491
20400851,1610612751,1610612748,90.0,106.0,0.375,0.507,0,2005-03-03,59,26,33,0.441,59,43,16,0.7290000000000001
20400850,1610612746,1610612742,101.0,92.0,0.442,0.4320000000000001,1,2005-03-02,58,26,32,0.4479999999999999,56,38,18,0.679
20400847,1610612759,1610612761,92.0,86.0,0.514,0.366,1,2005-03-02,57,44,13,0.772,57,24,33,0.421
20400846,1610612750,1610612744,93.0,99.0,0.476,0.449,0,2005-03-02,58,28,30,0.483,57,17,40,0.298
20400842,1610612764,1610612745,101.0,98.0,0.442,0.436,1,2005-03-02,56,32,24,0.5710000000000001,58,33,25,0.569
20400844,1610612739,1610612760,86.0,103.0,0.4320000000000001,0.5,0,2005-03-02,56,31,25,0.5539999999999999,56,40,16,0.7140000000000001
20400845,1610612738,1610612747,104.0,101.0,0.419,0.425,1,2005-03-02,58,30,28,0.517,56,28,28,0.5
20400848,1610612740,1610612766,94.0,85.0,0.3979999999999999,0.3979999999999999,1,2005-03-02,57,12,45,0.211,55,12,43,0.218
20400849,1610612762,1610612737,96.0,74.0,0.515,0.356,1,2005-03-02,57,20,37,0.351,57,10,47,0.175
20400843,1610612753,1610612758,114.0,111.0,0.5529999999999999,0.512,1,2005-03-02,56,29,27,0.518,59,36,23,0.61
20400841,1610612755,1610612751,93.0,99.0,0.429,0.413,0,2005-03-02,57,27,30,0.474,58,26,32,0.4479999999999999
20400836,1610612754,1610612760,93.0,101.0,0.423,0.528,0,2005-03-01,56,28,28,0.5,55,39,16,0.7090000000000001
20400838,1610612741,1610612745,89.0,119.0,0.3720000000000001,0.556,0,2005-03-01,54,29,25,0.537,57,33,24,0.579
20400840,1610612757,1610612765,93.0,103.0,0.4629999999999999,0.5539999999999999,0,2005-03-01,55,22,33,0.4,55,36,19,0.655
20400835,1610612766,1610612758,94.0,87.0,0.477,0.4270000000000001,1,2005-03-01,54,12,42,0.222,58,36,22,0.621
20400834,1610612763,1610612744,99.0,97.0,0.493,0.45,1,2005-03-01,57,32,25,0.561,56,16,40,0.286
20400839,1610612743,1610612737,97.0,74.0,0.5,0.369,1,2005-03-01,57,28,29,0.491,56,10,46,0.179
20400837,1610612749,1610612755,111.0,118.0,0.507,0.489,0,2005-03-01,55,23,32,0.418,56,27,29,0.482
20400831,1610612752,1610612747,117.0,115.0,0.5,0.439,1,2005-02-28,57,24,33,0.421,55,28,27,0.509
20400830,1610612739,1610612759,92.0,94.0,0.435,0.4629999999999999,0,2005-02-28,55,31,24,0.564,56,43,13,0.768
20400832,1610612742,1610612740,90.0,86.0,0.4479999999999999,0.471,1,2005-02-28,55,38,17,0.691,56,11,45,0.196
20400833,1610612762,1610612746,87.0,86.0,0.4370000000000001,0.429,1,2005-02-28,56,19,37,0.3389999999999999,57,25,32,0.439
20400829,1610612746,1610612737,111.0,104.0,0.507,0.5379999999999999,1,2005-02-27,56,25,31,0.446,55,10,45,0.182
20400823,1610612764,1610612758,108.0,110.0,0.465,0.494,0,2005-02-27,55,31,24,0.564,57,36,21,0.632
20400826,1610612756,1610612738,113.0,120.0,0.402,0.442,0,2005-02-27,57,43,14,0.754,57,29,28,0.509
20400822,1610612745,1610612762,92.0,99.0,0.5,0.476,0,2005-02-27,56,32,24,0.5710000000000001,55,18,37,0.327
20400828,1610612744,1610612765,88.0,94.0,0.412,0.405,0,2005-02-27,55,16,39,0.291,54,35,19,0.648
20400827,1610612757,1610612750,83.0,91.0,0.4,0.429,0,2005-02-27,54,22,32,0.407,57,28,29,0.491
20400819,1610612761,1610612747,108.0,102.0,0.4639999999999999,0.513,1,2005-02-27,56,24,32,0.429,54,28,26,0.519
20400824,1610612740,1610612743,93.0,94.0,0.416,0.414,0,2005-02-27,55,11,44,0.2,56,27,29,0.482
20400821,1610612749,1610612760,99.0,73.0,0.506,0.294,1,2005-02-27,54,23,31,0.426,54,38,16,0.7040000000000001
20400820,1610612751,1610612739,104.0,98.0,0.405,0.417,1,2005-02-27,57,25,32,0.439,54,31,23,0.574
20400825,1610612753,1610612748,103.0,112.0,0.493,0.532,0,2005-02-27,55,28,27,0.509,58,42,16,0.7240000000000001
20400818,1610612759,1610612763,82.0,84.0,0.415,0.3779999999999999,0,2005-02-26,55,42,13,0.764,56,31,25,0.5539999999999999
20400815,1610612752,1610612754,90.0,79.0,0.486,0.422,1,2005-02-26,56,23,33,0.411,55,28,27,0.509
20400813,1610612748,1610612753,101.0,98.0,0.4589999999999999,0.481,1,2005-02-26,57,41,16,0.7190000000000001,54,28,26,0.519
20400817,1610612742,1610612756,123.0,124.0,0.489,0.563,0,2005-02-26,54,37,17,0.685,56,43,13,0.768
20400814,1610612766,1610612741,90.0,94.0,0.402,0.419,0,2005-02-26,53,11,42,0.208,53,29,24,0.547
20400816,1610612755,1610612758,99.0,101.0,0.402,0.442,0,2005-02-26,55,26,29,0.473,56,35,21,0.625
20400811,1610612747,1610612765,90.0,111.0,0.447,0.537,0,2005-02-25,53,28,25,0.528,53,34,19,0.642
20400805,1610612754,1610612739,106.0,82.0,0.519,0.363,1,2005-02-25,54,28,26,0.519,53,31,22,0.585
20400807,1610612741,1610612764,97.0,90.0,0.407,0.391,1,2005-02-25,52,28,24,0.5379999999999999,54,31,23,0.574
20400810,1610612757,1610612737,102.0,101.0,0.524,0.478,1,2005-02-25,53,22,31,0.415,54,10,44,0.185
20400806,1610612763,1610612743,94.0,97.0,0.3979999999999999,0.342,0,2005-02-25,55,30,25,0.545,55,26,29,0.473
20400808,1610612749,1610612761,102.0,106.0,0.391,0.455,0,2005-02-25,53,22,31,0.415,55,23,32,0.418
20400809,1610612762,1610612738,102.0,109.0,0.4479999999999999,0.529,0,2005-02-25,54,17,37,0.315,56,28,28,0.5
20400812,1610612760,1610612750,98.0,88.0,0.3929999999999999,0.477,1,2005-02-25,53,38,15,0.7170000000000001,56,27,29,0.482
20400804,1610612751,1610612766,93.0,86.0,0.4379999999999999,0.419,1,2005-02-25,56,24,32,0.429,52,11,41,0.212
20400803,1610612746,1610612750,92.0,86.0,0.4379999999999999,0.455,1,2005-02-24,55,24,31,0.436,55,27,28,0.491
20400801,1610612752,1610612755,113.0,101.0,0.519,0.439,1,2005-02-24,55,22,33,0.4,54,26,28,0.481
20400802,1610612742,1610612758,122.0,113.0,0.467,0.457,1,2005-02-24,53,37,16,0.698,55,34,21,0.618
20400795,1610612759,1610612745,99.0,81.0,0.507,0.423,1,2005-02-23,54,42,12,0.778,55,32,23,0.5820000000000001
20400792,1610612754,1610612748,93.0,91.0,0.402,0.395,1,2005-02-23,53,27,26,0.509,56,40,16,0.7140000000000001
20400790,1610612764,1610612763,93.0,83.0,0.426,0.346,1,2005-02-23,53,31,22,0.585,54,30,24,0.556
20400798,1610612756,1610612746,118.0,101.0,0.563,0.4379999999999999,1,2005-02-23,55,42,13,0.764,54,23,31,0.426
20400791,1610612739,1610612741,100.0,91.0,0.4529999999999999,0.4320000000000001,1,2005-02-23,52,31,21,0.596,51,27,24,0.529
20400800,1610612744,1610612737,101.0,96.0,0.409,0.423,1,2005-02-23,54,16,38,0.296,53,10,43,0.1889999999999999
20400799,1610612757,1610612747,83.0,86.0,0.375,0.41,0,2005-02-23,52,21,31,0.4039999999999999,52,28,24,0.5379999999999999
20400796,1610612743,1610612738,107.0,86.0,0.409,0.375,1,2005-02-23,54,25,29,0.4629999999999999,55,27,28,0.491
20400793,1610612749,1610612751,100.0,81.0,0.547,0.371,1,2005-02-23,52,22,30,0.423,55,23,32,0.418
20400794,1610612740,1610612760,85.0,103.0,0.471,0.4429999999999999,0,2005-02-23,54,11,43,0.204,52,37,15,0.7120000000000001
20400797,1610612762,1610612742,83.0,101.0,0.307,0.472,0,2005-02-23,53,17,36,0.321,52,36,16,0.6920000000000001
20400789,1610612747,1610612738,104.0,95.0,0.415,0.4589999999999999,1,2005-02-22,51,27,24,0.529,54,27,27,0.5
20400785,1610612765,1610612752,97.0,88.0,0.4589999999999999,0.376,1,2005-02-22,52,33,19,0.635,54,21,33,0.389
20400787,1610612745,1610612760,85.0,87.0,0.434,0.365,0,2005-02-22,54,32,22,0.593,51,36,15,0.706
20400786,1610612741,1610612748,105.0,101.0,0.396,0.5,1,2005-02-22,50,27,23,0.54,55,40,15,0.727
20400782,1610612766,1610612749,102.0,112.0,0.411,0.557,0,2005-02-22,51,11,40,0.216,51,21,30,0.412
20400788,1610612758,1610612737,114.0,104.0,0.517,0.461,1,2005-02-22,54,34,20,0.63,52,10,42,0.192
20400784,1610612751,1610612761,82.0,100.0,0.373,0.48,0,2005-02-22,54,23,31,0.426,54,22,32,0.407
20400783,1610612753,1610612754,84.0,108.0,0.38,0.5,0,2005-02-22,53,28,25,0.528,52,26,26,0.5
20400780,1610612750,1610612739,94.0,88.0,0.4629999999999999,0.424,1,2005-02-17,54,27,27,0.5,51,30,21,0.588
20400781,1610612756,1610612742,113.0,119.0,0.4529999999999999,0.536,0,2005-02-17,54,41,13,0.759,51,35,16,0.6859999999999999
20400774,1610612754,1610612757,95.0,87.0,0.36,0.4379999999999999,1,2005-02-16,51,25,26,0.49,51,21,30,0.412
20400776,1610612752,1610612749,108.0,90.0,0.56,0.423,1,2005-02-16,53,21,32,0.396,50,20,30,0.4
20400773,1610612739,1610612737,111.0,89.0,0.479,0.429,1,2005-02-16,50,30,20,0.6,51,10,41,0.196
20400777,1610612748,1610612746,113.0,95.0,0.5329999999999999,0.425,1,2005-02-16,54,40,14,0.741,53,23,30,0.434
20400769,1610612738,1610612763,90.0,88.0,0.446,0.368,1,2005-02-16,53,27,26,0.509,53,30,23,0.5660000000000001
20400772,1610612766,1610612743,94.0,88.0,0.447,0.419,1,2005-02-16,50,11,39,0.22,53,24,29,0.4529999999999999
20400770,1610612761,1610612741,115.0,121.0,0.514,0.579,0,2005-02-16,53,21,32,0.396,49,26,23,0.531
20400778,1610612740,1610612759,78.0,101.0,0.441,0.455,0,2005-02-16,53,11,42,0.208,53,41,12,0.774
20400779,1610612760,1610612744,110.0,117.0,0.494,0.529,0,2005-02-16,50,35,15,0.7,53,15,38,0.283
20400775,1610612751,1610612758,96.0,85.0,0.429,0.42,1,2005-02-16,53,23,30,0.434,53,33,20,0.623
20400771,1610612755,1610612765,75.0,93.0,0.39,0.5,0,2005-02-16,53,26,27,0.491,51,32,19,0.627
20400767,1610612747,1610612762,102.0,95.0,0.452,0.43,1,2005-02-15,50,26,24,0.52,52,17,35,0.327
20400764,1610612750,1610612751,82.0,71.0,0.395,0.31,1,2005-02-15,53,26,27,0.491,52,22,30,0.423
20400763,1610612737,1610612743,96.0,100.0,0.461,0.4579999999999999,0,2005-02-15,50,10,40,0.2,52,24,28,0.462
20400766,1610612745,1610612764,123.0,93.0,0.595,0.417,1,2005-02-15,53,32,21,0.604,52,30,22,0.5770000000000001
20400765,1610612741,1610612758,107.0,102.0,0.53,0.425,1,2005-02-15,48,25,23,0.521,52,33,19,0.635
20400768,1610612744,1610612742,107.0,114.0,0.483,0.561,0,2005-02-15,52,14,38,0.2689999999999999,50,34,16,0.68
20400762,1610612753,1610612746,99.0,94.0,0.494,0.407,1,2005-02-15,52,28,24,0.5379999999999999,52,23,29,0.442
20400761,1610612756,1610612762,136.0,128.0,0.55,0.551,1,2005-02-14,53,41,12,0.774,51,17,34,0.3329999999999999
20400759,1610612765,1610612749,107.0,83.0,0.526,0.4320000000000001,1,2005-02-14,50,31,19,0.62,49,20,29,0.408
20400758,1610612766,1610612757,77.0,80.0,0.3879999999999999,0.465,0,2005-02-14,49,10,39,0.204,50,21,29,0.42
20400760,1610612740,1610612764,98.0,96.0,0.476,0.4270000000000001,1,2005-02-14,52,11,41,0.212,51,30,21,0.588
20400757,1610612755,1610612752,106.0,105.0,0.5,0.5,1,2005-02-14,52,26,26,0.5,52,20,32,0.385
20400745,1610612748,1610612759,96.0,92.0,0.522,0.392,1,2005-02-13,53,39,14,0.736,52,40,12,0.769
20400746,1610612739,1610612747,103.0,89.0,0.527,0.3829999999999999,1,2005-02-13,49,29,20,0.5920000000000001,49,25,24,0.51
20400747,1610612750,1610612741,83.0,87.0,0.4,0.402,0,2005-02-13,52,25,27,0.481,47,24,23,0.511
20400748,1610612738,1610612758,100.0,104.0,0.481,0.452,0,2005-02-13,52,26,26,0.5,51,33,18,0.647
20400749,1610612761,1610612746,109.0,106.0,0.447,0.471,1,2005-02-13,52,21,31,0.4039999999999999,51,23,28,0.451
20400750,1610612751,1610612743,94.0,79.0,0.522,0.431,1,2005-02-13,51,22,29,0.431,51,23,28,0.451
20400751,1610612752,1610612766,102.0,99.0,0.4679999999999999,0.441,1,2005-02-13,51,20,31,0.392,48,10,38,0.208
20400752,1610612753,1610612740,97.0,94.0,0.493,0.4379999999999999,1,2005-02-13,51,27,24,0.529,51,10,41,0.196
20400753,1610612754,1610612763,76.0,73.0,0.365,0.347,1,2005-02-13,50,24,26,0.48,52,30,22,0.5770000000000001
20400754,1610612760,1610612742,92.0,95.0,0.3929999999999999,0.467,0,2005-02-13,49,35,14,0.7140000000000001,49,33,16,0.6729999999999999
20400755,1610612745,1610612757,81.0,80.0,0.397,0.455,1,2005-02-13,52,31,21,0.596,49,20,29,0.408
20400756,1610612744,1610612756,102.0,106.0,0.364,0.46,0,2005-02-13,51,14,37,0.275,52,40,12,0.769
20400743,1610612765,1610612764,107.0,86.0,0.532,0.363,1,2005-02-12,49,30,19,0.612,50,30,20,0.6
20400744,1610612749,1610612737,113.0,83.0,0.5,0.39,1,2005-02-12,48,20,28,0.417,49,10,39,0.204
20400742,1610612755,1610612753,112.0,99.0,0.469,0.435,1,2005-02-12,51,25,26,0.49,50,26,24,0.52
20400733,1610612754,1610612745,83.0,91.0,0.419,0.417,0,2005-02-11,49,23,26,0.469,51,30,21,0.588
20400731,1610612764,1610612746,94.0,91.0,0.429,0.455,1,2005-02-11,49,30,19,0.612,50,23,27,0.46
20400740,1610612756,1610612760,105.0,113.0,0.451,0.473,0,2005-02-11,51,39,12,0.765,48,35,13,0.7290000000000001
20400736,1610612739,1610612743,101.0,106.0,0.4679999999999999,0.506,0,2005-02-11,48,28,20,0.583,50,23,27,0.46
20400734,1610612738,1610612752,111.0,94.0,0.532,0.451,1,2005-02-11,51,26,25,0.51,50,19,31,0.38
20400732,1610612766,1610612748,87.0,97.0,0.409,0.52,0,2005-02-11,47,10,37,0.213,52,38,14,0.731
20400741,1610612758,1610612742,113.0,115.0,0.506,0.5379999999999999,0,2005-02-11,50,32,18,0.64,48,32,16,0.667
20400737,1610612763,1610612757,88.0,82.0,0.357,0.421,1,2005-02-11,51,30,21,0.588,48,20,28,0.417
20400730,1610612761,1610612755,91.0,106.0,0.4270000000000001,0.5,0,2005-02-11,51,20,31,0.392,50,24,26,0.48
20400738,1610612740,1610612744,111.0,108.0,0.541,0.476,1,2005-02-11,50,10,40,0.2,50,14,36,0.28
20400739,1610612762,1610612750,100.0,82.0,0.471,0.4529999999999999,1,2005-02-11,50,17,33,0.34,51,25,26,0.49
20400735,1610612751,1610612759,91.0,101.0,0.434,0.4379999999999999,0,2005-02-11,50,21,29,0.42,51,40,11,0.784
20400728,1610612765,1610612747,103.0,81.0,0.441,0.39,1,2005-02-10,48,29,19,0.604,48,25,23,0.521
20400729,1610612760,1610612758,115.0,107.0,0.44,0.519,1,2005-02-10,47,34,13,0.723,49,32,17,0.653
20400727,1610612753,1610612737,101.0,96.0,0.376,0.43,1,2005-02-10,49,26,23,0.531,48,10,38,0.208
20400721,1610612754,1610612766,94.0,87.0,0.486,0.41,1,2005-02-09,48,23,25,0.479,46,10,36,0.217
20400724,1610612750,1610612743,98.0,92.0,0.493,0.474,1,2005-02-09,50,25,25,0.5,49,22,27,0.449
20400720,1610612764,1610612759,95.0,87.0,0.429,0.414,1,2005-02-09,48,29,19,0.604,50,39,11,0.78
20400723,1610612752,1610612748,110.0,116.0,0.471,0.482,0,2005-02-09,49,19,30,0.3879999999999999,51,37,14,0.725
20400725,1610612745,1610612741,105.0,92.0,0.5,0.368,1,2005-02-09,50,29,21,0.58,46,23,23,0.5
20400717,1610612738,1610612746,94.0,89.0,0.486,0.405,1,2005-02-09,50,25,25,0.5,49,23,26,0.469
20400726,1610612757,1610612740,80.0,91.0,0.4,0.4429999999999999,0,2005-02-09,47,20,27,0.426,49,9,40,0.184
20400718,1610612761,1610612749,107.0,110.0,0.471,0.519,0,2005-02-09,50,20,30,0.4,47,19,28,0.4039999999999999
20400722,1610612751,1610612747,103.0,104.0,0.4039999999999999,0.429,0,2005-02-09,49,21,28,0.429,47,25,22,0.532
20400719,1610612755,1610612763,95.0,98.0,0.457,0.4379999999999999,0,2005-02-09,49,23,26,0.469,50,29,21,0.58
20400710,1610612739,1610612761,104.0,91.0,0.5770000000000001,0.434,1,2005-02-08,47,28,19,0.596,49,20,29,0.408
20400713,1610612742,1610612741,100.0,107.0,0.3720000000000001,0.469,0,2005-02-08,47,31,16,0.66,45,23,22,0.511
20400708,1610612766,1610612759,85.0,104.0,0.376,0.475,0,2005-02-08,45,10,35,0.222,49,39,10,0.7959999999999999
20400715,1610612758,1610612756,123.0,125.0,0.505,0.521,0,2005-02-08,48,32,16,0.667,50,39,11,0.78
20400714,1610612743,1610612762,97.0,87.0,0.41,0.363,1,2005-02-08,48,22,26,0.4579999999999999,49,16,33,0.327
20400712,1610612763,1610612750,108.0,96.0,0.5,0.529,1,2005-02-08,49,28,21,0.5710000000000001,49,24,25,0.49
20400711,1610612749,1610612738,121.0,97.0,0.539,0.487,1,2005-02-08,46,18,28,0.391,49,24,25,0.49
20400716,1610612760,1610612740,108.0,91.0,0.586,0.387,1,2005-02-08,46,33,13,0.7170000000000001,48,8,40,0.1669999999999999
20400709,1610612753,1610612744,109.0,113.0,0.461,0.476,0,2005-02-08,48,25,23,0.521,49,14,35,0.286
20400703,1610612764,1610612754,108.0,104.0,0.494,0.4629999999999999,1,2005-02-07,47,28,19,0.596,47,22,25,0.4679999999999999
20400705,1610612737,1610612747,114.0,108.0,0.5,0.447,1,2005-02-07,47,10,37,0.213,46,24,22,0.522
20400706,1610612748,1610612744,105.0,96.0,0.513,0.4429999999999999,1,2005-02-07,50,36,14,0.72,48,13,35,0.271
20400707,1610612762,1610612752,99.0,102.0,0.478,0.466,0,2005-02-07,48,16,32,0.3329999999999999,48,19,29,0.396
20400704,1610612751,1610612755,107.0,97.0,0.433,0.481,1,2005-02-07,48,21,27,0.4379999999999999,48,23,25,0.479
20400701,1610612750,1610612738,100.0,103.0,0.469,0.446,0,2005-02-06,48,24,24,0.5,48,24,24,0.5
20400702,1610612745,1610612747,103.0,102.0,0.44,0.481,1,2005-02-06,49,28,21,0.5710000000000001,45,24,21,0.5329999999999999
20400699,1610612761,1610612742,113.0,122.0,0.519,0.603,0,2005-02-06,48,20,28,0.417,46,31,15,0.674
20400700,1610612755,1610612746,106.0,104.0,0.493,0.515,1,2005-02-06,47,23,24,0.489,48,23,25,0.479
20400690,1610612764,1610612749,112.0,94.0,0.494,0.486,1,2005-02-05,46,27,19,0.5870000000000001,45,17,28,0.3779999999999999
20400691,1610612737,1610612754,79.0,84.0,0.3979999999999999,0.4579999999999999,0,2005-02-05,46,9,37,0.196,46,22,24,0.478
20400696,1610612756,1610612752,114.0,106.0,0.483,0.424,1,2005-02-05,49,38,11,0.7759999999999999,47,18,29,0.3829999999999999
20400693,1610612739,1610612753,101.0,92.0,0.4270000000000001,0.493,1,2005-02-05,46,27,19,0.5870000000000001,47,25,22,0.532
20400692,1610612748,1610612741,108.0,97.0,0.494,0.43,1,2005-02-05,49,35,14,0.7140000000000001,44,22,22,0.5
20400697,1610612757,1610612758,114.0,108.0,0.551,0.406,1,2005-02-05,46,20,26,0.435,47,32,15,0.6809999999999999
20400694,1610612743,1610612744,107.0,91.0,0.494,0.384,1,2005-02-05,47,21,26,0.447,47,13,34,0.2769999999999999
20400695,1610612762,1610612740,108.0,92.0,0.53,0.417,1,2005-02-05,47,16,31,0.34,47,8,39,0.17
20400698,1610612760,1610612766,113.0,99.0,0.494,0.488,1,2005-02-05,45,32,13,0.711,44,10,34,0.2269999999999999
20400689,1610612751,1610612765,107.0,85.0,0.544,0.406,1,2005-02-05,47,20,27,0.426,47,28,19,0.596
20400682,1610612754,1610612742,95.0,94.0,0.419,0.4379999999999999,1,2005-02-04,45,21,24,0.467,45,30,15,0.667
20400685,1610612750,1610612745,113.0,119.0,0.477,0.442,0,2005-02-04,47,24,23,0.511,48,27,21,0.563
20400683,1610612738,1610612753,112.0,100.0,0.494,0.4679999999999999,1,2005-02-04,47,23,24,0.489,46,25,21,0.5429999999999999
20400688,1610612744,1610612740,90.0,82.0,0.3979999999999999,0.408,1,2005-02-04,46,13,33,0.283,46,8,38,0.174
20400687,1610612757,1610612766,101.0,89.0,0.429,0.366,1,2005-02-04,45,19,26,0.422,43,10,33,0.233
20400686,1610612758,1610612752,116.0,115.0,0.512,0.615,1,2005-02-04,46,32,14,0.696,46,18,28,0.391
20400680,1610612761,1610612764,103.0,100.0,0.494,0.526,1,2005-02-04,47,20,27,0.426,45,26,19,0.578
20400684,1610612749,1610612746,92.0,90.0,0.434,0.447,1,2005-02-04,44,17,27,0.386,47,23,24,0.489
20400681,1610612755,1610612737,103.0,85.0,0.4679999999999999,0.402,1,2005-02-04,46,22,24,0.478,45,9,36,0.2
20400679,1610612747,1610612759,91.0,103.0,0.486,0.488,0,2005-02-03,44,24,20,0.545,48,38,10,0.792
20400677,1610612748,1610612739,100.0,88.0,0.521,0.422,1,2005-02-03,48,34,14,0.708,45,26,19,0.578
20400678,1610612763,1610612746,103.0,106.0,0.474,0.597,0,2005-02-03,48,27,21,0.563,46,23,23,0.5
20400671,1610612754,1610612761,97.0,98.0,0.373,0.417,0,2005-02-02,44,20,24,0.455,46,19,27,0.413
20400674,1610612750,1610612756,79.0,108.0,0.407,0.489,0,2005-02-02,46,24,22,0.522,48,37,11,0.7709999999999999
20400672,1610612765,1610612737,99.0,84.0,0.507,0.425,1,2005-02-02,46,28,18,0.609,44,9,35,0.205
20400669,1610612738,1610612751,110.0,89.0,0.542,0.387,1,2005-02-02,46,22,24,0.478,46,19,27,0.413
20400675,1610612757,1610612743,97.0,94.0,0.442,0.461,1,2005-02-02,44,18,26,0.409,46,20,26,0.435
20400676,1610612744,1610612758,107.0,111.0,0.434,0.444,0,2005-02-02,45,12,33,0.267,45,31,14,0.6890000000000001
20400673,1610612740,1610612742,82.0,90.0,0.387,0.451,0,2005-02-02,45,8,37,0.178,44,30,14,0.682
20400670,1610612755,1610612745,95.0,118.0,0.436,0.539,0,2005-02-02,45,21,24,0.467,47,26,21,0.5529999999999999
20400668,1610612747,1610612757,92.0,79.0,0.482,0.364,1,2005-02-01,43,24,19,0.5579999999999999,43,17,26,0.395
20400659,1610612764,1610612765,96.0,105.0,0.429,0.446,0,2005-02-01,44,26,18,0.591,45,27,18,0.6
20400664,1610612742,1610612748,109.0,104.0,0.489,0.483,1,2005-02-01,43,29,14,0.674,47,33,14,0.7020000000000001
20400667,1610612758,1610612760,101.0,106.0,0.419,0.465,0,2005-02-01,44,30,14,0.682,44,31,13,0.705
20400663,1610612763,1610612756,108.0,97.0,0.456,0.446,1,2005-02-01,47,27,20,0.574,47,36,11,0.7659999999999999
20400665,1610612743,1610612752,96.0,76.0,0.494,0.365,1,2005-02-01,45,20,25,0.444,45,18,27,0.4
20400662,1610612749,1610612750,91.0,86.0,0.386,0.412,1,2005-02-01,43,16,27,0.3720000000000001,45,24,21,0.5329999999999999
20400666,1610612762,1610612766,105.0,109.0,0.452,0.515,0,2005-02-01,46,15,31,0.326,42,10,32,0.238
20400661,1610612751,1610612741,107.0,97.0,0.5,0.472,1,2005-02-01,45,19,26,0.422,43,22,21,0.512
20400660,1610612753,1610612739,105.0,102.0,0.557,0.4429999999999999,1,2005-02-01,45,25,20,0.556,44,26,18,0.591
20400658,1610612746,1610612752,96.0,89.0,0.477,0.521,1,2005-01-31,45,22,23,0.489,44,18,26,0.409
20400655,1610612737,1610612753,80.0,79.0,0.434,0.38,1,2005-01-31,43,9,34,0.209,44,24,20,0.545
20400653,1610612738,1610612745,94.0,97.0,0.494,0.466,0,2005-01-31,45,21,24,0.467,46,25,21,0.5429999999999999
20400656,1610612740,1610612763,91.0,98.0,0.469,0.4920000000000001,0,2005-01-31,44,8,36,0.182,46,26,20,0.565
20400657,1610612760,1610612759,84.0,103.0,0.411,0.481,0,2005-01-31,43,30,13,0.698,47,37,10,0.787
20400654,1610612755,1610612754,89.0,88.0,0.452,0.455,1,2005-01-31,44,21,23,0.477,43,20,23,0.465
20400652,1610612747,1610612766,101.0,90.0,0.461,0.418,1,2005-01-30,42,23,19,0.5479999999999999,41,9,32,0.22
20400650,1610612750,1610612758,84.0,94.0,0.4270000000000001,0.435,0,2005-01-30,44,24,20,0.545,43,30,13,0.698
20400651,1610612739,1610612749,104.0,87.0,0.43,0.447,1,2005-01-30,43,26,17,0.605,42,15,27,0.357
20400648,1610612748,1610612745,104.0,95.0,0.5,0.4320000000000001,1,2005-01-30,46,33,13,0.7170000000000001,45,24,21,0.5329999999999999
20400649,1610612761,1610612756,105.0,123.0,0.422,0.523,0,2005-01-30,45,18,27,0.4,46,36,10,0.7829999999999999
20400647,1610612746,1610612744,96.0,85.0,0.434,0.442,1,2005-01-29,44,21,23,0.477,44,12,32,0.273
20400645,1610612759,1610612740,93.0,83.0,0.472,0.455,1,2005-01-29,46,36,10,0.7829999999999999,43,8,35,0.186
20400641,1610612754,1610612743,88.0,95.0,0.361,0.5,0,2005-01-29,42,20,22,0.476,44,19,25,0.4320000000000001
20400639,1610612764,1610612753,97.0,103.0,0.366,0.481,0,2005-01-29,43,26,17,0.605,43,24,19,0.5579999999999999
20400640,1610612765,1610612752,91.0,61.0,0.474,0.361,1,2005-01-29,44,26,18,0.591,43,18,25,0.419
20400644,1610612742,1610612755,89.0,93.0,0.3670000000000001,0.407,0,2005-01-29,42,28,14,0.667,43,20,23,0.465
20400643,1610612741,1610612738,97.0,101.0,0.407,0.429,0,2005-01-29,42,22,20,0.524,44,21,23,0.477
20400642,1610612763,1610612737,84.0,83.0,0.4629999999999999,0.425,1,2005-01-29,45,25,20,0.556,42,8,34,0.19
20400646,1610612762,1610612751,82.0,99.0,0.386,0.529,0,2005-01-29,45,15,30,0.3329999999999999,44,18,26,0.409
20400637,1610612747,1610612751,103.0,109.0,0.416,0.531,0,2005-01-28,41,22,19,0.537,43,17,26,0.395
20400633,1610612750,1610612762,93.0,91.0,0.4,0.462,1,2005-01-28,43,24,19,0.5579999999999999,44,15,29,0.341
20400627,1610612752,1610612739,99.0,96.0,0.413,0.415,1,2005-01-28,42,18,24,0.429,42,25,17,0.595
20400631,1610612737,1610612748,96.0,106.0,0.507,0.474,0,2005-01-28,41,8,33,0.195,45,32,13,0.711
20400635,1610612745,1610612758,111.0,117.0,0.451,0.494,0,2005-01-28,44,24,20,0.545,42,29,13,0.69
20400630,1610612738,1610612756,119.0,128.0,0.516,0.5529999999999999,0,2005-01-28,43,20,23,0.465,45,35,10,0.778
20400636,1610612757,1610612746,90.0,86.0,0.4320000000000001,0.425,1,2005-01-28,42,17,25,0.405,43,20,23,0.465
20400638,1610612744,1610612760,85.0,88.0,0.416,0.418,0,2005-01-28,43,12,31,0.2789999999999999,42,30,12,0.7140000000000001
20400628,1610612766,1610612761,101.0,94.0,0.471,0.4270000000000001,1,2005-01-28,40,9,31,0.225,44,18,26,0.409
20400634,1610612749,1610612743,100.0,106.0,0.44,0.518,0,2005-01-28,41,15,26,0.366,43,18,25,0.419
20400632,1610612740,1610612755,99.0,95.0,0.5,0.395,1,2005-01-28,42,8,34,0.19,42,19,23,0.452
20400629,1610612753,1610612764,108.0,101.0,0.471,0.414,1,2005-01-28,42,23,19,0.5479999999999999,42,26,16,0.619
20400626,1610612759,1610612758,90.0,80.0,0.465,0.429,1,2005-01-27,45,35,10,0.778,41,28,13,0.6829999999999999
20400624,1610612754,1610612765,76.0,88.0,0.4029999999999999,0.471,0,2005-01-27,41,20,21,0.488,43,25,18,0.581
20400625,1610612741,1610612766,101.0,93.0,0.532,0.466,1,2005-01-27,41,22,19,0.537,39,8,31,0.205
20400622,1610612746,1610612747,105.0,89.0,0.4479999999999999,0.418,1,2005-01-26,42,20,22,0.476,40,22,18,0.55
20400619,1610612750,1610612737,104.0,87.0,0.557,0.425,1,2005-01-26,42,23,19,0.5479999999999999,40,8,32,0.2
20400614,1610612764,1610612755,117.0,107.0,0.461,0.5,1,2005-01-26,41,26,15,0.634,41,19,22,0.4629999999999999
20400616,1610612765,1610612743,87.0,70.0,0.436,0.3329999999999999,1,2005-01-26,42,24,18,0.5710000000000001,42,17,25,0.405
20400615,1610612739,1610612763,114.0,111.0,0.544,0.527,1,2005-01-26,41,25,16,0.61,44,24,20,0.545
20400612,1610612738,1610612754,100.0,86.0,0.466,0.441,1,2005-01-26,42,20,22,0.476,40,20,20,0.5
20400621,1610612757,1610612742,88.0,95.0,0.405,0.45,0,2005-01-26,41,16,25,0.39,41,28,13,0.6829999999999999
20400623,1610612744,1610612751,99.0,113.0,0.439,0.536,0,2005-01-26,42,12,30,0.286,42,16,26,0.381
20400617,1610612749,1610612756,115.0,121.0,0.4579999999999999,0.506,0,2005-01-26,40,15,25,0.375,44,34,10,0.773
20400613,1610612761,1610612748,96.0,111.0,0.38,0.534,0,2005-01-26,43,18,25,0.419,44,31,13,0.705
20400618,1610612740,1610612745,77.0,82.0,0.4320000000000001,0.382,0,2005-01-26,41,7,34,0.171,43,24,19,0.5579999999999999
20400620,1610612762,1610612760,109.0,100.0,0.5,0.416,1,2005-01-26,43,15,28,0.349,41,29,12,0.7070000000000001
20400611,1610612747,1610612760,93.0,104.0,0.4589999999999999,0.409,0,2005-01-25,39,22,17,0.564,40,29,11,0.725
20400607,1610612752,1610612756,118.0,133.0,0.429,0.541,0,2005-01-25,41,17,24,0.415,43,33,10,0.767
20400609,1610612741,1610612743,111.0,107.0,0.488,0.481,1,2005-01-25,40,21,19,0.525,41,17,24,0.415
20400606,1610612766,1610612738,92.0,97.0,0.447,0.446,0,2005-01-25,38,8,30,0.211,41,19,22,0.4629999999999999
20400610,1610612758,1610612751,113.0,93.0,0.5539999999999999,0.422,1,2005-01-25,40,28,12,0.7,41,15,26,0.366
20400608,1610612763,1610612753,95.0,83.0,0.413,0.38,1,2005-01-25,43,24,19,0.5579999999999999,41,22,19,0.537
20400605,1610612746,1610612742,97.0,87.0,0.481,0.39,1,2005-01-24,41,19,22,0.4629999999999999,40,27,13,0.675
20400602,1610612750,1610612765,86.0,83.0,0.397,0.3720000000000001,1,2005-01-24,41,22,19,0.537,41,23,18,0.561
20400600,1610612737,1610612741,82.0,107.0,0.325,0.487,0,2005-01-24,39,8,31,0.205,39,20,19,0.513
20400599,1610612739,1610612764,97.0,106.0,0.426,0.417,0,2005-01-24,40,24,16,0.6,40,25,15,0.625
20400603,1610612745,1610612753,89.0,78.0,0.41,0.402,1,2005-01-24,42,23,19,0.5479999999999999,40,22,18,0.55
20400604,1610612757,1610612759,107.0,99.0,0.56,0.442,1,2005-01-24,40,16,24,0.4,44,34,10,0.773
20400595,1610612755,1610612748,106.0,98.0,0.417,0.429,1,2005-01-24,40,19,21,0.475,43,30,13,0.698
20400594,1610612752,1610612749,96.0,101.0,0.4529999999999999,0.451,0,2005-01-23,40,17,23,0.425,39,15,24,0.385
20400596,1610612756,1610612751,113.0,105.0,0.534,0.434,1,2005-01-23,42,32,10,0.762,40,15,25,0.375
20400601,1610612748,1610612740,97.0,68.0,0.5,0.3289999999999999,1,2005-01-23,42,30,12,0.7140000000000001,40,7,33,0.175
20400593,1610612742,1610612743,95.0,93.0,0.462,0.424,1,2005-01-23,39,27,12,0.6920000000000001,40,17,23,0.425
20400597,1610612758,1610612759,73.0,103.0,0.375,0.477,0,2005-01-23,39,27,12,0.6920000000000001,43,34,9,0.7909999999999999
20400592,1610612761,1610612766,103.0,92.0,0.506,0.418,1,2005-01-23,42,18,24,0.429,37,8,29,0.216
20400598,1610612760,1610612762,122.0,105.0,0.594,0.4629999999999999,1,2005-01-23,39,28,11,0.718,42,14,28,0.3329999999999999
20400587,1610612754,1610612764,93.0,95.0,0.425,0.44,0,2005-01-22,39,20,19,0.513,39,24,15,0.615
20400584,1610612737,1610612738,100.0,96.0,0.424,0.5,1,2005-01-22,38,8,30,0.211,40,18,22,0.45
20400586,1610612765,1610612741,89.0,100.0,0.425,0.494,0,2005-01-22,40,23,17,0.575,38,19,19,0.5
20400590,1610612757,1610612750,83.0,92.0,0.447,0.4529999999999999,0,2005-01-22,39,15,24,0.385,40,21,19,0.525
20400591,1610612744,1610612739,87.0,105.0,0.447,0.505,0,2005-01-22,41,12,29,0.293,39,24,15,0.615
20400588,1610612740,1610612746,88.0,85.0,0.429,0.493,1,2005-01-22,39,7,32,0.179,40,18,22,0.45
20400589,1610612762,1610612763,94.0,110.0,0.4270000000000001,0.569,0,2005-01-22,41,14,27,0.341,42,23,19,0.5479999999999999
20400585,1610612753,1610612755,115.0,111.0,0.456,0.477,1,2005-01-22,39,22,17,0.564,39,18,21,0.462
20400582,1610612747,1610612744,105.0,101.0,0.488,0.477,1,2005-01-21,38,22,16,0.579,40,12,28,0.3
20400573,1610612764,1610612761,118.0,109.0,0.488,0.413,1,2005-01-21,38,23,15,0.605,41,17,24,0.415
20400576,1610612752,1610612745,91.0,92.0,0.3979999999999999,0.4679999999999999,0,2005-01-21,39,17,22,0.436,41,22,19,0.537
20400580,1610612756,1610612759,123.0,128.0,0.54,0.49,0,2005-01-21,41,31,10,0.7559999999999999,42,33,9,0.7859999999999999
20400577,1610612748,1610612754,100.0,106.0,0.481,0.4370000000000001,0,2005-01-21,41,29,12,0.7070000000000001,38,20,18,0.526
20400578,1610612741,1610612737,95.0,85.0,0.4589999999999999,0.341,1,2005-01-21,37,18,19,0.486,37,7,30,0.1889999999999999
20400574,1610612766,1610612742,99.0,105.0,0.4320000000000001,0.481,0,2005-01-21,36,8,28,0.222,38,26,12,0.684
20400581,1610612743,1610612763,92.0,82.0,0.494,0.431,1,2005-01-21,39,17,22,0.436,41,22,19,0.537
20400579,1610612749,1610612765,89.0,86.0,0.457,0.467,1,2005-01-21,38,14,24,0.368,39,23,16,0.59
20400583,1610612760,1610612750,107.0,112.0,0.47,0.581,0,2005-01-21,38,27,11,0.711,39,20,19,0.513
20400575,1610612751,1610612738,104.0,98.0,0.442,0.405,1,2005-01-21,39,15,24,0.385,39,18,21,0.462
20400570,1610612742,1610612746,99.0,77.0,0.488,0.35,1,2005-01-20,37,25,12,0.6759999999999999,39,18,21,0.462
20400572,1610612758,1610612739,123.0,96.0,0.5379999999999999,0.409,1,2005-01-20,38,27,11,0.711,38,23,15,0.605
20400571,1610612753,1610612745,99.0,108.0,0.486,0.42,0,2005-01-20,38,21,17,0.5529999999999999,40,21,19,0.525
20400569,1610612747,1610612750,93.0,90.0,0.479,0.42,1,2005-01-19,37,21,16,0.568,38,19,19,0.5
20400566,1610612759,1610612746,80.0,79.0,0.397,0.351,1,2005-01-19,41,32,9,0.78,38,18,20,0.474
20400567,1610612756,1610612763,79.0,88.0,0.3329999999999999,0.373,0,2005-01-19,40,31,9,0.775,40,22,18,0.55
20400564,1610612748,1610612737,111.0,92.0,0.519,0.429,1,2005-01-19,40,29,11,0.725,36,7,29,0.1939999999999999
20400560,1610612738,1610612741,92.0,83.0,0.407,0.35,1,2005-01-19,38,18,20,0.474,36,17,19,0.472
20400568,1610612757,1610612739,101.0,107.0,0.467,0.512,0,2005-01-19,38,15,23,0.395,37,23,14,0.622
20400562,1610612766,1610612755,105.0,107.0,0.4629999999999999,0.42,0,2005-01-19,35,8,27,0.2289999999999999,38,18,20,0.474
20400561,1610612761,1610612752,98.0,81.0,0.455,0.386,1,2005-01-19,40,17,23,0.425,38,17,21,0.447
20400565,1610612740,1610612754,90.0,87.0,0.4579999999999999,0.434,1,2005-01-19,38,6,32,0.158,37,19,18,0.514
20400563,1610612751,1610612749,96.0,90.0,0.527,0.455,1,2005-01-19,38,14,24,0.368,37,13,24,0.351
20400556,1610612745,1610612754,74.0,87.0,0.418,0.522,0,2005-01-18,39,20,19,0.513,36,19,17,0.528
20400557,1610612742,1610612764,137.0,120.0,0.5770000000000001,0.424,1,2005-01-18,36,24,12,0.667,37,22,15,0.595
20400558,1610612758,1610612757,113.0,107.0,0.5,0.4589999999999999,1,2005-01-18,37,26,11,0.703,37,15,22,0.405
20400559,1610612760,1610612743,110.0,116.0,0.441,0.4379999999999999,0,2005-01-18,37,27,10,0.73,38,16,22,0.421
20400555,1610612753,1610612765,103.0,101.0,0.482,0.482,1,2005-01-18,37,21,16,0.568,38,23,15,0.605
20400549,1610612746,1610612758,83.0,89.0,0.319,0.436,0,2005-01-17,37,18,19,0.486,36,25,11,0.6940000000000001
20400553,1610612747,1610612762,94.0,102.0,0.39,0.471,0,2005-01-17,36,20,16,0.556,40,14,26,0.35
20400550,1610612759,1610612764,101.0,73.0,0.52,0.318,1,2005-01-17,40,31,9,0.775,36,22,14,0.611
20400551,1610612750,1610612761,91.0,100.0,0.422,0.461,0,2005-01-17,37,19,18,0.514,39,16,23,0.41
20400544,1610612752,1610612741,86.0,88.0,0.41,0.407,0,2005-01-17,37,17,20,0.4589999999999999,35,17,18,0.486
20400547,1610612737,1610612751,84.0,85.0,0.405,0.39,0,2005-01-17,35,7,28,0.2,37,13,24,0.351
20400548,1610612765,1610612756,94.0,80.0,0.382,0.354,1,2005-01-17,37,23,14,0.622,39,31,8,0.795
20400554,1610612744,1610612743,107.0,97.0,0.478,0.481,1,2005-01-17,39,12,27,0.308,37,15,22,0.405
20400545,1610612766,1610612749,92.0,99.0,0.36,0.402,0,2005-01-17,34,8,26,0.235,36,13,23,0.361
20400552,1610612763,1610612745,99.0,80.0,0.507,0.389,1,2005-01-17,39,21,18,0.5379999999999999,38,20,18,0.526
20400546,1610612755,1610612740,95.0,91.0,0.386,0.429,1,2005-01-17,37,17,20,0.4589999999999999,37,5,32,0.135
20400542,1610612761,1610612740,102.0,99.0,0.416,0.444,1,2005-01-16,38,15,23,0.395,36,5,31,0.139
20400543,1610612760,1610612739,105.0,97.0,0.4579999999999999,0.402,1,2005-01-16,36,27,9,0.75,36,22,14,0.611
20400534,1610612754,1610612753,84.0,85.0,0.377,0.405,0,2005-01-15,35,18,17,0.514,36,20,16,0.556
20400536,1610612750,1610612757,92.0,84.0,0.456,0.4270000000000001,1,2005-01-15,36,19,17,0.528,36,15,21,0.417
20400531,1610612764,1610612756,108.0,103.0,0.4270000000000001,0.426,1,2005-01-15,35,22,13,0.629,38,31,7,0.816
20400532,1610612737,1610612766,103.0,95.0,0.512,0.449,1,2005-01-15,34,7,27,0.206,33,8,25,0.242
20400533,1610612765,1610612755,99.0,95.0,0.506,0.422,1,2005-01-15,36,22,14,0.611,36,16,20,0.444
20400537,1610612745,1610612759,73.0,67.0,0.3329999999999999,0.353,1,2005-01-15,37,20,17,0.541,39,30,9,0.769
20400538,1610612742,1610612751,98.0,93.0,0.392,0.415,1,2005-01-15,35,23,12,0.657,36,12,24,0.3329999999999999
20400530,1610612741,1610612752,86.0,84.0,0.447,0.3779999999999999,1,2005-01-15,34,16,18,0.471,36,17,19,0.472
20400541,1610612744,1610612747,102.0,104.0,0.424,0.457,0,2005-01-15,38,11,27,0.289,35,20,15,0.5710000000000001
20400540,1610612758,1610612746,99.0,95.0,0.494,0.447,1,2005-01-15,35,24,11,0.6859999999999999,36,18,18,0.5
20400535,1610612763,1610612749,101.0,82.0,0.43,0.446,1,2005-01-15,38,20,18,0.526,35,12,23,0.3429999999999999
20400539,1610612762,1610612739,71.0,84.0,0.366,0.409,0,2005-01-15,39,13,26,0.3329999999999999,35,22,13,0.629
20400528,1610612746,1610612748,114.0,112.0,0.478,0.396,1,2005-01-14,35,18,17,0.514,39,28,11,0.718
20400525,1610612759,1610612742,98.0,95.0,0.5,0.43,1,2005-01-14,38,30,8,0.789,34,22,12,0.647
20400521,1610612754,1610612756,101.0,83.0,0.471,0.392,1,2005-01-14,34,18,16,0.529,37,31,6,0.838
20400523,1610612765,1610612753,101.0,94.0,0.48,0.405,1,2005-01-14,35,21,14,0.6,35,19,16,0.5429999999999999
20400522,1610612738,1610612737,106.0,94.0,0.5,0.4039999999999999,1,2005-01-14,37,17,20,0.4589999999999999,33,6,27,0.182
20400520,1610612766,1610612763,89.0,109.0,0.411,0.482,0,2005-01-14,32,8,24,0.25,37,19,18,0.514
20400527,1610612743,1610612750,83.0,93.0,0.425,0.493,0,2005-01-14,36,15,21,0.417,35,18,17,0.514
20400526,1610612749,1610612764,103.0,105.0,0.519,0.486,0,2005-01-14,34,12,22,0.353,34,21,13,0.618
20400524,1610612740,1610612757,112.0,106.0,0.449,0.494,1,2005-01-14,35,5,30,0.143,35,15,20,0.429
20400529,1610612760,1610612744,103.0,84.0,0.512,0.434,1,2005-01-14,35,26,9,0.743,37,11,26,0.297
20400519,1610612755,1610612761,106.0,96.0,0.452,0.384,1,2005-01-14,35,16,19,0.457,37,14,23,0.3779999999999999
20400518,1610612747,1610612739,98.0,94.0,0.3879999999999999,0.481,1,2005-01-13,34,19,15,0.5589999999999999,34,21,13,0.618
20400516,1610612745,1610612751,94.0,85.0,0.429,0.3879999999999999,1,2005-01-13,36,19,17,0.528,35,12,23,0.3429999999999999
20400517,1610612758,1610612762,107.0,93.0,0.513,0.5,1,2005-01-13,34,23,11,0.6759999999999999,38,13,25,0.342
20400514,1610612746,1610612760,103.0,92.0,0.494,0.413,1,2005-01-12,34,17,17,0.5,34,25,9,0.735
20400510,1610612759,1610612749,94.0,79.0,0.4589999999999999,0.413,1,2005-01-12,37,29,8,0.784,33,12,21,0.364
20400508,1610612750,1610612753,80.0,87.0,0.39,0.407,0,2005-01-12,34,17,17,0.5,34,19,15,0.5589999999999999
20400506,1610612764,1610612757,104.0,100.0,0.488,0.457,1,2005-01-12,33,20,13,0.606,34,15,19,0.441
20400507,1610612765,1610612740,90.0,76.0,0.473,0.416,1,2005-01-12,34,20,14,0.588,34,4,30,0.118
20400511,1610612742,1610612745,114.0,124.0,0.476,0.61,0,2005-01-12,33,22,11,0.667,35,18,17,0.514
20400509,1610612741,1610612755,110.0,78.0,0.488,0.3779999999999999,1,2005-01-12,33,15,18,0.455,34,15,19,0.441
20400515,1610612744,1610612748,91.0,98.0,0.376,0.5589999999999999,0,2005-01-12,36,11,25,0.306,38,28,10,0.737
20400512,1610612743,1610612747,95.0,83.0,0.475,0.3779999999999999,1,2005-01-12,35,15,20,0.429,33,18,15,0.545
20400505,1610612761,1610612738,104.0,93.0,0.4379999999999999,0.4,1,2005-01-12,36,14,22,0.389,36,16,20,0.444
20400513,1610612762,1610612756,115.0,108.0,0.495,0.429,1,2005-01-12,37,13,24,0.351,36,31,5,0.861
20400499,1610612752,1610612740,82.0,88.0,0.429,0.4429999999999999,0,2005-01-11,35,17,18,0.486,33,4,29,0.121
20400500,1610612737,1610612749,103.0,80.0,0.551,0.414,1,2005-01-11,32,6,26,0.188,32,12,20,0.375
20400502,1610612756,1610612748,122.0,107.0,0.474,0.529,1,2005-01-11,35,31,4,0.8859999999999999,37,27,10,0.73
20400497,1610612739,1610612766,100.0,98.0,0.4379999999999999,0.471,1,2005-01-11,33,21,12,0.636,31,8,23,0.258
20400503,1610612758,1610612743,109.0,100.0,0.4679999999999999,0.4629999999999999,1,2005-01-11,33,22,11,0.667,34,14,20,0.412
20400501,1610612763,1610612754,85.0,86.0,0.4920000000000001,0.411,0,2005-01-11,36,18,18,0.5,33,17,16,0.515
20400504,1610612760,1610612746,104.0,99.0,0.4379999999999999,0.439,1,2005-01-11,33,25,8,0.758,33,16,17,0.485
20400498,1610612751,1610612765,80.0,89.0,0.3720000000000001,0.451,0,2005-01-11,34,12,22,0.353,33,19,14,0.5760000000000001
20400494,1610612750,1610612747,96.0,105.0,0.4679999999999999,0.439,0,2005-01-10,33,17,16,0.515,32,18,14,0.563
20400492,1610612738,1610612753,119.0,101.0,0.474,0.4579999999999999,1,2005-01-10,35,16,19,0.457,33,18,15,0.545
20400495,1610612741,1610612744,94.0,85.0,0.457,0.3289999999999999,1,2005-01-10,32,14,18,0.4379999999999999,35,11,24,0.314
20400496,1610612762,1610612759,97.0,96.0,0.486,0.541,1,2005-01-10,36,12,24,0.3329999999999999,36,28,8,0.778
20400493,1610612755,1610612757,100.0,109.0,0.44,0.481,0,2005-01-10,33,15,18,0.455,33,15,18,0.455
20400488,1610612752,1610612757,113.0,105.0,0.586,0.5529999999999999,1,2005-01-09,34,17,17,0.5,32,14,18,0.4379999999999999
20400489,1610612756,1610612754,124.0,89.0,0.5429999999999999,0.3979999999999999,1,2005-01-09,34,30,4,0.882,32,16,16,0.5
20400491,1610612743,1610612745,98.0,116.0,0.425,0.519,0,2005-01-09,33,14,19,0.424,34,17,17,0.5
20400487,1610612761,1610612744,109.0,87.0,0.536,0.405,1,2005-01-09,35,13,22,0.371,34,11,23,0.324
20400490,1610612760,1610612748,108.0,98.0,0.481,0.481,1,2005-01-09,32,24,8,0.75,36,27,9,0.75
20400480,1610612746,1610612756,91.0,108.0,0.402,0.488,0,2005-01-08,32,16,16,0.5,33,29,4,0.879
20400479,1610612759,1610612743,99.0,90.0,0.5,0.447,1,2005-01-08,35,28,7,0.8,32,14,18,0.4379999999999999
20400481,1610612764,1610612750,117.0,114.0,0.455,0.477,1,2005-01-08,32,19,13,0.594,32,17,15,0.531
20400478,1610612739,1610612752,104.0,79.0,0.526,0.39,1,2005-01-08,32,20,12,0.625,33,16,17,0.485
20400486,1610612742,1610612754,121.0,101.0,0.5479999999999999,0.421,1,2005-01-08,32,22,10,0.688,31,16,15,0.516
20400484,1610612741,1610612738,102.0,91.0,0.482,0.429,1,2005-01-08,31,13,18,0.419,34,15,19,0.441
20400485,1610612749,1610612762,89.0,86.0,0.412,0.3979999999999999,1,2005-01-08,31,12,19,0.387,35,11,24,0.314
20400483,1610612740,1610612758,121.0,117.0,0.452,0.442,1,2005-01-08,32,3,29,0.094,32,21,11,0.6559999999999999
20400482,1610612753,1610612751,104.0,101.0,0.474,0.402,1,2005-01-08,32,18,14,0.563,33,12,21,0.364
20400477,1610612747,1610612745,111.0,104.0,0.541,0.4589999999999999,1,2005-01-07,31,17,14,0.5479999999999999,33,16,17,0.485
20400474,1610612750,1610612755,89.0,84.0,0.402,0.346,1,2005-01-07,31,17,14,0.5479999999999999,32,15,17,0.469
20400472,1610612737,1610612758,97.0,100.0,0.488,0.469,0,2005-01-07,31,5,26,0.161,31,21,10,0.677
20400470,1610612738,1610612765,104.0,110.0,0.591,0.494,0,2005-01-07,33,15,18,0.455,32,18,14,0.563
20400475,1610612741,1610612762,84.0,78.0,0.408,0.366,1,2005-01-07,30,12,18,0.4,34,11,23,0.324
20400476,1610612757,1610612748,92.0,103.0,0.474,0.513,0,2005-01-07,31,14,17,0.452,35,27,8,0.7709999999999999
20400473,1610612763,1610612740,84.0,76.0,0.449,0.317,1,2005-01-07,35,18,17,0.514,31,2,29,0.065
20400468,1610612761,1610612749,105.0,107.0,0.368,0.4479999999999999,0,2005-01-07,34,12,22,0.353,30,11,19,0.3670000000000001
20400471,1610612751,1610612744,82.0,72.0,0.3879999999999999,0.356,1,2005-01-07,32,12,20,0.375,33,11,22,0.3329999999999999
20400469,1610612753,1610612766,111.0,91.0,0.507,0.444,1,2005-01-07,31,17,14,0.5479999999999999,30,8,22,0.267
20400467,1610612759,1610612754,111.0,98.0,0.507,0.507,1,2005-01-06,34,27,7,0.794,30,16,14,0.5329999999999999
20400465,1610612764,1610612760,107.0,96.0,0.41,0.4479999999999999,1,2005-01-06,31,18,13,0.581,31,23,8,0.742
20400466,1610612765,1610612763,79.0,101.0,0.313,0.506,0,2005-01-06,31,17,14,0.5479999999999999,34,17,17,0.5
20400464,1610612746,1610612757,102.0,98.0,0.482,0.469,1,2005-01-05,31,16,15,0.516,30,14,16,0.467
20400457,1610612739,1610612737,101.0,85.0,0.494,0.41,1,2005-01-05,31,19,12,0.613,30,5,25,0.1669999999999999
20400458,1610612748,1610612752,102.0,94.0,0.488,0.507,1,2005-01-05,34,26,8,0.765,32,16,16,0.5
20400453,1610612738,1610612744,84.0,83.0,0.4379999999999999,0.436,1,2005-01-05,32,15,17,0.469,32,11,21,0.344
20400462,1610612745,1610612756,98.0,108.0,0.392,0.4589999999999999,0,2005-01-05,32,16,16,0.5,32,28,4,0.875
20400461,1610612742,1610612747,118.0,104.0,0.5539999999999999,0.396,1,2005-01-05,31,21,10,0.677,30,16,14,0.5329999999999999
20400455,1610612766,1610612750,102.0,84.0,0.44,0.3929999999999999,1,2005-01-05,29,8,21,0.276,30,16,14,0.5329999999999999
20400454,1610612761,1610612758,96.0,93.0,0.391,0.395,1,2005-01-05,33,12,21,0.364,30,20,10,0.667
20400459,1610612749,1610612751,97.0,74.0,0.5379999999999999,0.349,1,2005-01-05,29,10,19,0.345,31,11,20,0.355
20400460,1610612740,1610612741,89.0,95.0,0.366,0.444,0,2005-01-05,30,2,28,0.067,29,11,18,0.379
20400463,1610612762,1610612755,99.0,106.0,0.514,0.462,0,2005-01-05,33,11,22,0.3329999999999999,31,15,16,0.484
20400456,1610612753,1610612760,105.0,87.0,0.512,0.35,1,2005-01-05,30,16,14,0.5329999999999999,30,23,7,0.767
20400452,1610612759,1610612747,100.0,83.0,0.465,0.408,1,2005-01-04,33,26,7,0.7879999999999999,29,16,13,0.552
20400449,1610612754,1610612749,116.0,99.0,0.522,0.486,1,2005-01-04,29,16,13,0.552,28,9,19,0.321
20400451,1610612750,1610612756,115.0,122.0,0.547,0.539,0,2005-01-04,29,16,13,0.552,31,27,4,0.871
20400448,1610612764,1610612751,112.0,88.0,0.482,0.507,1,2005-01-04,30,17,13,0.5670000000000001,30,11,19,0.3670000000000001
20400450,1610612752,1610612758,98.0,105.0,0.462,0.506,0,2005-01-04,31,16,15,0.516,29,20,9,0.69
20400443,1610612748,1610612760,96.0,98.0,0.471,0.414,0,2005-01-03,33,25,8,0.758,29,23,6,0.7929999999999999
20400440,1610612738,1610612740,108.0,90.0,0.45,0.391,1,2005-01-03,31,14,17,0.452,29,2,27,0.069
20400445,1610612741,1610612765,80.0,87.0,0.341,0.4379999999999999,0,2005-01-03,28,10,18,0.357,30,17,13,0.5670000000000001
20400447,1610612744,1610612755,104.0,112.0,0.514,0.5,0,2005-01-03,31,11,20,0.355,30,14,16,0.467
20400442,1610612766,1610612739,83.0,94.0,0.384,0.452,0,2005-01-03,28,7,21,0.25,30,18,12,0.6
20400446,1610612743,1610612746,98.0,102.0,0.43,0.444,0,2005-01-03,31,14,17,0.452,30,15,15,0.5
20400444,1610612763,1610612762,92.0,82.0,0.431,0.429,1,2005-01-03,33,16,17,0.485,32,11,21,0.344
20400441,1610612761,1610612753,105.0,94.0,0.4479999999999999,0.4529999999999999,1,2005-01-03,32,11,21,0.344,29,15,14,0.517
20400433,1610612746,1610612755,89.0,83.0,0.4589999999999999,0.356,1,2005-01-02,29,14,15,0.483,29,13,16,0.4479999999999999
20400439,1610612747,1610612743,99.0,91.0,0.391,0.371,1,2005-01-02,28,16,12,0.5710000000000001,30,14,16,0.467
20400432,1610612764,1610612737,104.0,101.0,0.43,0.4370000000000001,1,2005-01-02,29,16,13,0.552,29,5,24,0.172
20400434,1610612765,1610612738,100.0,88.0,0.494,0.436,1,2005-01-02,29,16,13,0.552,30,13,17,0.433
20400435,1610612756,1610612757,117.0,98.0,0.523,0.494,1,2005-01-02,30,26,4,0.867,29,14,15,0.483
20400436,1610612745,1610612762,99.0,80.0,0.446,0.39,1,2005-01-02,31,16,15,0.516,31,11,20,0.355
20400437,1610612742,1610612749,123.0,104.0,0.528,0.471,1,2005-01-02,30,20,10,0.667,27,9,18,0.3329999999999999
20400438,1610612758,1610612759,86.0,81.0,0.442,0.386,1,2005-01-02,28,19,9,0.679,32,25,7,0.7809999999999999
20400429,1610612750,1610612763,95.0,104.0,0.507,0.534,0,2005-01-01,28,16,12,0.5710000000000001,32,15,17,0.469
20400427,1610612752,1610612751,87.0,93.0,0.408,0.493,0,2005-01-01,30,16,14,0.5329999999999999,29,11,18,0.379
20400428,1610612748,1610612766,113.0,90.0,0.5920000000000001,0.439,1,2005-01-01,32,25,7,0.7809999999999999,27,7,20,0.259
20400430,1610612741,1610612753,105.0,90.0,0.475,0.375,1,2005-01-01,27,10,17,0.37,28,15,13,0.536
20400431,1610612757,1610612744,97.0,88.0,0.447,0.366,1,2005-01-01,28,14,14,0.5,30,11,19,0.3670000000000001
20400425,1610612746,1610612759,79.0,98.0,0.416,0.493,0,2004-12-31,28,13,15,0.4639999999999999,31,25,6,0.8059999999999999
20400421,1610612738,1610612764,108.0,103.0,0.4679999999999999,0.447,1,2004-12-31,29,13,16,0.4479999999999999,28,15,13,0.536
20400426,1610612745,1610612749,105.0,90.0,0.513,0.39,1,2004-12-31,30,15,15,0.5,26,9,17,0.346
20400422,1610612766,1610612760,97.0,103.0,0.483,0.488,0,2004-12-31,26,7,19,0.2689999999999999,28,22,6,0.7859999999999999
20400423,1610612743,1610612755,97.0,92.0,0.413,0.4429999999999999,1,2004-12-31,29,14,15,0.483,28,13,15,0.4639999999999999
20400424,1610612762,1610612758,102.0,109.0,0.513,0.519,0,2004-12-31,30,11,19,0.3670000000000001,27,18,9,0.667
20400417,1610612737,1610612760,79.0,94.0,0.3879999999999999,0.467,0,2004-12-30,28,5,23,0.179,27,21,6,0.778
20400419,1610612765,1610612748,78.0,89.0,0.39,0.467,0,2004-12-30,28,15,13,0.536,31,24,7,0.774
20400420,1610612757,1610612759,80.0,114.0,0.395,0.54,0,2004-12-30,27,13,14,0.481,30,24,6,0.8
20400418,1610612751,1610612754,83.0,96.0,0.384,0.44,0,2004-12-30,28,10,18,0.357,28,15,13,0.536
20400415,1610612746,1610612762,101.0,90.0,0.486,0.436,1,2004-12-29,27,13,14,0.481,29,11,18,0.379
20400408,1610612764,1610612765,105.0,107.0,0.488,0.5,0,2004-12-29,27,15,12,0.556,27,15,12,0.556
20400412,1610612752,1610612750,100.0,87.0,0.542,0.402,1,2004-12-29,29,16,13,0.552,27,16,11,0.593
20400411,1610612739,1610612745,87.0,98.0,0.377,0.4639999999999999,0,2004-12-29,29,17,12,0.586,29,14,15,0.483
20400416,1610612744,1610612761,111.0,105.0,0.4579999999999999,0.482,1,2004-12-29,29,11,18,0.379,31,10,21,0.3229999999999999
20400409,1610612766,1610612754,71.0,74.0,0.365,0.384,0,2004-12-29,25,7,18,0.28,27,14,13,0.519
20400413,1610612763,1610612738,117.0,109.0,0.481,0.493,1,2004-12-29,31,14,17,0.452,28,12,16,0.429
20400414,1610612740,1610612756,96.0,107.0,0.47,0.455,0,2004-12-29,28,2,26,0.071,29,25,4,0.862
20400410,1610612753,1610612749,105.0,111.0,0.494,0.488,0,2004-12-29,27,15,12,0.556,25,9,16,0.36
20400407,1610612747,1610612761,117.0,99.0,0.457,0.4039999999999999,1,2004-12-28,27,15,12,0.556,30,10,20,0.3329999999999999
20400405,1610612759,1610612756,115.0,94.0,0.516,0.397,1,2004-12-28,29,23,6,0.7929999999999999,28,24,4,0.857
20400401,1610612737,1610612739,102.0,111.0,0.526,0.475,0,2004-12-28,27,5,22,0.185,28,17,11,0.607
20400404,1610612742,1610612738,113.0,94.0,0.532,0.45,1,2004-12-28,29,19,10,0.655,27,12,15,0.444
20400403,1610612741,1610612751,80.0,84.0,0.435,0.382,0,2004-12-28,26,9,17,0.346,27,10,17,0.37
20400402,1610612749,1610612745,115.0,87.0,0.531,0.425,1,2004-12-28,24,8,16,0.3329999999999999,28,13,15,0.4639999999999999
20400406,1610612760,1610612755,107.0,114.0,0.4479999999999999,0.475,0,2004-12-28,26,20,6,0.769,27,13,14,0.481
20400394,1610612754,1610612740,100.0,82.0,0.507,0.4029999999999999,1,2004-12-27,26,13,13,0.5,27,2,25,0.074
20400392,1610612764,1610612766,106.0,87.0,0.5479999999999999,0.44,1,2004-12-27,26,15,11,0.5770000000000001,24,7,17,0.292
20400396,1610612765,1610612751,100.0,90.0,0.461,0.356,1,2004-12-27,26,14,12,0.5379999999999999,26,9,17,0.346
20400395,1610612748,1610612737,116.0,102.0,0.513,0.513,1,2004-12-27,30,23,7,0.767,26,5,21,0.192
20400399,1610612757,1610612755,104.0,111.0,0.482,0.446,0,2004-12-27,26,13,13,0.5,26,12,14,0.462
20400400,1610612744,1610612743,104.0,101.0,0.439,0.494,1,2004-12-27,28,10,18,0.357,28,13,15,0.4639999999999999
20400397,1610612763,1610612746,96.0,76.0,0.452,0.361,1,2004-12-27,30,13,17,0.433,26,12,14,0.462
20400398,1610612762,1610612760,88.0,98.0,0.466,0.4370000000000001,0,2004-12-27,28,11,17,0.3929999999999999,25,20,5,0.8
20400393,1610612753,1610612752,111.0,119.0,0.493,0.535,0,2004-12-27,26,15,11,0.5770000000000001,28,15,13,0.536
20400386,1610612759,1610612738,107.0,90.0,0.525,0.48,1,2004-12-26,28,22,6,0.7859999999999999,26,12,14,0.462
20400387,1610612750,1610612764,109.0,74.0,0.467,0.385,1,2004-12-26,26,16,10,0.615,25,14,11,0.56
20400383,1610612752,1610612766,91.0,82.0,0.478,0.375,1,2004-12-26,27,14,13,0.519,23,7,16,0.304
20400388,1610612756,1610612761,106.0,94.0,0.488,0.488,1,2004-12-26,27,24,3,0.889,29,10,19,0.345
20400384,1610612739,1610612740,100.0,91.0,0.507,0.357,1,2004-12-26,27,16,11,0.593,26,2,24,0.077
20400389,1610612745,1610612746,96.0,79.0,0.487,0.413,1,2004-12-26,27,13,14,0.481,25,12,13,0.48
20400390,1610612743,1610612742,88.0,102.0,0.3929999999999999,0.465,0,2004-12-26,27,13,14,0.481,28,18,10,0.643
20400391,1610612758,1610612744,94.0,98.0,0.457,0.465,0,2004-12-26,26,17,9,0.654,27,9,18,0.3329999999999999
20400385,1610612749,1610612741,99.0,92.0,0.476,0.449,1,2004-12-26,23,7,16,0.304,25,9,16,0.36
20400382,1610612747,1610612748,102.0,104.0,0.439,0.444,0,2004-12-25,26,14,12,0.5379999999999999,29,22,7,0.759
20400381,1610612754,1610612765,93.0,98.0,0.461,0.407,0,2004-12-25,25,12,13,0.48,25,13,12,0.52
20400378,1610612759,1610612750,96.0,82.0,0.457,0.408,1,2004-12-23,27,21,6,0.778,25,15,10,0.6
20400379,1610612756,1610612763,109.0,102.0,0.46,0.519,1,2004-12-23,26,23,3,0.885,29,12,17,0.414
20400380,1610612758,1610612748,107.0,109.0,0.421,0.494,0,2004-12-23,25,17,8,0.68,28,21,7,0.75
20400377,1610612747,1610612740,101.0,89.0,0.3779999999999999,0.364,1,2004-12-22,25,14,11,0.56,25,2,23,0.08
20400369,1610612754,1610612755,90.0,102.0,0.462,0.462,0,2004-12-22,24,12,12,0.5,25,11,14,0.44
20400371,1610612737,1610612742,113.0,100.0,0.535,0.44,1,2004-12-22,25,5,20,0.2,27,17,10,0.63
20400372,1610612765,1610612741,82.0,89.0,0.356,0.471,0,2004-12-22,24,12,12,0.5,24,9,15,0.375
20400374,1610612745,1610612766,87.0,90.0,0.3879999999999999,0.4379999999999999,0,2004-12-22,26,12,14,0.462,22,7,15,0.318
20400366,1610612738,1610612752,114.0,109.0,0.506,0.462,1,2004-12-22,25,12,13,0.48,26,13,13,0.5
20400375,1610612744,1610612763,109.0,99.0,0.456,0.5,1,2004-12-22,26,8,18,0.308,28,12,16,0.429
20400367,1610612761,1610612762,98.0,86.0,0.471,0.444,1,2004-12-22,28,10,18,0.357,27,11,16,0.407
20400373,1610612749,1610612757,95.0,104.0,0.472,0.507,0,2004-12-22,22,6,16,0.273,25,13,12,0.52
20400376,1610612760,1610612743,98.0,83.0,0.435,0.452,1,2004-12-22,24,19,5,0.792,26,13,13,0.5
20400370,1610612751,1610612739,92.0,90.0,0.436,0.381,1,2004-12-22,25,9,16,0.36,26,15,11,0.5770000000000001
20400368,1610612753,1610612759,93.0,87.0,0.429,0.3929999999999999,1,2004-12-22,25,15,10,0.6,26,20,6,0.769
20400365,1610612746,1610612740,100.0,91.0,0.494,0.352,1,2004-12-21,24,12,12,0.5,24,2,22,0.083
20400362,1610612752,1610612742,94.0,123.0,0.376,0.482,0,2004-12-21,25,13,12,0.52,26,17,9,0.654
20400361,1610612739,1610612750,107.0,97.0,0.527,0.44,1,2004-12-21,25,15,10,0.6,24,15,9,0.625
20400363,1610612748,1610612738,108.0,100.0,0.5,0.494,1,2004-12-21,27,20,7,0.741,24,11,13,0.4579999999999999
20400360,1610612766,1610612751,91.0,94.0,0.415,0.455,0,2004-12-21,21,6,15,0.286,24,8,16,0.3329999999999999
20400364,1610612758,1610612764,104.0,93.0,0.519,0.4629999999999999,1,2004-12-21,24,17,7,0.708,24,14,10,0.583
20400358,1610612747,1610612763,72.0,82.0,0.319,0.369,0,2004-12-20,24,13,11,0.542,27,12,15,0.444
20400356,1610612745,1610612761,114.0,102.0,0.519,0.461,1,2004-12-20,25,12,13,0.48,27,9,18,0.3329999999999999
20400355,1610612741,1610612757,92.0,87.0,0.467,0.39,1,2004-12-20,23,8,15,0.348,24,12,12,0.5
20400359,1610612744,1610612764,101.0,103.0,0.462,0.41,0,2004-12-20,25,7,18,0.28,23,14,9,0.609
20400357,1610612743,1610612756,105.0,107.0,0.512,0.531,0,2004-12-20,25,13,12,0.52,25,22,3,0.88
20400354,1610612755,1610612762,101.0,103.0,0.408,0.481,0,2004-12-20,24,10,14,0.417,26,11,15,0.423
20400353,1610612746,1610612763,82.0,92.0,0.441,0.434,0,2004-12-19,23,11,12,0.478,26,11,15,0.423
20400350,1610612752,1610612762,94.0,93.0,0.451,0.4579999999999999,1,2004-12-19,24,13,11,0.542,25,10,15,0.4
20400351,1610612748,1610612753,117.0,107.0,0.518,0.513,1,2004-12-19,26,19,7,0.731,24,14,10,0.583
20400352,1610612758,1610612740,107.0,71.0,0.52,0.325,1,2004-12-19,23,16,7,0.696,23,2,21,0.087
20400349,1610612761,1610612751,110.0,99.0,0.536,0.522,1,2004-12-19,26,9,17,0.346,23,7,16,0.304
20400347,1610612759,1610612744,104.0,85.0,0.518,0.418,1,2004-12-18,25,20,5,0.8,24,7,17,0.292
20400342,1610612765,1610612757,74.0,75.0,0.315,0.408,0,2004-12-18,23,12,11,0.522,23,12,11,0.522
20400348,1610612756,1610612764,110.0,96.0,0.478,0.46,1,2004-12-18,24,21,3,0.875,22,13,9,0.591
20400343,1610612739,1610612738,107.0,114.0,0.455,0.4429999999999999,0,2004-12-18,24,14,10,0.583,23,11,12,0.478
20400346,1610612742,1610612737,90.0,68.0,0.41,0.37,1,2004-12-18,25,16,9,0.64,24,4,20,0.1669999999999999
20400344,1610612741,1610612754,85.0,71.0,0.375,0.306,1,2004-12-18,22,7,15,0.318,23,12,11,0.522
20400340,1610612766,1610612745,101.0,100.0,0.356,0.422,1,2004-12-18,20,6,14,0.3,24,11,13,0.4579999999999999
20400345,1610612749,1610612755,97.0,116.0,0.341,0.4629999999999999,0,2004-12-18,21,6,15,0.286,23,10,13,0.435
20400341,1610612753,1610612743,117.0,95.0,0.581,0.407,1,2004-12-18,23,14,9,0.609,24,13,11,0.542
20400338,1610612747,1610612764,116.0,120.0,0.471,0.511,0,2004-12-17,23,13,10,0.565,21,13,8,0.619
20400330,1610612754,1610612761,89.0,86.0,0.481,0.411,1,2004-12-17,22,12,10,0.545,25,8,17,0.32
20400336,1610612750,1610612746,113.0,86.0,0.487,0.391,1,2004-12-17,23,15,8,0.652,22,11,11,0.5
20400332,1610612737,1610612757,84.0,100.0,0.36,0.5770000000000001,0,2004-12-17,23,4,19,0.174,22,11,11,0.5
20400333,1610612748,1610612743,107.0,100.0,0.518,0.4639999999999999,1,2004-12-17,25,18,7,0.72,23,13,10,0.565
20400331,1610612738,1610612762,114.0,106.0,0.551,0.446,1,2004-12-17,22,10,12,0.455,24,10,14,0.417
20400337,1610612745,1610612744,100.0,83.0,0.482,0.33,1,2004-12-17,23,11,12,0.478,23,7,16,0.304
20400334,1610612763,1610612751,89.0,84.0,0.417,0.41,1,2004-12-17,25,10,15,0.4,22,7,15,0.318
20400335,1610612740,1610612759,67.0,83.0,0.382,0.4270000000000001,0,2004-12-17,22,2,20,0.091,24,19,5,0.792
20400339,1610612760,1610612756,110.0,112.0,0.489,0.488,0,2004-12-17,23,18,5,0.7829999999999999,23,20,3,0.87
20400329,1610612755,1610612752,107.0,113.0,0.478,0.42,0,2004-12-17,22,9,13,0.409,23,12,11,0.522
20400326,1610612765,1610612739,81.0,69.0,0.408,0.346,1,2004-12-16,22,12,10,0.545,23,14,9,0.609
20400327,1610612741,1610612749,85.0,77.0,0.493,0.3879999999999999,1,2004-12-16,21,6,15,0.286,20,6,14,0.3
20400328,1610612758,1610612747,99.0,115.0,0.456,0.5539999999999999,0,2004-12-16,22,15,7,0.682,22,13,9,0.591
20400324,1610612759,1610612753,94.0,91.0,0.462,0.397,1,2004-12-15,23,18,5,0.7829999999999999,22,13,9,0.591
20400318,1610612764,1610612748,93.0,98.0,0.391,0.4639999999999999,0,2004-12-15,20,12,8,0.6,24,17,7,0.708
20400320,1610612752,1610612765,93.0,94.0,0.442,0.4679999999999999,0,2004-12-15,22,11,11,0.5,21,11,10,0.524
20400325,1610612756,1610612762,108.0,86.0,0.467,0.416,1,2004-12-15,22,19,3,0.8640000000000001,23,10,13,0.435
20400319,1610612739,1610612757,112.0,88.0,0.536,0.451,1,2004-12-15,22,14,8,0.636,21,10,11,0.476
20400316,1610612738,1610612743,99.0,100.0,0.3929999999999999,0.481,0,2004-12-15,21,9,12,0.429,22,13,9,0.591
20400323,1610612745,1610612737,92.0,69.0,0.467,0.342,1,2004-12-15,22,10,12,0.455,22,4,18,0.182
20400321,1610612763,1610612741,88.0,96.0,0.4429999999999999,0.467,0,2004-12-15,24,9,15,0.375,20,5,15,0.25
20400317,1610612761,1610612750,96.0,90.0,0.4320000000000001,0.4479999999999999,1,2004-12-15,24,8,16,0.3329999999999999,22,14,8,0.636
20400322,1610612740,1610612744,98.0,89.0,0.452,0.43,1,2004-12-15,21,2,19,0.095,22,7,15,0.318
20400312,1610612750,1610612757,100.0,89.0,0.5,0.4429999999999999,1,2004-12-14,21,14,7,0.667,20,10,10,0.5
20400310,1610612737,1610612754,97.0,108.0,0.452,0.513,0,2004-12-14,21,4,17,0.19,21,11,10,0.524
20400313,1610612742,1610612744,107.0,111.0,0.429,0.5,0,2004-12-14,24,15,9,0.625,21,7,14,0.3329999999999999
20400308,1610612766,1610612740,94.0,93.0,0.42,0.447,1,2004-12-14,19,5,14,0.263,20,1,19,0.05
20400311,1610612749,1610612758,86.0,89.0,0.395,0.389,0,2004-12-14,19,6,13,0.316,21,15,6,0.7140000000000001
20400314,1610612762,1610612746,93.0,91.0,0.4320000000000001,0.456,1,2004-12-14,22,10,12,0.455,21,11,10,0.524
20400315,1610612760,1610612747,108.0,93.0,0.5,0.395,1,2004-12-14,22,18,4,0.818,21,12,9,0.5710000000000001
20400309,1610612751,1610612752,79.0,87.0,0.346,0.3939999999999999,0,2004-12-14,21,7,14,0.3329999999999999,21,11,10,0.524
20400307,1610612755,1610612743,110.0,102.0,0.512,0.4579999999999999,1,2004-12-14,21,9,12,0.429,21,12,9,0.5710000000000001
20400306,1610612746,1610612738,127.0,134.0,0.462,0.5,0,2004-12-13,20,11,9,0.55,20,9,11,0.45
20400305,1610612756,1610612753,121.0,100.0,0.511,0.3829999999999999,1,2004-12-13,21,18,3,0.857,21,13,8,0.619
20400302,1610612748,1610612764,106.0,83.0,0.481,0.36,1,2004-12-13,23,16,7,0.696,19,12,7,0.632
20400304,1610612741,1610612742,93.0,94.0,0.526,0.415,0,2004-12-13,19,4,15,0.211,23,15,8,0.652
20400303,1610612763,1610612739,86.0,92.0,0.479,0.487,0,2004-12-13,23,9,14,0.391,21,13,8,0.619
20400301,1610612747,1610612753,105.0,98.0,0.425,0.488,1,2004-12-12,20,12,8,0.6,20,13,7,0.65
20400297,1610612764,1610612740,88.0,69.0,0.3979999999999999,0.318,1,2004-12-12,18,12,6,0.667,19,1,18,0.053
20400295,1610612752,1610612743,107.0,96.0,0.489,0.451,1,2004-12-12,20,10,10,0.5,20,12,8,0.6
20400300,1610612744,1610612766,99.0,87.0,0.444,0.45,1,2004-12-12,20,6,14,0.3,18,4,14,0.222
20400299,1610612757,1610612762,98.0,88.0,0.47,0.455,1,2004-12-12,19,10,9,0.526,21,9,12,0.429
20400296,1610612761,1610612748,98.0,106.0,0.4679999999999999,0.56,0,2004-12-12,23,7,16,0.304,22,15,7,0.682
20400298,1610612755,1610612749,107.0,101.0,0.476,0.422,1,2004-12-12,20,8,12,0.4,18,6,12,0.3329999999999999
20400294,1610612746,1610612747,87.0,89.0,0.371,0.421,0,2004-12-11,19,11,8,0.579,19,11,8,0.579
20400292,1610612759,1610612739,116.0,97.0,0.662,0.465,1,2004-12-11,22,17,5,0.773,20,12,8,0.6
20400288,1610612754,1610612758,92.0,97.0,0.385,0.4639999999999999,0,2004-12-11,20,10,10,0.5,20,14,6,0.7
20400287,1610612737,1610612751,90.0,95.0,0.481,0.416,0,2004-12-11,20,4,16,0.2,20,7,13,0.35
20400291,1610612745,1610612742,78.0,102.0,0.3379999999999999,0.4629999999999999,0,2004-12-11,21,9,12,0.429,22,14,8,0.636
20400290,1610612741,1610612750,99.0,88.0,0.4639999999999999,0.359,1,2004-12-11,18,4,14,0.222,20,13,7,0.65
20400289,1610612763,1610612765,72.0,68.0,0.375,0.356,1,2004-12-11,22,9,13,0.409,20,10,10,0.5
20400293,1610612760,1610612738,84.0,98.0,0.326,0.542,0,2004-12-11,21,17,4,0.81,19,8,11,0.421
20400282,1610612750,1610612758,113.0,105.0,0.512,0.477,1,2004-12-10,19,13,6,0.684,19,13,6,0.684
20400277,1610612764,1610612752,106.0,104.0,0.436,0.529,1,2004-12-10,17,11,6,0.647,19,9,10,0.474
20400280,1610612765,1610612737,72.0,88.0,0.307,0.551,0,2004-12-10,19,10,9,0.526,19,4,15,0.211
20400284,1610612756,1610612766,115.0,106.0,0.529,0.413,1,2004-12-10,20,17,3,0.85,17,4,13,0.235
20400279,1610612748,1610612763,92.0,84.0,0.508,0.359,1,2004-12-10,21,14,7,0.667,21,8,13,0.381
20400281,1610612741,1610612755,88.0,93.0,0.4,0.43,0,2004-12-10,17,3,14,0.176,19,7,12,0.368
20400286,1610612744,1610612753,109.0,113.0,0.513,0.477,0,2004-12-10,19,5,14,0.263,19,13,6,0.684
20400276,1610612761,1610612743,87.0,101.0,0.38,0.541,0,2004-12-10,22,7,15,0.318,19,12,7,0.632
20400283,1610612749,1610612754,95.0,86.0,0.39,0.389,1,2004-12-10,17,6,11,0.353,19,10,9,0.526
20400285,1610612762,1610612757,92.0,87.0,0.442,0.405,1,2004-12-10,20,9,11,0.45,18,9,9,0.5
20400278,1610612751,1610612740,94.0,91.0,0.5429999999999999,0.41,1,2004-12-10,19,6,13,0.316,18,1,17,0.0559999999999999
20400273,1610612745,1610612759,81.0,80.0,0.354,0.3379999999999999,1,2004-12-09,20,9,11,0.45,21,16,5,0.762
20400274,1610612742,1610612760,102.0,107.0,0.455,0.452,0,2004-12-09,21,13,8,0.619,20,17,3,0.85
20400275,1610612757,1610612738,89.0,87.0,0.355,0.386,1,2004-12-09,17,9,8,0.529,18,7,11,0.389
20400272,1610612747,1610612756,110.0,113.0,0.455,0.471,0,2004-12-08,18,10,8,0.556,19,16,3,0.8420000000000001
20400270,1610612759,1610612760,96.0,102.0,0.413,0.471,0,2004-12-08,20,16,4,0.8,19,16,3,0.8420000000000001
20400264,1610612764,1610612743,105.0,111.0,0.467,0.495,0,2004-12-08,16,10,6,0.625,18,11,7,0.611
20400265,1610612737,1610612763,89.0,97.0,0.397,0.4639999999999999,0,2004-12-08,18,3,15,0.1669999999999999,20,8,12,0.4
20400266,1610612765,1610612761,90.0,86.0,0.3779999999999999,0.376,1,2004-12-08,18,10,8,0.556,21,7,14,0.3329999999999999
20400269,1610612741,1610612739,113.0,85.0,0.529,0.363,1,2004-12-08,16,3,13,0.188,19,12,7,0.632
20400267,1610612749,1610612748,96.0,101.0,0.4429999999999999,0.447,0,2004-12-08,16,5,11,0.313,20,13,7,0.65
20400268,1610612740,1610612752,79.0,86.0,0.349,0.4320000000000001,0,2004-12-08,17,1,16,0.059,18,9,9,0.5
20400271,1610612762,1610612753,100.0,106.0,0.461,0.481,0,2004-12-08,19,8,11,0.421,18,12,6,0.667
20400263,1610612755,1610612750,84.0,119.0,0.381,0.494,0,2004-12-08,18,6,12,0.3329999999999999,18,12,6,0.667
20400257,1610612754,1610612749,86.0,89.0,0.465,0.449,0,2004-12-07,18,10,8,0.556,15,5,10,0.3329999999999999
20400259,1610612750,1610612742,87.0,97.0,0.442,0.389,0,2004-12-07,17,11,6,0.647,20,13,7,0.65
20400261,1610612756,1610612744,118.0,104.0,0.483,0.444,1,2004-12-07,18,15,3,0.833,18,5,13,0.278
20400256,1610612739,1610612751,103.0,97.0,0.493,0.493,1,2004-12-07,18,12,6,0.667,18,5,13,0.278
20400260,1610612745,1610612740,89.0,81.0,0.451,0.389,1,2004-12-07,19,8,11,0.421,16,1,15,0.063
20400262,1610612758,1610612766,109.0,92.0,0.444,0.384,1,2004-12-07,18,13,5,0.722,16,4,12,0.25
20400258,1610612763,1610612752,96.0,88.0,0.494,0.341,1,2004-12-07,19,7,12,0.368,17,8,9,0.471
20400254,1610612746,1610612766,99.0,93.0,0.474,0.3779999999999999,1,2004-12-06,18,11,7,0.611,15,4,11,0.267
20400249,1610612737,1610612755,96.0,92.0,0.365,0.413,1,2004-12-06,17,3,14,0.176,17,6,11,0.353
20400251,1610612742,1610612765,85.0,101.0,0.3329999999999999,0.481,0,2004-12-06,19,12,7,0.632,17,9,8,0.529
20400250,1610612741,1610612759,75.0,91.0,0.39,0.418,0,2004-12-06,15,2,13,0.133,19,16,3,0.8420000000000001
20400255,1610612744,1610612738,110.0,106.0,0.467,0.4579999999999999,1,2004-12-06,17,5,12,0.294,17,7,10,0.412
20400252,1610612743,1610612753,115.0,102.0,0.488,0.481,1,2004-12-06,17,10,7,0.588,17,11,6,0.647
20400253,1610612762,1610612748,80.0,100.0,0.389,0.515,0,2004-12-06,18,8,10,0.444,19,12,7,0.632
20400248,1610612751,1610612761,88.0,86.0,0.385,0.359,1,2004-12-06,17,5,12,0.294,20,7,13,0.35
20400247,1610612757,1610612756,99.0,121.0,0.416,0.478,0,2004-12-05,16,8,8,0.5,17,14,3,0.8240000000000001
20400246,1610612758,1610612738,119.0,105.0,0.479,0.447,1,2004-12-05,17,12,5,0.706,16,7,9,0.4379999999999999
20400243,1610612746,1610612750,100.0,107.0,0.4679999999999999,0.461,0,2004-12-04,17,10,7,0.588,16,11,5,0.688
20400237,1610612764,1610612741,95.0,88.0,0.353,0.4370000000000001,1,2004-12-04,15,10,5,0.667,14,2,12,0.143
20400236,1610612739,1610612761,105.0,97.0,0.5,0.371,1,2004-12-04,17,11,6,0.647,19,7,12,0.368
20400240,1610612745,1610612755,77.0,76.0,0.316,0.395,1,2004-12-04,18,7,11,0.389,16,6,10,0.375
20400241,1610612742,1610612762,109.0,86.0,0.4679999999999999,0.507,1,2004-12-04,18,12,6,0.667,17,8,9,0.471
20400244,1610612744,1610612754,104.0,96.0,0.4629999999999999,0.447,1,2004-12-04,16,4,12,0.25,17,10,7,0.588
20400233,1610612766,1610612752,107.0,101.0,0.435,0.494,1,2004-12-04,14,4,10,0.286,16,8,8,0.5
20400242,1610612743,1610612748,104.0,95.0,0.506,0.514,1,2004-12-04,16,9,7,0.563,18,11,7,0.611
20400239,1610612749,1610612759,83.0,104.0,0.444,0.573,0,2004-12-04,14,4,10,0.286,18,15,3,0.833
20400238,1610612740,1610612765,69.0,92.0,0.361,0.544,0,2004-12-04,15,1,14,0.067,16,8,8,0.5
20400245,1610612760,1610612757,99.0,89.0,0.48,0.405,1,2004-12-04,18,15,3,0.833,15,8,7,0.5329999999999999
20400235,1610612751,1610612737,109.0,88.0,0.544,0.42,1,2004-12-04,16,4,12,0.25,16,2,14,0.125
20400234,1610612753,1610612763,96.0,91.0,0.436,0.431,1,2004-12-04,16,11,5,0.688,18,6,12,0.3329999999999999
20400231,1610612747,1610612744,97.0,88.0,0.434,0.3670000000000001,1,2004-12-03,17,10,7,0.588,15,3,12,0.2
20400228,1610612759,1610612765,80.0,77.0,0.431,0.355,1,2004-12-03,17,14,3,0.8240000000000001,15,7,8,0.467
20400225,1610612752,1610612753,98.0,104.0,0.477,0.462,0,2004-12-03,15,8,7,0.5329999999999999,15,10,5,0.667
20400226,1610612737,1610612764,90.0,114.0,0.43,0.482,0,2004-12-03,15,2,13,0.133,14,9,5,0.643
20400230,1610612756,1610612750,93.0,97.0,0.402,0.421,0,2004-12-03,16,13,3,0.813,15,10,5,0.667
20400224,1610612738,1610612761,91.0,89.0,0.423,0.407,1,2004-12-03,15,7,8,0.467,18,7,11,0.389
20400229,1610612741,1610612748,81.0,105.0,0.375,0.506,0,2004-12-03,13,2,11,0.154,17,11,6,0.647
20400232,1610612758,1610612754,113.0,87.0,0.5,0.461,1,2004-12-03,16,11,5,0.688,16,10,6,0.625
20400227,1610612763,1610612755,94.0,86.0,0.45,0.43,1,2004-12-03,17,6,11,0.353,15,6,9,0.4
20400222,1610612742,1610612745,113.0,106.0,0.481,0.41,1,2004-12-02,17,11,6,0.647,17,6,11,0.353
20400223,1610612743,1610612739,73.0,92.0,0.36,0.419,0,2004-12-02,15,8,7,0.5329999999999999,16,10,6,0.625
20400220,1610612746,1610612754,88.0,76.0,0.493,0.455,1,2004-12-01,16,10,6,0.625,15,10,5,0.667
20400217,1610612759,1610612755,105.0,72.0,0.528,0.35,1,2004-12-01,16,13,3,0.813,14,6,8,0.429
20400212,1610612764,1610612751,95.0,68.0,0.41,0.313,1,2004-12-01,13,8,5,0.615,15,3,12,0.2
20400214,1610612752,1610612763,90.0,82.0,0.41,0.421,1,2004-12-01,14,8,6,0.5710000000000001,16,5,11,0.313
20400218,1610612756,1610612739,120.0,101.0,0.528,0.4429999999999999,1,2004-12-01,15,13,2,0.867,15,9,6,0.6
20400211,1610612738,1610612749,101.0,100.0,0.4,0.439,1,2004-12-01,14,6,8,0.429,13,4,9,0.308
20400216,1610612741,1610612747,92.0,84.0,0.395,0.419,1,2004-12-01,12,2,10,0.1669999999999999,16,9,7,0.563
20400221,1610612744,1610612750,99.0,107.0,0.46,0.44,0,2004-12-01,14,3,11,0.214,14,9,5,0.643
20400215,1610612740,1610612758,81.0,94.0,0.385,0.486,0,2004-12-01,14,1,13,0.071,15,10,5,0.667
20400219,1610612760,1610612762,129.0,119.0,0.519,0.489,1,2004-12-01,17,14,3,0.8240000000000001,16,8,8,0.5
20400213,1610612753,1610612761,129.0,108.0,0.573,0.4270000000000001,1,2004-12-01,14,9,5,0.643,17,7,10,0.412
20400203,1610612737,1610612752,109.0,110.0,0.494,0.4039999999999999,0,2004-11-30,14,2,12,0.143,13,7,6,0.5379999999999999
20400204,1610612748,1610612761,92.0,94.0,0.425,0.4,0,2004-11-30,16,10,6,0.625,16,7,9,0.4379999999999999
20400207,1610612745,1610612765,72.0,93.0,0.431,0.444,0,2004-11-30,16,6,10,0.375,14,7,7,0.5
20400208,1610612742,1610612759,89.0,107.0,0.444,0.475,0,2004-11-30,16,10,6,0.625,15,12,3,0.8
20400210,1610612757,1610612760,100.0,94.0,0.472,0.449,1,2004-11-30,14,8,6,0.5710000000000001,16,13,3,0.813
20400206,1610612763,1610612758,93.0,98.0,0.4529999999999999,0.5,0,2004-11-30,15,5,10,0.3329999999999999,14,9,5,0.643
20400205,1610612749,1610612747,90.0,95.0,0.436,0.4529999999999999,0,2004-11-30,12,4,8,0.3329999999999999,15,9,6,0.6
20400209,1610612762,1610612756,102.0,115.0,0.472,0.5379999999999999,0,2004-11-30,15,8,7,0.5329999999999999,14,12,2,0.857
20400202,1610612751,1610612766,99.0,86.0,0.528,0.417,1,2004-11-30,14,3,11,0.214,13,3,10,0.231
20400201,1610612746,1610612739,94.0,82.0,0.486,0.4379999999999999,1,2004-11-29,15,9,6,0.6,14,9,5,0.643
20400200,1610612743,1610612740,76.0,67.0,0.406,0.406,1,2004-11-29,14,8,6,0.5710000000000001,13,1,12,0.077
20400199,1610612753,1610612738,101.0,117.0,0.39,0.469,0,2004-11-29,13,8,5,0.615,13,5,8,0.385
20400193,1610612746,1610612744,103.0,91.0,0.532,0.42,1,2004-11-28,14,8,6,0.5710000000000001,13,3,10,0.231
20400198,1610612747,1610612740,89.0,76.0,0.4,0.3379999999999999,1,2004-11-28,14,8,6,0.5710000000000001,12,1,11,0.083
20400194,1610612748,1610612738,106.0,104.0,0.4529999999999999,0.407,1,2004-11-28,15,10,5,0.667,12,4,8,0.3329999999999999
20400195,1610612757,1610612751,83.0,71.0,0.354,0.377,1,2004-11-28,13,7,6,0.5379999999999999,13,2,11,0.154
20400196,1610612758,1610612750,110.0,121.0,0.461,0.489,0,2004-11-28,13,8,5,0.615,13,8,5,0.615
20400192,1610612761,1610612764,109.0,114.0,0.5,0.494,0,2004-11-28,15,6,9,0.4,12,7,5,0.583
20400197,1610612760,1610612754,103.0,95.0,0.493,0.434,1,2004-11-28,15,13,2,0.867,14,10,4,0.7140000000000001
20400190,1610612759,1610612762,109.0,76.0,0.59,0.444,1,2004-11-27,14,11,3,0.7859999999999999,14,8,6,0.5710000000000001
20400184,1610612752,1610612761,108.0,102.0,0.511,0.4629999999999999,1,2004-11-27,12,6,6,0.5,14,6,8,0.429
20400187,1610612739,1610612741,96.0,74.0,0.4639999999999999,0.4,1,2004-11-27,13,9,4,0.6920000000000001,11,1,10,0.091
20400189,1610612745,1610612743,76.0,82.0,0.4029999999999999,0.421,0,2004-11-27,15,6,9,0.4,13,7,6,0.5379999999999999
20400185,1610612766,1610612737,107.0,92.0,0.507,0.506,1,2004-11-27,12,3,9,0.25,13,2,11,0.154
20400188,1610612763,1610612742,85.0,98.0,0.373,0.4270000000000001,0,2004-11-27,14,5,9,0.357,15,10,5,0.667
20400191,1610612749,1610612765,96.0,90.0,0.507,0.522,1,2004-11-27,11,4,7,0.364,13,6,7,0.462
20400186,1610612753,1610612755,105.0,99.0,0.434,0.405,1,2004-11-27,12,8,4,0.667,13,6,7,0.462
20400181,1610612747,1610612758,106.0,109.0,0.414,0.4379999999999999,0,2004-11-26,13,7,6,0.5379999999999999,12,8,4,0.667
20400176,1610612754,1610612766,82.0,77.0,0.391,0.39,1,2004-11-26,13,10,3,0.769,11,2,9,0.182
20400177,1610612750,1610612763,115.0,90.0,0.525,0.375,1,2004-11-26,12,7,5,0.583,13,5,8,0.385
20400174,1610612737,1610612753,99.0,117.0,0.5,0.547,0,2004-11-26,12,2,10,0.1669999999999999,11,7,4,0.636
20400175,1610612765,1610612748,78.0,77.0,0.325,0.375,1,2004-11-26,12,6,6,0.5,14,9,5,0.643
20400180,1610612756,1610612740,95.0,86.0,0.415,0.386,1,2004-11-26,13,11,2,0.846,11,1,10,0.091
20400172,1610612738,1610612739,96.0,98.0,0.4579999999999999,0.544,0,2004-11-26,11,4,7,0.364,12,8,4,0.667
20400171,1610612742,1610612757,92.0,83.0,0.397,0.423,1,2004-11-26,14,9,5,0.643,12,6,6,0.5
20400182,1610612744,1610612746,87.0,98.0,0.39,0.488,0,2004-11-26,12,3,9,0.25,13,7,6,0.5379999999999999
20400178,1610612743,1610612759,75.0,89.0,0.341,0.456,0,2004-11-26,12,6,6,0.5,13,10,3,0.769
20400179,1610612762,1610612745,90.0,80.0,0.5,0.3670000000000001,1,2004-11-26,13,8,5,0.615,14,6,8,0.429
20400183,1610612760,1610612751,92.0,79.0,0.395,0.3939999999999999,1,2004-11-26,14,12,2,0.857,12,2,10,0.1669999999999999
20400173,1610612755,1610612764,116.0,114.0,0.4370000000000001,0.439,1,2004-11-26,12,6,6,0.5,11,6,5,0.545
20400170,1610612746,1610612751,101.0,88.0,0.532,0.434,1,2004-11-25,12,6,6,0.5,11,2,9,0.182
20400169,1610612754,1610612750,106.0,102.0,0.507,0.514,1,2004-11-25,12,9,3,0.75,11,6,5,0.545
20400166,1610612759,1610612742,94.0,80.0,0.423,0.389,1,2004-11-24,12,9,3,0.75,13,8,5,0.615
20400164,1610612737,1610612748,93.0,99.0,0.39,0.5,0,2004-11-24,11,2,9,0.182,13,9,4,0.6920000000000001
20400168,1610612756,1610612749,111.0,104.0,0.489,0.467,1,2004-11-24,12,10,2,0.833,10,3,7,0.3
20400163,1610612739,1610612765,92.0,76.0,0.451,0.373,1,2004-11-24,11,7,4,0.636,11,5,6,0.455
20400165,1610612763,1610612760,84.0,93.0,0.387,0.408,0,2004-11-24,12,5,7,0.417,13,11,2,0.846
20400160,1610612761,1610612752,114.0,91.0,0.524,0.409,1,2004-11-24,13,6,7,0.462,11,5,6,0.455
20400167,1610612762,1610612741,99.0,101.0,0.4679999999999999,0.441,0,2004-11-24,12,7,5,0.583,10,1,9,0.1
20400162,1610612753,1610612757,83.0,89.0,0.412,0.396,0,2004-11-24,10,6,4,0.6,11,6,5,0.545
20400161,1610612755,1610612738,110.0,97.0,0.5,0.434,1,2004-11-24,11,5,6,0.455,10,4,6,0.4
20400158,1610612747,1610612749,100.0,96.0,0.494,0.494,1,2004-11-23,12,7,5,0.583,9,3,6,0.3329999999999999
20400152,1610612754,1610612738,106.0,96.0,0.466,0.467,1,2004-11-23,11,8,3,0.727,9,4,5,0.444
20400155,1610612750,1610612760,92.0,103.0,0.423,0.4529999999999999,0,2004-11-23,10,6,4,0.6,12,10,2,0.833
20400150,1610612764,1610612761,102.0,86.0,0.386,0.369,1,2004-11-23,10,6,4,0.6,12,5,7,0.417
20400153,1610612752,1610612737,104.0,88.0,0.4679999999999999,0.4639999999999999,1,2004-11-23,10,5,5,0.5,10,2,8,0.2
20400154,1610612748,1610612757,87.0,99.0,0.419,0.456,0,2004-11-23,12,8,4,0.667,10,5,5,0.5
20400159,1610612744,1610612740,115.0,109.0,0.396,0.415,1,2004-11-23,11,3,8,0.273,10,1,9,0.1
20400151,1610612766,1610612765,91.0,89.0,0.474,0.507,1,2004-11-23,10,2,8,0.2,10,5,5,0.5
20400157,1610612758,1610612745,102.0,96.0,0.4589999999999999,0.521,1,2004-11-23,11,7,4,0.636,13,6,7,0.462
20400156,1610612743,1610612751,90.0,88.0,0.5,0.449,1,2004-11-23,11,6,5,0.545,10,2,8,0.2
20400149,1610612756,1610612741,100.0,82.0,0.425,0.381,1,2004-11-22,11,9,2,0.818,9,0,9,0.0
20400147,1610612742,1610612750,82.0,83.0,0.359,0.41,0,2004-11-22,12,8,4,0.667,9,6,3,0.667
20400146,1610612763,1610612759,93.0,90.0,0.487,0.4379999999999999,1,2004-11-22,11,5,6,0.455,11,8,3,0.727
20400148,1610612762,1610612740,75.0,76.0,0.382,0.354,0,2004-11-22,11,7,4,0.636,9,1,8,0.111
20400137,1610612746,1610612756,111.0,122.0,0.523,0.537,0,2004-11-21,11,5,6,0.455,10,8,2,0.8
20400145,1610612747,1610612741,102.0,93.0,0.4320000000000001,0.4629999999999999,1,2004-11-21,11,6,5,0.545,8,0,8,0.0
20400141,1610612752,1610612739,98.0,88.0,0.5329999999999999,0.474,1,2004-11-21,9,4,5,0.444,10,6,4,0.6
20400140,1610612765,1610612766,117.0,116.0,0.435,0.466,1,2004-11-21,9,5,4,0.556,9,1,8,0.111
20400139,1610612748,1610612755,93.0,83.0,0.433,0.377,1,2004-11-21,11,8,3,0.727,10,4,6,0.4
20400138,1610612738,1610612760,102.0,83.0,0.569,0.359,1,2004-11-21,8,4,4,0.5,11,9,2,0.818
20400142,1610612757,1610612745,93.0,97.0,0.436,0.462,0,2004-11-21,9,4,5,0.444,12,6,6,0.5
20400143,1610612743,1610612742,110.0,82.0,0.5,0.376,1,2004-11-21,10,5,5,0.5,11,8,3,0.727
20400144,1610612758,1610612749,88.0,79.0,0.366,0.356,1,2004-11-21,10,6,4,0.6,8,3,5,0.375
20400136,1610612761,1610612759,96.0,91.0,0.474,0.386,1,2004-11-21,11,5,6,0.455,10,8,2,0.8
20400129,1610612746,1610612745,86.0,91.0,0.413,0.39,0,2004-11-20,10,5,5,0.5,11,5,6,0.455
20400133,1610612754,1610612753,83.0,86.0,0.429,0.4379999999999999,0,2004-11-20,10,7,3,0.7,9,6,3,0.667
20400130,1610612737,1610612762,79.0,92.0,0.395,0.486,0,2004-11-20,9,2,7,0.222,10,7,3,0.7
20400131,1610612739,1610612766,100.0,84.0,0.434,0.365,1,2004-11-20,9,6,3,0.667,8,1,7,0.125
20400135,1610612744,1610612763,87.0,100.0,0.4,0.417,0,2004-11-20,10,2,8,0.2,10,4,6,0.4
20400134,1610612740,1610612750,94.0,99.0,0.487,0.506,0,2004-11-20,8,0,8,0.0,8,5,3,0.625
20400132,1610612751,1610612764,86.0,97.0,0.4429999999999999,0.4370000000000001,0,2004-11-20,9,2,7,0.222,9,5,4,0.556
20400126,1610612756,1610612747,107.0,102.0,0.457,0.457,1,2004-11-19,9,7,2,0.778,10,5,5,0.5
20400123,1610612765,1610612754,82.0,97.0,0.392,0.414,0,2004-11-19,8,4,4,0.5,9,7,2,0.778
20400122,1610612748,1610612762,107.0,105.0,0.4529999999999999,0.387,1,2004-11-19,10,7,3,0.7,9,6,3,0.667
20400121,1610612738,1610612759,84.0,92.0,0.408,0.472,0,2004-11-19,7,3,4,0.429,9,8,1,0.889
20400124,1610612742,1610612752,103.0,101.0,0.482,0.4270000000000001,1,2004-11-19,10,8,2,0.8,8,3,5,0.375
20400127,1610612757,1610612749,110.0,98.0,0.4429999999999999,0.482,1,2004-11-19,8,4,4,0.5,7,3,4,0.429
20400125,1610612743,1610612741,99.0,81.0,0.472,0.421,1,2004-11-19,9,4,5,0.444,7,0,7,0.0
20400128,1610612758,1610612763,107.0,105.0,0.474,0.507,1,2004-11-19,9,5,4,0.556,9,3,6,0.3329999999999999
20400120,1610612761,1610612760,94.0,101.0,0.43,0.43,0,2004-11-19,10,4,6,0.4,10,9,1,0.9
20400119,1610612745,1610612752,92.0,93.0,0.4629999999999999,0.402,0,2004-11-18,10,4,6,0.4,7,3,4,0.429
20400118,1610612766,1610612739,89.0,106.0,0.402,0.519,0,2004-11-18,7,1,6,0.143,8,5,3,0.625
20400117,1610612755,1610612759,80.0,88.0,0.354,0.408,0,2004-11-18,9,4,5,0.444,8,7,1,0.875
20400115,1610612747,1610612746,103.0,89.0,0.513,0.413,1,2004-11-17,9,5,4,0.556,9,5,4,0.556
20400108,1610612754,1610612737,93.0,86.0,0.456,0.423,1,2004-11-17,8,6,2,0.75,8,2,6,0.25
20400106,1610612764,1610612738,110.0,105.0,0.374,0.402,1,2004-11-17,8,4,4,0.5,6,3,3,0.5
20400110,1610612765,1610612750,93.0,85.0,0.434,0.413,1,2004-11-17,7,4,3,0.5710000000000001,7,4,3,0.5710000000000001
20400116,1610612744,1610612741,98.0,85.0,0.44,0.402,1,2004-11-17,9,2,7,0.222,6,0,6,0.0
20400114,1610612757,1610612763,82.0,101.0,0.392,0.542,0,2004-11-17,7,3,4,0.429,8,3,5,0.375
20400113,1610612743,1610612761,112.0,106.0,0.476,0.4270000000000001,1,2004-11-17,8,3,5,0.375,9,4,5,0.444
20400112,1610612749,1610612748,106.0,113.0,0.481,0.5870000000000001,0,2004-11-17,6,3,3,0.5,9,6,3,0.667
20400111,1610612740,1610612756,84.0,95.0,0.44,0.529,0,2004-11-17,7,0,7,0.0,8,6,2,0.75
20400109,1610612751,1610612760,68.0,79.0,0.413,0.406,0,2004-11-17,8,2,6,0.25,9,8,1,0.889
20400107,1610612753,1610612762,107.0,92.0,0.494,0.402,1,2004-11-17,8,5,3,0.625,8,6,2,0.75
20400105,1610612746,1610612761,101.0,89.0,0.521,0.424,1,2004-11-16,8,5,3,0.625,8,4,4,0.5
20400103,1610612759,1610612752,99.0,81.0,0.4639999999999999,0.387,1,2004-11-16,7,6,1,0.857,6,2,4,0.3329999999999999
20400101,1610612750,1610612748,108.0,97.0,0.4429999999999999,0.4589999999999999,1,2004-11-16,6,4,2,0.667,8,5,3,0.625
20400100,1610612737,1610612745,88.0,84.0,0.467,0.474,1,2004-11-16,7,2,5,0.286,9,4,5,0.444
20400102,1610612742,1610612756,101.0,107.0,0.412,0.478,0,2004-11-16,9,7,2,0.778,7,5,2,0.7140000000000001
20400099,1610612766,1610612762,105.0,107.0,0.569,0.507,0,2004-11-16,6,1,5,0.1669999999999999,7,6,1,0.857
20400104,1610612758,1610612741,113.0,106.0,0.461,0.446,1,2004-11-16,8,4,4,0.5,5,0,5,0.0
20400098,1610612755,1610612760,95.0,103.0,0.456,0.4679999999999999,0,2004-11-16,8,4,4,0.5,8,7,1,0.875
20400096,1610612739,1610612744,99.0,88.0,0.493,0.422,1,2004-11-15,7,4,3,0.5710000000000001,8,1,7,0.125
20400097,1610612751,1610612745,69.0,80.0,0.307,0.4379999999999999,0,2004-11-15,7,2,5,0.286,8,4,4,0.5
20400091,1610612764,1610612742,113.0,122.0,0.472,0.524,0,2004-11-14,7,3,4,0.429,8,7,1,0.875
20400093,1610612748,1610612749,112.0,110.0,0.4539999999999999,0.41,1,2004-11-14,7,5,2,0.7140000000000001,5,3,2,0.6
20400095,1610612758,1610612743,101.0,89.0,0.436,0.384,1,2004-11-14,7,3,4,0.429,7,2,5,0.286
20400094,1610612760,1610612763,118.0,113.0,0.574,0.5329999999999999,1,2004-11-14,7,6,1,0.857,7,2,5,0.286
20400092,1610612755,1610612753,96.0,87.0,0.4429999999999999,0.321,1,2004-11-14,7,4,3,0.5710000000000001,7,4,3,0.5710000000000001
20400084,1610612754,1610612752,103.0,97.0,0.4529999999999999,0.3979999999999999,1,2004-11-13,7,5,2,0.7140000000000001,5,2,3,0.4
20400083,1610612737,1610612759,88.0,103.0,0.3929999999999999,0.436,0,2004-11-13,6,1,5,0.1669999999999999,6,5,1,0.833
20400089,1610612756,1610612758,111.0,113.0,0.506,0.494,0,2004-11-13,6,4,2,0.667,6,2,4,0.3329999999999999
20400081,1610612739,1610612764,105.0,74.0,0.478,0.3329999999999999,1,2004-11-13,6,3,3,0.5,6,3,3,0.5
20400087,1610612745,1610612747,79.0,84.0,0.346,0.408,0,2004-11-13,7,3,4,0.429,8,4,4,0.5
20400085,1610612741,1610612746,96.0,97.0,0.4270000000000001,0.419,0,2004-11-13,4,0,4,0.0,7,4,3,0.5710000000000001
20400090,1610612757,1610612761,105.0,102.0,0.481,0.476,1,2004-11-13,6,3,3,0.5,7,4,3,0.5710000000000001
20400082,1610612766,1610612744,87.0,103.0,0.4270000000000001,0.526,0,2004-11-13,5,1,4,0.2,7,1,6,0.143
20400086,1610612749,1610612740,94.0,91.0,0.417,0.455,1,2004-11-13,4,3,1,0.75,6,0,6,0.0
20400088,1610612762,1610612765,108.0,93.0,0.586,0.5,1,2004-11-13,6,5,1,0.833,6,3,3,0.5
20400080,1610612751,1610612742,78.0,94.0,0.348,0.449,0,2004-11-13,6,2,4,0.3329999999999999,7,6,1,0.857
20400078,1610612759,1610612748,93.0,84.0,0.4529999999999999,0.425,1,2004-11-12,5,4,1,0.8,6,4,2,0.667
20400075,1610612752,1610612746,110.0,96.0,0.5,0.486,1,2004-11-12,4,2,2,0.5,6,3,3,0.5
20400074,1610612738,1610612766,91.0,74.0,0.4629999999999999,0.4,1,2004-11-12,5,3,2,0.6,4,1,3,0.25
20400076,1610612763,1610612744,96.0,67.0,0.469,0.275,1,2004-11-12,6,2,4,0.3329999999999999,6,0,6,0.0
20400077,1610612740,1610612737,95.0,96.0,0.44,0.5,0,2004-11-12,5,0,5,0.0,5,1,4,0.2
20400079,1610612760,1610612761,88.0,87.0,0.413,0.41,1,2004-11-12,6,5,1,0.833,6,4,2,0.667
20400073,1610612753,1610612747,122.0,113.0,0.5,0.47,1,2004-11-12,6,4,2,0.667,7,3,4,0.429
20400072,1610612755,1610612754,106.0,104.0,0.429,0.455,1,2004-11-12,6,3,3,0.5,6,4,2,0.667
20400069,1610612748,1610612742,93.0,113.0,0.3720000000000001,0.519,0,2004-11-11,5,4,1,0.8,6,5,1,0.833
20400070,1610612745,1610612750,91.0,96.0,0.436,0.4579999999999999,0,2004-11-11,6,3,3,0.5,5,3,2,0.6
20400071,1610612743,1610612765,117.0,109.0,0.506,0.5710000000000001,1,2004-11-11,6,2,4,0.3329999999999999,5,3,2,0.6
20400066,1610612759,1610612744,91.0,71.0,0.4679999999999999,0.325,1,2004-11-10,4,3,1,0.75,5,0,5,0.0
20400062,1610612754,1610612746,68.0,102.0,0.3379999999999999,0.494,0,2004-11-10,5,4,1,0.8,5,3,2,0.6
20400061,1610612764,1610612753,106.0,96.0,0.429,0.402,1,2004-11-10,5,3,2,0.6,5,3,2,0.6
20400063,1610612739,1610612756,114.0,109.0,0.4270000000000001,0.402,1,2004-11-10,5,2,3,0.4,5,4,1,0.8
20400059,1610612738,1610612757,90.0,88.0,0.446,0.4379999999999999,1,2004-11-10,4,2,2,0.5,5,2,3,0.4
20400065,1610612763,1610612747,110.0,87.0,0.4639999999999999,0.368,1,2004-11-10,5,1,4,0.2,6,3,3,0.5
20400064,1610612749,1610612766,102.0,100.0,0.4370000000000001,0.444,1,2004-11-10,3,2,1,0.667,3,1,2,0.3329999999999999
20400067,1610612762,1610612761,95.0,104.0,0.413,0.483,0,2004-11-10,5,4,1,0.8,5,4,1,0.8
20400068,1610612760,1610612758,108.0,78.0,0.415,0.3329999999999999,1,2004-11-10,5,4,1,0.8,5,1,4,0.2
20400060,1610612755,1610612751,108.0,100.0,0.411,0.4529999999999999,1,2004-11-10,5,2,3,0.4,5,2,3,0.4
20400054,1610612750,1610612754,101.0,102.0,0.5,0.4579999999999999,0,2004-11-09,4,2,2,0.5,4,4,0,1.0
20400050,1610612752,1610612755,96.0,88.0,0.481,0.4429999999999999,1,2004-11-09,3,1,2,0.3329999999999999,4,1,3,0.25
20400051,1610612737,1610612739,79.0,93.0,0.4379999999999999,0.47,0,2004-11-09,4,0,4,0.0,4,1,3,0.25
20400056,1610612745,1610612763,90.0,87.0,0.466,0.409,1,2004-11-09,5,3,2,0.6,4,0,4,0.0
20400052,1610612748,1610612764,103.0,93.0,0.519,0.4320000000000001,1,2004-11-09,4,4,0,1.0,4,2,2,0.5
20400055,1610612741,1610612756,74.0,94.0,0.33,0.4,0,2004-11-09,3,0,3,0.0,4,4,0,1.0
20400058,1610612758,1610612761,108.0,92.0,0.542,0.361,1,2004-11-09,4,1,3,0.25,4,3,1,0.75
20400057,1610612743,1610612760,88.0,108.0,0.48,0.494,0,2004-11-09,5,1,4,0.2,4,3,1,0.75
20400053,1610612740,1610612747,98.0,106.0,0.353,0.53,0,2004-11-09,4,0,4,0.0,5,3,2,0.6
20400049,1610612751,1610612757,64.0,60.0,0.342,0.244,1,2004-11-09,4,2,2,0.5,4,2,2,0.5
20400048,1610612753,1610612742,94.0,84.0,0.417,0.292,1,2004-11-09,4,3,1,0.75,5,4,1,0.8
20400047,1610612746,1610612765,96.0,99.0,0.429,0.418,0,2004-11-08,4,2,2,0.5,4,3,1,0.75
20400045,1610612742,1610612744,101.0,98.0,0.381,0.3829999999999999,1,2004-11-08,4,4,0,1.0,4,0,4,0.0
20400046,1610612762,1610612743,102.0,91.0,0.507,0.423,1,2004-11-08,4,4,0,1.0,4,1,3,0.25
20400044,1610612747,1610612737,106.0,90.0,0.561,0.43,1,2004-11-07,4,2,2,0.5,3,0,3,0.0
20400042,1610612761,1610612757,101.0,97.0,0.4479999999999999,0.457,1,2004-11-07,3,3,0,1.0,3,2,1,0.667
20400043,1610612760,1610612759,113.0,94.0,0.506,0.425,1,2004-11-07,3,2,1,0.667,3,2,1,0.667
20400035,1610612754,1610612741,100.0,90.0,0.515,0.449,1,2004-11-06,3,3,0,1.0,2,0,2,0.0
20400036,1610612750,1610612740,99.0,92.0,0.475,0.461,1,2004-11-06,3,2,1,0.667,3,0,3,0.0
20400030,1610612764,1610612748,106.0,118.0,0.435,0.5579999999999999,0,2004-11-06,3,2,1,0.667,3,3,0,1.0
20400032,1610612752,1610612738,73.0,107.0,0.414,0.5579999999999999,0,2004-11-06,2,0,2,0.0,3,1,2,0.3329999999999999
20400033,1610612765,1610612755,99.0,91.0,0.4270000000000001,0.3879999999999999,1,2004-11-06,3,2,1,0.667,3,1,2,0.3329999999999999
20400038,1610612745,1610612758,104.0,101.0,0.4479999999999999,0.375,1,2004-11-06,4,2,2,0.5,3,0,3,0.0
20400039,1610612742,1610612763,112.0,88.0,0.5,0.376,1,2004-11-06,3,3,0,1.0,3,0,3,0.0
20400041,1610612744,1610612746,86.0,94.0,0.352,0.493,0,2004-11-06,3,0,3,0.0,3,2,1,0.667
20400031,1610612766,1610612753,111.0,100.0,0.455,0.364,1,2004-11-06,2,1,1,0.5,3,2,1,0.667
20400040,1610612743,1610612762,82.0,106.0,0.397,0.506,0,2004-11-06,3,1,2,0.3329999999999999,3,3,0,1.0
20400037,1610612749,1610612739,102.0,88.0,0.446,0.39,1,2004-11-06,2,1,1,0.5,3,0,3,0.0
20400034,1610612751,1610612756,80.0,112.0,0.366,0.574,0,2004-11-06,3,1,2,0.3329999999999999,3,3,0,1.0
20400027,1610612747,1610612759,96.0,105.0,0.4320000000000001,0.476,0,2004-11-05,3,1,2,0.3329999999999999,2,2,0,1.0
20400022,1610612738,1610612754,94.0,100.0,0.4679999999999999,0.425,0,2004-11-05,2,0,2,0.0,2,2,0,1.0
20400025,1610612741,1610612751,106.0,111.0,0.371,0.507,0,2004-11-05,1,0,1,0.0,2,1,1,0.5
20400028,1610612744,1610612762,80.0,102.0,0.37,0.5870000000000001,0,2004-11-05,2,0,2,0.0,2,2,0,1.0
20400026,1610612757,1610612746,94.0,81.0,0.494,0.439,1,2004-11-05,2,2,0,1.0,2,1,1,0.5
20400023,1610612763,1610612745,81.0,89.0,0.351,0.429,0,2004-11-05,2,0,2,0.0,3,1,2,0.3329999999999999
20400020,1610612761,1610612765,101.0,89.0,0.466,0.419,1,2004-11-05,2,2,0,1.0,2,1,1,0.5
20400024,1610612740,1610612753,89.0,90.0,0.457,0.405,0,2004-11-05,2,0,2,0.0,2,2,0,1.0
20400029,1610612760,1610612737,106.0,85.0,0.507,0.419,1,2004-11-05,2,1,1,0.5,2,0,2,0.0
20400021,1610612755,1610612756,98.0,108.0,0.4320000000000001,0.4379999999999999,0,2004-11-05,2,1,1,0.5,2,2,0,1.0
20400018,1610612748,1610612739,92.0,86.0,0.474,0.3879999999999999,1,2004-11-04,2,2,0,1.0,2,0,2,0.0
20400017,1610612766,1610612764,96.0,103.0,0.474,0.434,0,2004-11-04,1,0,1,0.0,2,2,0,1.0
20400019,1610612743,1610612750,94.0,92.0,0.381,0.451,1,2004-11-04,2,1,1,0.5,2,1,1,0.5
20400004,1610612761,1610612745,95.0,88.0,0.455,0.465,1,2004-11-03,1,1,0,1.0,2,0,2,0.0
20400005,1610612753,1610612749,93.0,92.0,0.446,0.402,1,2004-11-03,1,1,0,1.0,1,0,1,0.0
20400015,1610612746,1610612760,114.0,84.0,0.629,0.37,1,2004-11-03,1,1,0,1.0,1,0,1,0.0
20400012,1610612759,1610612758,101.0,85.0,0.451,0.405,1,2004-11-03,1,1,0,1.0,2,0,2,0.0
20400011,1610612750,1610612752,99.0,93.0,0.494,0.3929999999999999,1,2004-11-03,1,1,0,1.0,1,0,1,0.0
20400013,1610612756,1610612737,112.0,82.0,0.506,0.3329999999999999,1,2004-11-03,1,1,0,1.0,1,0,1,0.0
20400006,1610612739,1610612754,104.0,109.0,0.425,0.462,0,2004-11-03,1,0,1,0.0,1,1,0,1.0
20400007,1610612738,1610612755,95.0,98.0,0.478,0.444,0,2004-11-03,1,0,1,0.0,1,1,0,1.0
20400016,1610612744,1610612757,75.0,78.0,0.3829999999999999,0.4270000000000001,0,2004-11-03,1,0,1,0.0,1,1,0,1.0
20400009,1610612763,1610612764,91.0,103.0,0.422,0.45,0,2004-11-03,1,0,1,0.0,1,1,0,1.0
20400010,1610612740,1610612742,91.0,106.0,0.41,0.5379999999999999,0,2004-11-03,1,0,1,0.0,2,2,0,1.0
20400014,1610612762,1610612747,104.0,78.0,0.507,0.294,1,2004-11-03,1,1,0,1.0,2,1,1,0.5
20400008,1610612751,1610612748,77.0,100.0,0.3779999999999999,0.507,0,2004-11-03,1,0,1,0.0,1,1,0,1.0
20400001,1610612765,1610612745,87.0,79.0,0.444,0.3939999999999999,1,2004-11-02,1,1,0,1.0,1,0,1,0.0
20400002,1610612742,1610612758,107.0,98.0,0.494,0.414,1,2004-11-02,1,1,0,1.0,1,0,1,0.0
20400003,1610612747,1610612743,89.0,78.0,0.429,0.341,1,2004-11-02,1,1,0,1.0,1,0,1,0.0
10400118,1610612759,1610612740,102.0,86.0,0.451,0.375,1,2004-10-29,0,0,0,0.0,0,0,0,0.0
10400115,1610612754,1610612743,79.0,98.0,0.382,0.48,0,2004-10-29,0,0,0,0.0,0,0,0,0.0
10400116,1610612750,1610612765,102.0,95.0,0.4529999999999999,0.486,1,2004-10-29,0,0,0,0.0,0,0,0,0.0
10400119,1610612758,1610612756,96.0,122.0,0.4629999999999999,0.54,0,2004-10-29,0,0,0,0.0,0,0,0,0.0
10400114,1610612761,1610612739,100.0,92.0,0.385,0.4579999999999999,1,2004-10-29,0,0,0,0.0,0,0,0,0.0
10400117,1610612760,1610612757,91.0,87.0,0.485,0.384,1,2004-10-29,0,0,0,0.0,0,0,0,0.0
10400113,1610612746,1610612756,88.0,109.0,0.353,0.423,0,2004-10-28,0,0,0,0.0,0,0,0,0.0
10400108,1610612752,1610612762,93.0,85.0,0.4,0.4379999999999999,1,2004-10-28,0,0,0,0.0,0,0,0,0.0
10400111,1610612745,1610612743,88.0,93.0,0.434,0.516,0,2004-10-28,0,0,0,0.0,0,0,0,0.0
10400110,1610612742,1610612758,112.0,93.0,0.541,0.441,1,2004-10-28,0,0,0,0.0,0,0,0,0.0
10400107,1610612751,1610612755,96.0,94.0,0.471,0.4639999999999999,1,2004-10-28,0,0,0,0.0,0,0,0,0.0
10400101,1610612754,1610612741,91.0,71.0,0.449,0.375,1,2004-10-27,0,0,0,0.0,0,0,0,0.0
10400102,1610612750,1610612749,75.0,76.0,0.421,0.352,0,2004-10-27,0,0,0,0.0,0,0,0,0.0
10400098,1610612738,1610612765,96.0,84.0,0.525,0.3829999999999999,1,2004-10-27,0,0,0,0.0,0,0,0,0.0
10400105,1610612744,1610612746,83.0,76.0,0.36,0.384,1,2004-10-27,0,0,0,0.0,0,0,0,0.0
10400103,1610612757,1610612761,97.0,95.0,0.493,0.3879999999999999,1,2004-10-27,0,0,0,0.0,0,0,0,0.0
10400100,1610612753,1610612748,109.0,103.0,0.4379999999999999,0.422,1,2004-10-27,0,0,0,0.0,0,0,0,0.0
10400093,1610612754,1610612763,102.0,96.0,0.485,0.446,1,2004-10-26,0,0,0,0.0,0,0,0,0.0
10400095,1610612756,1610612760,103.0,95.0,0.486,0.3779999999999999,1,2004-10-26,0,0,0,0.0,0,0,0,0.0
10400097,1610612742,1610612759,94.0,98.0,0.384,0.423,0,2004-10-26,0,0,0,0.0,0,0,0,0.0
10400091,1610612766,1610612748,82.0,74.0,0.446,0.3879999999999999,1,2004-10-26,0,0,0,0.0,0,0,0,0.0
10400094,1610612743,1610612761,102.0,98.0,0.494,0.472,1,2004-10-26,0,0,0,0.0,0,0,0,0.0
10400096,1610612751,1610612752,79.0,86.0,0.387,0.371,0,2004-10-26,0,0,0,0.0,0,0,0,0.0
10400092,1610612755,1610612762,97.0,88.0,0.4679999999999999,0.408,1,2004-10-26,0,0,0,0.0,0,0,0,0.0
10400089,1610612741,1610612764,100.0,95.0,0.4589999999999999,0.413,1,2004-10-25,0,0,0,0.0,0,0,0,0.0
10400087,1610612757,1610612744,84.0,87.0,0.434,0.407,0,2004-10-25,0,0,0,0.0,0,0,0,0.0
10400082,1610612746,1610612740,97.0,96.0,0.471,0.421,1,2004-10-24,0,0,0,0.0,0,0,0,0.0
10400084,1610612764,1610612766,97.0,85.0,0.455,0.444,1,2004-10-24,0,0,0,0.0,0,0,0,0.0
10400083,1610612752,1610612742,102.0,86.0,0.506,0.366,1,2004-10-24,0,0,0,0.0,0,0,0,0.0
10400081,1610612765,1610612762,82.0,75.0,0.419,0.385,1,2004-10-24,0,0,0,0.0,0,0,0,0.0
10400085,1610612743,1610612754,98.0,80.0,0.487,0.365,1,2004-10-24,0,0,0,0.0,0,0,0,0.0
10400080,1610612759,1610612760,91.0,82.0,0.522,0.425,1,2004-10-23,0,0,0,0.0,0,0,0,0.0
10400078,1610612741,1610612761,89.0,91.0,0.38,0.4529999999999999,0,2004-10-23,0,0,0,0.0,0,0,0,0.0
10400075,1610612758,1610612740,92.0,87.0,0.455,0.4320000000000001,1,2004-10-23,0,0,0,0.0,0,0,0,0.0
10400073,1610612763,1610612737,100.0,72.0,0.514,0.351,1,2004-10-23,0,0,0,0.0,0,0,0,0.0
10400079,1610612749,1610612742,89.0,91.0,0.3929999999999999,0.43,0,2004-10-23,0,0,0,0.0,0,0,0,0.0
10400076,1610612738,1610612739,91.0,96.0,0.479,0.486,0,2004-10-23,0,0,0,0.0,0,0,0,0.0
10400072,1610612753,1610612745,95.0,72.0,0.481,0.385,1,2004-10-23,0,0,0,0.0,0,0,0,0.0
10400074,1610612750,1610612754,104.0,106.0,0.449,0.521,0,2004-10-23,0,0,0,0.0,0,0,0,0.0
10400077,1610612755,1610612751,86.0,81.0,0.422,0.408,1,2004-10-23,0,0,0,0.0,0,0,0,0.0
10400064,1610612744,1610612743,86.0,105.0,0.405,0.483,0,2004-10-22,0,0,0,0.0,0,0,0,0.0
10400069,1610612747,1610612746,113.0,94.0,0.465,0.357,1,2004-10-22,0,0,0,0.0,0,0,0,0.0
10400070,1610612737,1610612748,82.0,113.0,0.4029999999999999,0.5820000000000001,0,2004-10-22,0,0,0,0.0,0,0,0,0.0
10400071,1610612765,1610612764,100.0,82.0,0.5489999999999999,0.411,1,2004-10-22,0,0,0,0.0,0,0,0,0.0
10400068,1610612738,1610612751,83.0,96.0,0.431,0.449,0,2004-10-22,0,0,0,0.0,0,0,0,0.0
10400065,1610612766,1610612757,69.0,63.0,0.377,0.311,1,2004-10-22,0,0,0,0.0,0,0,0,0.0
10400067,1610612762,1610612758,103.0,88.0,0.507,0.362,1,2004-10-22,0,0,0,0.0,0,0,0,0.0
10400066,1610612750,1610612752,102.0,82.0,0.523,0.3329999999999999,1,2004-10-22,0,0,0,0.0,0,0,0,0.0
40300405,1610612765,1610612747,100.0,87.0,0.461,0.413,1,2004-06-15,82,54,28,0.659,82,56,26,0.6829999999999999
40300404,1610612765,1610612747,88.0,80.0,0.426,0.423,1,2004-06-13,82,54,28,0.659,82,56,26,0.6829999999999999
40300403,1610612765,1610612747,88.0,68.0,0.408,0.365,1,2004-06-10,82,54,28,0.659,82,56,26,0.6829999999999999
40300402,1610612747,1610612765,99.0,91.0,0.475,0.395,1,2004-06-08,82,56,26,0.6829999999999999,82,54,28,0.659
40300401,1610612747,1610612765,75.0,87.0,0.397,0.462,0,2004-06-06,82,56,26,0.6829999999999999,82,54,28,0.659
40300306,1610612765,1610612754,69.0,65.0,0.3289999999999999,0.364,1,2004-06-01,82,54,28,0.659,82,61,21,0.7440000000000001
40300316,1610612747,1610612750,96.0,90.0,0.449,0.4320000000000001,1,2004-05-31,82,56,26,0.6829999999999999,82,58,24,0.7070000000000001
40300305,1610612754,1610612765,65.0,83.0,0.3289999999999999,0.414,0,2004-05-30,82,61,21,0.7440000000000001,82,54,28,0.659
40300315,1610612750,1610612747,98.0,96.0,0.4379999999999999,0.5,1,2004-05-29,82,58,24,0.7070000000000001,82,56,26,0.6829999999999999
40300304,1610612765,1610612754,68.0,83.0,0.308,0.457,0,2004-05-28,82,54,28,0.659,82,61,21,0.7440000000000001
40300314,1610612747,1610612750,92.0,85.0,0.415,0.381,1,2004-05-27,82,56,26,0.6829999999999999,82,58,24,0.7070000000000001
40300303,1610612765,1610612754,85.0,78.0,0.441,0.347,1,2004-05-26,82,54,28,0.659,82,61,21,0.7440000000000001
40300313,1610612747,1610612750,100.0,89.0,0.515,0.447,1,2004-05-25,82,56,26,0.6829999999999999,82,58,24,0.7070000000000001
40300302,1610612754,1610612765,67.0,72.0,0.275,0.348,0,2004-05-24,82,61,21,0.7440000000000001,82,54,28,0.659
40300312,1610612750,1610612747,89.0,71.0,0.446,0.368,1,2004-05-23,82,58,24,0.7070000000000001,82,56,26,0.6829999999999999
40300301,1610612754,1610612765,78.0,74.0,0.337,0.411,1,2004-05-22,82,61,21,0.7440000000000001,82,54,28,0.659
40300311,1610612750,1610612747,88.0,97.0,0.493,0.474,0,2004-05-21,82,58,24,0.7070000000000001,82,56,26,0.6829999999999999
40300217,1610612765,1610612751,90.0,69.0,0.4,0.358,1,2004-05-20,82,54,28,0.659,82,47,35,0.573
40300227,1610612750,1610612758,83.0,80.0,0.423,0.395,1,2004-05-19,82,58,24,0.7070000000000001,82,55,27,0.6709999999999999
40300206,1610612748,1610612754,70.0,73.0,0.305,0.324,0,2004-05-18,82,42,40,0.512,82,61,21,0.7440000000000001
40300226,1610612758,1610612750,104.0,87.0,0.5,0.407,1,2004-05-16,82,55,27,0.6709999999999999,82,58,24,0.7070000000000001
40300216,1610612751,1610612765,75.0,81.0,0.397,0.4379999999999999,0,2004-05-16,82,47,35,0.573,82,54,28,0.659
40300205,1610612754,1610612748,94.0,83.0,0.514,0.435,1,2004-05-15,82,61,21,0.7440000000000001,82,42,40,0.512
40300236,1610612747,1610612759,88.0,76.0,0.446,0.302,1,2004-05-15,82,56,26,0.6829999999999999,82,57,25,0.695
40300215,1610612765,1610612751,120.0,127.0,0.3779999999999999,0.43,0,2004-05-14,82,54,28,0.659,82,47,35,0.573
40300225,1610612750,1610612758,86.0,74.0,0.417,0.3329999999999999,1,2004-05-14,82,58,24,0.7070000000000001,82,55,27,0.6709999999999999
40300235,1610612759,1610612747,73.0,74.0,0.382,0.431,0,2004-05-13,82,57,25,0.695,82,56,26,0.6829999999999999
40300204,1610612748,1610612754,100.0,88.0,0.514,0.452,1,2004-05-12,82,42,40,0.512,82,61,21,0.7440000000000001
40300224,1610612758,1610612750,87.0,81.0,0.421,0.4029999999999999,1,2004-05-12,82,55,27,0.6709999999999999,82,58,24,0.7070000000000001
40300214,1610612751,1610612765,94.0,79.0,0.4379999999999999,0.369,1,2004-05-11,82,47,35,0.573,82,54,28,0.659
40300234,1610612747,1610612759,98.0,90.0,0.5,0.405,1,2004-05-11,82,56,26,0.6829999999999999,82,57,25,0.695
40300203,1610612748,1610612754,94.0,87.0,0.47,0.389,1,2004-05-10,82,42,40,0.512,82,61,21,0.7440000000000001
40300223,1610612758,1610612750,113.0,114.0,0.44,0.462,0,2004-05-10,82,55,27,0.6709999999999999,82,58,24,0.7070000000000001
40300233,1610612747,1610612759,105.0,81.0,0.569,0.341,1,2004-05-09,82,56,26,0.6829999999999999,82,57,25,0.695
40300213,1610612751,1610612765,82.0,64.0,0.414,0.289,1,2004-05-09,82,47,35,0.573,82,54,28,0.659
40300202,1610612754,1610612748,91.0,80.0,0.477,0.405,1,2004-05-08,82,61,21,0.7440000000000001,82,42,40,0.512
40300222,1610612750,1610612758,94.0,89.0,0.442,0.368,1,2004-05-08,82,58,24,0.7070000000000001,82,55,27,0.6709999999999999
40300212,1610612765,1610612751,95.0,80.0,0.436,0.431,1,2004-05-07,82,54,28,0.659,82,47,35,0.573
40300201,1610612754,1610612748,94.0,81.0,0.435,0.381,1,2004-05-06,82,61,21,0.7440000000000001,82,42,40,0.512
40300232,1610612759,1610612747,95.0,85.0,0.522,0.514,1,2004-05-05,82,57,25,0.695,82,56,26,0.6829999999999999
40300137,1610612748,1610612740,85.0,77.0,0.41,0.4029999999999999,1,2004-05-04,82,42,40,0.512,82,41,41,0.5
40300221,1610612750,1610612758,98.0,104.0,0.4429999999999999,0.4379999999999999,0,2004-05-04,82,58,24,0.7070000000000001,82,55,27,0.6709999999999999
40300211,1610612765,1610612751,78.0,56.0,0.476,0.271,1,2004-05-03,82,54,28,0.659,82,47,35,0.573
40300136,1610612740,1610612748,89.0,83.0,0.446,0.387,1,2004-05-02,82,41,41,0.5,82,42,40,0.512
40300231,1610612759,1610612747,88.0,78.0,0.4679999999999999,0.377,1,2004-05-02,82,57,25,0.695,82,56,26,0.6829999999999999
40300135,1610612748,1610612740,87.0,83.0,0.4429999999999999,0.354,1,2004-04-30,82,42,40,0.512,82,41,41,0.5
40300145,1610612750,1610612743,102.0,91.0,0.507,0.455,1,2004-04-30,82,58,24,0.7070000000000001,82,43,39,0.524
40300125,1610612765,1610612749,91.0,77.0,0.4579999999999999,0.397,1,2004-04-29,82,54,28,0.659,82,41,41,0.5
40300175,1610612758,1610612742,119.0,118.0,0.527,0.46,1,2004-04-29,82,55,27,0.6709999999999999,82,52,30,0.634
40300155,1610612747,1610612745,97.0,78.0,0.5,0.412,1,2004-04-28,82,56,26,0.6829999999999999,82,45,37,0.5489999999999999
40300134,1610612740,1610612748,96.0,85.0,0.5,0.405,1,2004-04-27,82,41,41,0.5,82,42,40,0.512
40300144,1610612743,1610612750,82.0,84.0,0.359,0.455,0,2004-04-27,82,43,39,0.524,82,58,24,0.7070000000000001
40300124,1610612749,1610612765,92.0,109.0,0.451,0.569,0,2004-04-26,82,41,41,0.5,82,54,28,0.659
40300174,1610612742,1610612758,92.0,94.0,0.347,0.396,0,2004-04-26,82,52,30,0.634,82,55,27,0.6709999999999999
40300104,1610612738,1610612754,75.0,90.0,0.4029999999999999,0.452,0,2004-04-25,82,36,46,0.439,82,61,21,0.7440000000000001
40300154,1610612745,1610612747,88.0,92.0,0.425,0.4270000000000001,0,2004-04-25,82,45,37,0.5489999999999999,82,56,26,0.6829999999999999
40300114,1610612752,1610612751,94.0,100.0,0.418,0.466,0,2004-04-25,82,39,43,0.476,82,47,35,0.573
40300164,1610612763,1610612759,97.0,110.0,0.48,0.5870000000000001,0,2004-04-25,82,50,32,0.61,82,57,25,0.695
40300133,1610612740,1610612748,77.0,71.0,0.355,0.3289999999999999,1,2004-04-24,82,41,41,0.5,82,42,40,0.512
40300123,1610612749,1610612765,85.0,95.0,0.37,0.4579999999999999,0,2004-04-24,82,41,41,0.5,82,54,28,0.659
40300173,1610612742,1610612758,104.0,79.0,0.4,0.373,1,2004-04-24,82,52,30,0.634,82,55,27,0.6709999999999999
40300143,1610612743,1610612750,107.0,86.0,0.474,0.416,1,2004-04-24,82,43,39,0.524,82,58,24,0.7070000000000001
40300103,1610612738,1610612754,85.0,108.0,0.421,0.472,0,2004-04-23,82,36,46,0.439,82,61,21,0.7440000000000001
40300153,1610612745,1610612747,102.0,91.0,0.481,0.434,1,2004-04-23,82,45,37,0.5489999999999999,82,56,26,0.6829999999999999
40300113,1610612752,1610612751,78.0,81.0,0.408,0.4029999999999999,0,2004-04-22,82,39,43,0.476,82,47,35,0.573
40300163,1610612763,1610612759,93.0,95.0,0.487,0.472,0,2004-04-22,82,50,32,0.61,82,57,25,0.695
40300122,1610612765,1610612749,88.0,92.0,0.402,0.4379999999999999,0,2004-04-21,82,54,28,0.659,82,41,41,0.5
40300132,1610612748,1610612740,93.0,63.0,0.451,0.244,1,2004-04-21,82,42,40,0.512,82,41,41,0.5
40300142,1610612750,1610612743,95.0,81.0,0.4679999999999999,0.408,1,2004-04-21,82,58,24,0.7070000000000001,82,43,39,0.524
40300102,1610612754,1610612738,103.0,90.0,0.446,0.4029999999999999,1,2004-04-20,82,61,21,0.7440000000000001,82,36,46,0.439
40300172,1610612758,1610612742,83.0,79.0,0.37,0.3229999999999999,1,2004-04-20,82,55,27,0.6709999999999999,82,52,30,0.634
40300112,1610612751,1610612752,99.0,81.0,0.535,0.341,1,2004-04-20,82,47,35,0.573,82,39,43,0.476
40300152,1610612747,1610612745,98.0,84.0,0.4529999999999999,0.4370000000000001,1,2004-04-19,82,56,26,0.6829999999999999,82,45,37,0.5489999999999999
40300162,1610612759,1610612763,87.0,70.0,0.442,0.366,1,2004-04-19,82,57,25,0.695,82,50,32,0.61
40300141,1610612750,1610612743,106.0,92.0,0.46,0.435,1,2004-04-18,82,58,24,0.7070000000000001,82,43,39,0.524
40300121,1610612765,1610612749,108.0,82.0,0.429,0.4270000000000001,1,2004-04-18,82,54,28,0.659,82,41,41,0.5
40300131,1610612748,1610612740,81.0,79.0,0.411,0.4029999999999999,1,2004-04-18,82,42,40,0.512,82,41,41,0.5
40300171,1610612758,1610612742,116.0,105.0,0.53,0.451,1,2004-04-18,82,55,27,0.6709999999999999,82,52,30,0.634
40300151,1610612747,1610612745,72.0,71.0,0.3289999999999999,0.382,1,2004-04-17,82,56,26,0.6829999999999999,82,45,37,0.5489999999999999
40300101,1610612754,1610612738,104.0,88.0,0.4639999999999999,0.4029999999999999,1,2004-04-17,82,61,21,0.7440000000000001,82,36,46,0.439
40300161,1610612759,1610612763,98.0,74.0,0.539,0.348,1,2004-04-17,82,57,25,0.695,82,50,32,0.61
40300111,1610612751,1610612752,107.0,83.0,0.5,0.377,1,2004-04-17,82,47,35,0.573,82,39,43,0.476
20301188,1610612746,1610612760,87.0,118.0,0.423,0.542,0,2004-04-14,82,28,54,0.341,82,37,45,0.451
20301184,1610612759,1610612743,93.0,67.0,0.424,0.325,1,2004-04-14,82,57,25,0.695,82,43,39,0.524
20301181,1610612754,1610612741,101.0,96.0,0.42,0.42,1,2004-04-14,82,61,21,0.7440000000000001,82,23,59,0.28
20301177,1610612764,1610612740,78.0,94.0,0.375,0.451,0,2004-04-14,82,25,57,0.305,82,41,41,0.5
20301179,1610612752,1610612739,90.0,100.0,0.481,0.488,0,2004-04-14,82,39,43,0.476,82,35,47,0.4270000000000001
20301180,1610612748,1610612751,96.0,84.0,0.5,0.361,1,2004-04-14,82,42,40,0.512,82,47,35,0.573
20301186,1610612745,1610612742,89.0,92.0,0.456,0.408,0,2004-04-14,82,45,37,0.5489999999999999,82,52,30,0.634
20301176,1610612738,1610612737,137.0,132.0,0.517,0.527,1,2004-04-14,82,36,46,0.439,82,28,54,0.341
20301189,1610612744,1610612758,97.0,91.0,0.433,0.396,1,2004-04-14,82,37,45,0.451,82,55,27,0.6709999999999999
20301187,1610612757,1610612747,104.0,105.0,0.484,0.3979999999999999,0,2004-04-14,82,41,41,0.5,82,56,26,0.6829999999999999
20301182,1610612749,1610612761,87.0,89.0,0.384,0.4589999999999999,0,2004-04-14,82,41,41,0.5,82,33,49,0.402
20301185,1610612762,1610612756,84.0,89.0,0.4,0.479,0,2004-04-14,82,42,40,0.512,82,29,53,0.354
20301178,1610612753,1610612755,95.0,89.0,0.449,0.481,1,2004-04-14,82,21,61,0.256,82,33,49,0.402
20301183,1610612763,1610612750,90.0,107.0,0.41,0.542,0,2004-04-14,82,50,32,0.61,82,58,24,0.7070000000000001
20301175,1610612747,1610612744,109.0,104.0,0.532,0.494,1,2004-04-13,81,55,26,0.679,81,36,45,0.444
20301174,1610612756,1610612746,96.0,98.0,0.429,0.494,0,2004-04-13,81,28,53,0.346,81,28,53,0.346
20301173,1610612742,1610612763,110.0,103.0,0.524,0.446,1,2004-04-13,81,51,30,0.63,81,50,31,0.617
20301172,1610612761,1610612765,87.0,78.0,0.4429999999999999,0.387,1,2004-04-13,81,32,49,0.395,82,54,28,0.659
20301167,1610612750,1610612762,104.0,90.0,0.484,0.377,1,2004-04-12,81,57,24,0.7040000000000001,81,42,39,0.519
20301164,1610612737,1610612751,129.0,107.0,0.588,0.494,1,2004-04-12,81,28,53,0.346,81,47,34,0.58
20301165,1610612765,1610612764,101.0,79.0,0.52,0.377,1,2004-04-12,81,54,27,0.667,81,25,56,0.309
20301162,1610612739,1610612749,93.0,89.0,0.4629999999999999,0.3879999999999999,1,2004-04-12,81,34,47,0.42,81,41,40,0.506
20301161,1610612738,1610612748,77.0,84.0,0.4,0.3779999999999999,0,2004-04-12,81,35,46,0.4320000000000001,81,41,40,0.506
20301168,1610612741,1610612753,84.0,93.0,0.358,0.407,0,2004-04-12,81,23,58,0.284,81,20,61,0.247
20301170,1610612757,1610612759,66.0,78.0,0.308,0.4579999999999999,0,2004-04-12,81,41,40,0.506,81,56,25,0.691
20301169,1610612743,1610612758,97.0,89.0,0.436,0.4,1,2004-04-12,81,43,38,0.531,81,55,26,0.679
20301166,1610612740,1610612752,97.0,101.0,0.4429999999999999,0.434,0,2004-04-12,81,40,41,0.494,81,39,42,0.481
20301171,1610612760,1610612745,107.0,111.0,0.487,0.484,0,2004-04-12,81,36,45,0.444,81,45,36,0.556
20301163,1610612755,1610612754,93.0,107.0,0.525,0.6,0,2004-04-12,81,33,48,0.407,81,60,21,0.741
20301160,1610612746,1610612759,79.0,88.0,0.356,0.5,0,2004-04-11,80,27,53,0.3379999999999999,80,55,25,0.688
20301158,1610612756,1610612763,89.0,83.0,0.435,0.352,1,2004-04-11,80,28,52,0.35,80,50,30,0.625
20301159,1610612744,1610612742,108.0,107.0,0.452,0.449,1,2004-04-11,80,36,44,0.45,80,50,30,0.625
20301157,1610612758,1610612747,102.0,85.0,0.42,0.381,1,2004-04-11,80,55,25,0.688,80,54,26,0.675
20301156,1610612761,1610612741,108.0,114.0,0.441,0.44,0,2004-04-11,80,31,49,0.3879999999999999,80,23,57,0.288
20301155,1610612751,1610612755,89.0,75.0,0.434,0.433,1,2004-04-11,80,47,33,0.588,80,33,47,0.413
20301148,1610612764,1610612752,98.0,102.0,0.434,0.43,0,2004-04-10,80,25,55,0.313,80,38,42,0.475
20301150,1610612737,1610612738,110.0,99.0,0.494,0.486,1,2004-04-10,80,27,53,0.3379999999999999,80,35,45,0.4379999999999999
20301151,1610612739,1610612748,91.0,80.0,0.442,0.3289999999999999,1,2004-04-10,80,33,47,0.413,80,40,40,0.5
20301153,1610612743,1610612757,110.0,100.0,0.457,0.487,1,2004-04-10,80,42,38,0.525,80,41,39,0.513
20301152,1610612749,1610612740,87.0,92.0,0.3879999999999999,0.4579999999999999,0,2004-04-10,80,41,39,0.513,80,40,40,0.5
20301154,1610612762,1610612745,82.0,69.0,0.415,0.379,1,2004-04-10,80,42,38,0.525,80,44,36,0.55
20301147,1610612760,1610612742,119.0,99.0,0.586,0.43,1,2004-04-10,80,36,44,0.45,79,50,29,0.633
20301149,1610612753,1610612765,89.0,101.0,0.5,0.489,0,2004-04-10,80,19,61,0.238,80,53,27,0.6629999999999999
20301145,1610612747,1610612763,103.0,95.0,0.493,0.4639999999999999,1,2004-04-09,79,54,25,0.684,79,50,29,0.633
20301140,1610612759,1610612757,84.0,74.0,0.466,0.414,1,2004-04-09,79,54,25,0.684,79,41,38,0.519
20301141,1610612754,1610612751,90.0,80.0,0.421,0.476,1,2004-04-09,80,59,21,0.738,79,46,33,0.5820000000000001
20301144,1610612756,1610612758,101.0,96.0,0.4320000000000001,0.444,1,2004-04-09,79,27,52,0.342,79,54,25,0.684
20301139,1610612765,1610612761,74.0,66.0,0.3379999999999999,0.3379999999999999,1,2004-04-09,79,52,27,0.6579999999999999,79,31,48,0.392
20301137,1610612748,1610612739,106.0,91.0,0.479,0.493,1,2004-04-09,79,40,39,0.506,79,32,47,0.405
20301143,1610612745,1610612743,106.0,103.0,0.474,0.532,1,2004-04-09,79,44,35,0.557,79,41,38,0.519
20301142,1610612741,1610612737,101.0,116.0,0.4629999999999999,0.494,0,2004-04-09,79,22,57,0.278,79,26,53,0.3289999999999999
20301146,1610612744,1610612750,74.0,92.0,0.355,0.424,0,2004-04-09,79,35,44,0.4429999999999999,80,56,24,0.7
20301138,1610612740,1610612738,89.0,80.0,0.397,0.321,1,2004-04-09,79,39,40,0.494,79,35,44,0.4429999999999999
20301136,1610612755,1610612764,80.0,83.0,0.395,0.397,0,2004-04-09,79,33,46,0.418,79,25,54,0.316
20301134,1610612742,1610612762,117.0,94.0,0.532,0.493,1,2004-04-08,78,50,28,0.6409999999999999,79,41,38,0.519
20301135,1610612758,1610612750,86.0,94.0,0.434,0.4589999999999999,0,2004-04-08,78,54,24,0.6920000000000001,79,55,24,0.696
20301133,1610612751,1610612753,101.0,81.0,0.4370000000000001,0.408,1,2004-04-08,78,46,32,0.59,79,19,60,0.241
20301132,1610612746,1610612745,79.0,102.0,0.354,0.526,0,2004-04-07,79,27,52,0.342,78,43,35,0.551
20301129,1610612759,1610612760,96.0,75.0,0.532,0.355,1,2004-04-07,78,53,25,0.679,79,35,44,0.4429999999999999
20301124,1610612752,1610612741,96.0,82.0,0.4529999999999999,0.354,1,2004-04-07,79,37,42,0.4679999999999999,78,22,56,0.282
20301130,1610612756,1610612743,96.0,111.0,0.4370000000000001,0.457,0,2004-04-07,78,26,52,0.3329999999999999,78,41,37,0.526
20301125,1610612748,1610612738,104.0,101.0,0.419,0.455,1,2004-04-07,78,39,39,0.5,78,35,43,0.449
20301131,1610612757,1610612744,87.0,81.0,0.472,0.389,1,2004-04-07,78,41,37,0.526,78,35,43,0.449
20301126,1610612761,1610612754,90.0,94.0,0.429,0.466,0,2004-04-07,78,31,47,0.397,79,58,21,0.7340000000000001
20301127,1610612749,1610612764,116.0,107.0,0.5,0.405,1,2004-04-07,79,41,38,0.519,78,24,54,0.308
20301128,1610612763,1610612739,92.0,74.0,0.4,0.4029999999999999,1,2004-04-07,78,50,28,0.6409999999999999,78,32,46,0.41
20301121,1610612747,1610612757,80.0,91.0,0.397,0.5,0,2004-04-06,78,53,25,0.679,77,40,37,0.519
20301119,1610612754,1610612752,107.0,86.0,0.513,0.465,1,2004-04-06,78,57,21,0.731,78,36,42,0.462
20301117,1610612737,1610612755,100.0,103.0,0.419,0.494,0,2004-04-06,78,25,53,0.321,78,33,45,0.423
20301118,1610612765,1610612753,102.0,86.0,0.512,0.395,1,2004-04-06,78,51,27,0.654,78,19,59,0.244
20301115,1610612739,1610612761,86.0,87.0,0.3979999999999999,0.41,0,2004-04-06,77,32,45,0.416,77,31,46,0.4029999999999999
20301120,1610612742,1610612760,118.0,108.0,0.552,0.495,1,2004-04-06,77,49,28,0.636,78,35,43,0.449
20301123,1610612744,1610612745,97.0,90.0,0.529,0.4589999999999999,1,2004-04-06,77,35,42,0.455,77,42,35,0.545
20301122,1610612758,1610612740,105.0,91.0,0.542,0.419,1,2004-04-06,77,54,23,0.701,78,38,40,0.487
20301116,1610612751,1610612749,98.0,103.0,0.494,0.507,0,2004-04-06,77,45,32,0.584,78,40,38,0.513
20300501,1610612762,1610612763,92.0,81.0,0.3720000000000001,0.446,1,2004-04-05,78,41,37,0.526,77,49,28,0.636
20301114,1610612746,1610612762,92.0,97.0,0.4529999999999999,0.487,0,2004-04-04,78,27,51,0.346,77,40,37,0.519
20301110,1610612747,1610612759,89.0,95.0,0.4270000000000001,0.4320000000000001,0,2004-04-04,77,53,24,0.688,77,52,25,0.675
20301109,1610612750,1610612763,90.0,82.0,0.395,0.387,1,2004-04-04,78,54,24,0.6920000000000001,76,49,27,0.645
20301108,1610612764,1610612738,112.0,102.0,0.556,0.532,1,2004-04-04,77,24,53,0.312,77,35,42,0.455
20301111,1610612765,1610612754,79.0,61.0,0.386,0.324,1,2004-04-04,77,50,27,0.649,77,56,21,0.727
20301107,1610612745,1610612758,94.0,99.0,0.475,0.5,0,2004-04-04,76,42,34,0.5529999999999999,76,53,23,0.6970000000000001
20301106,1610612761,1610612749,83.0,90.0,0.413,0.455,0,2004-04-04,76,30,46,0.395,77,39,38,0.506
20301113,1610612760,1610612740,96.0,88.0,0.461,0.359,1,2004-04-04,77,35,42,0.455,77,38,39,0.494
20301112,1610612751,1610612737,106.0,89.0,0.537,0.3939999999999999,1,2004-04-04,76,45,31,0.5920000000000001,77,25,52,0.325
20301102,1610612739,1610612744,100.0,103.0,0.37,0.536,0,2004-04-03,76,32,44,0.421,76,34,42,0.447
20301104,1610612742,1610612756,124.0,103.0,0.61,0.446,1,2004-04-03,76,48,28,0.632,77,26,51,0.3379999999999999
20301103,1610612741,1610612748,83.0,97.0,0.345,0.3979999999999999,0,2004-04-03,77,22,55,0.286,77,38,39,0.494
20301105,1610612757,1610612740,81.0,94.0,0.4,0.486,0,2004-04-03,76,39,37,0.513,76,38,38,0.5
20301101,1610612755,1610612752,75.0,86.0,0.375,0.425,0,2004-04-03,77,32,45,0.416,77,36,41,0.4679999999999999
20301091,1610612754,1610612761,84.0,64.0,0.39,0.347,1,2004-04-02,76,56,20,0.737,75,30,45,0.4
20301094,1610612750,1610612764,91.0,73.0,0.4379999999999999,0.3289999999999999,1,2004-04-02,77,53,24,0.688,76,23,53,0.303
20301093,1610612765,1610612748,92.0,84.0,0.4,0.39,1,2004-04-02,76,49,27,0.645,76,37,39,0.487
20301090,1610612738,1610612744,111.0,106.0,0.526,0.456,1,2004-04-02,76,35,41,0.461,75,33,42,0.44
20301096,1610612741,1610612746,114.0,110.0,0.413,0.368,1,2004-04-02,76,22,54,0.289,77,27,50,0.351
20301098,1610612743,1610612745,110.0,100.0,0.488,0.494,1,2004-04-02,77,40,37,0.519,75,42,33,0.56
20301097,1610612749,1610612739,107.0,89.0,0.475,0.513,1,2004-04-02,76,38,38,0.5,75,32,43,0.4270000000000001
20301099,1610612762,1610612759,81.0,94.0,0.462,0.429,0,2004-04-02,76,39,37,0.513,76,51,25,0.6709999999999999
20301100,1610612760,1610612747,86.0,97.0,0.447,0.557,0,2004-04-02,76,34,42,0.447,76,53,23,0.6970000000000001
20301092,1610612751,1610612752,108.0,83.0,0.6,0.4,1,2004-04-02,75,44,31,0.5870000000000001,76,35,41,0.461
20301089,1610612753,1610612737,87.0,95.0,0.3779999999999999,0.425,0,2004-04-02,77,19,58,0.247,76,25,51,0.3289999999999999
20301095,1610612763,1610612756,109.0,99.0,0.5,0.482,1,2004-04-02,75,49,26,0.653,76,26,50,0.342
20301088,1610612747,1610612745,93.0,85.0,0.377,0.407,1,2004-04-01,75,52,23,0.693,74,42,32,0.568
20301087,1610612742,1610612758,127.0,117.0,0.542,0.477,1,2004-04-01,75,47,28,0.627,75,52,23,0.693
20301086,1610612755,1610612757,82.0,88.0,0.3829999999999999,0.486,0,2004-04-01,76,32,44,0.421,75,39,36,0.52
20301084,1610612759,1610612758,107.0,89.0,0.575,0.4429999999999999,1,2004-03-31,75,50,25,0.667,74,52,22,0.703
20301079,1610612754,1610612749,111.0,78.0,0.563,0.373,1,2004-03-31,75,55,20,0.733,75,37,38,0.493
20301083,1610612750,1610612760,90.0,83.0,0.4629999999999999,0.413,1,2004-03-31,76,52,24,0.684,75,34,41,0.4529999999999999
20301077,1610612764,1610612751,99.0,103.0,0.341,0.4629999999999999,0,2004-03-31,75,23,52,0.307,74,43,31,0.581
20301080,1610612737,1610612748,97.0,100.0,0.361,0.47,0,2004-03-31,75,24,51,0.32,75,37,38,0.493
20301082,1610612765,1610612746,108.0,99.0,0.481,0.513,1,2004-03-31,75,48,27,0.64,76,27,49,0.355
20301076,1610612738,1610612757,98.0,105.0,0.4529999999999999,0.608,0,2004-03-31,75,34,41,0.4529999999999999,74,38,36,0.514
20301081,1610612761,1610612744,78.0,85.0,0.402,0.447,0,2004-03-31,74,30,44,0.405,74,33,41,0.446
20301085,1610612762,1610612740,89.0,76.0,0.524,0.3329999999999999,1,2004-03-31,75,39,36,0.52,75,37,38,0.493
20301078,1610612753,1610612741,91.0,109.0,0.402,0.478,0,2004-03-31,76,19,57,0.25,75,21,54,0.28
20301075,1610612747,1610612740,107.0,88.0,0.519,0.392,1,2004-03-30,74,51,23,0.6890000000000001,74,37,37,0.5
20301073,1610612742,1610612739,126.0,109.0,0.544,0.489,1,2004-03-30,74,46,28,0.622,74,32,42,0.4320000000000001
20301074,1610612743,1610612760,124.0,119.0,0.505,0.5,1,2004-03-30,76,39,37,0.513,74,34,40,0.4589999999999999
20301072,1610612749,1610612754,95.0,86.0,0.465,0.425,1,2004-03-30,74,37,37,0.5,74,54,20,0.73
20301071,1610612755,1610612744,95.0,71.0,0.4429999999999999,0.375,1,2004-03-30,75,32,43,0.4270000000000001,73,32,41,0.4379999999999999
20301069,1610612759,1610612739,101.0,93.0,0.512,0.474,1,2004-03-29,74,49,25,0.662,73,32,41,0.4379999999999999
20301064,1610612752,1610612757,92.0,91.0,0.469,0.5,1,2004-03-29,75,35,40,0.467,73,37,36,0.507
20301067,1610612737,1610612763,133.0,136.0,0.41,0.505,0,2004-03-29,74,24,50,0.324,74,48,26,0.649
20301070,1610612756,1610612764,101.0,95.0,0.493,0.3979999999999999,1,2004-03-29,75,26,49,0.347,74,23,51,0.311
20301066,1610612748,1610612741,105.0,96.0,0.4320000000000001,0.392,1,2004-03-29,74,36,38,0.486,74,20,54,0.27
20301068,1610612745,1610612750,88.0,94.0,0.4579999999999999,0.425,0,2004-03-29,73,42,31,0.575,75,51,24,0.68
20301065,1610612751,1610612738,80.0,84.0,0.349,0.391,0,2004-03-29,73,42,31,0.575,74,34,40,0.4589999999999999
20301063,1610612747,1610612762,91.0,84.0,0.375,0.413,1,2004-03-28,73,50,23,0.685,74,38,36,0.514
20301059,1610612754,1610612748,87.0,80.0,0.353,0.39,1,2004-03-28,73,54,19,0.74,73,35,38,0.479
20301060,1610612738,1610612755,89.0,65.0,0.481,0.27,1,2004-03-28,73,33,40,0.452,74,31,43,0.419
20301061,1610612744,1610612746,105.0,77.0,0.472,0.411,1,2004-03-28,72,32,40,0.444,75,27,48,0.36
20301062,1610612758,1610612764,100.0,92.0,0.44,0.373,1,2004-03-28,73,52,21,0.7120000000000001,73,23,50,0.315
20301056,1610612761,1610612763,88.0,94.0,0.4629999999999999,0.5539999999999999,0,2004-03-28,73,30,43,0.411,73,47,26,0.644
20301058,1610612749,1610612745,107.0,111.0,0.446,0.472,0,2004-03-28,73,36,37,0.493,72,42,30,0.583
20301057,1610612753,1610612742,88.0,118.0,0.352,0.556,0,2004-03-28,75,19,56,0.253,73,45,28,0.616
20301055,1610612746,1610612750,82.0,98.0,0.42,0.4589999999999999,0,2004-03-27,74,27,47,0.365,74,50,24,0.6759999999999999
20301052,1610612759,1610612756,105.0,76.0,0.5,0.397,1,2004-03-27,73,48,25,0.6579999999999999,74,25,49,0.3379999999999999
20301049,1610612737,1610612741,97.0,88.0,0.382,0.3929999999999999,1,2004-03-27,73,24,49,0.3289999999999999,73,20,53,0.2739999999999999
20301051,1610612765,1610612752,100.0,85.0,0.4629999999999999,0.387,1,2004-03-27,74,47,27,0.635,74,34,40,0.4589999999999999
20301050,1610612739,1610612751,107.0,104.0,0.5379999999999999,0.482,1,2004-03-27,72,32,40,0.444,72,42,30,0.583
20301054,1610612757,1610612760,115.0,108.0,0.47,0.513,1,2004-03-27,72,37,35,0.514,73,34,39,0.466
20301053,1610612762,1610612743,85.0,83.0,0.42,0.3720000000000001,1,2004-03-27,73,38,35,0.521,75,38,37,0.507
20301046,1610612747,1610612750,90.0,73.0,0.3929999999999999,0.314,1,2004-03-26,72,49,23,0.6809999999999999,73,49,24,0.6709999999999999
20301040,1610612752,1610612761,108.0,101.0,0.481,0.42,1,2004-03-26,73,34,39,0.466,72,30,42,0.417
20301041,1610612748,1610612742,119.0,118.0,0.446,0.469,1,2004-03-26,72,35,37,0.486,72,44,28,0.611
20301042,1610612738,1610612751,102.0,93.0,0.4429999999999999,0.4429999999999999,1,2004-03-26,72,32,40,0.444,71,42,29,0.5920000000000001
20301045,1610612741,1610612749,105.0,115.0,0.452,0.522,0,2004-03-26,72,20,52,0.278,72,36,36,0.5
20301047,1610612744,1610612764,99.0,78.0,0.4379999999999999,0.3329999999999999,1,2004-03-26,71,31,40,0.4370000000000001,72,23,49,0.319
20301043,1610612740,1610612756,94.0,99.0,0.474,0.507,0,2004-03-26,73,37,36,0.507,73,25,48,0.342
20301048,1610612760,1610612743,102.0,86.0,0.441,0.418,1,2004-03-26,72,34,38,0.472,74,38,36,0.514
20301038,1610612755,1610612739,86.0,71.0,0.452,0.391,1,2004-03-26,73,31,42,0.425,71,31,40,0.4370000000000001
20301039,1610612753,1610612754,92.0,107.0,0.493,0.494,0,2004-03-26,74,19,55,0.257,72,53,19,0.736
20301044,1610612763,1610612745,109.0,86.0,0.47,0.4579999999999999,1,2004-03-26,72,46,26,0.639,71,41,30,0.5770000000000001
20301037,1610612746,1610612764,94.0,103.0,0.3779999999999999,0.4270000000000001,0,2004-03-25,73,27,46,0.37,71,23,48,0.324
20301036,1610612759,1610612765,84.0,75.0,0.392,0.452,1,2004-03-25,72,47,25,0.653,73,46,27,0.63
20301035,1610612737,1610612740,84.0,76.0,0.461,0.358,1,2004-03-25,72,23,49,0.319,72,37,35,0.514
20301033,1610612747,1610612758,115.0,91.0,0.516,0.41,1,2004-03-24,71,48,23,0.6759999999999999,72,51,21,0.708
20301028,1610612754,1610612742,103.0,99.0,0.417,0.494,1,2004-03-24,71,52,19,0.732,71,44,27,0.62
20301027,1610612752,1610612763,97.0,111.0,0.434,0.405,0,2004-03-24,72,33,39,0.4579999999999999,71,45,26,0.634
20301029,1610612745,1610612761,90.0,89.0,0.415,0.41,1,2004-03-24,70,41,29,0.586,71,30,41,0.423
20301034,1610612744,1610612749,98.0,89.0,0.488,0.451,1,2004-03-24,70,30,40,0.429,71,35,36,0.493
20301031,1610612757,1610612746,91.0,85.0,0.41,0.485,1,2004-03-24,71,36,35,0.507,72,27,45,0.375
20301030,1610612743,1610612750,101.0,92.0,0.368,0.467,1,2004-03-24,73,38,35,0.521,72,49,23,0.6809999999999999
20301032,1610612760,1610612762,84.0,77.0,0.413,0.349,1,2004-03-24,71,33,38,0.465,72,37,35,0.514
20301026,1610612753,1610612748,90.0,105.0,0.416,0.488,0,2004-03-24,73,19,54,0.26,71,34,37,0.479
20301025,1610612755,1610612756,99.0,94.0,0.485,0.447,1,2004-03-24,72,30,42,0.417,72,24,48,0.3329999999999999
20301020,1610612750,1610612759,86.0,81.0,0.4270000000000001,0.407,1,2004-03-23,71,49,22,0.69,71,46,25,0.648
20301018,1610612739,1610612756,86.0,103.0,0.314,0.57,0,2004-03-23,70,31,39,0.4429999999999999,71,24,47,0.3379999999999999
20301022,1610612741,1610612751,81.0,84.0,0.4,0.4270000000000001,0,2004-03-23,71,20,51,0.282,70,42,28,0.6
20301024,1610612758,1610612749,101.0,112.0,0.44,0.512,0,2004-03-23,71,51,20,0.718,70,35,35,0.5
20301019,1610612740,1610612765,82.0,81.0,0.4370000000000001,0.419,1,2004-03-23,71,37,34,0.521,72,46,26,0.639
20301023,1610612762,1610612764,85.0,77.0,0.444,0.354,1,2004-03-23,71,37,34,0.521,70,22,48,0.314
20301021,1610612763,1610612761,95.0,86.0,0.446,0.3329999999999999,1,2004-03-23,70,44,26,0.629,70,30,40,0.429
20301014,1610612754,1610612741,101.0,77.0,0.397,0.431,1,2004-03-22,70,51,19,0.7290000000000001,70,20,50,0.286
20301015,1610612752,1610612737,96.0,84.0,0.447,0.368,1,2004-03-22,71,33,38,0.465,71,22,49,0.31
20301017,1610612757,1610612745,85.0,93.0,0.375,0.481,0,2004-03-22,70,35,35,0.5,69,40,29,0.58
20301016,1610612743,1610612746,102.0,80.0,0.506,0.356,1,2004-03-22,72,37,35,0.514,71,27,44,0.38
20301013,1610612755,1610612742,107.0,98.0,0.545,0.476,1,2004-03-22,71,29,42,0.408,70,44,26,0.629
20301012,1610612747,1610612749,104.0,103.0,0.494,0.4039999999999999,1,2004-03-21,70,47,23,0.6709999999999999,69,34,35,0.493
20301006,1610612746,1610612744,85.0,96.0,0.385,0.461,0,2004-03-21,70,27,43,0.386,69,29,40,0.42
20301005,1610612750,1610612743,98.0,77.0,0.481,0.309,1,2004-03-21,70,48,22,0.6859999999999999,71,36,35,0.507
20301007,1610612764,1610612748,81.0,101.0,0.395,0.473,0,2004-03-21,69,22,47,0.319,70,33,37,0.471
20301008,1610612739,1610612765,76.0,96.0,0.382,0.456,0,2004-03-21,69,31,38,0.449,71,46,25,0.648
20301010,1610612758,1610612745,100.0,95.0,0.466,0.4579999999999999,1,2004-03-21,70,51,19,0.7290000000000001,68,39,29,0.574
20301009,1610612740,1610612761,120.0,121.0,0.442,0.525,0,2004-03-21,70,36,34,0.514,69,30,39,0.435
20301011,1610612760,1610612753,84.0,67.0,0.418,0.348,1,2004-03-21,70,32,38,0.457,72,19,53,0.264
20301004,1610612751,1610612742,98.0,101.0,0.514,0.506,0,2004-03-21,69,41,28,0.594,69,44,25,0.638
20301001,1610612759,1610612738,103.0,87.0,0.507,0.415,1,2004-03-20,70,46,24,0.657,71,31,40,0.4370000000000001
20300998,1610612737,1610612762,81.0,87.0,0.389,0.439,0,2004-03-20,70,22,48,0.314,70,36,34,0.514
20301002,1610612756,1610612749,123.0,111.0,0.544,0.506,1,2004-03-20,70,23,47,0.3289999999999999,68,34,34,0.5
20300997,1610612748,1610612755,101.0,69.0,0.5,0.3379999999999999,1,2004-03-20,69,32,37,0.4639999999999999,70,28,42,0.4
20301000,1610612741,1610612752,87.0,81.0,0.4639999999999999,0.386,1,2004-03-20,69,20,49,0.29,70,32,38,0.457
20301003,1610612757,1610612753,92.0,73.0,0.494,0.315,1,2004-03-20,69,35,34,0.507,71,19,52,0.268
20300999,1610612763,1610612754,99.0,95.0,0.528,0.507,1,2004-03-20,69,43,26,0.623,69,50,19,0.725
20300995,1610612747,1610612746,106.0,100.0,0.506,0.4320000000000001,1,2004-03-19,69,46,23,0.667,69,27,42,0.391
20300990,1610612754,1610612758,92.0,94.0,0.4,0.455,0,2004-03-19,68,50,18,0.735,69,50,19,0.725
20300986,1610612764,1610612737,94.0,84.0,0.44,0.341,1,2004-03-19,68,22,46,0.324,69,22,47,0.319
20300988,1610612752,1610612751,79.0,65.0,0.41,0.3289999999999999,1,2004-03-19,69,32,37,0.4639999999999999,68,41,27,0.603
20300994,1610612756,1610612750,80.0,93.0,0.381,0.451,0,2004-03-19,69,22,47,0.319,69,47,22,0.6809999999999999
20300989,1610612739,1610612762,88.0,97.0,0.413,0.507,0,2004-03-19,68,31,37,0.456,69,35,34,0.507
20300992,1610612765,1610612743,94.0,75.0,0.5329999999999999,0.407,1,2004-03-19,70,45,25,0.643,70,36,34,0.514
20300993,1610612742,1610612738,120.0,104.0,0.529,0.507,1,2004-03-19,68,43,25,0.632,70,31,39,0.4429999999999999
20300996,1610612744,1610612745,90.0,84.0,0.429,0.405,1,2004-03-19,68,28,40,0.412,67,39,28,0.5820000000000001
20300987,1610612761,1610612741,91.0,96.0,0.4629999999999999,0.4629999999999999,0,2004-03-19,68,29,39,0.426,68,19,49,0.2789999999999999
20300991,1610612740,1610612760,80.0,91.0,0.39,0.457,0,2004-03-19,69,36,33,0.522,69,31,38,0.449
20300985,1610612759,1610612750,106.0,86.0,0.481,0.4370000000000001,1,2004-03-18,69,45,24,0.652,68,46,22,0.6759999999999999
20300983,1610612751,1610612765,71.0,89.0,0.353,0.452,0,2004-03-18,67,41,26,0.612,69,44,25,0.638
20300984,1610612763,1610612760,94.0,97.0,0.4270000000000001,0.522,0,2004-03-18,68,42,26,0.618,68,30,38,0.441
20300981,1610612746,1610612747,103.0,106.0,0.4320000000000001,0.5489999999999999,0,2004-03-17,68,27,41,0.397,68,45,23,0.662
20300977,1610612754,1610612757,80.0,71.0,0.449,0.3929999999999999,1,2004-03-17,67,50,17,0.746,68,34,34,0.5
20300976,1610612764,1610612758,114.0,108.0,0.489,0.562,1,2004-03-17,67,21,46,0.313,68,49,19,0.721
20300975,1610612738,1610612743,104.0,100.0,0.5,0.442,1,2004-03-17,69,31,38,0.449,69,36,33,0.522
20300980,1610612742,1610612737,110.0,111.0,0.489,0.5,0,2004-03-17,67,42,25,0.627,68,22,46,0.324
20300982,1610612744,1610612753,110.0,85.0,0.525,0.4,1,2004-03-17,67,27,40,0.4029999999999999,70,19,51,0.271
20300978,1610612761,1610612762,85.0,81.0,0.4379999999999999,0.391,1,2004-03-17,67,29,38,0.433,68,34,34,0.5
20300979,1610612740,1610612755,104.0,80.0,0.43,0.47,1,2004-03-17,68,36,32,0.529,69,28,41,0.406
20300968,1610612752,1610612764,114.0,110.0,0.434,0.494,1,2004-03-16,68,31,37,0.456,66,20,46,0.303
20300971,1610612737,1610612760,110.0,118.0,0.408,0.457,0,2004-03-16,67,21,46,0.313,67,29,38,0.433
20300974,1610612756,1610612746,98.0,110.0,0.47,0.451,0,2004-03-16,68,22,46,0.324,67,27,40,0.4029999999999999
20300967,1610612739,1610612741,111.0,87.0,0.452,0.396,1,2004-03-16,67,31,36,0.4629999999999999,67,18,49,0.2689999999999999
20300970,1610612748,1610612740,96.0,83.0,0.43,0.384,1,2004-03-16,68,31,37,0.456,67,35,32,0.522
20300972,1610612749,1610612757,99.0,100.0,0.494,0.483,0,2004-03-16,67,34,33,0.507,67,34,33,0.507
20300969,1610612751,1610612758,94.0,77.0,0.494,0.3779999999999999,1,2004-03-16,66,41,25,0.621,67,49,18,0.731
20300973,1610612763,1610612755,82.0,79.0,0.407,0.387,1,2004-03-16,67,42,25,0.627,68,28,40,0.412
20300966,1610612747,1610612753,113.0,110.0,0.446,0.478,1,2004-03-15,67,44,23,0.657,69,19,50,0.275
20300964,1610612745,1610612756,97.0,99.0,0.3929999999999999,0.352,0,2004-03-15,66,39,27,0.591,67,22,45,0.3279999999999999
20300965,1610612744,1610612759,97.0,80.0,0.479,0.386,1,2004-03-15,66,26,40,0.3939999999999999,68,44,24,0.647
20300963,1610612746,1610612742,88.0,101.0,0.369,0.452,0,2004-03-14,66,26,40,0.3939999999999999,66,42,24,0.636
20300959,1610612750,1610612757,83.0,92.0,0.4,0.421,0,2004-03-14,67,46,21,0.687,66,33,33,0.5
20300956,1610612765,1610612755,85.0,69.0,0.5,0.391,1,2004-03-14,68,43,25,0.632,67,28,39,0.418
20300957,1610612739,1610612754,107.0,104.0,0.545,0.5579999999999999,1,2004-03-14,66,30,36,0.455,66,49,17,0.742
20300961,1610612748,1610612751,104.0,95.0,0.535,0.515,1,2004-03-14,67,30,37,0.4479999999999999,65,40,25,0.615
20300960,1610612758,1610612759,101.0,87.0,0.5,0.4379999999999999,1,2004-03-14,66,49,17,0.742,67,44,23,0.657
20300962,1610612743,1610612762,102.0,75.0,0.422,0.364,1,2004-03-14,68,36,32,0.529,67,34,33,0.507
20300955,1610612761,1610612737,101.0,84.0,0.467,0.421,1,2004-03-14,66,28,38,0.424,66,21,45,0.318
20300958,1610612749,1610612752,100.0,103.0,0.419,0.488,0,2004-03-14,66,34,32,0.515,67,30,37,0.4479999999999999
20300949,1610612764,1610612738,102.0,111.0,0.476,0.472,0,2004-03-13,65,20,45,0.308,68,30,38,0.441
20300954,1610612756,1610612742,90.0,113.0,0.376,0.4539999999999999,0,2004-03-13,66,21,45,0.318,65,41,24,0.631
20300953,1610612745,1610612763,88.0,80.0,0.472,0.39,1,2004-03-13,65,39,26,0.6,66,41,25,0.621
20300952,1610612741,1610612747,81.0,88.0,0.3829999999999999,0.39,0,2004-03-13,66,18,48,0.273,66,43,23,0.652
20300951,1610612740,1610612744,102.0,84.0,0.556,0.456,1,2004-03-13,66,35,31,0.53,65,25,40,0.385
20300950,1610612753,1610612760,101.0,115.0,0.4529999999999999,0.561,0,2004-03-13,68,19,49,0.2789999999999999,66,28,38,0.424
20300946,1610612759,1610612744,99.0,74.0,0.476,0.382,1,2004-03-12,66,44,22,0.667,64,25,39,0.391
20300943,1610612750,1610612747,96.0,86.0,0.45,0.436,1,2004-03-12,66,46,20,0.6970000000000001,65,42,23,0.6459999999999999
20300942,1610612737,1610612764,138.0,124.0,0.5539999999999999,0.5489999999999999,1,2004-03-12,65,21,44,0.3229999999999999,64,20,44,0.313
20300947,1610612756,1610612762,90.0,99.0,0.405,0.466,0,2004-03-12,65,21,44,0.3229999999999999,66,34,32,0.515
20300941,1610612748,1610612760,82.0,74.0,0.417,0.368,1,2004-03-12,66,29,37,0.439,65,27,38,0.415
20300939,1610612738,1610612754,81.0,99.0,0.408,0.507,0,2004-03-12,67,29,38,0.433,65,49,16,0.754
20300948,1610612757,1610612758,83.0,81.0,0.434,0.425,1,2004-03-12,65,32,33,0.4920000000000001,65,48,17,0.738
20300945,1610612749,1610612743,111.0,117.0,0.457,0.56,0,2004-03-12,65,34,31,0.523,67,35,32,0.522
20300940,1610612751,1610612741,88.0,76.0,0.469,0.368,1,2004-03-12,64,40,24,0.625,65,18,47,0.2769999999999999
20300938,1610612755,1610612752,99.0,94.0,0.423,0.3720000000000001,1,2004-03-12,66,28,38,0.424,66,29,37,0.439
20300944,1610612763,1610612746,98.0,89.0,0.4379999999999999,0.395,1,2004-03-12,65,41,24,0.631,65,26,39,0.4
20300936,1610612745,1610612740,97.0,86.0,0.479,0.3929999999999999,1,2004-03-11,64,38,26,0.594,65,34,31,0.523
20300937,1610612758,1610612742,120.0,102.0,0.565,0.41,1,2004-03-11,64,48,16,0.75,64,40,24,0.625
20300933,1610612759,1610612746,108.0,90.0,0.456,0.449,1,2004-03-10,65,43,22,0.662,64,26,38,0.406
20300930,1610612765,1610612741,98.0,65.0,0.547,0.309,1,2004-03-10,67,42,25,0.627,64,18,46,0.281
20300926,1610612738,1610612747,109.0,117.0,0.4629999999999999,0.4639999999999999,0,2004-03-10,66,29,37,0.439,64,42,22,0.6559999999999999
20300935,1610612757,1610612750,92.0,79.0,0.481,0.3929999999999999,1,2004-03-10,64,31,33,0.484,65,45,20,0.6920000000000001
20300928,1610612761,1610612739,92.0,106.0,0.424,0.519,0,2004-03-10,65,27,38,0.415,65,29,36,0.446
20300931,1610612740,1610612748,95.0,84.0,0.348,0.375,1,2004-03-10,64,34,30,0.531,65,28,37,0.431
20300932,1610612749,1610612737,94.0,80.0,0.407,0.39,1,2004-03-10,64,34,30,0.531,64,20,44,0.313
20300934,1610612762,1610612744,91.0,77.0,0.487,0.406,1,2004-03-10,65,33,32,0.508,63,25,38,0.397
20300929,1610612751,1610612743,98.0,97.0,0.5670000000000001,0.4529999999999999,1,2004-03-10,63,39,24,0.619,66,34,32,0.515
20300927,1610612753,1610612764,108.0,99.0,0.407,0.3979999999999999,1,2004-03-10,67,19,48,0.284,63,20,43,0.317
20300918,1610612754,1610612761,94.0,84.0,0.429,0.4529999999999999,1,2004-03-09,64,48,16,0.75,64,27,37,0.422
20300917,1610612764,1610612743,87.0,117.0,0.392,0.54,0,2004-03-09,62,20,42,0.3229999999999999,65,34,31,0.523
20300919,1610612752,1610612738,84.0,87.0,0.439,0.405,0,2004-03-09,65,29,36,0.446,65,29,36,0.446
20300920,1610612748,1610612753,100.0,89.0,0.3879999999999999,0.493,1,2004-03-09,64,28,36,0.4379999999999999,66,18,48,0.273
20300923,1610612745,1610612746,90.0,85.0,0.419,0.4579999999999999,1,2004-03-09,63,37,26,0.5870000000000001,63,26,37,0.413
20300922,1610612741,1610612755,81.0,89.0,0.375,0.444,0,2004-03-09,63,18,45,0.286,65,27,38,0.415
20300924,1610612758,1610612744,96.0,92.0,0.3829999999999999,0.487,1,2004-03-09,63,47,16,0.746,62,25,37,0.4029999999999999
20300925,1610612760,1610612750,92.0,105.0,0.4679999999999999,0.494,0,2004-03-09,64,27,37,0.422,64,45,19,0.703
20300921,1610612763,1610612759,94.0,88.0,0.425,0.423,1,2004-03-09,64,40,24,0.625,64,42,22,0.6559999999999999
20300914,1610612737,1610612739,102.0,108.0,0.412,0.5,0,2004-03-08,63,20,43,0.317,64,28,36,0.4379999999999999
20300915,1610612742,1610612756,103.0,90.0,0.417,0.449,1,2004-03-08,63,40,23,0.635,64,21,43,0.3279999999999999
20300916,1610612762,1610612747,88.0,83.0,0.392,0.4029999999999999,1,2004-03-08,64,32,32,0.5,63,41,22,0.6509999999999999
20300913,1610612755,1610612749,97.0,92.0,0.474,0.493,1,2004-03-08,64,26,38,0.406,63,33,30,0.524
20300906,1610612747,1610612751,94.0,88.0,0.444,0.409,1,2004-03-07,62,41,21,0.6609999999999999,62,38,24,0.613
20300911,1610612746,1610612757,91.0,71.0,0.48,0.357,1,2004-03-07,62,26,36,0.419,63,30,33,0.476
20300908,1610612750,1610612738,77.0,80.0,0.359,0.3329999999999999,0,2004-03-07,63,44,19,0.698,64,28,36,0.4379999999999999
20300905,1610612764,1610612752,86.0,99.0,0.44,0.494,0,2004-03-07,61,20,41,0.3279999999999999,64,29,35,0.4529999999999999
20300904,1610612745,1610612742,101.0,98.0,0.488,0.417,1,2004-03-07,62,36,26,0.581,62,39,23,0.629
20300909,1610612744,1610612763,85.0,95.0,0.397,0.481,0,2004-03-07,61,25,36,0.41,63,39,24,0.619
20300912,1610612743,1610612754,94.0,103.0,0.494,0.5,0,2004-03-07,64,33,31,0.516,63,47,16,0.746
20300903,1610612761,1610612740,84.0,76.0,0.386,0.356,1,2004-03-07,63,27,36,0.429,63,33,30,0.524
20300910,1610612760,1610612765,65.0,86.0,0.39,0.452,0,2004-03-07,63,27,36,0.429,66,41,25,0.621
20300907,1610612753,1610612758,90.0,107.0,0.3929999999999999,0.447,0,2004-03-07,65,18,47,0.2769999999999999,62,46,16,0.742
20300897,1610612746,1610612763,92.0,98.0,0.4429999999999999,0.423,0,2004-03-06,61,25,36,0.41,62,38,24,0.613
20300901,1610612756,1610612759,86.0,107.0,0.4320000000000001,0.5,0,2004-03-06,63,21,42,0.3329999999999999,63,42,21,0.667
20300899,1610612739,1610612749,106.0,97.0,0.494,0.456,1,2004-03-06,63,27,36,0.429,62,33,29,0.532
20300896,1610612748,1610612758,102.0,96.0,0.42,0.3929999999999999,1,2004-03-06,63,27,36,0.429,61,45,16,0.738
20300902,1610612757,1610612762,91.0,70.0,0.486,0.36,1,2004-03-06,62,30,32,0.484,63,31,32,0.4920000000000001
20300900,1610612743,1610612765,66.0,97.0,0.321,0.482,0,2004-03-06,63,33,30,0.524,65,40,25,0.615
20300898,1610612755,1610612741,97.0,88.0,0.447,0.4,1,2004-03-06,63,25,38,0.397,62,18,44,0.29
20300894,1610612747,1610612760,99.0,91.0,0.452,0.439,1,2004-03-05,61,40,21,0.6559999999999999,62,27,35,0.435
20300892,1610612759,1610612742,113.0,100.0,0.5,0.3779999999999999,1,2004-03-05,62,41,21,0.6609999999999999,61,39,22,0.639
20300891,1610612750,1610612745,109.0,112.0,0.551,0.5,0,2004-03-05,62,44,18,0.71,61,35,26,0.574
20300889,1610612738,1610612764,94.0,90.0,0.461,0.39,1,2004-03-05,63,27,36,0.429,60,20,40,0.3329999999999999
20300895,1610612744,1610612751,74.0,78.0,0.451,0.444,0,2004-03-05,60,25,35,0.417,61,38,23,0.623
20300888,1610612761,1610612752,103.0,109.0,0.506,0.479,0,2004-03-05,62,26,36,0.419,63,28,35,0.444
20300890,1610612740,1610612739,85.0,88.0,0.381,0.416,0,2004-03-05,62,33,29,0.532,62,26,36,0.419
20300893,1610612762,1610612754,88.0,96.0,0.39,0.483,0,2004-03-05,62,31,31,0.5,62,46,16,0.742
20300887,1610612753,1610612737,101.0,96.0,0.519,0.417,1,2004-03-05,64,18,46,0.281,62,20,42,0.3229999999999999
20300885,1610612748,1610612749,104.0,98.0,0.4639999999999999,0.449,1,2004-03-04,62,26,36,0.419,61,33,28,0.541
20300886,1610612757,1610612765,68.0,83.0,0.342,0.442,0,2004-03-04,61,29,32,0.475,64,39,25,0.609
20300884,1610612755,1610612758,105.0,114.0,0.5,0.473,0,2004-03-04,62,24,38,0.387,60,45,15,0.75
20300883,1610612746,1610612754,94.0,101.0,0.4479999999999999,0.447,0,2004-03-03,60,25,35,0.417,61,45,16,0.738
20300880,1610612759,1610612760,88.0,84.0,0.434,0.493,1,2004-03-03,61,40,21,0.6559999999999999,61,27,34,0.4429999999999999
20300879,1610612750,1610612742,121.0,97.0,0.552,0.361,1,2004-03-03,61,44,17,0.721,60,39,21,0.65
20300874,1610612764,1610612761,84.0,70.0,0.412,0.33,1,2004-03-03,59,20,39,0.3389999999999999,61,26,35,0.426
20300877,1610612752,1610612755,88.0,77.0,0.43,0.358,1,2004-03-03,62,27,35,0.435,61,24,37,0.3929999999999999
20300882,1610612756,1610612751,87.0,74.0,0.4320000000000001,0.3929999999999999,1,2004-03-03,62,21,41,0.3389999999999999,60,37,23,0.617
20300876,1610612739,1610612737,112.0,80.0,0.4320000000000001,0.341,1,2004-03-03,61,25,36,0.41,61,20,41,0.3279999999999999
20300881,1610612745,1610612747,93.0,96.0,0.467,0.487,0,2004-03-03,60,34,26,0.5670000000000001,60,39,21,0.65
20300491,1610612757,1610612763,88.0,97.0,0.382,0.5,0,2004-03-03,60,29,31,0.483,61,37,24,0.607
20300878,1610612740,1610612741,100.0,97.0,0.41,0.419,1,2004-03-03,61,33,28,0.541,61,18,43,0.295
20300875,1610612753,1610612749,97.0,105.0,0.433,0.506,0,2004-03-03,63,17,46,0.27,60,33,27,0.55
20300869,1610612737,1610612747,94.0,93.0,0.3979999999999999,0.4579999999999999,1,2004-03-02,60,20,40,0.3329999999999999,59,38,21,0.644
20300868,1610612748,1610612761,86.0,89.0,0.436,0.486,0,2004-03-02,61,25,36,0.41,60,26,34,0.433
20300870,1610612742,1610612760,107.0,96.0,0.488,0.412,1,2004-03-02,59,39,20,0.6609999999999999,60,27,33,0.45
20300873,1610612744,1610612754,88.0,96.0,0.377,0.408,0,2004-03-02,59,25,34,0.424,60,44,16,0.733
20300872,1610612758,1610612746,113.0,106.0,0.5,0.494,1,2004-03-02,59,44,15,0.746,59,25,34,0.424
20300871,1610612743,1610612751,91.0,95.0,0.423,0.479,0,2004-03-02,62,33,29,0.532,59,37,22,0.627
20300866,1610612759,1610612763,80.0,81.0,0.417,0.3879999999999999,0,2004-03-01,60,39,21,0.65,60,36,24,0.6
20300864,1610612764,1610612740,111.0,106.0,0.518,0.433,1,2004-03-01,58,19,39,0.3279999999999999,60,32,28,0.5329999999999999
20300863,1610612738,1610612753,117.0,96.0,0.495,0.424,1,2004-03-01,62,26,36,0.419,62,17,45,0.2739999999999999
20300865,1610612741,1610612739,92.0,81.0,0.3779999999999999,0.361,1,2004-03-01,60,18,42,0.3,60,24,36,0.4
20300867,1610612762,1610612765,94.0,86.0,0.447,0.371,1,2004-03-01,61,31,30,0.508,63,38,25,0.603
20300862,1610612746,1610612765,88.0,100.0,0.4270000000000001,0.485,0,2004-02-29,58,25,33,0.431,62,38,24,0.613
20300857,1610612745,1610612760,80.0,97.0,0.342,0.479,0,2004-02-29,59,34,25,0.5760000000000001,59,27,32,0.4579999999999999
20300861,1610612758,1610612756,108.0,94.0,0.442,0.425,1,2004-02-29,58,43,15,0.741,61,20,41,0.3279999999999999
20300860,1610612743,1610612752,107.0,96.0,0.5,0.488,1,2004-02-29,61,33,28,0.541,61,26,35,0.426
20300855,1610612761,1610612738,82.0,91.0,0.3829999999999999,0.522,0,2004-02-29,59,25,34,0.424,61,25,36,0.41
20300856,1610612749,1610612748,108.0,104.0,0.434,0.414,1,2004-02-29,59,32,27,0.542,60,25,35,0.417
20300858,1610612751,1610612747,83.0,100.0,0.416,0.47,0,2004-02-29,58,36,22,0.621,58,38,20,0.655
20300859,1610612755,1610612750,81.0,74.0,0.408,0.359,1,2004-02-29,60,24,36,0.4,60,43,17,0.7170000000000001
20300854,1610612759,1610612743,117.0,92.0,0.505,0.465,1,2004-02-28,59,39,20,0.6609999999999999,60,32,28,0.5329999999999999
20300850,1610612754,1610612755,81.0,74.0,0.423,0.426,1,2004-02-28,59,43,16,0.7290000000000001,59,23,36,0.39
20300848,1610612764,1610612747,110.0,122.0,0.449,0.556,0,2004-02-28,57,18,39,0.316,57,37,20,0.649
20300849,1610612737,1610612753,99.0,104.0,0.4479999999999999,0.3829999999999999,0,2004-02-28,59,19,40,0.322,61,17,44,0.2789999999999999
20300853,1610612742,1610612757,111.0,91.0,0.517,0.4,1,2004-02-28,58,38,20,0.655,59,29,30,0.4920000000000001
20300852,1610612741,1610612744,87.0,81.0,0.39,0.273,1,2004-02-28,59,17,42,0.288,58,25,33,0.431
20300847,1610612751,1610612748,92.0,86.0,0.382,0.38,1,2004-02-28,57,36,21,0.632,59,25,34,0.424
20300851,1610612763,1610612740,97.0,92.0,0.493,0.411,1,2004-02-28,59,35,24,0.593,59,32,27,0.542
20300846,1610612746,1610612752,96.0,94.0,0.413,0.425,1,2004-02-27,57,25,32,0.439,60,26,34,0.433
20300841,1610612750,1610612744,91.0,81.0,0.487,0.41,1,2004-02-27,59,43,16,0.7290000000000001,57,25,32,0.439
20300840,1610612765,1610612737,105.0,83.0,0.514,0.345,1,2004-02-27,61,37,24,0.607,58,19,39,0.3279999999999999
20300843,1610612745,1610612757,89.0,85.0,0.4529999999999999,0.471,1,2004-02-27,58,34,24,0.586,58,29,29,0.5
20300837,1610612738,1610612761,88.0,75.0,0.446,0.3379999999999999,1,2004-02-27,60,24,36,0.4,58,25,33,0.431
20300845,1610612758,1610612762,97.0,102.0,0.382,0.4529999999999999,0,2004-02-27,57,42,15,0.737,60,30,30,0.5
20300839,1610612740,1610612754,89.0,77.0,0.418,0.359,1,2004-02-27,58,32,26,0.552,58,42,16,0.7240000000000001
20300842,1610612749,1610612763,106.0,104.0,0.452,0.531,1,2004-02-27,58,31,27,0.534,58,34,24,0.586
20300844,1610612760,1610612756,99.0,104.0,0.374,0.5,0,2004-02-27,58,26,32,0.4479999999999999,60,20,40,0.3329999999999999
20300838,1610612753,1610612739,107.0,112.0,0.462,0.482,0,2004-02-27,60,16,44,0.267,59,24,35,0.407
20300836,1610612747,1610612758,101.0,103.0,0.4479999999999999,0.48,0,2004-02-26,56,36,20,0.643,56,42,14,0.75
20300834,1610612764,1610612741,95.0,87.0,0.451,0.3929999999999999,1,2004-02-26,56,18,38,0.321,58,16,42,0.276
20300835,1610612742,1610612759,115.0,91.0,0.526,0.429,1,2004-02-26,57,37,20,0.649,58,38,20,0.655
20300827,1610612750,1610612751,81.0,68.0,0.441,0.386,1,2004-02-25,58,42,16,0.7240000000000001,56,35,21,0.625
20300832,1610612756,1610612752,113.0,95.0,0.5,0.452,1,2004-02-25,59,19,40,0.322,59,26,33,0.441
20300830,1610612745,1610612739,90.0,84.0,0.422,0.3979999999999999,1,2004-02-25,57,33,24,0.579,58,23,35,0.397
20300824,1610612738,1610612749,104.0,106.0,0.475,0.4629999999999999,0,2004-02-25,59,23,36,0.39,57,30,27,0.526
20300829,1610612741,1610612765,88.0,107.0,0.416,0.479,0,2004-02-25,57,16,41,0.281,60,36,24,0.6
20300831,1610612743,1610612747,111.0,112.0,0.5579999999999999,0.516,0,2004-02-25,59,32,27,0.542,55,36,19,0.655
20300825,1610612761,1610612764,74.0,76.0,0.406,0.485,0,2004-02-25,57,25,32,0.439,55,17,38,0.309
20300826,1610612740,1610612746,99.0,93.0,0.493,0.419,1,2004-02-25,57,31,26,0.544,56,24,32,0.429
20300833,1610612760,1610612762,92.0,93.0,0.392,0.452,0,2004-02-25,57,26,31,0.456,59,29,30,0.4920000000000001
20300828,1610612763,1610612744,92.0,99.0,0.4,0.423,0,2004-02-25,57,34,23,0.596,56,25,31,0.446
20300821,1610612759,1610612745,86.0,77.0,0.434,0.429,1,2004-02-24,57,38,19,0.667,56,32,24,0.5710000000000001
20300816,1610612754,1610612744,107.0,96.0,0.518,0.416,1,2004-02-24,57,42,15,0.737,55,24,31,0.436
20300818,1610612737,1610612755,86.0,75.0,0.4029999999999999,0.361,1,2004-02-24,57,19,38,0.3329999999999999,58,23,35,0.397
20300820,1610612742,1610612746,116.0,91.0,0.494,0.417,1,2004-02-24,56,36,20,0.643,55,24,31,0.436
20300823,1610612758,1610612752,107.0,99.0,0.488,0.477,1,2004-02-24,55,41,14,0.745,58,26,32,0.4479999999999999
20300819,1610612749,1610612750,102.0,108.0,0.48,0.5529999999999999,0,2004-02-24,56,29,27,0.518,57,41,16,0.7190000000000001
20300822,1610612762,1610612760,99.0,86.0,0.424,0.3379999999999999,1,2004-02-24,58,28,30,0.483,56,26,30,0.4639999999999999
20300817,1610612751,1610612761,86.0,74.0,0.455,0.391,1,2004-02-24,55,35,20,0.636,56,25,31,0.446
20300815,1610612753,1610612757,91.0,94.0,0.37,0.4629999999999999,0,2004-02-24,59,16,43,0.271,57,29,28,0.509
20300812,1610612739,1610612740,104.0,100.0,0.47,0.462,1,2004-02-23,57,23,34,0.4039999999999999,56,30,26,0.536
20300813,1610612748,1610612757,81.0,89.0,0.415,0.466,0,2004-02-23,58,25,33,0.431,56,28,28,0.5
20300811,1610612755,1610612765,66.0,76.0,0.301,0.413,0,2004-02-23,57,23,34,0.4039999999999999,59,35,24,0.593
20300814,1610612763,1610612743,109.0,106.0,0.5,0.425,1,2004-02-23,56,34,22,0.607,58,32,26,0.552
20300804,1610612754,1610612762,94.0,80.0,0.456,0.365,1,2004-02-22,56,41,15,0.732,57,27,30,0.474
20300805,1610612750,1610612759,92.0,94.0,0.487,0.402,0,2004-02-22,56,40,16,0.7140000000000001,56,37,19,0.6609999999999999
20300806,1610612764,1610612749,85.0,113.0,0.384,0.531,0,2004-02-22,54,16,38,0.296,55,29,26,0.527
20300802,1610612752,1610612739,86.0,92.0,0.385,0.3779999999999999,0,2004-02-22,57,26,31,0.456,56,22,34,0.3929999999999999
20300808,1610612756,1610612747,92.0,104.0,0.481,0.5,0,2004-02-22,58,18,40,0.31,54,35,19,0.648
20300807,1610612765,1610612753,86.0,87.0,0.416,0.418,0,2004-02-22,58,34,24,0.586,58,16,42,0.276
20300809,1610612745,1610612737,123.0,121.0,0.423,0.45,1,2004-02-22,55,32,23,0.5820000000000001,56,18,38,0.321
20300803,1610612761,1610612758,81.0,96.0,0.447,0.442,0,2004-02-22,55,25,30,0.455,54,40,14,0.741
20300810,1610612760,1610612738,108.0,87.0,0.457,0.479,1,2004-02-22,55,26,29,0.473,58,23,35,0.397
20300796,1610612748,1610612743,97.0,81.0,0.455,0.308,1,2004-02-21,57,25,32,0.439,57,32,25,0.561
20300799,1610612742,1610612745,97.0,88.0,0.425,0.4270000000000001,1,2004-02-21,55,35,20,0.636,54,31,23,0.574
20300797,1610612741,1610612763,98.0,105.0,0.418,0.421,0,2004-02-21,56,16,40,0.286,55,33,22,0.6
20300801,1610612744,1610612760,94.0,92.0,0.4,0.455,1,2004-02-21,54,24,30,0.444,54,25,29,0.4629999999999999
20300800,1610612757,1610612738,105.0,84.0,0.521,0.35,1,2004-02-21,55,27,28,0.491,57,23,34,0.4039999999999999
20300798,1610612749,1610612746,103.0,105.0,0.429,0.429,0,2004-02-21,54,28,26,0.519,54,24,30,0.444
20300795,1610612751,1610612740,97.0,84.0,0.414,0.358,1,2004-02-21,54,34,20,0.63,55,30,25,0.545
20300793,1610612747,1610612755,116.0,88.0,0.484,0.408,1,2004-02-20,53,34,19,0.642,56,23,33,0.411
20300784,1610612764,1610612754,87.0,96.0,0.413,0.478,0,2004-02-20,53,16,37,0.302,55,40,15,0.727
20300786,1610612752,1610612762,78.0,92.0,0.381,0.397,0,2004-02-20,56,26,30,0.4639999999999999,56,27,29,0.482
20300789,1610612739,1610612759,89.0,87.0,0.44,0.385,1,2004-02-20,55,21,34,0.382,55,36,19,0.655
20300790,1610612765,1610612750,87.0,88.0,0.429,0.442,0,2004-02-20,57,34,23,0.596,55,40,15,0.727
20300787,1610612748,1610612737,125.0,92.0,0.593,0.418,1,2004-02-20,56,24,32,0.429,55,18,37,0.327
20300792,1610612741,1610612758,83.0,91.0,0.386,0.4270000000000001,0,2004-02-20,55,16,39,0.291,53,39,14,0.736
20300794,1610612744,1610612757,93.0,94.0,0.415,0.405,0,2004-02-20,53,23,30,0.434,54,26,28,0.481
20300788,1610612761,1610612751,72.0,91.0,0.36,0.493,0,2004-02-20,54,25,29,0.4629999999999999,53,33,20,0.623
20300785,1610612753,1610612743,102.0,98.0,0.467,0.4589999999999999,1,2004-02-20,57,15,42,0.263,56,32,24,0.5710000000000001
20300791,1610612763,1610612756,97.0,92.0,0.414,0.411,1,2004-02-20,54,32,22,0.593,57,18,39,0.316
20300783,1610612746,1610612738,102.0,100.0,0.479,0.425,1,2004-02-19,53,23,30,0.434,56,23,33,0.411
20300781,1610612750,1610612758,92.0,75.0,0.455,0.337,1,2004-02-19,54,39,15,0.722,52,38,14,0.731
20300782,1610612760,1610612755,101.0,112.0,0.385,0.481,0,2004-02-19,53,25,28,0.472,55,23,32,0.418
20300777,1610612765,1610612749,102.0,98.0,0.425,0.352,1,2004-02-18,56,34,22,0.607,53,28,25,0.528
20300775,1610612739,1610612742,98.0,114.0,0.4639999999999999,0.474,0,2004-02-18,54,20,34,0.37,54,34,20,0.63
20300780,1610612744,1610612747,99.0,100.0,0.488,0.487,0,2004-02-18,52,23,29,0.442,52,33,19,0.635
20300779,1610612757,1610612746,101.0,86.0,0.476,0.373,1,2004-02-18,53,25,28,0.472,52,22,30,0.423
20300774,1610612761,1610612759,82.0,86.0,0.38,0.37,0,2004-02-18,53,25,28,0.472,54,36,18,0.667
20300778,1610612740,1610612764,120.0,98.0,0.552,0.449,1,2004-02-18,54,30,24,0.556,52,16,36,0.308
20300776,1610612751,1610612737,98.0,92.0,0.415,0.38,1,2004-02-18,52,32,20,0.615,54,18,36,0.3329999999999999
20300773,1610612753,1610612762,90.0,77.0,0.449,0.376,1,2004-02-18,56,14,42,0.25,55,26,29,0.473
20300772,1610612747,1610612757,89.0,86.0,0.494,0.436,1,2004-02-17,51,32,19,0.627,52,24,28,0.462
20300762,1610612754,1610612740,75.0,89.0,0.3329999999999999,0.446,0,2004-02-17,54,39,15,0.722,53,29,24,0.547
20300766,1610612750,1610612756,110.0,95.0,0.494,0.384,1,2004-02-17,53,38,15,0.7170000000000001,56,18,38,0.321
20300763,1610612752,1610612765,92.0,88.0,0.434,0.359,1,2004-02-17,55,26,29,0.473,55,33,22,0.6
20300764,1610612748,1610612762,97.0,85.0,0.446,0.3979999999999999,1,2004-02-17,55,23,32,0.418,54,26,28,0.481
20300769,1610612745,1610612764,107.0,81.0,0.5429999999999999,0.408,1,2004-02-17,53,31,22,0.585,51,16,35,0.314
20300768,1610612741,1610612761,75.0,73.0,0.326,0.303,1,2004-02-17,54,16,38,0.296,52,25,27,0.481
20300771,1610612758,1610612738,127.0,111.0,0.56,0.442,1,2004-02-17,51,38,13,0.745,55,23,32,0.418
20300770,1610612743,1610612755,106.0,85.0,0.488,0.4529999999999999,1,2004-02-17,55,32,23,0.5820000000000001,54,22,32,0.407
20300765,1610612749,1610612753,127.0,104.0,0.56,0.449,1,2004-02-17,52,28,24,0.5379999999999999,55,13,42,0.236
20300767,1610612763,1610612742,109.0,92.0,0.452,0.406,1,2004-02-17,53,31,22,0.585,53,33,20,0.623
20300759,1610612741,1610612738,107.0,87.0,0.513,0.369,1,2004-02-12,53,15,38,0.283,54,23,31,0.426
20300760,1610612757,1610612743,98.0,107.0,0.488,0.5479999999999999,0,2004-02-12,51,24,27,0.471,54,31,23,0.574
20300761,1610612760,1610612761,94.0,74.0,0.434,0.408,1,2004-02-12,52,25,27,0.481,51,25,26,0.49
20300752,1610612739,1610612751,85.0,105.0,0.38,0.482,0,2004-02-11,53,20,33,0.377,51,31,20,0.608
20300753,1610612765,1610612758,94.0,96.0,0.475,0.4679999999999999,0,2004-02-11,54,33,21,0.611,50,37,13,0.74
20300756,1610612745,1610612747,102.0,87.0,0.5479999999999999,0.4,1,2004-02-11,52,30,22,0.5770000000000001,50,31,19,0.62
20300758,1610612744,1610612756,110.0,99.0,0.524,0.481,1,2004-02-11,51,23,28,0.451,55,18,37,0.327
20300754,1610612740,1610612752,106.0,98.0,0.488,0.462,1,2004-02-11,52,28,24,0.5379999999999999,54,25,29,0.4629999999999999
20300757,1610612762,1610612750,66.0,77.0,0.379,0.382,0,2004-02-11,53,26,27,0.491,52,37,15,0.7120000000000001
20300751,1610612753,1610612748,98.0,111.0,0.481,0.539,0,2004-02-11,54,13,41,0.241,54,22,32,0.407
20300750,1610612755,1610612764,113.0,88.0,0.545,0.4629999999999999,1,2004-02-11,53,22,31,0.415,50,16,34,0.32
20300755,1610612763,1610612746,110.0,102.0,0.494,0.4270000000000001,1,2004-02-11,52,30,22,0.5770000000000001,51,22,29,0.431
20300744,1610612750,1610612746,96.0,84.0,0.482,0.395,1,2004-02-10,51,36,15,0.706,50,22,28,0.44
20300747,1610612756,1610612761,94.0,101.0,0.434,0.493,0,2004-02-10,54,18,36,0.3329999999999999,50,25,25,0.5
20300742,1610612748,1610612747,83.0,98.0,0.444,0.494,0,2004-02-10,53,21,32,0.396,49,31,18,0.633
20300746,1610612742,1610612752,105.0,90.0,0.478,0.419,1,2004-02-10,52,33,19,0.635,53,25,28,0.472
20300745,1610612741,1610612754,84.0,103.0,0.436,0.481,0,2004-02-10,52,14,38,0.2689999999999999,53,39,14,0.736
20300748,1610612757,1610612762,81.0,86.0,0.433,0.457,0,2004-02-10,50,24,26,0.48,52,26,26,0.5
20300743,1610612749,1610612758,117.0,124.0,0.534,0.5770000000000001,0,2004-02-10,51,27,24,0.529,49,36,13,0.735
20300749,1610612760,1610612744,97.0,106.0,0.487,0.488,0,2004-02-10,51,24,27,0.471,50,22,28,0.44
20300741,1610612751,1610612765,89.0,78.0,0.416,0.38,1,2004-02-10,50,30,20,0.6,53,33,20,0.623
20300738,1610612737,1610612742,102.0,96.0,0.4629999999999999,0.421,1,2004-02-09,53,18,35,0.34,51,32,19,0.627
20300737,1610612739,1610612738,97.0,89.0,0.395,0.402,1,2004-02-09,52,20,32,0.385,53,23,30,0.434
20300740,1610612745,1610612759,82.0,85.0,0.4320000000000001,0.4579999999999999,0,2004-02-09,51,29,22,0.569,53,35,18,0.66
20300739,1610612743,1610612763,86.0,83.0,0.386,0.451,1,2004-02-09,53,30,23,0.5660000000000001,51,29,22,0.569
20300730,1610612754,1610612748,97.0,91.0,0.4,0.5,1,2004-02-08,52,38,14,0.731,52,21,31,0.4039999999999999
20300731,1610612750,1610612763,98.0,99.0,0.506,0.513,0,2004-02-08,50,35,15,0.7,50,29,21,0.58
20300732,1610612752,1610612746,110.0,104.0,0.56,0.408,1,2004-02-08,52,25,27,0.481,49,22,27,0.449
20300735,1610612744,1610612761,81.0,84.0,0.425,0.395,0,2004-02-08,49,21,28,0.429,49,24,25,0.49
20300734,1610612757,1610612760,95.0,85.0,0.4429999999999999,0.392,1,2004-02-08,49,24,25,0.49,50,24,26,0.48
20300736,1610612758,1610612743,115.0,92.0,0.482,0.4270000000000001,1,2004-02-08,48,35,13,0.7290000000000001,52,29,23,0.5579999999999999
20300733,1610612751,1610612755,99.0,87.0,0.395,0.3879999999999999,1,2004-02-08,49,29,20,0.5920000000000001,52,21,31,0.4039999999999999
20300729,1610612753,1610612747,96.0,98.0,0.514,0.494,0,2004-02-08,53,13,40,0.245,48,30,18,0.625
20300724,1610612737,1610612745,77.0,86.0,0.3720000000000001,0.422,0,2004-02-07,52,17,35,0.327,50,29,21,0.58
20300728,1610612756,1610612762,92.0,96.0,0.469,0.449,0,2004-02-07,53,18,35,0.34,51,25,26,0.49
20300725,1610612739,1610612764,88.0,106.0,0.416,0.481,0,2004-02-07,51,19,32,0.373,49,16,33,0.327
20300722,1610612748,1610612752,64.0,76.0,0.305,0.413,0,2004-02-07,51,21,30,0.412,51,24,27,0.471
20300727,1610612742,1610612765,111.0,108.0,0.5539999999999999,0.556,1,2004-02-07,50,32,18,0.64,52,33,19,0.635
20300726,1610612749,1610612740,107.0,97.0,0.523,0.494,1,2004-02-07,50,27,23,0.54,51,27,24,0.529
20300723,1610612755,1610612738,80.0,110.0,0.382,0.528,0,2004-02-07,51,21,30,0.412,52,23,29,0.442
20300715,1610612750,1610612739,103.0,92.0,0.488,0.473,1,2004-02-06,49,35,14,0.7140000000000001,50,19,31,0.38
20300710,1610612764,1610612746,112.0,100.0,0.52,0.376,1,2004-02-06,48,15,33,0.313,48,22,26,0.4579999999999999
20300719,1610612756,1610612760,105.0,107.0,0.4589999999999999,0.494,0,2004-02-06,52,18,34,0.346,49,24,25,0.49
20300717,1610612745,1610612741,82.0,80.0,0.4370000000000001,0.369,1,2004-02-06,49,28,21,0.5710000000000001,51,14,37,0.275
20300711,1610612738,1610612737,96.0,100.0,0.414,0.536,0,2004-02-06,51,22,29,0.431,51,17,34,0.3329999999999999
20300720,1610612744,1610612743,96.0,87.0,0.421,0.3879999999999999,1,2004-02-06,48,21,27,0.4379999999999999,51,29,22,0.569
20300721,1610612758,1610612759,94.0,102.0,0.37,0.494,0,2004-02-06,47,34,13,0.723,52,34,18,0.654
20300712,1610612761,1610612754,77.0,83.0,0.39,0.4270000000000001,0,2004-02-06,48,23,25,0.479,51,37,14,0.725
20300714,1610612740,1610612765,92.0,81.0,0.413,0.385,1,2004-02-06,50,27,23,0.54,51,33,18,0.647
20300718,1610612762,1610612757,73.0,87.0,0.342,0.418,0,2004-02-06,50,24,26,0.48,48,23,25,0.479
20300713,1610612751,1610612753,120.0,99.0,0.598,0.493,1,2004-02-06,48,28,20,0.583,52,13,39,0.25
20300716,1610612763,1610612749,105.0,85.0,0.475,0.373,1,2004-02-06,49,28,21,0.5710000000000001,49,26,23,0.531
20300709,1610612760,1610612759,90.0,96.0,0.425,0.4639999999999999,0,2004-02-05,48,23,25,0.479,51,33,18,0.647
20300708,1610612755,1610612747,96.0,73.0,0.493,0.341,1,2004-02-05,50,21,29,0.42,47,29,18,0.617
20300699,1610612764,1610612763,101.0,103.0,0.424,0.481,0,2004-02-04,47,14,33,0.298,48,27,21,0.563
20300702,1610612737,1610612750,97.0,89.0,0.44,0.384,1,2004-02-04,50,16,34,0.32,48,34,14,0.708
20300707,1610612756,1610612757,97.0,101.0,0.457,0.513,0,2004-02-04,51,18,33,0.353,47,22,25,0.4679999999999999
20300703,1610612739,1610612747,106.0,111.0,0.406,0.519,0,2004-02-04,49,19,30,0.3879999999999999,46,29,17,0.63
20300705,1610612745,1610612749,103.0,89.0,0.494,0.3720000000000001,1,2004-02-04,48,27,21,0.563,48,26,22,0.542
20300698,1610612738,1610612746,86.0,95.0,0.474,0.405,0,2004-02-04,50,22,28,0.44,47,22,25,0.4679999999999999
20300700,1610612761,1610612753,110.0,90.0,0.531,0.415,1,2004-02-04,47,23,24,0.489,51,13,38,0.255
20300704,1610612740,1610612742,104.0,113.0,0.4379999999999999,0.506,0,2004-02-04,49,26,23,0.531,49,31,18,0.633
20300706,1610612762,1610612741,79.0,95.0,0.375,0.532,0,2004-02-04,49,24,25,0.49,50,14,36,0.28
20300701,1610612751,1610612748,99.0,88.0,0.456,0.449,1,2004-02-04,47,27,20,0.574,50,21,29,0.42
20300695,1610612750,1610612753,113.0,100.0,0.55,0.422,1,2004-02-03,47,34,13,0.723,50,13,37,0.26
20300693,1610612752,1610612754,97.0,90.0,0.4379999999999999,0.413,1,2004-02-03,50,23,27,0.46,50,36,14,0.72
20300694,1610612765,1610612739,82.0,85.0,0.384,0.417,0,2004-02-03,50,33,17,0.66,48,19,29,0.396
20300696,1610612742,1610612744,107.0,93.0,0.489,0.5,1,2004-02-03,48,30,18,0.625,47,20,27,0.426
20300697,1610612758,1610612760,117.0,101.0,0.506,0.4679999999999999,1,2004-02-03,46,34,12,0.7390000000000001,47,23,24,0.489
20300692,1610612755,1610612761,80.0,93.0,0.373,0.434,0,2004-02-03,49,20,29,0.408,46,22,24,0.478
20300683,1610612754,1610612747,85.0,72.0,0.467,0.347,1,2004-02-02,49,36,13,0.735,45,28,17,0.622
20300685,1610612737,1610612746,95.0,101.0,0.4429999999999999,0.44,0,2004-02-02,49,15,34,0.306,46,21,25,0.457
20300690,1610612756,1610612745,99.0,79.0,0.4679999999999999,0.358,1,2004-02-02,50,18,32,0.36,47,26,21,0.5529999999999999
20300684,1610612748,1610612765,100.0,102.0,0.475,0.411,0,2004-02-02,49,21,28,0.429,49,33,16,0.6729999999999999
20300688,1610612743,1610612757,116.0,97.0,0.5329999999999999,0.444,1,2004-02-02,50,29,21,0.58,46,21,25,0.457
20300686,1610612740,1610612751,70.0,91.0,0.358,0.494,0,2004-02-02,48,26,22,0.542,46,26,20,0.565
20300689,1610612762,1610612759,65.0,83.0,0.362,0.431,0,2004-02-02,48,24,24,0.5,50,32,18,0.64
20300691,1610612760,1610612741,109.0,97.0,0.476,0.487,1,2004-02-02,46,23,23,0.5,49,13,36,0.265
20300687,1610612763,1610612744,106.0,101.0,0.506,0.457,1,2004-02-02,47,26,21,0.5529999999999999,46,20,26,0.435
20300682,1610612750,1610612755,106.0,101.0,0.494,0.41,1,2004-02-01,46,33,13,0.7170000000000001,48,20,28,0.417
20300680,1610612764,1610612739,100.0,104.0,0.43,0.514,0,2004-02-01,46,14,32,0.304,47,18,29,0.3829999999999999
20300681,1610612761,1610612747,83.0,84.0,0.3379999999999999,0.395,0,2004-02-01,45,21,24,0.467,44,28,16,0.636
20300677,1610612759,1610612762,85.0,81.0,0.364,0.429,1,2004-01-31,49,31,18,0.633,47,24,23,0.511
20300676,1610612754,1610612738,99.0,98.0,0.486,0.519,1,2004-01-31,48,35,13,0.7290000000000001,49,22,27,0.449
20300673,1610612752,1610612756,110.0,105.0,0.455,0.391,1,2004-01-31,49,22,27,0.449,49,17,32,0.347
20300672,1610612737,1610612749,93.0,83.0,0.455,0.368,1,2004-01-31,48,15,33,0.313,47,26,21,0.5529999999999999
20300674,1610612765,1610612763,80.0,78.0,0.43,0.397,1,2004-01-31,48,32,16,0.667,46,25,21,0.5429999999999999
20300670,1610612745,1610612751,77.0,88.0,0.4379999999999999,0.449,0,2004-01-31,46,26,20,0.565,45,25,20,0.556
20300669,1610612742,1610612743,102.0,107.0,0.483,0.5,0,2004-01-31,47,29,18,0.617,49,28,21,0.5710000000000001
20300678,1610612757,1610612741,102.0,95.0,0.488,0.424,1,2004-01-31,45,21,24,0.467,48,13,35,0.271
20300675,1610612740,1610612748,70.0,94.0,0.3289999999999999,0.471,0,2004-01-31,47,26,21,0.5529999999999999,48,21,27,0.4379999999999999
20300679,1610612760,1610612758,103.0,110.0,0.442,0.444,0,2004-01-31,45,22,23,0.489,45,33,12,0.733
20300671,1610612753,1610612746,106.0,115.0,0.5,0.5329999999999999,0,2004-01-31,49,13,36,0.265,45,20,25,0.444
20300667,1610612747,1610612750,84.0,97.0,0.392,0.479,0,2004-01-30,43,27,16,0.628,45,32,13,0.711
20300661,1610612764,1610612756,105.0,100.0,0.4320000000000001,0.436,1,2004-01-30,45,14,31,0.311,48,17,31,0.354
20300664,1610612748,1610612746,97.0,88.0,0.4270000000000001,0.452,1,2004-01-30,47,20,27,0.426,44,19,25,0.4320000000000001
20300663,1610612738,1610612752,74.0,92.0,0.317,0.43,0,2004-01-30,48,22,26,0.4579999999999999,48,21,27,0.4379999999999999
20300668,1610612744,1610612741,101.0,81.0,0.507,0.341,1,2004-01-30,45,20,25,0.444,47,13,34,0.2769999999999999
20300662,1610612761,1610612765,89.0,90.0,0.414,0.402,0,2004-01-30,44,21,23,0.477,47,31,16,0.66
20300666,1610612749,1610612739,101.0,95.0,0.471,0.396,1,2004-01-30,46,26,20,0.565,46,17,29,0.37
20300660,1610612755,1610612740,85.0,82.0,0.434,0.345,1,2004-01-30,47,20,27,0.426,46,26,20,0.565
20300665,1610612763,1610612762,79.0,85.0,0.431,0.42,0,2004-01-30,45,25,20,0.556,46,24,22,0.522
20300659,1610612759,1610612758,91.0,96.0,0.476,0.5,0,2004-01-29,48,30,18,0.625,44,32,12,0.727
20300658,1610612737,1610612757,85.0,93.0,0.45,0.444,0,2004-01-29,47,14,33,0.298,44,20,24,0.455
20300657,1610612753,1610612751,79.0,89.0,0.3939999999999999,0.471,0,2004-01-29,48,13,35,0.271,44,24,20,0.545
20300655,1610612747,1610612760,96.0,82.0,0.465,0.419,1,2004-01-28,42,27,15,0.643,44,22,22,0.5
20300648,1610612754,1610612756,101.0,79.0,0.4629999999999999,0.44,1,2004-01-28,47,34,13,0.723,47,17,30,0.362
20300646,1610612764,1610612753,100.0,104.0,0.42,0.524,0,2004-01-28,44,13,31,0.295,47,13,34,0.2769999999999999
20300647,1610612739,1610612748,94.0,93.0,0.474,0.487,1,2004-01-28,45,17,28,0.3779999999999999,46,19,27,0.413
20300652,1610612745,1610612758,94.0,99.0,0.475,0.4679999999999999,0,2004-01-28,45,26,19,0.578,43,31,12,0.721
20300645,1610612738,1610612765,103.0,106.0,0.4379999999999999,0.444,0,2004-01-28,47,22,25,0.4679999999999999,46,30,16,0.652
20300656,1610612744,1610612750,97.0,90.0,0.386,0.386,1,2004-01-28,44,19,25,0.4320000000000001,44,31,13,0.705
20300653,1610612743,1610612741,115.0,99.0,0.494,0.4629999999999999,1,2004-01-28,48,27,21,0.563,46,13,33,0.283
20300649,1610612761,1610612755,94.0,84.0,0.5,0.385,1,2004-01-28,43,21,22,0.488,46,19,27,0.413
20300650,1610612740,1610612749,101.0,100.0,0.461,0.417,1,2004-01-28,45,26,19,0.578,45,25,20,0.556
20300654,1610612762,1610612742,91.0,88.0,0.486,0.466,1,2004-01-28,45,23,22,0.511,46,29,17,0.63
20300651,1610612763,1610612757,76.0,88.0,0.321,0.4,0,2004-01-28,44,25,19,0.568,43,19,24,0.442
20300644,1610612746,1610612741,102.0,92.0,0.5329999999999999,0.4429999999999999,1,2004-01-27,43,19,24,0.442,45,13,32,0.289
20300641,1610612752,1610612759,67.0,77.0,0.36,0.38,0,2004-01-27,47,20,27,0.426,47,30,17,0.638
20300642,1610612737,1610612756,85.0,89.0,0.411,0.408,0,2004-01-27,46,14,32,0.304,46,17,29,0.37
20300643,1610612760,1610612742,116.0,118.0,0.544,0.483,0,2004-01-27,43,22,21,0.512,45,29,16,0.644
20300640,1610612755,1610612751,76.0,94.0,0.349,0.413,0,2004-01-27,45,19,26,0.422,43,23,20,0.535
20300634,1610612764,1610612757,83.0,94.0,0.402,0.521,0,2004-01-26,43,13,30,0.302,42,18,24,0.429
20300635,1610612739,1610612753,99.0,98.0,0.3829999999999999,0.449,1,2004-01-26,44,16,28,0.364,46,12,34,0.261
20300636,1610612748,1610612745,95.0,81.0,0.514,0.371,1,2004-01-26,45,19,26,0.422,44,26,18,0.591
20300638,1610612743,1610612750,95.0,97.0,0.465,0.419,0,2004-01-26,47,26,21,0.5529999999999999,43,31,12,0.721
20300637,1610612749,1610612759,93.0,92.0,0.436,0.467,1,2004-01-26,44,25,19,0.568,46,29,17,0.63
20300639,1610612762,1610612746,98.0,93.0,0.4379999999999999,0.493,1,2004-01-26,44,22,22,0.5,42,18,24,0.429
20300630,1610612750,1610612756,99.0,95.0,0.439,0.424,1,2004-01-25,42,30,12,0.7140000000000001,45,16,29,0.356
20300632,1610612765,1610612737,82.0,91.0,0.429,0.467,0,2004-01-25,45,29,16,0.644,45,14,31,0.311
20300628,1610612742,1610612758,108.0,99.0,0.4679999999999999,0.417,1,2004-01-25,44,28,16,0.636,42,30,12,0.7140000000000001
20300629,1610612741,1610612761,96.0,89.0,0.522,0.351,1,2004-01-25,44,13,31,0.295,42,20,22,0.476
20300627,1610612751,1610612738,110.0,91.0,0.5,0.356,1,2004-01-25,42,22,20,0.524,46,22,24,0.478
20300631,1610612753,1610612745,87.0,99.0,0.382,0.494,0,2004-01-25,45,12,33,0.267,43,26,17,0.605
20300633,1610612763,1610612743,106.0,88.0,0.5539999999999999,0.4429999999999999,1,2004-01-25,43,25,18,0.581,46,26,20,0.565
20300624,1610612759,1610612740,96.0,98.0,0.493,0.452,0,2004-01-24,45,29,16,0.644,44,25,19,0.568
20300621,1610612764,1610612754,107.0,96.0,0.5,0.462,1,2004-01-24,42,13,29,0.31,46,33,13,0.7170000000000001
20300622,1610612752,1610612748,77.0,85.0,0.413,0.46,0,2004-01-24,46,20,26,0.435,44,18,26,0.409
20300623,1610612739,1610612755,95.0,87.0,0.4320000000000001,0.471,1,2004-01-24,43,15,28,0.349,44,19,25,0.4320000000000001
20300620,1610612757,1610612744,87.0,105.0,0.475,0.5,0,2004-01-24,41,17,24,0.415,43,18,25,0.419
20300625,1610612762,1610612747,86.0,93.0,0.507,0.467,0,2004-01-24,43,21,22,0.488,41,26,15,0.634
20300626,1610612760,1610612746,102.0,97.0,0.506,0.42,1,2004-01-24,42,22,20,0.524,41,18,23,0.439
20300619,1610612746,1610612762,93.0,82.0,0.475,0.384,1,2004-01-23,40,18,22,0.45,42,21,21,0.5
20300613,1610612754,1610612745,74.0,78.0,0.368,0.4029999999999999,0,2004-01-23,45,33,12,0.733,42,25,17,0.595
20300614,1610612750,1610612765,80.0,79.0,0.365,0.375,1,2004-01-23,41,29,12,0.7070000000000001,44,29,15,0.659
20300611,1610612737,1610612752,94.0,96.0,0.456,0.524,0,2004-01-23,44,13,31,0.295,45,20,25,0.444
20300618,1610612756,1610612759,84.0,86.0,0.456,0.402,0,2004-01-23,44,16,28,0.364,44,29,15,0.659
20300610,1610612748,1610612751,85.0,64.0,0.4379999999999999,0.288,1,2004-01-23,43,17,26,0.395,41,21,20,0.512
20300609,1610612738,1610612764,100.0,89.0,0.407,0.425,1,2004-01-23,45,22,23,0.489,41,12,29,0.293
20300616,1610612741,1610612742,93.0,106.0,0.471,0.488,0,2004-01-23,43,12,31,0.2789999999999999,43,27,16,0.628
20300617,1610612749,1610612761,98.0,86.0,0.545,0.4379999999999999,1,2004-01-23,43,24,19,0.5579999999999999,41,20,21,0.488
20300612,1610612740,1610612743,97.0,91.0,0.514,0.439,1,2004-01-23,43,24,19,0.5579999999999999,45,26,19,0.578
20300608,1610612755,1610612753,93.0,98.0,0.444,0.4320000000000001,0,2004-01-23,43,19,24,0.442,44,12,32,0.273
20300615,1610612763,1610612758,109.0,95.0,0.513,0.385,1,2004-01-23,42,24,18,0.5710000000000001,41,30,11,0.732
20300605,1610612739,1610612758,89.0,95.0,0.3879999999999999,0.45,0,2004-01-22,42,14,28,0.3329999999999999,40,30,10,0.75
20300606,1610612742,1610612747,106.0,87.0,0.488,0.4029999999999999,1,2004-01-22,42,26,16,0.619,40,25,15,0.625
20300607,1610612760,1610612744,103.0,87.0,0.47,0.359,1,2004-01-22,41,21,20,0.512,42,17,25,0.405
20300604,1610612746,1610612744,106.0,102.0,0.411,0.429,1,2004-01-21,39,17,22,0.436,41,17,24,0.415
20300601,1610612759,1610612751,99.0,76.0,0.481,0.3720000000000001,1,2004-01-21,43,28,15,0.6509999999999999,40,21,19,0.525
20300597,1610612737,1610612741,97.0,87.0,0.5,0.4320000000000001,1,2004-01-21,43,13,30,0.302,42,12,30,0.286
20300602,1610612745,1610612752,86.0,71.0,0.487,0.397,1,2004-01-21,41,24,17,0.585,44,19,25,0.4320000000000001
20300603,1610612743,1610612756,97.0,92.0,0.507,0.442,1,2004-01-21,44,26,18,0.591,43,16,27,0.3720000000000001
20300596,1610612761,1610612750,97.0,108.0,0.446,0.562,0,2004-01-21,40,20,20,0.5,40,28,12,0.7
20300599,1610612749,1610612753,113.0,102.0,0.56,0.488,1,2004-01-21,42,23,19,0.5479999999999999,43,11,32,0.256
20300598,1610612740,1610612755,86.0,92.0,0.376,0.486,0,2004-01-21,42,23,19,0.5479999999999999,42,19,23,0.452
20300600,1610612763,1610612747,88.0,82.0,0.474,0.349,1,2004-01-21,41,23,18,0.561,39,25,14,0.6409999999999999
20300591,1610612754,1610612765,81.0,69.0,0.3779999999999999,0.391,1,2004-01-20,44,33,11,0.75,43,29,14,0.674
20300590,1610612739,1610612760,99.0,94.0,0.341,0.416,1,2004-01-20,41,14,27,0.341,40,20,20,0.5
20300592,1610612748,1610612738,84.0,86.0,0.418,0.417,0,2004-01-20,42,16,26,0.381,44,21,23,0.477
20300593,1610612742,1610612751,106.0,93.0,0.46,0.488,1,2004-01-20,41,25,16,0.61,39,21,18,0.5379999999999999
20300595,1610612758,1610612757,104.0,109.0,0.3289999999999999,0.488,0,2004-01-20,39,29,10,0.7440000000000001,40,17,23,0.425
20300594,1610612762,1610612743,75.0,96.0,0.357,0.507,0,2004-01-20,41,21,20,0.512,43,25,18,0.581
20300585,1610612746,1610612758,100.0,125.0,0.465,0.563,0,2004-01-19,38,16,22,0.421,38,29,9,0.763
20300589,1610612747,1610612756,85.0,88.0,0.3829999999999999,0.442,0,2004-01-19,38,25,13,0.6579999999999999,42,16,26,0.381
20300586,1610612750,1610612740,97.0,90.0,0.513,0.478,1,2004-01-19,39,27,12,0.6920000000000001,41,23,18,0.561
20300580,1610612764,1610612741,93.0,83.0,0.382,0.425,1,2004-01-19,40,12,28,0.3,41,12,29,0.293
20300579,1610612752,1610612761,90.0,79.0,0.4679999999999999,0.408,1,2004-01-19,43,19,24,0.442,39,20,19,0.513
20300582,1610612737,1610612754,97.0,100.0,0.508,0.455,0,2004-01-19,42,12,30,0.286,43,32,11,0.7440000000000001
20300584,1610612765,1610612759,85.0,77.0,0.411,0.4320000000000001,1,2004-01-19,42,29,13,0.69,42,27,15,0.643
20300588,1610612744,1610612762,101.0,85.0,0.513,0.456,1,2004-01-19,40,17,23,0.425,40,21,19,0.525
20300581,1610612755,1610612760,81.0,90.0,0.392,0.402,0,2004-01-19,41,18,23,0.439,39,20,19,0.513
20300583,1610612753,1610612749,106.0,99.0,0.5,0.412,1,2004-01-19,42,11,31,0.262,41,22,19,0.537
20300587,1610612763,1610612745,88.0,83.0,0.429,0.429,1,2004-01-19,40,22,18,0.55,40,23,17,0.575
20300577,1610612756,1610612757,96.0,92.0,0.429,0.43,1,2004-01-18,41,15,26,0.366,39,16,23,0.41
20300576,1610612738,1610612759,92.0,109.0,0.418,0.53,0,2004-01-18,43,20,23,0.465,41,27,14,0.659
20300578,1610612743,1610612748,88.0,80.0,0.516,0.3829999999999999,1,2004-01-18,42,24,18,0.5710000000000001,41,16,25,0.39
20300575,1610612747,1610612746,91.0,89.0,0.44,0.376,1,2004-01-17,37,25,12,0.6759999999999999,37,16,21,0.4320000000000001
20300567,1610612764,1610612760,99.0,84.0,0.513,0.3929999999999999,1,2004-01-17,39,11,28,0.282,38,19,19,0.5
20300568,1610612737,1610612761,75.0,70.0,0.389,0.365,1,2004-01-17,41,12,29,0.293,38,20,18,0.526
20300566,1610612745,1610612750,95.0,76.0,0.486,0.3670000000000001,1,2004-01-17,39,23,16,0.59,38,26,12,0.684
20300571,1610612741,1610612752,96.0,101.0,0.469,0.386,0,2004-01-17,40,12,28,0.3,42,18,24,0.429
20300574,1610612757,1610612742,104.0,108.0,0.514,0.471,0,2004-01-17,38,16,22,0.421,40,24,16,0.6
20300572,1610612749,1610612765,94.0,99.0,0.447,0.514,0,2004-01-17,40,22,18,0.55,41,28,13,0.6829999999999999
20300570,1610612740,1610612753,91.0,90.0,0.442,0.514,1,2004-01-17,40,23,17,0.575,41,10,31,0.244
20300573,1610612762,1610612739,96.0,102.0,0.405,0.3879999999999999,0,2004-01-17,39,21,18,0.5379999999999999,40,13,27,0.325
20300569,1610612751,1610612754,84.0,90.0,0.395,0.405,0,2004-01-17,38,21,17,0.5529999999999999,42,31,11,0.738
20300565,1610612755,1610612763,87.0,91.0,0.413,0.4320000000000001,0,2004-01-17,40,18,22,0.45,39,21,18,0.5379999999999999
20300563,1610612746,1610612748,85.0,87.0,0.431,0.3720000000000001,0,2004-01-16,36,16,20,0.444,40,16,24,0.4
20300558,1610612754,1610612759,89.0,79.0,0.418,0.359,1,2004-01-16,41,30,11,0.732,40,26,14,0.65
20300559,1610612752,1610612760,108.0,88.0,0.524,0.363,1,2004-01-16,41,17,24,0.415,37,19,18,0.514
20300560,1610612765,1610612764,98.0,77.0,0.519,0.385,1,2004-01-16,40,27,13,0.675,38,10,28,0.263
20300562,1610612756,1610612744,104.0,93.0,0.563,0.405,1,2004-01-16,40,14,26,0.35,39,16,23,0.41
20300561,1610612743,1610612742,88.0,91.0,0.392,0.418,0,2004-01-16,41,23,18,0.561,39,23,16,0.59
20300564,1610612758,1610612747,103.0,83.0,0.5489999999999999,0.412,1,2004-01-16,37,28,9,0.757,36,24,12,0.667
20300557,1610612753,1610612738,124.0,118.0,0.489,0.537,1,2004-01-16,40,10,30,0.25,42,20,22,0.476
20300555,1610612757,1610612756,96.0,105.0,0.474,0.55,0,2004-01-15,37,16,21,0.4320000000000001,39,13,26,0.3329999999999999
20300556,1610612744,1610612739,119.0,102.0,0.524,0.424,1,2004-01-15,38,16,22,0.421,39,12,27,0.308
20300552,1610612749,1610612751,86.0,83.0,0.4,0.405,1,2004-01-15,39,22,17,0.564,37,21,16,0.568
20300551,1610612740,1610612761,74.0,78.0,0.354,0.4,0,2004-01-15,39,22,17,0.564,37,20,17,0.541
20300554,1610612762,1610612748,97.0,85.0,0.508,0.4,1,2004-01-15,38,21,17,0.5529999999999999,39,15,24,0.385
20300553,1610612763,1610612741,108.0,93.0,0.417,0.4270000000000001,1,2004-01-15,38,20,18,0.526,39,12,27,0.308
20300550,1610612747,1610612743,97.0,71.0,0.507,0.359,1,2004-01-14,35,24,11,0.6859999999999999,40,23,17,0.575
20300548,1610612759,1610612750,93.0,100.0,0.425,0.506,0,2004-01-14,39,26,13,0.667,37,26,11,0.703
20300544,1610612754,1610612737,85.0,78.0,0.3379999999999999,0.395,1,2004-01-14,40,29,11,0.725,40,11,29,0.275
20300545,1610612752,1610612753,120.0,110.0,0.6,0.471,1,2004-01-14,40,16,24,0.4,39,9,30,0.231
20300547,1610612765,1610612761,95.0,91.0,0.38,0.41,1,2004-01-14,39,26,13,0.667,36,19,17,0.528
20300543,1610612738,1610612745,80.0,95.0,0.36,0.5,0,2004-01-14,41,20,21,0.488,38,22,16,0.579
20300549,1610612742,1610612755,125.0,122.0,0.425,0.469,1,2004-01-14,38,22,16,0.579,39,18,21,0.462
20300546,1610612751,1610612764,115.0,103.0,0.511,0.4629999999999999,1,2004-01-14,36,21,15,0.583,37,10,27,0.27
20300542,1610612746,1610612757,103.0,96.0,0.4379999999999999,0.451,1,2004-01-13,35,16,19,0.457,36,16,20,0.444
20300533,1610612764,1610612745,80.0,93.0,0.392,0.515,0,2004-01-13,36,10,26,0.278,37,21,16,0.568
20300534,1610612737,1610612759,86.0,77.0,0.449,0.3289999999999999,1,2004-01-13,39,11,28,0.282,38,26,12,0.684
20300539,1610612756,1610612743,92.0,105.0,0.488,0.519,0,2004-01-13,38,12,26,0.316,39,23,16,0.59
20300537,1610612741,1610612765,89.0,105.0,0.4370000000000001,0.43,0,2004-01-13,38,12,26,0.316,38,25,13,0.6579999999999999
20300540,1610612758,1610612748,90.0,86.0,0.485,0.4429999999999999,1,2004-01-13,36,27,9,0.75,38,15,23,0.395
20300536,1610612749,1610612738,111.0,103.0,0.486,0.465,1,2004-01-13,38,21,17,0.5529999999999999,40,20,20,0.5
20300535,1610612740,1610612750,89.0,94.0,0.471,0.429,0,2004-01-13,38,22,16,0.579,36,25,11,0.6940000000000001
20300538,1610612762,1610612744,97.0,80.0,0.48,0.3829999999999999,1,2004-01-13,37,20,17,0.541,37,15,22,0.405
20300541,1610612760,1610612739,96.0,104.0,0.3979999999999999,0.461,0,2004-01-13,36,19,17,0.528,38,12,26,0.316
20300531,1610612747,1610612739,89.0,79.0,0.363,0.3329999999999999,1,2004-01-12,34,23,11,0.6759999999999999,37,11,26,0.297
20300529,1610612752,1610612742,121.0,127.0,0.516,0.495,0,2004-01-12,39,15,24,0.385,37,21,16,0.568
20300532,1610612744,1610612763,113.0,115.0,0.4270000000000001,0.46,0,2004-01-12,36,15,21,0.417,37,19,18,0.514
20300530,1610612753,1610612755,82.0,87.0,0.36,0.413,0,2004-01-12,38,9,29,0.237,38,18,20,0.474
20300528,1610612746,1610612763,107.0,108.0,0.471,0.532,0,2004-01-11,34,15,19,0.441,36,18,18,0.5
20300525,1610612765,1610612742,115.0,102.0,0.513,0.482,1,2004-01-11,37,24,13,0.649,36,20,16,0.556
20300526,1610612745,1610612738,93.0,97.0,0.4379999999999999,0.471,0,2004-01-11,36,20,16,0.556,39,20,19,0.513
20300527,1610612758,1610612743,117.0,106.0,0.544,0.512,1,2004-01-11,35,26,9,0.743,38,22,16,0.579
20300524,1610612761,1610612757,83.0,72.0,0.474,0.325,1,2004-01-11,35,19,16,0.5429999999999999,35,16,19,0.457
20300521,1610612759,1610612754,89.0,88.0,0.413,0.409,1,2004-01-10,37,26,11,0.703,39,28,11,0.718
20300519,1610612750,1610612748,83.0,77.0,0.413,0.395,1,2004-01-10,35,24,11,0.6859999999999999,37,15,22,0.405
20300517,1610612764,1610612755,94.0,87.0,0.4529999999999999,0.425,1,2004-01-10,35,10,25,0.286,37,17,20,0.4589999999999999
20300518,1610612752,1610612749,94.0,88.0,0.451,0.4,1,2004-01-10,38,15,23,0.395,37,20,17,0.541
20300520,1610612741,1610612740,89.0,84.0,0.381,0.352,1,2004-01-10,37,12,25,0.324,37,22,15,0.595
20300523,1610612744,1610612760,113.0,110.0,0.456,0.436,1,2004-01-10,35,15,20,0.429,35,19,16,0.5429999999999999
20300522,1610612762,1610612737,92.0,71.0,0.471,0.3939999999999999,1,2004-01-10,36,19,17,0.528,38,10,28,0.263
20300515,1610612747,1610612737,113.0,67.0,0.511,0.4,1,2004-01-09,33,22,11,0.667,37,10,27,0.27
20300514,1610612756,1610612758,93.0,113.0,0.4320000000000001,0.494,0,2004-01-09,37,12,25,0.324,34,25,9,0.735
20300508,1610612738,1610612739,107.0,82.0,0.462,0.3329999999999999,1,2004-01-09,38,19,19,0.5,36,11,25,0.306
20300510,1610612742,1610612754,80.0,92.0,0.368,0.4379999999999999,0,2004-01-09,35,20,15,0.5710000000000001,38,28,10,0.737
20300511,1610612741,1610612757,78.0,87.0,0.322,0.4370000000000001,0,2004-01-09,36,11,25,0.306,34,16,18,0.471
20300513,1610612743,1610612762,106.0,96.0,0.526,0.41,1,2004-01-09,37,22,15,0.595,35,18,17,0.514
20300507,1610612761,1610612746,68.0,78.0,0.414,0.4479999999999999,0,2004-01-09,34,18,16,0.529,33,15,18,0.455
20300512,1610612749,1610612748,103.0,94.0,0.494,0.376,1,2004-01-09,36,20,16,0.556,36,15,21,0.417
20300509,1610612740,1610612759,84.0,94.0,0.32,0.515,0,2004-01-09,36,22,14,0.611,36,25,11,0.6940000000000001
20300516,1610612760,1610612763,122.0,116.0,0.5710000000000001,0.473,1,2004-01-09,34,19,15,0.5589999999999999,35,17,18,0.486
20300506,1610612753,1610612764,103.0,92.0,0.4320000000000001,0.418,1,2004-01-09,37,9,28,0.243,34,9,25,0.265
20300505,1610612755,1610612751,97.0,81.0,0.534,0.38,1,2004-01-09,36,17,19,0.472,35,20,15,0.5710000000000001
20300504,1610612750,1610612757,96.0,75.0,0.488,0.41,1,2004-01-08,34,23,11,0.6759999999999999,33,15,18,0.455
20300503,1610612752,1610612745,79.0,111.0,0.3329999999999999,0.493,0,2004-01-08,37,14,23,0.3779999999999999,35,20,15,0.5710000000000001
20300496,1610612765,1610612745,85.0,66.0,0.397,0.3329999999999999,1,2004-01-07,36,23,13,0.639,34,19,15,0.5589999999999999
20300495,1610612748,1610612741,102.0,95.0,0.5429999999999999,0.475,1,2004-01-07,35,15,20,0.429,35,11,24,0.314
20300492,1610612738,1610612753,101.0,93.0,0.5,0.392,1,2004-01-07,37,18,19,0.486,36,8,28,0.222
20300499,1610612742,1610612744,105.0,99.0,0.466,0.449,1,2004-01-07,34,20,14,0.588,34,14,20,0.412
20300500,1610612743,1610612747,113.0,91.0,0.495,0.386,1,2004-01-07,36,21,15,0.583,32,21,11,0.6559999999999999
20300498,1610612749,1610612756,95.0,87.0,0.435,0.4379999999999999,1,2004-01-07,35,19,16,0.5429999999999999,36,12,24,0.3329999999999999
20300494,1610612761,1610612739,75.0,69.0,0.37,0.357,1,2004-01-07,33,18,15,0.545,35,11,24,0.314
20300497,1610612740,1610612764,97.0,87.0,0.456,0.386,1,2004-01-07,35,22,13,0.629,33,9,24,0.273
20300502,1610612760,1610612758,104.0,93.0,0.44,0.376,1,2004-01-07,33,18,15,0.545,33,24,9,0.727
20300493,1610612755,1610612746,100.0,80.0,0.506,0.386,1,2004-01-07,35,16,19,0.457,32,14,18,0.4379999999999999
20300489,1610612759,1610612764,94.0,72.0,0.5,0.3289999999999999,1,2004-01-06,35,24,11,0.6859999999999999,32,9,23,0.281
20300486,1610612754,1610612753,114.0,107.0,0.506,0.5,1,2004-01-06,37,27,10,0.73,35,8,27,0.2289999999999999
20300488,1610612750,1610612747,106.0,90.0,0.544,0.4,1,2004-01-06,33,22,11,0.667,31,21,10,0.677
20300485,1610612739,1610612752,107.0,96.0,0.476,0.412,1,2004-01-06,34,11,23,0.324,36,14,22,0.389
20300490,1610612758,1610612737,105.0,89.0,0.482,0.474,1,2004-01-06,32,24,8,0.75,36,10,26,0.278
20300487,1610612751,1610612746,92.0,75.0,0.417,0.368,1,2004-01-06,34,20,14,0.588,31,14,17,0.452
20300479,1610612748,1610612754,65.0,87.0,0.3329999999999999,0.406,0,2004-01-05,34,14,20,0.412,36,26,10,0.722
20300477,1610612738,1610612765,68.0,78.0,0.293,0.41,0,2004-01-05,36,17,19,0.472,35,22,13,0.629
20300481,1610612745,1610612744,83.0,65.0,0.467,0.3329999999999999,1,2004-01-05,33,19,14,0.5760000000000001,33,14,19,0.424
20300480,1610612741,1610612756,87.0,82.0,0.375,0.407,1,2004-01-05,34,11,23,0.324,35,12,23,0.3429999999999999
20300482,1610612743,1610612759,74.0,98.0,0.368,0.526,0,2004-01-05,35,20,15,0.5710000000000001,34,23,11,0.6759999999999999
20300483,1610612762,1610612742,108.0,94.0,0.47,0.402,1,2004-01-05,34,18,16,0.529,33,19,14,0.5760000000000001
20300484,1610612760,1610612757,119.0,108.0,0.536,0.495,1,2004-01-05,32,17,15,0.531,32,15,17,0.469
20300478,1610612755,1610612749,76.0,88.0,0.361,0.39,0,2004-01-05,34,15,19,0.441,34,18,16,0.529
20300476,1610612746,1610612747,101.0,98.0,0.486,0.3879999999999999,1,2004-01-04,30,14,16,0.467,30,21,9,0.7
20300473,1610612764,1610612749,94.0,100.0,0.4429999999999999,0.4529999999999999,0,2004-01-04,31,9,22,0.29,33,17,16,0.515
20300474,1610612752,1610612751,85.0,95.0,0.42,0.425,0,2004-01-04,35,14,21,0.4,33,19,14,0.5760000000000001
20300475,1610612758,1610612760,130.0,99.0,0.584,0.424,1,2004-01-04,31,23,8,0.742,31,16,15,0.516
20300472,1610612761,1610612756,83.0,73.0,0.384,0.365,1,2004-01-04,32,17,15,0.531,34,12,22,0.353
20300464,1610612746,1610612758,109.0,116.0,0.467,0.551,0,2004-01-03,29,13,16,0.4479999999999999,30,22,8,0.733
20300463,1610612759,1610612755,77.0,83.0,0.3879999999999999,0.42,0,2004-01-03,33,22,11,0.667,33,15,18,0.455
20300466,1610612754,1610612740,91.0,84.0,0.4,0.3779999999999999,1,2004-01-03,35,25,10,0.7140000000000001,34,21,13,0.618
20300465,1610612765,1610612744,99.0,93.0,0.506,0.4529999999999999,1,2004-01-03,34,21,13,0.618,32,14,18,0.4379999999999999
20300470,1610612745,1610612762,84.0,63.0,0.4579999999999999,0.353,1,2004-01-03,32,18,14,0.563,33,17,16,0.515
20300469,1610612742,1610612750,119.0,112.0,0.512,0.473,1,2004-01-03,32,19,13,0.594,32,21,11,0.6559999999999999
20300468,1610612741,1610612738,77.0,88.0,0.3329999999999999,0.368,0,2004-01-03,33,10,23,0.303,35,17,18,0.486
20300471,1610612743,1610612737,76.0,84.0,0.385,0.42,0,2004-01-03,34,20,14,0.588,35,10,25,0.286
20300467,1610612763,1610612753,112.0,103.0,0.517,0.474,1,2004-01-03,34,17,17,0.5,34,8,26,0.235
20300458,1610612750,1610612737,93.0,75.0,0.409,0.3720000000000001,1,2004-01-02,31,21,10,0.677,34,9,25,0.265
20300451,1610612764,1610612744,97.0,79.0,0.446,0.4029999999999999,1,2004-01-02,30,9,21,0.3,31,14,17,0.452
20300454,1610612752,1610612741,99.0,104.0,0.47,0.488,0,2004-01-02,34,14,20,0.412,32,10,22,0.313
20300457,1610612765,1610612756,93.0,81.0,0.389,0.395,1,2004-01-02,33,20,13,0.606,33,12,21,0.364
20300456,1610612748,1610612753,112.0,101.0,0.466,0.43,1,2004-01-02,33,14,19,0.424,33,8,25,0.242
20300453,1610612738,1610612754,90.0,103.0,0.507,0.4370000000000001,0,2004-01-02,34,16,18,0.471,34,24,10,0.706
20300461,1610612757,1610612743,96.0,106.0,0.486,0.513,0,2004-01-02,31,15,16,0.484,33,20,13,0.606
20300452,1610612761,1610612740,74.0,86.0,0.377,0.422,0,2004-01-02,31,16,15,0.516,33,21,12,0.636
20300460,1610612749,1610612742,109.0,101.0,0.462,0.476,1,2004-01-02,32,16,16,0.5,31,18,13,0.581
20300462,1610612760,1610612747,111.0,109.0,0.477,0.483,1,2004-01-02,30,16,14,0.5329999999999999,29,21,8,0.7240000000000001
20300455,1610612751,1610612739,97.0,82.0,0.481,0.415,1,2004-01-02,32,18,14,0.563,33,10,23,0.303
20300459,1610612763,1610612762,100.0,88.0,0.4479999999999999,0.461,1,2004-01-02,33,16,17,0.485,32,17,15,0.531
20300449,1610612746,1610612743,120.0,104.0,0.517,0.494,1,2003-12-31,28,13,15,0.4639999999999999,32,19,13,0.594
20300447,1610612765,1610612757,78.0,71.0,0.416,0.4,1,2003-12-31,32,19,13,0.594,30,15,15,0.5
20300446,1610612738,1610612740,94.0,96.0,0.456,0.418,0,2003-12-31,33,16,17,0.485,32,20,12,0.625
20300450,1610612745,1610612755,80.0,72.0,0.4029999999999999,0.347,1,2003-12-31,31,17,14,0.5479999999999999,32,14,18,0.4379999999999999
20300448,1610612751,1610612744,88.0,70.0,0.436,0.4,1,2003-12-31,31,17,14,0.5479999999999999,30,14,16,0.467
20300442,1610612750,1610612741,98.0,93.0,0.506,0.389,1,2003-12-30,30,20,10,0.667,31,9,22,0.29
20300439,1610612764,1610612737,73.0,83.0,0.342,0.4370000000000001,0,2003-12-30,29,8,21,0.276,33,9,24,0.273
20300441,1610612752,1610612748,102.0,73.0,0.5539999999999999,0.349,1,2003-12-30,33,14,19,0.424,32,13,19,0.406
20300440,1610612739,1610612754,89.0,92.0,0.521,0.3879999999999999,0,2003-12-30,32,10,22,0.313,33,23,10,0.6970000000000001
20300444,1610612742,1610612749,101.0,92.0,0.471,0.4320000000000001,1,2003-12-30,30,18,12,0.6,31,15,16,0.484
20300445,1610612743,1610612761,74.0,81.0,0.382,0.451,0,2003-12-30,31,19,12,0.613,30,16,14,0.5329999999999999
20300443,1610612763,1610612760,99.0,105.0,0.43,0.47,0,2003-12-30,32,15,17,0.469,29,15,14,0.517
20300437,1610612746,1610612756,105.0,113.0,0.446,0.529,0,2003-12-29,27,12,15,0.444,32,12,20,0.375
20300431,1610612754,1610612763,94.0,86.0,0.472,0.413,1,2003-12-29,32,22,10,0.688,31,15,16,0.484
20300433,1610612765,1610612740,108.0,99.0,0.545,0.4629999999999999,1,2003-12-29,31,18,13,0.581,31,19,12,0.613
20300435,1610612745,1610612760,86.0,87.0,0.429,0.354,0,2003-12-29,30,16,14,0.5329999999999999,28,14,14,0.5
20300434,1610612741,1610612748,83.0,90.0,0.395,0.423,0,2003-12-29,30,9,21,0.3,31,13,18,0.419
20300438,1610612744,1610612738,91.0,100.0,0.439,0.4629999999999999,0,2003-12-29,29,14,15,0.483,32,16,16,0.5
20300436,1610612762,1610612755,106.0,97.0,0.556,0.471,1,2003-12-29,31,17,14,0.5479999999999999,31,14,17,0.452
20300432,1610612751,1610612757,87.0,91.0,0.446,0.513,0,2003-12-29,30,16,14,0.5329999999999999,29,15,14,0.517
20300430,1610612753,1610612752,86.0,114.0,0.337,0.55,0,2003-12-29,32,8,24,0.25,32,13,19,0.406
20300423,1610612746,1610612761,88.0,94.0,0.395,0.462,0,2003-12-28,26,12,14,0.462,29,15,14,0.517
20300429,1610612747,1610612738,105.0,82.0,0.43,0.417,1,2003-12-28,28,21,7,0.75,31,15,16,0.484
20300425,1610612759,1610612749,89.0,74.0,0.429,0.357,1,2003-12-28,32,22,10,0.688,30,15,15,0.5
20300426,1610612756,1610612755,100.0,92.0,0.416,0.434,1,2003-12-28,31,11,20,0.355,30,14,16,0.467
20300424,1610612739,1610612757,86.0,74.0,0.5,0.346,1,2003-12-28,31,10,21,0.3229999999999999,28,14,14,0.5
20300428,1610612758,1610612762,98.0,89.0,0.4,0.412,1,2003-12-28,29,21,8,0.7240000000000001,30,16,14,0.5329999999999999
20300427,1610612743,1610612744,103.0,79.0,0.467,0.3779999999999999,1,2003-12-28,30,19,11,0.633,28,14,14,0.5
20300419,1610612754,1610612751,75.0,82.0,0.364,0.423,0,2003-12-27,31,21,10,0.677,29,16,13,0.552
20300417,1610612737,1610612765,84.0,87.0,0.452,0.429,0,2003-12-27,32,8,24,0.25,30,17,13,0.5670000000000001
20300418,1610612748,1610612752,80.0,100.0,0.359,0.513,0,2003-12-27,30,12,18,0.4,31,12,19,0.387
20300421,1610612742,1610612763,104.0,98.0,0.465,0.451,1,2003-12-27,29,17,12,0.586,30,15,15,0.5
20300420,1610612741,1610612764,100.0,86.0,0.406,0.4270000000000001,1,2003-12-27,29,9,20,0.31,28,8,20,0.286
20300422,1610612760,1610612750,86.0,104.0,0.365,0.524,0,2003-12-27,27,13,14,0.481,29,19,10,0.655
20300414,1610612746,1610612755,101.0,98.0,0.487,0.4679999999999999,1,2003-12-26,25,12,13,0.48,29,14,15,0.483
20300410,1610612759,1610612753,98.0,83.0,0.482,0.43,1,2003-12-26,31,21,10,0.677,31,8,23,0.258
20300404,1610612764,1610612748,84.0,92.0,0.4,0.493,0,2003-12-26,27,8,19,0.296,29,12,17,0.414
20300413,1610612756,1610612738,102.0,104.0,0.419,0.515,0,2003-12-26,30,10,20,0.3329999999999999,30,15,15,0.5
20300407,1610612765,1610612751,79.0,82.0,0.3779999999999999,0.3879999999999999,0,2003-12-26,29,16,13,0.552,28,15,13,0.536
20300405,1610612739,1610612741,80.0,87.0,0.417,0.407,0,2003-12-26,30,9,21,0.3,28,8,20,0.286
20300415,1610612744,1610612758,98.0,91.0,0.41,0.42,1,2003-12-26,27,14,13,0.519,28,20,8,0.7140000000000001
20300416,1610612757,1610612750,101.0,92.0,0.481,0.46,1,2003-12-26,27,14,13,0.519,28,18,10,0.643
20300411,1610612743,1610612745,95.0,94.0,0.414,0.493,1,2003-12-26,29,18,11,0.621,29,16,13,0.552
20300409,1610612749,1610612754,101.0,96.0,0.545,0.5,1,2003-12-26,29,15,14,0.517,30,21,9,0.7
20300406,1610612740,1610612737,109.0,79.0,0.506,0.451,1,2003-12-26,30,19,11,0.633,31,8,23,0.258
20300412,1610612762,1610612761,97.0,94.0,0.439,0.449,1,2003-12-26,29,16,13,0.552,28,14,14,0.5
20300408,1610612763,1610612752,94.0,98.0,0.366,0.521,0,2003-12-26,29,15,14,0.517,30,11,19,0.3670000000000001
20300403,1610612747,1610612745,87.0,99.0,0.376,0.444,0,2003-12-25,27,20,7,0.741,28,16,12,0.5710000000000001
20300402,1610612758,1610612742,103.0,111.0,0.435,0.435,0,2003-12-25,27,20,7,0.741,28,16,12,0.5710000000000001
20300401,1610612753,1610612739,113.0,101.0,0.475,0.494,1,2003-12-25,30,8,22,0.267,29,9,20,0.31
20300396,1610612759,1610612746,111.0,90.0,0.56,0.462,1,2003-12-23,30,20,10,0.667,24,11,13,0.4579999999999999
20300390,1610612752,1610612750,92.0,98.0,0.4,0.473,0,2003-12-23,29,10,19,0.345,27,18,9,0.667
20300393,1610612737,1610612738,93.0,88.0,0.467,0.39,1,2003-12-23,30,8,22,0.267,29,14,15,0.483
20300389,1610612739,1610612740,97.0,86.0,0.361,0.405,1,2003-12-23,28,9,19,0.321,29,18,11,0.621
20300392,1610612748,1610612764,79.0,72.0,0.408,0.3670000000000001,1,2003-12-23,28,11,17,0.3929999999999999,26,8,18,0.308
20300395,1610612745,1610612754,71.0,79.0,0.352,0.3779999999999999,0,2003-12-23,27,15,12,0.556,29,21,8,0.7240000000000001
20300398,1610612757,1610612742,97.0,88.0,0.526,0.429,1,2003-12-23,26,13,13,0.5,27,15,12,0.556
20300400,1610612744,1610612747,107.0,98.0,0.481,0.506,1,2003-12-23,26,13,13,0.5,26,20,6,0.769
20300397,1610612758,1610612763,114.0,97.0,0.487,0.435,1,2003-12-23,26,20,6,0.769,28,15,13,0.536
20300394,1610612749,1610612765,83.0,78.0,0.405,0.36,1,2003-12-23,28,14,14,0.5,28,16,12,0.5710000000000001
20300399,1610612760,1610612756,116.0,90.0,0.561,0.429,1,2003-12-23,26,13,13,0.5,29,10,19,0.345
20300391,1610612751,1610612741,95.0,78.0,0.487,0.3720000000000001,1,2003-12-23,27,14,13,0.519,27,7,20,0.259
20300387,1610612741,1610612762,80.0,92.0,0.342,0.493,0,2003-12-22,26,7,19,0.2689999999999999,28,15,13,0.536
20300388,1610612743,1610612763,106.0,99.0,0.506,0.471,1,2003-12-22,28,17,11,0.607,27,15,12,0.556
20300386,1610612755,1610612753,95.0,73.0,0.4529999999999999,0.3289999999999999,1,2003-12-22,28,14,14,0.5,29,7,22,0.241
20300385,1610612747,1610612756,107.0,101.0,0.494,0.447,1,2003-12-21,25,20,5,0.8,28,10,18,0.357
20300383,1610612765,1610612762,96.0,75.0,0.537,0.4429999999999999,1,2003-12-21,27,16,11,0.593,27,14,13,0.519
20300382,1610612748,1610612744,104.0,93.0,0.519,0.479,1,2003-12-21,27,10,17,0.37,25,12,13,0.48
20300381,1610612738,1610612755,87.0,84.0,0.429,0.385,1,2003-12-21,28,14,14,0.5,27,13,14,0.481
20300384,1610612758,1610612757,117.0,98.0,0.544,0.5,1,2003-12-21,25,19,6,0.76,25,12,13,0.48
20300380,1610612761,1610612753,93.0,104.0,0.4589999999999999,0.467,0,2003-12-21,27,14,13,0.519,28,7,21,0.25
20300373,1610612750,1610612754,102.0,80.0,0.522,0.354,1,2003-12-20,26,17,9,0.654,28,20,8,0.7140000000000001
20300371,1610612752,1610612737,103.0,92.0,0.541,0.4370000000000001,1,2003-12-20,28,10,18,0.357,29,7,22,0.241
20300378,1610612756,1610612745,102.0,87.0,0.4629999999999999,0.3670000000000001,1,2003-12-20,27,10,17,0.37,26,15,11,0.5770000000000001
20300376,1610612742,1610612746,105.0,115.0,0.433,0.473,0,2003-12-20,26,15,11,0.5770000000000001,23,11,12,0.478
20300374,1610612741,1610612739,87.0,95.0,0.363,0.452,0,2003-12-20,25,7,18,0.28,27,8,19,0.296
20300379,1610612757,1610612759,91.0,101.0,0.4320000000000001,0.526,0,2003-12-20,24,12,12,0.5,29,19,10,0.655
20300377,1610612743,1610612760,106.0,115.0,0.409,0.506,0,2003-12-20,27,16,11,0.593,25,12,13,0.48
20300375,1610612749,1610612751,92.0,87.0,0.521,0.386,1,2003-12-20,27,13,14,0.481,26,13,13,0.5
20300372,1610612740,1610612763,94.0,89.0,0.4320000000000001,0.405,1,2003-12-20,28,18,10,0.643,26,15,11,0.5770000000000001
20300369,1610612747,1610612743,101.0,99.0,0.5,0.419,1,2003-12-19,24,19,5,0.792,26,16,10,0.615
20300366,1610612754,1610612765,80.0,75.0,0.386,0.444,1,2003-12-19,27,20,7,0.741,26,15,11,0.5770000000000001
20300365,1610612737,1610612758,86.0,98.0,0.42,0.422,0,2003-12-19,28,7,21,0.25,24,18,6,0.75
20300363,1610612738,1610612762,96.0,99.0,0.457,0.494,0,2003-12-19,27,13,14,0.481,26,14,12,0.5379999999999999
20300368,1610612745,1610612746,99.0,85.0,0.494,0.364,1,2003-12-19,25,15,10,0.6,22,10,12,0.455
20300362,1610612761,1610612752,105.0,99.0,0.5,0.411,1,2003-12-19,26,14,12,0.5379999999999999,27,9,18,0.3329999999999999
20300370,1610612760,1610612759,73.0,87.0,0.341,0.4589999999999999,0,2003-12-19,24,11,13,0.4579999999999999,28,18,10,0.643
20300364,1610612751,1610612764,97.0,87.0,0.481,0.385,1,2003-12-19,25,13,12,0.52,25,8,17,0.32
20300360,1610612755,1610612739,81.0,88.0,0.516,0.479,0,2003-12-19,26,13,13,0.5,26,7,19,0.2689999999999999
20300361,1610612753,1610612744,119.0,93.0,0.516,0.474,1,2003-12-19,27,6,21,0.222,24,12,12,0.5
20300367,1610612763,1610612748,97.0,83.0,0.521,0.38,1,2003-12-19,25,15,10,0.6,26,9,17,0.346
20300357,1610612750,1610612742,114.0,109.0,0.525,0.4589999999999999,1,2003-12-18,25,16,9,0.64,25,15,10,0.6
20300359,1610612757,1610612756,101.0,94.0,0.494,0.475,1,2003-12-18,23,12,11,0.522,26,9,17,0.346
20300358,1610612740,1610612758,90.0,101.0,0.402,0.552,0,2003-12-18,27,17,10,0.63,23,17,6,0.7390000000000001
20300356,1610612746,1610612749,93.0,83.0,0.395,0.395,1,2003-12-17,21,10,11,0.476,26,12,14,0.462
20300354,1610612759,1610612761,73.0,70.0,0.3939999999999999,0.4,1,2003-12-17,27,17,10,0.63,25,13,12,0.52
20300349,1610612754,1610612753,90.0,94.0,0.363,0.487,0,2003-12-17,26,19,7,0.731,26,5,21,0.192
20300351,1610612737,1610612744,85.0,98.0,0.434,0.4629999999999999,0,2003-12-17,27,7,20,0.259,23,12,11,0.522
20300352,1610612765,1610612741,77.0,73.0,0.4639999999999999,0.313,1,2003-12-17,25,15,10,0.6,24,7,17,0.292
20300348,1610612739,1610612745,85.0,89.0,0.352,0.457,0,2003-12-17,25,6,19,0.24,24,14,10,0.583
20300353,1610612738,1610612742,105.0,103.0,0.4589999999999999,0.368,1,2003-12-17,26,13,13,0.5,24,15,9,0.625
20300355,1610612760,1610612743,98.0,99.0,0.447,0.483,0,2003-12-17,23,11,12,0.478,25,16,9,0.64
20300350,1610612751,1610612762,87.0,74.0,0.484,0.382,1,2003-12-17,24,12,12,0.5,25,13,12,0.52
20300347,1610612755,1610612748,87.0,76.0,0.565,0.4029999999999999,1,2003-12-17,25,13,12,0.52,25,9,16,0.36
20300341,1610612750,1610612745,92.0,75.0,0.481,0.389,1,2003-12-16,24,15,9,0.625,23,13,10,0.565
20300338,1610612764,1610612762,91.0,87.0,0.41,0.493,1,2003-12-16,24,8,16,0.3329999999999999,24,13,11,0.542
20300339,1610612752,1610612744,86.0,104.0,0.377,0.506,0,2003-12-16,26,9,17,0.346,22,11,11,0.5
20300345,1610612756,1610612760,92.0,91.0,0.385,0.3879999999999999,1,2003-12-16,25,9,16,0.36,22,11,11,0.5
20300340,1610612748,1610612737,97.0,79.0,0.43,0.3879999999999999,1,2003-12-16,24,9,15,0.375,26,7,19,0.2689999999999999
20300343,1610612741,1610612753,102.0,88.0,0.478,0.36,1,2003-12-16,23,7,16,0.304,25,4,21,0.16
20300346,1610612757,1610612749,99.0,106.0,0.512,0.5820000000000001,0,2003-12-16,22,11,11,0.5,25,12,13,0.48
20300344,1610612743,1610612740,116.0,94.0,0.524,0.42,1,2003-12-16,24,15,9,0.625,26,17,9,0.654
20300342,1610612763,1610612758,105.0,100.0,0.4639999999999999,0.416,1,2003-12-16,24,14,10,0.583,22,16,6,0.727
20300337,1610612746,1610612740,109.0,80.0,0.506,0.357,1,2003-12-15,20,9,11,0.45,25,17,8,0.68
20300336,1610612759,1610612763,78.0,67.0,0.365,0.359,1,2003-12-15,26,16,10,0.615,23,13,10,0.565
20300334,1610612754,1610612739,95.0,85.0,0.457,0.507,1,2003-12-15,25,19,6,0.76,24,6,18,0.25
20300333,1610612738,1610612750,95.0,116.0,0.417,0.628,0,2003-12-15,25,12,13,0.48,23,14,9,0.609
20300335,1610612742,1610612761,111.0,94.0,0.472,0.455,1,2003-12-15,23,15,8,0.652,24,13,11,0.542
20300331,1610612752,1610612764,89.0,87.0,0.38,0.4320000000000001,1,2003-12-14,25,9,16,0.36,23,7,16,0.304
20300332,1610612758,1610612756,107.0,102.0,0.4270000000000001,0.473,1,2003-12-14,21,16,5,0.762,24,8,16,0.3329999999999999
20300328,1610612761,1610612748,89.0,90.0,0.4429999999999999,0.41,0,2003-12-14,23,13,10,0.565,23,8,15,0.348
20300329,1610612760,1610612749,108.0,102.0,0.513,0.4429999999999999,1,2003-12-14,21,11,10,0.524,24,11,13,0.4579999999999999
20300330,1610612755,1610612762,86.0,94.0,0.419,0.517,0,2003-12-14,24,12,12,0.5,23,13,10,0.565
20300327,1610612746,1610612756,106.0,91.0,0.476,0.407,1,2003-12-13,19,8,11,0.421,23,8,15,0.348
20300325,1610612759,1610612745,86.0,73.0,0.4589999999999999,0.3329999999999999,1,2003-12-13,25,15,10,0.6,22,13,9,0.591
20300320,1610612752,1610612743,95.0,88.0,0.467,0.395,1,2003-12-13,24,8,16,0.3329999999999999,23,14,9,0.609
20300321,1610612737,1610612753,102.0,105.0,0.433,0.4429999999999999,0,2003-12-13,25,7,18,0.28,24,4,20,0.1669999999999999
20300322,1610612739,1610612738,98.0,105.0,0.444,0.474,0,2003-12-13,23,6,17,0.261,24,12,12,0.5
20300324,1610612741,1610612754,86.0,75.0,0.384,0.418,1,2003-12-13,22,6,16,0.273,24,18,6,0.75
20300326,1610612757,1610612747,112.0,108.0,0.511,0.506,1,2003-12-13,21,11,10,0.524,23,18,5,0.7829999999999999
20300323,1610612763,1610612751,110.0,63.0,0.62,0.342,1,2003-12-13,22,13,9,0.591,23,11,12,0.478
20300318,1610612747,1610612742,93.0,110.0,0.425,0.441,0,2003-12-12,22,18,4,0.818,22,14,8,0.636
20300313,1610612754,1610612737,103.0,92.0,0.507,0.475,1,2003-12-12,23,18,5,0.7829999999999999,24,7,17,0.292
20300310,1610612764,1610612750,91.0,110.0,0.412,0.56,0,2003-12-12,22,7,15,0.318,22,13,9,0.591
20300315,1610612765,1610612760,72.0,93.0,0.382,0.5,0,2003-12-12,24,14,10,0.583,20,10,10,0.5
20300312,1610612748,1610612763,91.0,88.0,0.42,0.4320000000000001,1,2003-12-12,22,7,15,0.318,21,12,9,0.5710000000000001
20300311,1610612738,1610612761,114.0,111.0,0.489,0.4379999999999999,1,2003-12-12,23,11,12,0.478,22,13,9,0.591
20300319,1610612744,1610612740,85.0,96.0,0.39,0.439,0,2003-12-12,21,10,11,0.476,24,17,7,0.708
20300316,1610612749,1610612741,109.0,95.0,0.506,0.474,1,2003-12-12,23,11,12,0.478,21,5,16,0.238
20300317,1610612762,1610612758,93.0,100.0,0.506,0.44,0,2003-12-12,22,12,10,0.545,20,15,5,0.75
20300309,1610612755,1610612743,77.0,86.0,0.39,0.474,0,2003-12-12,23,12,11,0.522,22,14,8,0.636
20300314,1610612753,1610612751,95.0,99.0,0.412,0.4629999999999999,0,2003-12-12,23,3,20,0.13,22,11,11,0.5
20300308,1610612756,1610612740,101.0,111.0,0.541,0.494,0,2003-12-11,22,8,14,0.364,23,16,7,0.696
20300306,1610612739,1610612765,95.0,86.0,0.53,0.359,1,2003-12-11,22,6,16,0.273,23,14,9,0.609
20300307,1610612745,1610612759,67.0,71.0,0.4,0.321,0,2003-12-11,21,13,8,0.619,24,14,10,0.583
20300305,1610612746,1610612742,100.0,99.0,0.526,0.466,1,2003-12-10,18,7,11,0.389,21,13,8,0.619
20300303,1610612759,1610612757,102.0,77.0,0.494,0.33,1,2003-12-10,23,13,10,0.565,20,10,10,0.5
20300300,1610612764,1610612753,91.0,95.0,0.407,0.391,0,2003-12-10,21,7,14,0.3329999999999999,22,3,19,0.136
20300299,1610612738,1610612760,126.0,112.0,0.5770000000000001,0.421,1,2003-12-10,22,10,12,0.455,19,9,10,0.474
20300301,1610612749,1610612744,94.0,89.0,0.3929999999999999,0.382,1,2003-12-10,22,10,12,0.455,20,10,10,0.5
20300304,1610612762,1610612752,95.0,73.0,0.4679999999999999,0.354,1,2003-12-10,21,12,9,0.5710000000000001,23,7,16,0.304
20300302,1610612763,1610612737,103.0,90.0,0.42,0.402,1,2003-12-10,20,12,8,0.6,23,7,16,0.304
20300298,1610612747,1610612752,98.0,90.0,0.43,0.424,1,2003-12-09,21,18,3,0.857,22,7,15,0.318
20300290,1610612754,1610612764,93.0,79.0,0.4579999999999999,0.485,1,2003-12-09,22,17,5,0.773,20,7,13,0.35
20300295,1610612750,1610612744,95.0,98.0,0.469,0.442,0,2003-12-09,21,12,9,0.5710000000000001,19,10,9,0.526
20300293,1610612737,1610612743,112.0,98.0,0.5479999999999999,0.4,1,2003-12-09,22,7,15,0.318,21,13,8,0.619
20300294,1610612765,1610612755,76.0,78.0,0.373,0.425,0,2003-12-09,22,14,8,0.636,22,12,10,0.545
20300289,1610612739,1610612761,93.0,100.0,0.444,0.488,0,2003-12-09,21,5,16,0.238,21,13,8,0.619
20300292,1610612748,1610612756,92.0,72.0,0.429,0.357,1,2003-12-09,21,6,15,0.286,21,8,13,0.381
20300296,1610612745,1610612757,93.0,91.0,0.528,0.407,1,2003-12-09,20,13,7,0.65,19,10,9,0.526
20300297,1610612758,1610612746,105.0,95.0,0.45,0.39,1,2003-12-09,19,14,5,0.737,17,6,11,0.353
20300291,1610612751,1610612760,101.0,88.0,0.551,0.405,1,2003-12-09,21,10,11,0.476,18,9,9,0.5
20300287,1610612741,1610612759,82.0,96.0,0.3939999999999999,0.507,0,2003-12-08,20,5,15,0.25,22,12,10,0.545
20300286,1610612740,1610612749,91.0,85.0,0.384,0.347,1,2003-12-08,22,15,7,0.682,21,9,12,0.429
20300288,1610612762,1610612738,80.0,102.0,0.386,0.514,0,2003-12-08,20,11,9,0.55,21,9,12,0.429
20300285,1610612753,1610612756,105.0,98.0,0.4679999999999999,0.4379999999999999,1,2003-12-08,21,2,19,0.095,20,8,12,0.4
20300279,1610612746,1610612750,94.0,96.0,0.434,0.482,0,2003-12-07,16,6,10,0.375,20,12,8,0.6
20300284,1610612747,1610612762,94.0,92.0,0.452,0.4379999999999999,1,2003-12-07,20,17,3,0.85,19,11,8,0.579
20300283,1610612758,1610612754,91.0,88.0,0.481,0.39,1,2003-12-07,18,13,5,0.722,21,16,5,0.762
20300282,1610612743,1610612738,111.0,116.0,0.512,0.5,0,2003-12-07,20,13,7,0.65,20,8,12,0.4
20300280,1610612761,1610612760,108.0,98.0,0.449,0.4379999999999999,1,2003-12-07,20,12,8,0.6,17,9,8,0.529
20300281,1610612763,1610612757,93.0,79.0,0.384,0.493,1,2003-12-07,19,11,8,0.579,18,10,8,0.556
20300273,1610612739,1610612737,95.0,85.0,0.467,0.466,1,2003-12-06,20,5,15,0.25,21,6,15,0.286
20300272,1610612748,1610612759,70.0,86.0,0.3879999999999999,0.423,0,2003-12-06,20,5,15,0.25,21,11,10,0.524
20300277,1610612745,1610612765,86.0,80.0,0.4629999999999999,0.409,1,2003-12-06,19,12,7,0.632,21,14,7,0.667
20300276,1610612742,1610612753,110.0,97.0,0.523,0.417,1,2003-12-06,20,13,7,0.65,20,1,19,0.05
20300274,1610612741,1610612740,91.0,97.0,0.41,0.408,0,2003-12-06,19,5,14,0.263,21,14,7,0.667
20300278,1610612744,1610612752,104.0,92.0,0.53,0.569,1,2003-12-06,18,9,9,0.5,21,7,14,0.3329999999999999
20300275,1610612749,1610612764,109.0,114.0,0.414,0.473,0,2003-12-06,20,9,11,0.45,19,7,12,0.368
20300271,1610612751,1610612756,99.0,88.0,0.487,0.409,1,2003-12-06,20,9,11,0.45,19,8,11,0.421
20300262,1610612748,1610612755,90.0,93.0,0.386,0.426,0,2003-12-05,19,5,14,0.263,21,11,10,0.524
20300260,1610612738,1610612756,106.0,110.0,0.435,0.444,0,2003-12-05,19,7,12,0.368,18,8,10,0.444
20300268,1610612757,1610612752,88.0,81.0,0.462,0.521,1,2003-12-05,17,10,7,0.588,20,7,13,0.35
20300269,1610612758,1610612750,109.0,112.0,0.38,0.517,0,2003-12-05,17,12,5,0.706,19,11,8,0.579
20300266,1610612743,1610612744,98.0,91.0,0.425,0.434,1,2003-12-05,19,13,6,0.684,17,8,9,0.471
20300259,1610612761,1610612737,92.0,87.0,0.479,0.4579999999999999,1,2003-12-05,19,11,8,0.579,20,6,14,0.3
20300264,1610612740,1610612745,74.0,83.0,0.359,0.439,0,2003-12-05,20,13,7,0.65,18,11,7,0.611
20300267,1610612762,1610612746,86.0,67.0,0.423,0.357,1,2003-12-05,18,11,7,0.611,15,6,9,0.4
20300270,1610612760,1610612754,94.0,101.0,0.41,0.519,0,2003-12-05,16,9,7,0.563,20,16,4,0.8
20300261,1610612751,1610612749,93.0,86.0,0.422,0.412,1,2003-12-05,19,8,11,0.421,19,9,10,0.474
20300263,1610612753,1610612759,94.0,105.0,0.434,0.5,0,2003-12-05,19,1,18,0.053,20,10,10,0.5
20300265,1610612763,1610612764,92.0,77.0,0.429,0.346,1,2003-12-05,18,10,8,0.556,18,6,12,0.3329999999999999
20300258,1610612742,1610612747,103.0,114.0,0.374,0.442,0,2003-12-04,19,12,7,0.632,19,16,3,0.8420000000000001
20300257,1610612755,1610612741,83.0,82.0,0.395,0.337,1,2003-12-04,20,10,10,0.5,18,5,13,0.278
20300255,1610612746,1610612739,90.0,80.0,0.4,0.3879999999999999,1,2003-12-03,14,6,8,0.429,19,4,15,0.211
20300251,1610612759,1610612747,86.0,90.0,0.417,0.423,0,2003-12-03,19,9,10,0.474,18,15,3,0.833
20300248,1610612765,1610612748,87.0,73.0,0.358,0.337,1,2003-12-03,20,14,6,0.7,18,5,13,0.278
20300252,1610612756,1610612750,79.0,92.0,0.382,0.475,0,2003-12-03,17,7,10,0.412,18,10,8,0.556
20300250,1610612745,1610612762,107.0,101.0,0.507,0.474,1,2003-12-03,17,10,7,0.588,17,10,7,0.588
20300253,1610612757,1610612754,97.0,95.0,0.418,0.47,1,2003-12-03,16,9,7,0.563,19,15,4,0.789
20300256,1610612744,1610612743,109.0,117.0,0.5,0.597,0,2003-12-03,16,8,8,0.5,18,12,6,0.667
20300246,1610612761,1610612738,105.0,95.0,0.424,0.506,1,2003-12-03,18,10,8,0.556,18,7,11,0.389
20300249,1610612740,1610612753,106.0,91.0,0.449,0.424,1,2003-12-03,19,13,6,0.684,18,1,17,0.0559999999999999
20300254,1610612760,1610612752,95.0,87.0,0.439,0.441,1,2003-12-03,15,9,6,0.6,19,7,12,0.368
20300247,1610612751,1610612763,93.0,96.0,0.426,0.456,0,2003-12-03,18,7,11,0.389,17,9,8,0.529
20300243,1610612737,1610612749,94.0,106.0,0.3979999999999999,0.506,0,2003-12-02,19,6,13,0.316,18,9,9,0.5
20300244,1610612742,1610612764,97.0,72.0,0.417,0.321,1,2003-12-02,18,12,6,0.667,17,6,11,0.353
20300245,1610612743,1610612739,115.0,103.0,0.532,0.4379999999999999,1,2003-12-02,17,11,6,0.647,18,4,14,0.222
20300241,1610612755,1610612761,88.0,95.0,0.345,0.472,0,2003-12-02,19,9,10,0.474,17,9,8,0.529
20300242,1610612753,1610612740,91.0,100.0,0.3779999999999999,0.4039999999999999,0,2003-12-02,17,1,16,0.059,18,12,6,0.667
20300240,1610612746,1610612759,91.0,83.0,0.392,0.369,1,2003-12-01,13,5,8,0.385,18,9,9,0.5
20300236,1610612752,1610612765,78.0,79.0,0.3879999999999999,0.384,0,2003-12-01,18,7,11,0.389,19,13,6,0.684
20300239,1610612756,1610612754,82.0,89.0,0.43,0.4320000000000001,0,2003-12-01,16,7,9,0.4379999999999999,18,15,3,0.833
20300235,1610612738,1610612763,89.0,96.0,0.381,0.419,0,2003-12-01,17,7,10,0.412,16,8,8,0.5
20300237,1610612741,1610612749,97.0,87.0,0.424,0.3829999999999999,1,2003-12-01,17,5,12,0.294,17,8,9,0.471
20300238,1610612762,1610612751,91.0,84.0,0.486,0.389,1,2003-12-01,16,10,6,0.625,17,7,10,0.412
20300234,1610612747,1610612754,99.0,77.0,0.48,0.391,1,2003-11-30,17,14,3,0.8240000000000001,17,14,3,0.8240000000000001
20300233,1610612758,1610612751,105.0,92.0,0.506,0.47,1,2003-11-30,16,12,4,0.75,16,7,9,0.4379999999999999
20300231,1610612746,1610612743,86.0,98.0,0.349,0.4679999999999999,0,2003-11-29,12,4,8,0.3329999999999999,16,10,6,0.625
20300225,1610612764,1610612765,69.0,80.0,0.3779999999999999,0.409,0,2003-11-29,16,6,10,0.375,18,12,6,0.667
20300223,1610612752,1610612740,79.0,74.0,0.408,0.319,1,2003-11-29,17,7,10,0.412,17,11,6,0.647
20300227,1610612739,1610612763,115.0,122.0,0.431,0.4639999999999999,0,2003-11-29,17,4,13,0.235,15,7,8,0.467
20300226,1610612748,1610612761,78.0,66.0,0.419,0.3939999999999999,1,2003-11-29,17,5,12,0.294,16,8,8,0.5
20300228,1610612742,1610612750,92.0,88.0,0.3429999999999999,0.442,1,2003-11-29,17,11,6,0.647,17,9,8,0.529
20300232,1610612744,1610612759,91.0,89.0,0.39,0.405,1,2003-11-29,15,8,7,0.5329999999999999,17,9,8,0.529
20300229,1610612749,1610612738,100.0,94.0,0.449,0.462,1,2003-11-29,16,8,8,0.5,16,7,9,0.4379999999999999
20300230,1610612760,1610612745,95.0,88.0,0.397,0.397,1,2003-11-29,14,8,6,0.5710000000000001,16,9,7,0.563
20300224,1610612755,1610612737,98.0,86.0,0.481,0.44,1,2003-11-29,18,9,9,0.5,18,6,12,0.3329999999999999
20300222,1610612747,1610612759,103.0,87.0,0.525,0.39,1,2003-11-28,16,13,3,0.813,16,9,7,0.563
20300215,1610612754,1610612755,90.0,77.0,0.455,0.408,1,2003-11-28,16,14,2,0.875,17,8,9,0.471
20300212,1610612737,1610612748,95.0,83.0,0.3929999999999999,0.39,1,2003-11-28,17,6,11,0.353,16,4,12,0.25
20300214,1610612765,1610612739,92.0,88.0,0.41,0.456,1,2003-11-28,17,11,6,0.647,16,4,12,0.25
20300219,1610612756,1610612744,83.0,92.0,0.366,0.487,0,2003-11-28,15,7,8,0.467,14,7,7,0.5
20300211,1610612738,1610612749,106.0,96.0,0.526,0.415,1,2003-11-28,15,7,8,0.467,15,7,8,0.467
20300221,1610612757,1610612751,97.0,93.0,0.494,0.462,1,2003-11-28,15,8,7,0.5329999999999999,15,7,8,0.467
20300220,1610612758,1610612745,103.0,74.0,0.519,0.364,1,2003-11-28,15,11,4,0.733,15,9,6,0.6
20300217,1610612743,1610612742,113.0,103.0,0.52,0.423,1,2003-11-28,15,9,6,0.6,16,10,6,0.625
20300218,1610612762,1610612760,98.0,81.0,0.5,0.4,1,2003-11-28,15,9,6,0.6,13,7,6,0.5379999999999999
20300213,1610612753,1610612761,86.0,87.0,0.425,0.413,0,2003-11-28,16,1,15,0.063,15,8,7,0.5329999999999999
20300216,1610612763,1610612750,98.0,102.0,0.418,0.493,0,2003-11-28,14,6,8,0.429,16,9,7,0.563
20300210,1610612746,1610612751,96.0,102.0,0.384,0.416,0,2003-11-27,11,4,7,0.364,14,7,7,0.5
20300209,1610612754,1610612752,93.0,70.0,0.439,0.354,1,2003-11-27,15,13,2,0.867,16,6,10,0.375
20300208,1610612747,1610612764,120.0,99.0,0.614,0.419,1,2003-11-26,15,12,3,0.8,15,6,9,0.4
20300205,1610612759,1610612741,109.0,98.0,0.518,0.539,1,2003-11-26,15,9,6,0.6,16,4,12,0.25
20300204,1610612750,1610612752,92.0,97.0,0.5,0.522,0,2003-11-26,15,8,7,0.5329999999999999,15,6,9,0.4
20300202,1610612737,1610612761,97.0,99.0,0.477,0.494,0,2003-11-26,16,5,11,0.313,14,7,7,0.5
20300207,1610612756,1610612742,121.0,90.0,0.544,0.395,1,2003-11-26,14,7,7,0.5,15,10,5,0.667
20300203,1610612740,1610612739,82.0,72.0,0.3879999999999999,0.337,1,2003-11-26,16,11,5,0.688,15,4,11,0.267
20300206,1610612762,1610612745,83.0,76.0,0.434,0.3329999999999999,1,2003-11-26,14,8,6,0.5710000000000001,14,9,5,0.643
20300200,1610612755,1610612765,90.0,86.0,0.481,0.4579999999999999,1,2003-11-26,16,8,8,0.5,16,10,6,0.625
20300201,1610612753,1610612738,92.0,94.0,0.4429999999999999,0.479,0,2003-11-26,15,1,14,0.067,14,6,8,0.429
20300192,1610612754,1610612750,98.0,75.0,0.488,0.389,1,2003-11-25,14,12,2,0.857,14,8,6,0.5710000000000001
20300193,1610612748,1610612740,91.0,87.0,0.493,0.412,1,2003-11-25,15,4,11,0.267,15,10,5,0.667
20300195,1610612742,1610612741,124.0,98.0,0.528,0.489,1,2003-11-25,14,10,4,0.7140000000000001,15,4,11,0.267
20300198,1610612757,1610612764,80.0,81.0,0.442,0.429,0,2003-11-25,14,7,7,0.5,14,6,8,0.429
20300196,1610612743,1610612756,110.0,80.0,0.4270000000000001,0.397,1,2003-11-25,14,8,6,0.5710000000000001,13,6,7,0.462
20300197,1610612758,1610612763,109.0,89.0,0.494,0.423,1,2003-11-25,14,10,4,0.7140000000000001,13,6,7,0.462
20300194,1610612749,1610612755,95.0,91.0,0.514,0.419,1,2003-11-25,14,7,7,0.5,15,7,8,0.467
20300199,1610612760,1610612751,70.0,93.0,0.3379999999999999,0.469,0,2003-11-25,12,7,5,0.583,13,6,7,0.462
20300191,1610612746,1610612745,90.0,105.0,0.341,0.494,0,2003-11-24,10,4,6,0.4,13,9,4,0.6920000000000001
20300190,1610612737,1610612765,89.0,94.0,0.435,0.422,0,2003-11-24,15,5,10,0.3329999999999999,15,10,5,0.667
20300188,1610612738,1610612752,88.0,94.0,0.392,0.3879999999999999,0,2003-11-24,13,5,8,0.385,14,5,9,0.357
20300189,1610612753,1610612754,78.0,89.0,0.4270000000000001,0.415,0,2003-11-24,14,1,13,0.071,13,11,2,0.846
20300187,1610612747,1610612763,121.0,89.0,0.5920000000000001,0.472,1,2003-11-23,14,11,3,0.7859999999999999,12,6,6,0.5
20300183,1610612765,1610612740,80.0,81.0,0.4,0.348,0,2003-11-23,14,9,5,0.643,14,10,4,0.7140000000000001
20300184,1610612744,1610612757,78.0,72.0,0.38,0.386,1,2003-11-23,13,6,7,0.462,13,7,6,0.5379999999999999
20300185,1610612758,1610612741,110.0,99.0,0.461,0.519,1,2003-11-23,13,9,4,0.6920000000000001,14,4,10,0.286
20300182,1610612761,1610612749,62.0,82.0,0.342,0.425,0,2003-11-23,13,6,7,0.462,13,6,7,0.462
20300186,1610612760,1610612764,88.0,85.0,0.42,0.386,1,2003-11-23,11,7,4,0.636,13,5,8,0.385
20300179,1610612750,1610612746,103.0,91.0,0.524,0.44,1,2003-11-22,13,8,5,0.615,9,4,5,0.444
20300178,1610612752,1610612755,99.0,88.0,0.506,0.389,1,2003-11-22,13,4,9,0.308,14,7,7,0.5
20300177,1610612737,1610612739,92.0,83.0,0.447,0.33,1,2003-11-22,14,5,9,0.357,14,4,10,0.286
20300181,1610612756,1610612748,100.0,98.0,0.535,0.3779999999999999,1,2003-11-22,12,6,6,0.5,14,3,11,0.214
20300180,1610612742,1610612743,115.0,101.0,0.472,0.389,1,2003-11-22,13,9,4,0.6920000000000001,13,7,6,0.5379999999999999
20300176,1610612751,1610612761,80.0,81.0,0.485,0.431,0,2003-11-22,12,5,7,0.417,12,6,6,0.5
20300172,1610612747,1610612741,101.0,94.0,0.424,0.43,1,2003-11-21,13,10,3,0.769,13,4,9,0.308
20300168,1610612759,1610612737,114.0,75.0,0.518,0.3379999999999999,1,2003-11-21,14,8,6,0.5710000000000001,13,4,9,0.308
20300167,1610612765,1610612752,94.0,85.0,0.397,0.395,1,2003-11-21,13,9,4,0.6920000000000001,12,3,9,0.25
20300166,1610612739,1610612750,83.0,97.0,0.413,0.422,0,2003-11-21,13,4,9,0.308,12,7,5,0.583
20300173,1610612744,1610612748,101.0,91.0,0.4679999999999999,0.407,1,2003-11-21,12,5,7,0.417,13,3,10,0.231
20300174,1610612757,1610612745,85.0,78.0,0.341,0.429,1,2003-11-21,12,7,5,0.583,12,8,4,0.667
20300169,1610612743,1610612764,108.0,87.0,0.473,0.408,1,2003-11-21,12,7,5,0.583,12,5,7,0.417
20300171,1610612758,1610612753,122.0,92.0,0.529,0.396,1,2003-11-21,12,8,4,0.667,13,1,12,0.077
20300165,1610612740,1610612754,75.0,76.0,0.3670000000000001,0.392,0,2003-11-21,13,9,4,0.6920000000000001,12,10,2,0.833
20300170,1610612762,1610612749,99.0,90.0,0.467,0.449,1,2003-11-21,13,7,6,0.5379999999999999,12,5,7,0.417
20300175,1610612760,1610612763,97.0,98.0,0.457,0.3929999999999999,0,2003-11-21,10,6,4,0.6,11,6,5,0.545
20300164,1610612755,1610612738,87.0,85.0,0.4479999999999999,0.387,1,2003-11-21,13,7,6,0.5379999999999999,12,5,7,0.417
20300163,1610612756,1610612753,96.0,89.0,0.513,0.419,1,2003-11-20,11,5,6,0.455,12,1,11,0.083
20300162,1610612742,1610612759,95.0,92.0,0.369,0.4429999999999999,1,2003-11-20,12,8,4,0.667,13,7,6,0.5379999999999999
20300155,1610612754,1610612746,91.0,78.0,0.423,0.365,1,2003-11-19,11,9,2,0.818,8,4,4,0.5
20300153,1610612764,1610612739,106.0,95.0,0.389,0.4679999999999999,1,2003-11-19,11,5,6,0.455,12,4,8,0.3329999999999999
20300156,1610612752,1610612747,83.0,104.0,0.429,0.4320000000000001,0,2003-11-19,11,3,8,0.273,12,9,3,0.75
20300157,1610612745,1610612744,85.0,83.0,0.436,0.4529999999999999,1,2003-11-19,11,8,3,0.727,11,4,7,0.364
20300152,1610612738,1610612740,73.0,81.0,0.406,0.366,0,2003-11-19,11,5,6,0.455,12,9,3,0.75
20300161,1610612757,1610612748,94.0,93.0,0.479,0.447,1,2003-11-19,11,6,5,0.545,12,3,9,0.25
20300159,1610612743,1610612749,94.0,86.0,0.3979999999999999,0.3829999999999999,1,2003-11-19,11,6,5,0.545,11,5,6,0.455
20300154,1610612761,1610612755,75.0,81.0,0.406,0.42,0,2003-11-19,11,5,6,0.455,12,6,6,0.5
20300160,1610612762,1610612758,110.0,118.0,0.471,0.58,0,2003-11-19,12,6,6,0.5,11,7,4,0.636
20300158,1610612763,1610612765,92.0,99.0,0.4379999999999999,0.481,0,2003-11-19,10,5,5,0.5,12,8,4,0.667
20300149,1610612759,1610612744,94.0,81.0,0.5,0.447,1,2003-11-18,12,7,5,0.583,10,4,6,0.4
20300148,1610612750,1610612743,89.0,76.0,0.462,0.321,1,2003-11-18,11,6,5,0.545,10,5,5,0.5
20300146,1610612765,1610612747,106.0,96.0,0.568,0.469,1,2003-11-18,11,7,4,0.636,11,8,3,0.727
20300150,1610612756,1610612741,95.0,82.0,0.474,0.407,1,2003-11-18,10,4,6,0.4,12,4,8,0.3329999999999999
20300144,1610612739,1610612746,103.0,95.0,0.481,0.319,1,2003-11-18,11,4,7,0.364,7,4,3,0.5710000000000001
20300147,1610612749,1610612737,93.0,101.0,0.377,0.4579999999999999,0,2003-11-18,10,5,5,0.5,12,4,8,0.3329999999999999
20300151,1610612760,1610612748,98.0,105.0,0.439,0.527,0,2003-11-18,9,6,3,0.667,11,3,8,0.273
20300145,1610612751,1610612740,85.0,88.0,0.39,0.407,0,2003-11-18,11,5,6,0.455,11,8,3,0.727
20300140,1610612752,1610612738,89.0,86.0,0.3720000000000001,0.37,1,2003-11-17,10,3,7,0.3,10,5,5,0.5
20300141,1610612737,1610612764,97.0,106.0,0.423,0.39,0,2003-11-17,11,3,8,0.273,10,4,6,0.4
20300142,1610612742,1610612757,105.0,98.0,0.471,0.4429999999999999,1,2003-11-17,11,7,4,0.636,10,5,5,0.5
20300143,1610612762,1610612753,90.0,88.0,0.364,0.429,1,2003-11-17,11,6,5,0.545,11,1,10,0.091
20300139,1610612755,1610612745,66.0,74.0,0.315,0.325,0,2003-11-17,11,5,6,0.455,10,7,3,0.7
20300138,1610612747,1610612748,99.0,77.0,0.446,0.363,1,2003-11-16,10,8,2,0.8,10,2,8,0.2
20300137,1610612758,1610612744,106.0,104.0,0.424,0.524,1,2003-11-16,10,6,4,0.6,9,4,5,0.444
20300136,1610612761,1610612745,101.0,97.0,0.418,0.369,1,2003-11-16,10,5,5,0.5,9,6,3,0.667
20300135,1610612746,1610612753,95.0,92.0,0.41,0.436,1,2003-11-15,6,4,2,0.667,10,1,9,0.1
20300127,1610612764,1610612759,71.0,95.0,0.337,0.475,0,2003-11-15,9,3,6,0.3329999999999999,11,6,5,0.545
20300129,1610612752,1610612754,94.0,95.0,0.488,0.4579999999999999,0,2003-11-15,9,2,7,0.222,10,8,2,0.8
20300128,1610612737,1610612751,85.0,100.0,0.382,0.479,0,2003-11-15,10,3,7,0.3,10,5,5,0.5
20300134,1610612756,1610612765,91.0,100.0,0.4629999999999999,0.473,0,2003-11-15,9,3,6,0.3329999999999999,10,6,4,0.6
20300130,1610612739,1610612755,91.0,88.0,0.4370000000000001,0.337,1,2003-11-15,10,3,7,0.3,10,5,5,0.5
20300132,1610612741,1610612760,90.0,98.0,0.473,0.474,0,2003-11-15,11,4,7,0.364,8,6,2,0.75
20300133,1610612749,1610612762,100.0,95.0,0.493,0.44,1,2003-11-15,9,5,4,0.556,10,5,5,0.5
20300126,1610612740,1610612757,101.0,79.0,0.5,0.361,1,2003-11-15,10,7,3,0.7,9,5,4,0.556
20300131,1610612763,1610612742,108.0,101.0,0.449,0.402,1,2003-11-15,9,5,4,0.556,10,6,4,0.6
20300124,1610612747,1610612765,94.0,89.0,0.474,0.425,1,2003-11-14,9,7,2,0.778,9,5,4,0.556
20300118,1610612754,1610612760,101.0,78.0,0.402,0.365,1,2003-11-14,9,7,2,0.778,7,5,2,0.7140000000000001
20300120,1610612750,1610612762,77.0,85.0,0.392,0.451,0,2003-11-14,10,5,5,0.5,9,5,4,0.556
20300117,1610612748,1610612764,105.0,101.0,0.409,0.4479999999999999,1,2003-11-14,9,2,7,0.222,8,3,5,0.375
20300121,1610612745,1610612756,90.0,85.0,0.3879999999999999,0.38,1,2003-11-14,8,6,2,0.75,8,3,5,0.375
20300115,1610612738,1610612739,91.0,82.0,0.41,0.351,1,2003-11-14,9,5,4,0.556,9,2,7,0.222
20300125,1610612744,1610612746,98.0,104.0,0.418,0.494,0,2003-11-14,8,4,4,0.5,5,3,2,0.6
20300122,1610612758,1610612761,94.0,64.0,0.5,0.3379999999999999,1,2003-11-14,9,5,4,0.556,9,4,5,0.444
20300123,1610612743,1610612753,106.0,101.0,0.382,0.4479999999999999,1,2003-11-14,9,5,4,0.556,9,1,8,0.111
20300116,1610612751,1610612752,85.0,80.0,0.435,0.375,1,2003-11-14,9,4,5,0.444,8,2,6,0.25
20300119,1610612755,1610612759,100.0,96.0,0.493,0.375,1,2003-11-14,9,5,4,0.556,10,5,5,0.5
20300112,1610612742,1610612745,97.0,86.0,0.45,0.402,1,2003-11-13,9,6,3,0.667,7,5,2,0.7140000000000001
20300113,1610612741,1610612750,89.0,92.0,0.419,0.452,0,2003-11-13,10,4,6,0.4,9,5,4,0.556
20300114,1610612757,1610612758,112.0,110.0,0.522,0.484,1,2003-11-13,8,5,3,0.625,8,4,4,0.5
20300111,1610612747,1610612761,94.0,79.0,0.416,0.348,1,2003-11-12,8,6,2,0.75,8,4,4,0.5
20300109,1610612756,1610612737,94.0,99.0,0.429,0.457,0,2003-11-12,7,3,4,0.429,9,3,6,0.3329999999999999
20300106,1610612748,1610612739,88.0,83.0,0.455,0.451,1,2003-11-12,8,1,7,0.125,8,2,6,0.25
20300103,1610612738,1610612741,82.0,89.0,0.3289999999999999,0.431,0,2003-11-12,8,4,4,0.5,9,4,5,0.444
20300110,1610612744,1610612765,87.0,85.0,0.447,0.402,1,2003-11-12,7,4,3,0.5710000000000001,8,5,3,0.625
20300108,1610612749,1610612760,99.0,104.0,0.379,0.494,0,2003-11-12,8,4,4,0.5,6,5,1,0.833
20300107,1610612740,1610612762,96.0,89.0,0.4629999999999999,0.486,1,2003-11-12,9,6,3,0.667,8,4,4,0.5
20300104,1610612751,1610612759,71.0,85.0,0.36,0.41,0,2003-11-12,8,3,5,0.375,9,5,4,0.556
20300105,1610612753,1610612763,97.0,107.0,0.452,0.446,0,2003-11-12,8,1,7,0.125,8,4,4,0.5
20300102,1610612746,1610612737,115.0,103.0,0.4639999999999999,0.5429999999999999,1,2003-11-11,4,2,2,0.5,8,2,6,0.25
20300096,1610612754,1610612738,76.0,78.0,0.412,0.413,0,2003-11-11,8,6,2,0.75,7,4,3,0.5710000000000001
20300097,1610612750,1610612760,87.0,89.0,0.434,0.452,0,2003-11-11,8,4,4,0.5,5,4,1,0.8
20300095,1610612764,1610612755,105.0,112.0,0.46,0.45,0,2003-11-11,7,3,4,0.429,8,4,4,0.5
20300099,1610612745,1610612748,90.0,70.0,0.449,0.347,1,2003-11-11,6,5,1,0.833,7,0,7,0.0
20300098,1610612742,1610612740,125.0,97.0,0.581,0.481,1,2003-11-11,8,5,3,0.625,8,5,3,0.625
20300101,1610612757,1610612761,83.0,80.0,0.456,0.414,1,2003-11-11,7,4,3,0.5710000000000001,7,4,3,0.5710000000000001
20300100,1610612758,1610612765,97.0,91.0,0.481,0.397,1,2003-11-11,7,4,3,0.5710000000000001,7,5,2,0.7140000000000001
20300093,1610612759,1610612762,87.0,78.0,0.4429999999999999,0.408,1,2003-11-10,8,4,4,0.5,7,4,3,0.5710000000000001
20300090,1610612739,1610612752,94.0,80.0,0.444,0.4029999999999999,1,2003-11-10,7,2,5,0.286,7,2,5,0.286
20300094,1610612744,1610612756,96.0,99.0,0.45,0.488,0,2003-11-10,6,3,3,0.5,6,3,3,0.5
20300092,1610612741,1610612743,97.0,105.0,0.506,0.379,0,2003-11-10,8,3,5,0.375,8,4,4,0.5
20300091,1610612763,1610612747,105.0,95.0,0.488,0.44,1,2003-11-10,7,3,4,0.429,7,5,2,0.7140000000000001
20300088,1610612765,1610612751,98.0,84.0,0.4379999999999999,0.4320000000000001,1,2003-11-09,6,5,1,0.833,7,3,4,0.429
20300086,1610612738,1610612758,91.0,82.0,0.434,0.356,1,2003-11-09,6,3,3,0.5,6,3,3,0.5
20300085,1610612761,1610612743,89.0,76.0,0.487,0.347,1,2003-11-09,6,4,2,0.667,7,3,4,0.429
20300089,1610612760,1610612737,81.0,91.0,0.379,0.479,0,2003-11-09,4,3,1,0.75,7,2,5,0.286
20300087,1610612755,1610612754,74.0,85.0,0.417,0.4589999999999999,0,2003-11-09,7,3,4,0.429,7,6,1,0.857
20300082,1610612759,1610612742,78.0,81.0,0.325,0.4,0,2003-11-08,7,3,4,0.429,7,4,3,0.5710000000000001
20300078,1610612739,1610612764,111.0,98.0,0.524,0.449,1,2003-11-08,6,1,5,0.1669999999999999,6,3,3,0.5
20300081,1610612745,1610612753,96.0,86.0,0.45,0.405,1,2003-11-08,5,4,1,0.8,7,1,6,0.143
20300077,1610612748,1610612750,79.0,88.0,0.341,0.4579999999999999,0,2003-11-08,6,0,6,0.0,7,4,3,0.5710000000000001
20300084,1610612757,1610612737,90.0,83.0,0.425,0.4379999999999999,1,2003-11-08,6,3,3,0.5,6,1,5,0.1669999999999999
20300080,1610612749,1610612752,90.0,87.0,0.429,0.418,1,2003-11-08,7,4,3,0.5710000000000001,6,2,4,0.3329999999999999
20300079,1610612740,1610612741,106.0,109.0,0.462,0.594,0,2003-11-08,7,5,2,0.7140000000000001,7,3,4,0.429
20300083,1610612762,1610612763,96.0,89.0,0.45,0.434,1,2003-11-08,6,4,2,0.667,6,2,4,0.3329999999999999
20300068,1610612754,1610612739,91.0,90.0,0.423,0.444,1,2003-11-07,6,5,1,0.833,5,0,5,0.0
20300065,1610612764,1610612761,86.0,60.0,0.397,0.368,1,2003-11-07,5,3,2,0.6,5,3,2,0.6
20300067,1610612752,1610612758,114.0,111.0,0.488,0.517,1,2003-11-07,5,2,3,0.4,5,3,2,0.6
20300074,1610612756,1610612763,96.0,88.0,0.481,0.4,1,2003-11-07,5,2,3,0.4,5,2,3,0.4
20300071,1610612765,1610612749,105.0,99.0,0.4479999999999999,0.419,1,2003-11-07,5,4,1,0.8,6,3,3,0.5
20300066,1610612738,1610612751,87.0,94.0,0.444,0.424,0,2003-11-07,5,2,3,0.4,6,3,3,0.5
20300075,1610612744,1610612762,95.0,89.0,0.433,0.384,1,2003-11-07,5,3,2,0.6,5,3,2,0.6
20300072,1610612741,1610612755,85.0,106.0,0.4270000000000001,0.475,0,2003-11-07,6,2,4,0.3329999999999999,6,3,3,0.5
20300073,1610612743,1610612746,102.0,104.0,0.384,0.4529999999999999,0,2003-11-07,6,3,3,0.5,3,1,2,0.3329999999999999
20300070,1610612740,1610612747,114.0,95.0,0.573,0.461,1,2003-11-07,6,5,1,0.833,6,5,1,0.833
20300076,1610612760,1610612757,100.0,82.0,0.488,0.439,1,2003-11-07,3,3,0,1.0,5,2,3,0.4
20300069,1610612753,1610612750,71.0,100.0,0.3879999999999999,0.456,0,2003-11-07,6,1,5,0.1669999999999999,6,3,3,0.5
20300064,1610612759,1610612747,117.0,120.0,0.407,0.435,0,2003-11-06,6,3,3,0.5,5,5,0,1.0
20300063,1610612761,1610612742,77.0,71.0,0.397,0.354,1,2003-11-06,4,3,1,0.75,6,3,3,0.5
20300062,1610612751,1610612754,81.0,87.0,0.408,0.478,0,2003-11-06,5,2,3,0.4,5,4,1,0.8
20300058,1610612750,1610612758,121.0,125.0,0.515,0.5,0,2003-11-05,5,2,3,0.4,4,3,1,0.75
20300053,1610612764,1610612742,100.0,90.0,0.4270000000000001,0.376,1,2003-11-05,4,2,2,0.5,5,3,2,0.6
20300055,1610612752,1610612749,90.0,106.0,0.44,0.4679999999999999,0,2003-11-05,4,1,3,0.25,5,3,2,0.6
20300056,1610612765,1610612738,96.0,88.0,0.413,0.473,1,2003-11-05,4,3,1,0.75,4,2,2,0.5
20300057,1610612739,1610612743,89.0,93.0,0.379,0.4320000000000001,0,2003-11-05,4,0,4,0.0,5,3,2,0.6
20300060,1610612744,1610612737,99.0,72.0,0.446,0.3670000000000001,1,2003-11-05,4,2,2,0.5,5,1,4,0.2
20300061,1610612757,1610612763,93.0,87.0,0.462,0.407,1,2003-11-05,4,2,2,0.5,4,2,2,0.5
20300059,1610612762,1610612756,91.0,80.0,0.461,0.375,1,2003-11-05,4,3,1,0.75,4,1,3,0.25
20300052,1610612755,1610612740,99.0,106.0,0.407,0.451,0,2003-11-05,5,2,3,0.4,5,4,1,0.8
20300054,1610612753,1610612741,100.0,106.0,0.46,0.542,0,2003-11-05,5,1,4,0.2,5,2,3,0.4
20300051,1610612759,1610612748,80.0,73.0,0.342,0.353,1,2003-11-04,5,3,2,0.6,5,0,5,0.0
20300048,1610612754,1610612743,71.0,60.0,0.355,0.291,1,2003-11-04,4,3,1,0.75,4,2,2,0.5
20300050,1610612749,1610612747,107.0,113.0,0.4,0.46,0,2003-11-04,4,2,2,0.5,4,4,0,1.0
20300049,1610612751,1610612745,75.0,86.0,0.3379999999999999,0.53,0,2003-11-04,4,2,2,0.5,4,3,1,0.75
20300042,1610612737,1610612740,90.0,80.0,0.4270000000000001,0.407,1,2003-11-03,4,1,3,0.25,4,3,1,0.75
20300045,1610612742,1610612748,103.0,93.0,0.506,0.47,1,2003-11-03,4,3,1,0.75,4,0,4,0.0
20300044,1610612741,1610612745,66.0,98.0,0.266,0.521,0,2003-11-03,4,1,3,0.25,3,2,1,0.667
20300047,1610612757,1610612755,83.0,94.0,0.392,0.485,0,2003-11-03,3,1,2,0.3329999999999999,4,2,2,0.5
20300046,1610612762,1610612750,93.0,88.0,0.4320000000000001,0.444,1,2003-11-03,3,2,1,0.667,4,2,2,0.5
20300041,1610612753,1610612752,68.0,75.0,0.25,0.4029999999999999,0,2003-11-03,4,1,3,0.25,3,1,2,0.3329999999999999
20300043,1610612763,1610612759,88.0,80.0,0.373,0.382,1,2003-11-03,3,2,1,0.667,4,2,2,0.5
20300040,1610612747,1610612744,87.0,72.0,0.425,0.3720000000000001,1,2003-11-02,3,3,0,1.0,3,1,2,0.3329999999999999
20300035,1610612759,1610612752,86.0,74.0,0.429,0.408,1,2003-11-01,3,2,1,0.667,2,0,2,0.0
20300031,1610612750,1610612761,73.0,56.0,0.456,0.275,1,2003-11-01,3,2,1,0.667,3,2,1,0.667
20300027,1610612764,1610612751,85.0,98.0,0.42,0.425,0,2003-11-01,3,1,2,0.3329999999999999,3,2,1,0.667
20300029,1610612737,1610612754,99.0,103.0,0.4679999999999999,0.4479999999999999,0,2003-11-01,3,0,3,0.0,3,2,1,0.667
20300037,1610612756,1610612747,99.0,103.0,0.413,0.457,0,2003-11-01,3,1,2,0.3329999999999999,2,2,0,1.0
20300034,1610612745,1610612763,71.0,79.0,0.364,0.417,0,2003-11-01,2,1,1,0.5,2,1,1,0.5
20300033,1610612742,1610612762,127.0,102.0,0.517,0.44,1,2003-11-01,3,2,1,0.667,2,1,1,0.5
20300039,1610612744,1610612755,104.0,90.0,0.594,0.4679999999999999,1,2003-11-01,2,1,1,0.5,3,1,2,0.3329999999999999
20300038,1610612757,1610612739,104.0,85.0,0.494,0.479,1,2003-11-01,2,1,1,0.5,3,0,3,0.0
20300036,1610612743,1610612758,109.0,88.0,0.488,0.363,1,2003-11-01,3,2,1,0.667,3,2,1,0.667
20300032,1610612749,1610612741,98.0,68.0,0.4479999999999999,0.28,1,2003-11-01,3,2,1,0.667,3,1,2,0.3329999999999999
20300030,1610612740,1610612738,97.0,90.0,0.479,0.407,1,2003-11-01,3,3,0,1.0,3,2,1,0.667
20300028,1610612753,1610612765,85.0,96.0,0.39,0.417,0,2003-11-01,3,1,2,0.3329999999999999,3,2,1,0.667
20300021,1610612754,1610612749,79.0,93.0,0.3879999999999999,0.542,0,2003-10-31,2,1,1,0.5,2,1,1,0.5
20300020,1610612748,1610612765,81.0,93.0,0.357,0.435,0,2003-10-31,3,0,3,0.0,2,1,1,0.5
20300024,1610612741,1610612737,100.0,94.0,0.4,0.4,1,2003-10-31,2,1,1,0.5,2,0,2,0.0
20300026,1610612758,1610612755,100.0,89.0,0.514,0.418,1,2003-10-31,2,2,0,1.0,2,1,1,0.5
20300019,1610612761,1610612764,82.0,79.0,0.386,0.4429999999999999,1,2003-10-31,2,2,0,1.0,2,1,1,0.5
20300022,1610612751,1610612750,84.0,61.0,0.456,0.3329999999999999,1,2003-10-31,2,1,1,0.5,2,1,1,0.5
20300025,1610612746,1610612760,105.0,124.0,0.4039999999999999,0.535,0,2003-10-31,2,0,2,0.0,2,2,0,1.0
20300023,1610612763,1610612738,91.0,93.0,0.37,0.472,0,2003-10-31,1,0,1,0.0,2,2,0,1.0
20300018,1610612756,1610612739,95.0,86.0,0.413,0.43,1,2003-10-30,2,1,1,0.5,2,0,2,0.0
20300017,1610612745,1610612743,102.0,85.0,0.487,0.356,1,2003-10-30,1,1,0,1.0,2,1,1,0.5
20300016,1610612753,1610612740,98.0,100.0,0.41,0.449,0,2003-10-30,2,1,1,0.5,2,2,0,1.0
20300015,1610612760,1610612746,109.0,100.0,0.408,0.418,1,2003-10-30,1,1,0,1.0,1,0,1,0.0
20300005,1610612752,1610612753,83.0,85.0,0.4,0.368,0,2003-10-29,1,0,1,0.0,1,1,0,1.0
20300004,1610612738,1610612748,98.0,75.0,0.507,0.366,1,2003-10-29,1,1,0,1.0,2,0,2,0.0
20300009,1610612750,1610612749,95.0,89.0,0.447,0.422,1,2003-10-29,1,1,0,1.0,1,0,1,0.0
20300008,1610612765,1610612754,87.0,89.0,0.392,0.456,0,2003-10-29,1,0,1,0.0,1,1,0,1.0
20300010,1610612741,1610612764,74.0,99.0,0.317,0.487,0,2003-10-29,1,0,1,0.0,1,1,0,1.0
20300013,1610612744,1610612742,87.0,95.0,0.391,0.436,0,2003-10-29,1,0,1,0.0,2,1,1,0.5
20300014,1610612758,1610612739,106.0,92.0,0.506,0.465,1,2003-10-29,1,1,0,1.0,1,0,1,0.0
20300011,1610612743,1610612759,80.0,72.0,0.292,0.268,1,2003-10-29,1,1,0,1.0,2,1,1,0.5
20300007,1610612761,1610612751,90.0,87.0,0.425,0.407,1,2003-10-29,1,1,0,1.0,1,0,1,0.0
20300006,1610612740,1610612737,88.0,83.0,0.324,0.3979999999999999,1,2003-10-29,1,1,0,1.0,1,0,1,0.0
20300012,1610612762,1610612757,99.0,92.0,0.575,0.429,1,2003-10-29,1,1,0,1.0,1,0,1,0.0
20300001,1610612755,1610612748,89.0,74.0,0.44,0.408,1,2003-10-28,1,1,0,1.0,1,0,1,0.0
20300002,1610612759,1610612756,83.0,82.0,0.425,0.361,1,2003-10-28,1,1,0,1.0,1,0,1,0.0
20300003,1610612747,1610612742,109.0,93.0,0.506,0.376,1,2003-10-28,1,1,0,1.0,1,0,1,0.0
10300116,1610612753,1610612762,,,,,0,2003-10-24,0,0,0,0.0,0,0,0,0.0
10300108,1610612737,1610612764,,,,,0,2003-10-24,0,0,0,0.0,0,0,0,0.0
10300109,1610612738,1610612751,,,,,0,2003-10-24,0,0,0,0.0,0,0,0,0.0
10300113,1610612759,1610612745,,,,,0,2003-10-24,0,0,0,0.0,0,0,0,0.0
10300112,1610612749,1610612765,,,,,0,2003-10-24,0,0,0,0.0,0,0,0,0.0
10300110,1610612756,1610612757,,,,,0,2003-10-24,0,0,0,0.0,0,0,0,0.0
10300111,1610612743,1610612754,,,,,0,2003-10-24,0,0,0,0.0,0,0,0,0.0
10300114,1610612746,1610612744,,,,,0,2003-10-24,0,0,0,0.0,0,0,0,0.0
10300115,1610612747,1610612758,,,,,0,2003-10-24,0,0,0,0.0,0,0,0,0.0
10300103,1610612761,1610612739,,,,,0,2003-10-23,0,0,0,0.0,0,0,0,0.0
10300106,1610612755,1610612751,,,,,0,2003-10-23,0,0,0,0.0,0,0,0,0.0
10300107,1610612752,1610612762,,,,,0,2003-10-23,0,0,0,0.0,0,0,0,0.0
10300104,1610612750,1610612754,,,,,0,2003-10-23,0,0,0,0.0,0,0,0,0.0
10300102,1610612741,1610612763,,,,,0,2003-10-23,0,0,0,0.0,0,0,0,0.0
10300105,1610612747,1610612746,,,,,0,2003-10-23,0,0,0,0.0,0,0,0,0.0
10300094,1610612753,1610612737,,,,,0,2003-10-22,0,0,0,0.0,0,0,0,0.0
10300095,1610612738,1610612750,,,,,0,2003-10-22,0,0,0,0.0,0,0,0,0.0
10300101,1610612739,1610612764,,,,,0,2003-10-22,0,0,0,0.0,0,0,0,0.0
10300097,1610612745,1610612743,,,,,0,2003-10-22,0,0,0,0.0,0,0,0,0.0
10300099,1610612759,1610612740,,,,,0,2003-10-22,0,0,0,0.0,0,0,0,0.0
10300096,1610612758,1610612742,,,,,0,2003-10-22,0,0,0,0.0,0,0,0,0.0
10300098,1610612760,1610612744,,,,,0,2003-10-22,0,0,0,0.0,0,0,0,0.0
10300100,1610612757,1610612756,,,,,0,2003-10-22,0,0,0,0.0,0,0,0,0.0
10300089,1610612761,1610612741,,,,,0,2003-10-21,0,0,0,0.0,0,0,0,0.0
10300091,1610612765,1610612749,,,,,0,2003-10-21,0,0,0,0.0,0,0,0,0.0
10300093,1610612751,1610612752,,,,,0,2003-10-21,0,0,0,0.0,0,0,0,0.0
10300090,1610612742,1610612762,,,,,0,2003-10-21,0,0,0,0.0,0,0,0,0.0
10300092,1610612748,1610612763,,,,,0,2003-10-21,0,0,0,0.0,0,0,0,0.0
10300085,1610612764,1610612737,,,,,0,2003-10-20,0,0,0,0.0,0,0,0,0.0
10300088,1610612755,1610612740,,,,,0,2003-10-20,0,0,0,0.0,0,0,0,0.0
10300087,1610612750,1610612749,,,,,0,2003-10-20,0,0,0,0.0,0,0,0,0.0
10300086,1610612757,1610612743,,,,,0,2003-10-20,0,0,0,0.0,0,0,0,0.0
10300080,1610612765,1610612743,,,,,0,2003-10-19,0,0,0,0.0,0,0,0,0.0
10300082,1610612759,1610612742,,,,,0,2003-10-19,0,0,0,0.0,0,0,0,0.0
10300083,1610612758,1610612760,,,,,0,2003-10-19,0,0,0,0.0,0,0,0,0.0
10300084,1610612744,1610612746,,,,,0,2003-10-19,0,0,0,0.0,0,0,0,0.0
10300081,1610612747,1610612739,,,,,0,2003-10-19,0,0,0,0.0,0,0,0,0.0
10300074,1610612738,1610612754,,,,,0,2003-10-18,0,0,0,0.0,0,0,0,0.0
10300077,1610612751,1610612761,,,,,0,2003-10-18,0,0,0,0.0,0,0,0,0.0
10300073,1610612763,1610612737,,,,,0,2003-10-18,0,0,0,0.0,0,0,0,0.0
10300079,1610612740,1610612764,,,,,0,2003-10-18,0,0,0,0.0,0,0,0,0.0
10300075,1610612741,1610612749,,,,,0,2003-10-18,0,0,0,0.0,0,0,0,0.0
10300076,1610612742,1610612755,,,,,0,2003-10-18,0,0,0,0.0,0,0,0,0.0
10300078,1610612760,1610612757,,,,,0,2003-10-18,0,0,0,0.0,0,0,0,0.0
10300069,1610612761,1610612743,,,,,0,2003-10-17,0,0,0,0.0,0,0,0,0.0
10300064,1610612751,1610612738,,,,,0,2003-10-17,0,0,0,0.0,0,0,0,0.0
10300071,1610612746,1610612739,,,,,0,2003-10-17,0,0,0,0.0,0,0,0,0.0
10300066,1610612765,1610612748,,,,,0,2003-10-17,0,0,0,0.0,0,0,0,0.0
10300067,1610612763,1610612753,,,,,0,2003-10-17,0,0,0,0.0,0,0,0,0.0
10300070,1610612754,1610612750,,,,,0,2003-10-17,0,0,0,0.0,0,0,0,0.0
10300068,1610612759,1610612752,,,,,0,2003-10-17,0,0,0,0.0,0,0,0,0.0
10300065,1610612762,1610612755,,,,,0,2003-10-17,0,0,0,0.0,0,0,0,0.0
10300072,1610612747,1610612756,,,,,0,2003-10-17,0,0,0,0.0,0,0,0,0.0
10300058,1610612737,1610612748,,,,,0,2003-10-16,0,0,0,0.0,0,0,0,0.0
10300062,1610612746,1610612756,,,,,0,2003-10-16,0,0,0,0.0,0,0,0,0.0
10300059,1610612740,1610612741,,,,,0,2003-10-16,0,0,0,0.0,0,0,0,0.0
10300060,1610612745,1610612758,,,,,0,2003-10-16,0,0,0,0.0,0,0,0,0.0
10300061,1610612762,1610612753,,,,,0,2003-10-16,0,0,0,0.0,0,0,0,0.0
10300063,1610612747,1610612739,,,,,0,2003-10-16,0,0,0,0.0,0,0,0,0.0
10300057,1610612750,1610612761,,,,,0,2003-10-15,0,0,0,0.0,0,0,0,0.0
10300054,1610612765,1610612738,,,,,0,2003-10-15,0,0,0,0.0,0,0,0,0.0
10300055,1610612754,1610612743,,,,,0,2003-10-15,0,0,0,0.0,0,0,0,0.0
10300056,1610612744,1610612760,,,,,0,2003-10-15,0,0,0,0.0,0,0,0,0.0
10300051,1610612753,1610612740,,,,,0,2003-10-14,0,0,0,0.0,0,0,0,0.0
10300049,1610612748,1610612759,,,,,0,2003-10-14,0,0,0,0.0,0,0,0,0.0
10300050,1610612751,1610612755,,,,,0,2003-10-14,0,0,0,0.0,0,0,0,0.0
10300048,1610612763,1610612764,,,,,0,2003-10-14,0,0,0,0.0,0,0,0,0.0
10300044,1610612741,1610612754,,,,,0,2003-10-14,0,0,0,0.0,0,0,0,0.0
10300052,1610612762,1610612752,,,,,0,2003-10-14,0,0,0,0.0,0,0,0,0.0
10300046,1610612758,1610612745,,,,,0,2003-10-14,0,0,0,0.0,0,0,0,0.0
10300053,1610612757,1610612760,,,,,0,2003-10-14,0,0,0,0.0,0,0,0,0.0
10300045,1610612746,1610612742,,,,,0,2003-10-14,0,0,0,0.0,0,0,0,0.0
10300047,1610612747,1610612756,,,,,0,2003-10-14,0,0,0,0.0,0,0,0,0.0
10300043,1610612739,1610612749,,,,,0,2003-10-13,0,0,0,0.0,0,0,0,0.0
10300042,1610612750,1610612737,,,,,0,2003-10-13,0,0,0,0.0,0,0,0,0.0
10300039,1610612765,1610612761,,,,,0,2003-10-12,0,0,0,0.0,0,0,0,0.0
10300040,1610612752,1610612759,,,,,0,2003-10-12,0,0,0,0.0,0,0,0,0.0
10300041,1610612745,1610612740,,,,,0,2003-10-12,0,0,0,0.0,0,0,0,0.0
10300034,1610612752,1610612750,,,,,0,2003-10-11,0,0,0,0.0,0,0,0,0.0
10300035,1610612753,1610612748,,,,,0,2003-10-11,0,0,0,0.0,0,0,0,0.0
10300036,1610612755,1610612759,,,,,0,2003-10-11,0,0,0,0.0,0,0,0,0.0
10300030,1610612754,1610612738,,,,,0,2003-10-11,0,0,0,0.0,0,0,0,0.0
10300031,1610612749,1610612741,,,,,0,2003-10-11,0,0,0,0.0,0,0,0,0.0
10300032,1610612742,1610612740,,,,,0,2003-10-11,0,0,0,0.0,0,0,0,0.0
10300033,1610612756,1610612743,,,,,0,2003-10-11,0,0,0,0.0,0,0,0,0.0
10300037,1610612744,1610612758,,,,,0,2003-10-11,0,0,0,0.0,0,0,0,0.0
10300038,1610612762,1610612760,,,,,0,2003-10-11,0,0,0,0.0,0,0,0,0.0
10300023,1610612748,1610612737,,,,,0,2003-10-10,0,0,0,0.0,0,0,0,0.0
10300027,1610612764,1610612755,,,,,0,2003-10-10,0,0,0,0.0,0,0,0,0.0
10300024,1610612741,1610612738,,,,,0,2003-10-10,0,0,0,0.0,0,0,0,0.0
10300025,1610612745,1610612760,,,,,0,2003-10-10,0,0,0,0.0,0,0,0,0.0
10300026,1610612746,1610612757,,,,,0,2003-10-10,0,0,0,0.0,0,0,0,0.0
10300020,1610612749,1610612750,,,,,0,2003-10-09,0,0,0,0.0,0,0,0,0.0
10300021,1610612752,1610612751,,,,,0,2003-10-09,0,0,0,0.0,0,0,0,0.0
10300019,1610612743,1610612756,,,,,0,2003-10-09,0,0,0,0.0,0,0,0,0.0
10300022,1610612757,1610612758,,,,,0,2003-10-09,0,0,0,0.0,0,0,0,0.0
10300013,1610612759,1610612763,,,,,0,2003-10-08,0,0,0,0.0,0,0,0,0.0
10300011,1610612737,1610612739,80.0,83.0,0.35,0.4379999999999999,0,2003-10-08,0,0,0,0.0,0,0,0,0.0
10300018,1610612761,1610612764,76.0,71.0,0.3829999999999999,0.358,1,2003-10-08,0,0,0,0.0,0,0,0,0.0
10300014,1610612738,1610612765,89.0,104.0,0.462,0.493,0,2003-10-08,0,0,0,0.0,0,0,0,0.0
10300012,1610612754,1610612741,62.0,58.0,0.385,0.457,1,2003-10-08,0,0,0,0.0,0,0,0,0.0
10300017,1610612740,1610612753,105.0,98.0,0.527,0.5,1,2003-10-08,0,0,0,0.0,0,0,0,0.0
10300016,1610612760,1610612745,98.0,78.0,0.413,0.3289999999999999,1,2003-10-08,0,0,0,0.0,0,0,0,0.0
10300015,1610612747,1610612744,,,,,0,2003-10-08,0,0,0,0.0,0,0,0,0.0
10300006,1610612747,1610612744,,,,,0,2003-10-07,0,0,0,0.0,0,0,0,0.0
10300010,1610612764,1610612752,104.0,86.0,0.506,0.38,1,2003-10-07,0,0,0,0.0,0,0,0,0.0
10300003,1610612765,1610612739,96.0,100.0,0.391,0.494,0,2003-10-07,0,0,0,0.0,0,0,0,0.0
10300004,1610612742,1610612753,99.0,89.0,0.488,0.408,1,2003-10-07,0,0,0,0.0,0,0,0,0.0
10300008,1610612756,1610612751,79.0,101.0,0.3329999999999999,0.4639999999999999,0,2003-10-07,0,0,0,0.0,0,0,0,0.0
10300007,1610612748,1610612755,86.0,79.0,0.352,0.3289999999999999,1,2003-10-07,0,0,0,0.0,0,0,0,0.0
10300005,1610612757,1610612745,104.0,80.0,0.527,0.47,1,2003-10-07,0,0,0,0.0,0,0,0,0.0
10300009,1610612758,1610612746,101.0,82.0,0.467,0.368,1,2003-10-07,0,0,0,0.0,0,0,0,0.0
10300002,1610612763,1610612749,105.0,94.0,0.494,0.4270000000000001,1,2003-10-06,0,0,0,0.0,0,0,0,0.0
10300001,1610612762,1610612742,90.0,85.0,0.457,0.447,1,2003-10-05,0,0,0,0.0,0,0,0,0.0
21900293,1610612766,1610612756,104.0,109.0,0.452,0.4429999999999999,0,2019-12-02,22,8,14,0.364,19,9,10,0.474
21900294,1610612755,1610612762,103.0,94.0,0.407,0.469,1,2019-12-02,21,15,6,0.7140000000000001,21,12,9,0.5710000000000001
21900295,1610612737,1610612744,104.0,79.0,0.461,0.3979999999999999,1,2019-12-02,21,5,16,0.238,22,4,18,0.182
21900296,1610612763,1610612754,104.0,117.0,0.4270000000000001,0.5,0,2019-12-02,20,6,14,0.3,20,13,7,0.65
21900297,1610612749,1610612752,132.0,88.0,0.5579999999999999,0.308,1,2019-12-02,21,18,3,0.857,21,4,17,0.19
21900298,1610612758,1610612741,106.0,113.0,0.482,0.48,0,2019-12-02,19,8,11,0.421,21,7,14,0.3329999999999999
21900284,1610612751,1610612748,106.0,109.0,0.44,0.389,0,2019-12-01,20,10,10,0.5,19,14,5,0.737
21900285,1610612752,1610612738,104.0,113.0,0.461,0.441,0,2019-12-01,20,4,16,0.2,19,14,5,0.737
21900286,1610612750,1610612763,107.0,115.0,0.3879999999999999,0.41,0,2019-12-01,19,10,9,0.526,19,6,13,0.316
21900287,1610612747,1610612742,100.0,114.0,0.46,0.433,0,2019-12-01,20,17,3,0.85,19,13,6,0.684
21900288,1610612765,1610612759,132.0,98.0,0.591,0.409,1,2019-12-01,20,7,13,0.35,21,7,14,0.3329999999999999
21900289,1610612740,1610612760,104.0,107.0,0.4479999999999999,0.469,0,2019-12-01,20,6,14,0.3,19,8,11,0.421
21900290,1610612753,1610612744,100.0,96.0,0.425,0.396,1,2019-12-01,19,8,11,0.421,21,4,17,0.19
21900291,1610612761,1610612762,130.0,110.0,0.522,0.422,1,2019-12-01,19,15,4,0.789,20,12,8,0.6
21900292,1610612746,1610612764,150.0,125.0,0.5529999999999999,0.461,1,2019-12-01,21,15,6,0.7140000000000001,18,6,12,0.3329999999999999
21900280,1610612758,1610612743,100.0,97.0,0.385,0.414,1,2019-11-30,18,8,10,0.444,17,13,4,0.765
21900281,1610612755,1610612754,119.0,116.0,0.494,0.5529999999999999,1,2019-11-30,20,14,6,0.7,19,12,7,0.632
21900282,1610612745,1610612737,158.0,111.0,0.584,0.4270000000000001,1,2019-11-30,19,13,6,0.684,20,4,16,0.2
21900283,1610612749,1610612766,137.0,96.0,0.563,0.366,1,2019-11-30,20,17,3,0.85,21,8,13,0.381
21900267,1610612751,1610612738,112.0,107.0,0.462,0.441,1,2019-11-29,19,10,9,0.526,18,13,5,0.722
21900268,1610612765,1610612766,107.0,110.0,0.494,0.482,0,2019-11-29,19,6,13,0.316,20,8,12,0.4
21900269,1610612753,1610612761,83.0,90.0,0.346,0.369,0,2019-11-29,18,7,11,0.389,18,14,4,0.778
21900270,1610612739,1610612749,110.0,119.0,0.5,0.511,0,2019-11-29,19,5,14,0.263,19,16,3,0.8420000000000001
21900271,1610612752,1610612755,95.0,101.0,0.436,0.431,0,2019-11-29,19,4,15,0.211,19,13,6,0.684
21900272,1610612754,1610612737,105.0,104.0,0.424,0.433,1,2019-11-29,18,12,6,0.667,19,4,15,0.211
21900273,1610612748,1610612744,122.0,105.0,0.537,0.39,1,2019-11-29,18,13,5,0.722,20,4,16,0.2
21900274,1610612763,1610612762,94.0,103.0,0.3939999999999999,0.4,0,2019-11-29,18,5,13,0.278,19,12,7,0.632
21900275,1610612760,1610612740,109.0,104.0,0.478,0.4479999999999999,1,2019-11-29,18,7,11,0.389,19,6,13,0.316
21900276,1610612759,1610612746,107.0,97.0,0.43,0.391,1,2019-11-29,20,7,13,0.35,20,14,6,0.7
21900277,1610612756,1610612742,113.0,120.0,0.441,0.412,0,2019-11-29,18,8,10,0.444,18,12,6,0.667
21900278,1610612757,1610612741,107.0,103.0,0.452,0.3829999999999999,1,2019-11-29,20,8,12,0.4,20,6,14,0.3
21900279,1610612747,1610612764,125.0,103.0,0.517,0.396,1,2019-11-29,19,17,2,0.895,17,6,11,0.353
21900253,1610612738,1610612751,121.0,110.0,0.4429999999999999,0.444,1,2019-11-27,17,13,4,0.765,18,9,9,0.5
21900254,1610612766,1610612765,102.0,101.0,0.4429999999999999,0.466,1,2019-11-27,19,7,12,0.368,18,6,12,0.3329999999999999
21900255,1610612739,1610612753,104.0,116.0,0.457,0.484,0,2019-11-27,18,5,13,0.278,17,7,10,0.412
21900256,1610612754,1610612762,121.0,102.0,0.521,0.434,1,2019-11-27,17,11,6,0.647,18,11,7,0.611
21900257,1610612755,1610612758,97.0,91.0,0.4679999999999999,0.411,1,2019-11-27,18,12,6,0.667,17,7,10,0.412
21900258,1610612761,1610612752,126.0,98.0,0.489,0.375,1,2019-11-27,17,13,4,0.765,18,4,14,0.222
21900259,1610612745,1610612748,117.0,108.0,0.4579999999999999,0.4629999999999999,1,2019-11-27,18,12,6,0.667,17,12,5,0.706
21900260,1610612763,1610612746,119.0,121.0,0.467,0.4629999999999999,0,2019-11-27,17,5,12,0.294,19,14,5,0.737
21900261,1610612749,1610612737,111.0,102.0,0.477,0.4039999999999999,1,2019-11-27,18,15,3,0.833,18,4,14,0.222
21900262,1610612759,1610612750,101.0,113.0,0.423,0.435,0,2019-11-27,19,6,13,0.316,18,10,8,0.556
21900263,1610612756,1610612764,132.0,140.0,0.516,0.573,0,2019-11-27,17,8,9,0.471,16,6,10,0.375
21900264,1610612740,1610612747,110.0,114.0,0.405,0.518,0,2019-11-27,18,6,12,0.3329999999999999,18,16,2,0.889
21900265,1610612757,1610612760,136.0,119.0,0.521,0.4429999999999999,1,2019-11-27,19,7,12,0.368,17,6,11,0.353
21900266,1610612744,1610612741,104.0,90.0,0.457,0.382,1,2019-11-27,19,4,15,0.211,19,6,13,0.316
21900251,1610612742,1610612746,99.0,114.0,0.38,0.423,0,2019-11-26,17,11,6,0.647,18,13,5,0.722
21900252,1610612743,1610612764,117.0,104.0,0.522,0.421,1,2019-11-26,16,13,3,0.813,15,5,10,0.3329999999999999
21900240,1610612739,1610612751,106.0,108.0,0.426,0.4679999999999999,0,2019-11-25,17,5,12,0.294,17,9,8,0.529
21900241,1610612765,1610612753,103.0,88.0,0.43,0.381,1,2019-11-25,17,6,11,0.353,16,6,10,0.375
21900242,1610612754,1610612763,126.0,114.0,0.5429999999999999,0.479,1,2019-11-25,16,10,6,0.625,16,5,11,0.313
21900243,1610612737,1610612750,113.0,125.0,0.436,0.456,0,2019-11-25,17,4,13,0.235,17,9,8,0.529
21900244,1610612738,1610612758,103.0,102.0,0.447,0.4679999999999999,1,2019-11-25,16,12,4,0.75,16,7,9,0.4379999999999999
21900245,1610612748,1610612766,117.0,100.0,0.519,0.414,1,2019-11-25,16,12,4,0.75,18,6,12,0.3329999999999999
21900246,1610612761,1610612755,101.0,96.0,0.452,0.409,1,2019-11-25,16,12,4,0.75,17,11,6,0.647
21900247,1610612741,1610612757,94.0,117.0,0.419,0.517,0,2019-11-25,18,6,12,0.3329999999999999,18,6,12,0.3329999999999999
21900248,1610612749,1610612762,122.0,118.0,0.4429999999999999,0.506,1,2019-11-25,17,14,3,0.8240000000000001,17,11,6,0.647
21900249,1610612759,1610612747,104.0,114.0,0.466,0.494,0,2019-11-25,18,6,12,0.3329999999999999,17,15,2,0.882
21900250,1610612744,1610612760,97.0,100.0,0.416,0.471,0,2019-11-25,18,3,15,0.1669999999999999,16,6,10,0.375
21900235,1610612745,1610612742,123.0,137.0,0.4589999999999999,0.48,0,2019-11-24,17,11,6,0.647,16,11,5,0.688
21900236,1610612752,1610612751,101.0,103.0,0.4629999999999999,0.4029999999999999,0,2019-11-24,17,4,13,0.235,16,8,8,0.5
21900237,1610612764,1610612758,106.0,113.0,0.457,0.481,0,2019-11-24,14,5,9,0.357,15,7,8,0.467
21900238,1610612743,1610612756,116.0,104.0,0.473,0.5,1,2019-11-24,15,12,3,0.8,16,8,8,0.5
21900239,1610612746,1610612740,134.0,109.0,0.469,0.439,1,2019-11-24,17,12,5,0.706,17,6,11,0.353
21900225,1610612750,1610612756,98.0,100.0,0.418,0.344,0,2019-11-23,16,8,8,0.5,15,8,7,0.5329999999999999
21900226,1610612766,1610612741,115.0,116.0,0.55,0.4529999999999999,0,2019-11-23,17,6,11,0.353,17,6,11,0.353
21900227,1610612754,1610612753,111.0,106.0,0.544,0.467,1,2019-11-23,15,9,6,0.6,15,6,9,0.4
21900228,1610612737,1610612761,116.0,119.0,0.522,0.455,0,2019-11-23,16,4,12,0.25,15,11,4,0.733
21900229,1610612752,1610612759,104.0,111.0,0.43,0.5329999999999999,0,2019-11-23,16,4,12,0.25,17,6,11,0.353
21900230,1610612755,1610612748,113.0,86.0,0.506,0.4,1,2019-11-23,16,11,5,0.688,15,11,4,0.733
21900231,1610612739,1610612757,110.0,104.0,0.425,0.4479999999999999,1,2019-11-23,16,5,11,0.313,17,5,12,0.294
21900232,1610612763,1610612747,108.0,109.0,0.483,0.452,0,2019-11-23,15,5,10,0.3329999999999999,16,14,2,0.875
21900233,1610612749,1610612765,104.0,90.0,0.488,0.407,1,2019-11-23,16,13,3,0.813,16,5,11,0.313
21900234,1610612762,1610612740,128.0,120.0,0.512,0.416,1,2019-11-23,16,11,5,0.688,16,6,10,0.375
21900215,1610612765,1610612737,128.0,103.0,0.598,0.4320000000000001,1,2019-11-22,15,5,10,0.3329999999999999,15,4,11,0.267
21900216,1610612764,1610612766,125.0,118.0,0.527,0.516,1,2019-11-22,13,5,8,0.385,16,6,10,0.375
21900217,1610612751,1610612758,116.0,97.0,0.506,0.4529999999999999,1,2019-11-22,15,7,8,0.467,14,6,8,0.429
21900218,1610612755,1610612759,115.0,104.0,0.517,0.506,1,2019-11-22,15,10,5,0.667,16,5,11,0.313
21900219,1610612741,1610612748,108.0,116.0,0.456,0.494,0,2019-11-22,16,5,11,0.313,14,11,3,0.7859999999999999
21900220,1610612760,1610612747,127.0,130.0,0.527,0.511,0,2019-11-22,15,5,10,0.3329999999999999,15,13,2,0.867
21900221,1610612742,1610612739,143.0,101.0,0.58,0.43,1,2019-11-22,15,10,5,0.667,15,4,11,0.267
21900222,1610612743,1610612738,96.0,92.0,0.4429999999999999,0.407,1,2019-11-22,14,11,3,0.7859999999999999,15,11,4,0.733
21900223,1610612762,1610612744,113.0,109.0,0.506,0.457,1,2019-11-22,15,10,5,0.667,17,3,14,0.176
21900224,1610612746,1610612745,122.0,119.0,0.517,0.4639999999999999,1,2019-11-22,16,11,5,0.688,16,11,5,0.688
21900213,1610612749,1610612757,137.0,129.0,0.472,0.485,1,2019-11-21,15,12,3,0.8,16,5,11,0.313
21900214,1610612756,1610612740,121.0,124.0,0.465,0.534,0,2019-11-21,14,7,7,0.5,15,6,9,0.4
21900202,1610612755,1610612752,109.0,104.0,0.4379999999999999,0.476,1,2019-11-20,14,9,5,0.643,15,4,11,0.267
21900203,1610612764,1610612759,138.0,132.0,0.5870000000000001,0.527,1,2019-11-20,12,4,8,0.3329999999999999,15,5,10,0.3329999999999999
21900204,1610612737,1610612749,127.0,135.0,0.4579999999999999,0.529,0,2019-11-20,14,4,10,0.286,14,11,3,0.7859999999999999
21900205,1610612751,1610612766,101.0,91.0,0.4,0.37,1,2019-11-20,14,6,8,0.429,15,6,9,0.4
21900206,1610612748,1610612739,124.0,100.0,0.526,0.425,1,2019-11-20,13,10,3,0.769,14,4,10,0.286
21900207,1610612761,1610612753,113.0,97.0,0.517,0.385,1,2019-11-20,14,10,4,0.7140000000000001,14,6,8,0.429
21900208,1610612742,1610612744,142.0,94.0,0.5670000000000001,0.389,1,2019-11-20,14,9,5,0.643,16,3,13,0.188
21900209,1610612741,1610612765,109.0,89.0,0.429,0.337,1,2019-11-20,15,5,10,0.3329999999999999,14,4,10,0.286
21900210,1610612750,1610612762,95.0,103.0,0.3929999999999999,0.407,0,2019-11-20,15,8,7,0.5329999999999999,14,9,5,0.643
21900211,1610612743,1610612745,105.0,95.0,0.4679999999999999,0.421,1,2019-11-20,13,10,3,0.769,15,11,4,0.733
21900212,1610612746,1610612738,107.0,104.0,0.419,0.3939999999999999,1,2019-11-20,15,10,5,0.667,14,11,3,0.7859999999999999
21900198,1610612763,1610612744,95.0,114.0,0.409,0.478,0,2019-11-19,14,5,9,0.357,15,3,12,0.2
21900199,1610612740,1610612757,115.0,104.0,0.441,0.435,1,2019-11-19,14,5,9,0.357,15,5,10,0.3329999999999999
21900200,1610612758,1610612756,120.0,116.0,0.532,0.4270000000000001,1,2019-11-19,13,6,7,0.462,13,7,6,0.5379999999999999
21900201,1610612747,1610612760,112.0,107.0,0.483,0.475,1,2019-11-19,14,12,2,0.857,14,5,9,0.357
21900189,1610612752,1610612739,123.0,105.0,0.449,0.474,1,2019-11-18,14,4,10,0.286,13,4,9,0.308
21900190,1610612751,1610612754,86.0,115.0,0.357,0.436,0,2019-11-18,13,5,8,0.385,14,8,6,0.5710000000000001
21900191,1610612761,1610612766,132.0,96.0,0.515,0.423,1,2019-11-18,13,9,4,0.6920000000000001,14,6,8,0.429
21900192,1610612741,1610612749,101.0,115.0,0.402,0.4629999999999999,0,2019-11-18,14,4,10,0.286,13,10,3,0.769
21900193,1610612745,1610612757,132.0,108.0,0.47,0.417,1,2019-11-18,14,11,3,0.7859999999999999,14,5,9,0.357
21900194,1610612742,1610612759,117.0,110.0,0.5,0.4579999999999999,1,2019-11-18,13,8,5,0.615,14,5,9,0.357
21900195,1610612756,1610612738,85.0,99.0,0.402,0.416,0,2019-11-18,12,7,5,0.583,13,11,2,0.846
21900196,1610612762,1610612750,102.0,112.0,0.365,0.461,0,2019-11-18,13,8,5,0.615,14,8,6,0.5710000000000001
21900197,1610612746,1610612760,90.0,88.0,0.402,0.373,1,2019-11-18,14,9,5,0.643,13,5,8,0.385
21900183,1610612739,1610612755,95.0,114.0,0.3779999999999999,0.5479999999999999,0,2019-11-17,12,4,8,0.3329999999999999,13,8,5,0.615
21900184,1610612758,1610612738,100.0,99.0,0.4270000000000001,0.415,1,2019-11-17,12,5,7,0.417,12,10,2,0.833
21900185,1610612753,1610612764,125.0,121.0,0.494,0.474,1,2019-11-17,13,6,7,0.462,11,3,8,0.273
21900186,1610612763,1610612743,114.0,131.0,0.4639999999999999,0.551,0,2019-11-17,13,5,8,0.385,12,9,3,0.75
21900187,1610612740,1610612744,108.0,100.0,0.416,0.407,1,2019-11-17,13,4,9,0.308,14,2,12,0.143
21900188,1610612747,1610612737,122.0,101.0,0.528,0.43,1,2019-11-17,13,11,2,0.846,13,4,9,0.308
21900175,1610612741,1610612751,111.0,117.0,0.352,0.455,0,2019-11-16,13,4,9,0.308,12,5,7,0.417
21900176,1610612754,1610612749,83.0,102.0,0.32,0.4479999999999999,0,2019-11-16,13,7,6,0.5379999999999999,12,9,3,0.75
21900177,1610612752,1610612766,102.0,103.0,0.4529999999999999,0.414,0,2019-11-16,13,3,10,0.231,13,6,7,0.462
21900178,1610612748,1610612740,109.0,94.0,0.5429999999999999,0.451,1,2019-11-16,12,9,3,0.75,12,3,9,0.25
21900179,1610612750,1610612745,105.0,125.0,0.452,0.457,0,2019-11-16,13,7,6,0.5379999999999999,13,10,3,0.769
21900180,1610612742,1610612761,110.0,102.0,0.42,0.416,1,2019-11-16,12,7,5,0.583,12,8,4,0.667
21900181,1610612759,1610612757,116.0,121.0,0.466,0.452,0,2019-11-16,13,5,8,0.385,13,5,8,0.385
21900182,1610612746,1610612737,150.0,101.0,0.5379999999999999,0.3779999999999999,1,2019-11-16,13,8,5,0.615,12,4,8,0.3329999999999999
21900167,1610612766,1610612765,109.0,106.0,0.4479999999999999,0.494,1,2019-11-15,12,5,7,0.417,13,4,9,0.308
21900168,1610612753,1610612759,111.0,109.0,0.414,0.506,1,2019-11-15,12,5,7,0.417,12,5,7,0.417
21900169,1610612745,1610612754,111.0,102.0,0.4039999999999999,0.451,1,2019-11-15,12,9,3,0.75,12,7,5,0.583
21900170,1610612763,1610612762,107.0,106.0,0.4479999999999999,0.402,1,2019-11-15,12,5,7,0.417,12,8,4,0.667
21900171,1610612750,1610612764,116.0,137.0,0.472,0.54,0,2019-11-15,12,7,5,0.583,10,3,7,0.3
21900172,1610612760,1610612755,127.0,119.0,0.539,0.5,1,2019-11-15,12,5,7,0.417,12,7,5,0.583
21900173,1610612744,1610612738,100.0,105.0,0.415,0.407,0,2019-11-15,13,2,11,0.154,11,10,1,0.909
21900174,1610612747,1610612758,99.0,97.0,0.42,0.439,1,2019-11-15,12,10,2,0.833,11,4,7,0.364
21900161,1610612739,1610612748,97.0,108.0,0.424,0.544,0,2019-11-14,11,4,7,0.364,11,8,3,0.727
21900162,1610612752,1610612742,106.0,103.0,0.447,0.429,1,2019-11-14,12,3,9,0.25,11,6,5,0.545
21900163,1610612749,1610612741,124.0,115.0,0.477,0.409,1,2019-11-14,11,8,3,0.727,12,4,8,0.3329999999999999
21900164,1610612740,1610612746,132.0,127.0,0.48,0.5479999999999999,1,2019-11-14,11,3,8,0.273,12,7,5,0.583
21900165,1610612756,1610612737,128.0,112.0,0.482,0.44,1,2019-11-14,11,7,4,0.636,11,4,7,0.364
21900166,1610612743,1610612751,101.0,93.0,0.426,0.379,1,2019-11-14,11,8,3,0.727,11,4,7,0.364
21900154,1610612766,1610612763,117.0,119.0,0.494,0.539,0,2019-11-13,11,4,7,0.364,11,4,7,0.364
21900155,1610612753,1610612755,112.0,97.0,0.442,0.44,1,2019-11-13,11,4,7,0.364,11,7,4,0.636
21900156,1610612738,1610612764,140.0,133.0,0.51,0.521,1,2019-11-13,10,9,1,0.9,9,2,7,0.222
21900157,1610612745,1610612746,102.0,93.0,0.384,0.3879999999999999,1,2019-11-13,11,8,3,0.727,11,7,4,0.636
21900158,1610612750,1610612759,129.0,114.0,0.495,0.489,1,2019-11-13,11,7,4,0.636,11,5,6,0.455
21900159,1610612747,1610612744,120.0,94.0,0.539,0.4039999999999999,1,2019-11-13,11,9,2,0.818,12,2,10,0.1669999999999999
21900160,1610612757,1610612761,106.0,114.0,0.396,0.457,0,2019-11-13,12,4,8,0.3329999999999999,11,8,3,0.727
21900146,1610612754,1610612760,111.0,85.0,0.489,0.354,1,2019-11-12,11,7,4,0.636,11,4,7,0.364
21900147,1610612755,1610612739,98.0,97.0,0.449,0.442,1,2019-11-12,10,7,3,0.7,10,4,6,0.4
21900148,1610612748,1610612765,117.0,108.0,0.532,0.436,1,2019-11-12,10,7,3,0.7,12,4,8,0.3329999999999999
21900149,1610612741,1610612752,120.0,102.0,0.506,0.409,1,2019-11-12,11,4,7,0.364,11,2,9,0.182
21900150,1610612743,1610612737,121.0,125.0,0.442,0.53,0,2019-11-12,10,7,3,0.7,10,4,6,0.4
21900151,1610612756,1610612747,115.0,123.0,0.473,0.537,0,2019-11-12,10,6,4,0.6,10,8,2,0.8
21900152,1610612762,1610612751,119.0,114.0,0.467,0.456,1,2019-11-12,11,8,3,0.727,10,4,6,0.4
21900153,1610612758,1610612757,107.0,99.0,0.442,0.442,1,2019-11-12,10,4,6,0.4,11,4,7,0.364
21900140,1610612765,1610612750,114.0,120.0,0.4479999999999999,0.506,0,2019-11-11,11,4,7,0.364,10,6,4,0.6
21900141,1610612738,1610612742,116.0,106.0,0.477,0.416,1,2019-11-11,9,8,1,0.889,10,6,4,0.6
21900143,1610612759,1610612763,109.0,113.0,0.467,0.506,0,2019-11-11,10,5,5,0.5,10,3,7,0.3
21900142,1610612740,1610612745,116.0,122.0,0.4320000000000001,0.518,0,2019-11-11,10,2,8,0.2,10,7,3,0.7
21900144,1610612744,1610612762,108.0,122.0,0.479,0.494,0,2019-11-11,11,2,9,0.182,10,7,3,0.7
21900145,1610612746,1610612761,98.0,88.0,0.37,0.4,1,2019-11-11,10,7,3,0.7,10,7,3,0.7
21900132,1610612750,1610612743,98.0,100.0,0.351,0.386,0,2019-11-10,9,5,4,0.556,9,7,2,0.778
21900133,1610612753,1610612754,102.0,109.0,0.461,0.527,0,2019-11-10,10,3,7,0.3,10,6,4,0.6
21900134,1610612755,1610612766,114.0,106.0,0.5479999999999999,0.452,1,2019-11-10,9,6,3,0.667,10,4,6,0.4
21900135,1610612760,1610612749,119.0,121.0,0.495,0.5660000000000001,0,2019-11-10,10,4,6,0.4,10,7,3,0.7
21900136,1610612752,1610612739,87.0,108.0,0.36,0.439,0,2019-11-10,10,2,8,0.2,9,4,5,0.444
21900137,1610612756,1610612751,138.0,112.0,0.525,0.484,1,2019-11-10,9,6,3,0.667,9,4,5,0.444
21900138,1610612757,1610612737,124.0,113.0,0.433,0.4039999999999999,1,2019-11-10,10,4,6,0.4,9,3,6,0.3329999999999999
21900139,1610612747,1610612761,104.0,113.0,0.436,0.483,0,2019-11-10,9,7,2,0.778,9,7,2,0.778
21900127,1610612759,1610612738,115.0,135.0,0.3939999999999999,0.511,0,2019-11-09,9,5,4,0.556,8,7,1,0.875
21900128,1610612766,1610612740,110.0,115.0,0.409,0.5329999999999999,0,2019-11-09,9,4,5,0.444,9,2,7,0.222
21900129,1610612741,1610612745,94.0,117.0,0.3779999999999999,0.47,0,2019-11-09,10,3,7,0.3,9,6,3,0.667
21900130,1610612763,1610612742,122.0,138.0,0.526,0.536,0,2019-11-09,9,2,7,0.222,9,6,3,0.667
21900131,1610612760,1610612744,114.0,108.0,0.544,0.494,1,2019-11-09,9,4,5,0.444,10,2,8,0.2
21900116,1610612754,1610612765,112.0,106.0,0.518,0.4529999999999999,1,2019-11-08,9,5,4,0.556,10,4,6,0.4
21900117,1610612753,1610612763,118.0,86.0,0.473,0.3720000000000001,1,2019-11-08,9,3,6,0.3329999999999999,8,2,6,0.25
21900118,1610612764,1610612739,100.0,113.0,0.469,0.456,0,2019-11-08,8,2,6,0.25,8,3,5,0.375
21900119,1610612737,1610612758,109.0,121.0,0.529,0.5529999999999999,0,2019-11-08,8,3,5,0.375,9,3,6,0.3329999999999999
21900120,1610612750,1610612744,125.0,119.0,0.4320000000000001,0.417,1,2019-11-08,8,5,3,0.625,9,2,7,0.222
21900121,1610612740,1610612761,104.0,122.0,0.4039999999999999,0.441,0,2019-11-08,8,1,7,0.125,8,6,2,0.75
21900122,1610612742,1610612752,102.0,106.0,0.411,0.416,0,2019-11-08,8,5,3,0.625,9,2,7,0.222
21900123,1610612743,1610612755,100.0,97.0,0.4479999999999999,0.442,1,2019-11-08,8,6,2,0.75,8,5,3,0.625
21900124,1610612762,1610612749,103.0,100.0,0.405,0.358,1,2019-11-08,9,6,3,0.667,9,6,3,0.667
21900125,1610612757,1610612751,115.0,119.0,0.412,0.414,0,2019-11-08,9,3,6,0.3329999999999999,8,4,4,0.5
21900126,1610612747,1610612748,95.0,80.0,0.449,0.35,1,2019-11-08,8,7,1,0.875,9,6,3,0.667
21900112,1610612766,1610612738,87.0,108.0,0.384,0.43,0,2019-11-07,8,4,4,0.5,7,6,1,0.857
21900113,1610612759,1610612760,121.0,112.0,0.5429999999999999,0.525,1,2019-11-07,8,5,3,0.625,8,3,5,0.375
21900114,1610612756,1610612748,108.0,124.0,0.44,0.5489999999999999,0,2019-11-07,8,5,3,0.625,8,6,2,0.75
21900115,1610612746,1610612757,107.0,101.0,0.4379999999999999,0.375,1,2019-11-07,9,6,3,0.667,8,3,5,0.375
21900103,1610612765,1610612752,122.0,102.0,0.557,0.488,1,2019-11-06,9,4,5,0.444,8,1,7,0.125
21900104,1610612754,1610612764,121.0,106.0,0.4679999999999999,0.389,1,2019-11-06,8,4,4,0.5,7,2,5,0.286
21900105,1610612737,1610612741,93.0,113.0,0.405,0.5,0,2019-11-06,7,3,4,0.429,9,3,6,0.3329999999999999
21900106,1610612761,1610612758,124.0,120.0,0.551,0.442,1,2019-11-06,7,5,2,0.7140000000000001,8,2,6,0.25
21900107,1610612745,1610612744,129.0,112.0,0.495,0.396,1,2019-11-06,8,5,3,0.625,8,2,6,0.25
21900108,1610612763,1610612750,137.0,121.0,0.568,0.4479999999999999,1,2019-11-06,7,2,5,0.286,7,4,3,0.5710000000000001
21900109,1610612742,1610612753,107.0,106.0,0.429,0.488,1,2019-11-06,7,5,2,0.7140000000000001,8,2,6,0.25
21900110,1610612762,1610612755,106.0,104.0,0.461,0.413,1,2019-11-06,8,5,3,0.625,7,5,2,0.7140000000000001
21900111,1610612746,1610612749,124.0,129.0,0.418,0.429,0,2019-11-06,8,5,3,0.625,8,6,2,0.75
21900097,1610612766,1610612754,122.0,120.0,0.477,0.5429999999999999,1,2019-11-05,7,4,3,0.5710000000000001,7,3,4,0.429
21900098,1610612739,1610612738,113.0,119.0,0.421,0.565,0,2019-11-05,7,2,5,0.286,6,5,1,0.833
21900099,1610612737,1610612759,108.0,100.0,0.478,0.418,1,2019-11-05,6,3,3,0.5,7,4,3,0.5710000000000001
21900100,1610612741,1610612747,112.0,118.0,0.506,0.489,0,2019-11-05,8,2,6,0.25,7,6,1,0.857
21900101,1610612760,1610612753,102.0,94.0,0.43,0.39,1,2019-11-05,7,3,4,0.429,7,2,5,0.286
21900102,1610612743,1610612748,109.0,89.0,0.523,0.364,1,2019-11-05,7,5,2,0.7140000000000001,7,5,2,0.7140000000000001
21900091,1610612764,1610612765,115.0,99.0,0.462,0.415,1,2019-11-04,6,2,4,0.3329999999999999,8,3,5,0.375
21900092,1610612751,1610612740,135.0,125.0,0.5329999999999999,0.495,1,2019-11-04,7,3,4,0.429,7,1,6,0.143
21900093,1610612763,1610612745,100.0,107.0,0.426,0.376,0,2019-11-04,6,1,5,0.1669999999999999,7,4,3,0.5710000000000001
21900094,1610612750,1610612749,106.0,134.0,0.359,0.5379999999999999,0,2019-11-04,6,4,2,0.667,7,5,2,0.7140000000000001
21900095,1610612756,1610612755,114.0,109.0,0.532,0.472,1,2019-11-04,7,5,2,0.7140000000000001,6,5,1,0.833
21900096,1610612744,1610612757,127.0,118.0,0.488,0.4479999999999999,1,2019-11-04,7,2,5,0.286,7,3,4,0.429
21900085,1610612754,1610612741,108.0,95.0,0.471,0.429,1,2019-11-03,6,3,3,0.5,7,2,5,0.286
21900086,1610612748,1610612745,129.0,100.0,0.528,0.392,1,2019-11-03,6,5,1,0.833,6,3,3,0.5
21900087,1610612752,1610612758,92.0,113.0,0.4,0.482,0,2019-11-03,7,1,6,0.143,7,2,5,0.286
21900088,1610612759,1610612747,96.0,103.0,0.3979999999999999,0.483,0,2019-11-03,6,4,2,0.667,6,5,1,0.833
21900089,1610612739,1610612742,111.0,131.0,0.406,0.532,0,2019-11-03,6,2,4,0.3329999999999999,6,4,2,0.667
21900090,1610612746,1610612762,105.0,94.0,0.391,0.397,1,2019-11-03,7,5,2,0.7140000000000001,7,4,3,0.5710000000000001
21900077,1610612760,1610612740,115.0,104.0,0.456,0.426,1,2019-11-02,6,2,4,0.3329999999999999,6,1,5,0.1669999999999999
21900078,1610612765,1610612751,113.0,109.0,0.451,0.462,1,2019-11-02,7,3,4,0.429,6,2,4,0.3329999999999999
21900079,1610612753,1610612743,87.0,91.0,0.43,0.37,0,2019-11-02,6,2,4,0.3329999999999999,6,4,2,0.667
21900080,1610612764,1610612750,109.0,131.0,0.389,0.5429999999999999,0,2019-11-02,5,1,4,0.2,5,4,1,0.8
21900081,1610612763,1610612756,105.0,114.0,0.488,0.5,0,2019-11-02,5,1,4,0.2,6,4,2,0.667
21900082,1610612749,1610612761,115.0,105.0,0.461,0.405,1,2019-11-02,6,4,2,0.667,6,4,2,0.667
21900083,1610612744,1610612766,87.0,93.0,0.442,0.424,0,2019-11-02,6,1,5,0.1669999999999999,6,3,3,0.5
21900084,1610612757,1610612755,128.0,129.0,0.5770000000000001,0.505,0,2019-11-02,6,3,3,0.5,5,5,0,1.0
21900069,1610612751,1610612745,123.0,116.0,0.494,0.414,1,2019-11-01,5,2,3,0.4,5,3,2,0.6
21900070,1610612754,1610612739,102.0,95.0,0.406,0.368,1,2019-11-01,5,2,3,0.4,5,2,3,0.4
21900071,1610612753,1610612749,91.0,123.0,0.374,0.505,0,2019-11-01,5,2,3,0.4,5,3,2,0.6
21900072,1610612738,1610612752,104.0,102.0,0.446,0.3979999999999999,1,2019-11-01,5,4,1,0.8,6,1,5,0.1669999999999999
21900073,1610612741,1610612765,112.0,106.0,0.4379999999999999,0.482,1,2019-11-01,6,2,4,0.3329999999999999,6,2,4,0.3329999999999999
21900074,1610612742,1610612747,110.0,119.0,0.392,0.49,0,2019-11-01,5,3,2,0.6,5,4,1,0.8
21900075,1610612758,1610612762,102.0,101.0,0.488,0.479,1,2019-11-01,6,1,5,0.1669999999999999,6,4,2,0.667
21900076,1610612744,1610612759,110.0,127.0,0.4639999999999999,0.473,0,2019-11-01,5,1,4,0.2,5,4,1,0.8
21900066,1610612737,1610612748,97.0,106.0,0.409,0.476,0,2019-10-31,5,2,3,0.4,5,4,1,0.8
21900067,1610612740,1610612743,122.0,107.0,0.532,0.483,1,2019-10-31,5,1,4,0.2,5,3,2,0.6
21900068,1610612746,1610612759,103.0,97.0,0.429,0.45,1,2019-10-31,6,4,2,0.667,4,3,1,0.75
21900055,1610612739,1610612741,117.0,111.0,0.526,0.433,1,2019-10-30,4,2,2,0.5,5,1,4,0.2
21900056,1610612753,1610612752,95.0,83.0,0.42,0.3779999999999999,1,2019-10-30,4,2,2,0.5,5,1,4,0.2
21900057,1610612755,1610612750,117.0,95.0,0.467,0.395,1,2019-10-30,4,4,0,1.0,4,3,1,0.75
21900058,1610612738,1610612749,116.0,105.0,0.446,0.4629999999999999,1,2019-10-30,4,3,1,0.75,4,2,2,0.5
21900059,1610612751,1610612754,108.0,118.0,0.441,0.469,0,2019-10-30,4,1,3,0.25,4,1,3,0.25
21900060,1610612761,1610612765,125.0,113.0,0.593,0.466,1,2019-10-30,5,4,1,0.8,5,2,3,0.4
21900061,1610612764,1610612745,158.0,159.0,0.626,0.534,0,2019-10-30,4,1,3,0.25,4,3,1,0.75
21900062,1610612760,1610612757,99.0,102.0,0.3929999999999999,0.395,0,2019-10-30,5,1,4,0.2,5,3,2,0.6
21900063,1610612762,1610612746,110.0,96.0,0.55,0.476,1,2019-10-30,5,4,1,0.8,5,3,2,0.6
21900064,1610612758,1610612766,111.0,118.0,0.4579999999999999,0.5479999999999999,0,2019-10-30,5,0,5,0.0,5,2,3,0.4
21900065,1610612744,1610612756,110.0,121.0,0.439,0.4579999999999999,0,2019-10-30,4,1,3,0.25,5,3,2,0.6
21900052,1610612748,1610612737,112.0,97.0,0.452,0.422,1,2019-10-29,4,3,1,0.75,4,2,2,0.5
21900053,1610612743,1610612742,106.0,109.0,0.473,0.488,0,2019-10-29,4,3,1,0.75,4,3,1,0.75
21900054,1610612747,1610612763,120.0,91.0,0.465,0.326,1,2019-10-29,4,3,1,0.75,4,1,3,0.25
21900041,1610612765,1610612754,96.0,94.0,0.457,0.415,1,2019-10-28,4,2,2,0.5,3,0,3,0.0
21900042,1610612752,1610612741,105.0,98.0,0.418,0.424,1,2019-10-28,4,1,3,0.25,4,1,3,0.25
21900043,1610612737,1610612755,103.0,105.0,0.429,0.42,0,2019-10-28,3,2,1,0.667,3,3,0,1.0
21900044,1610612761,1610612753,104.0,95.0,0.3879999999999999,0.382,1,2019-10-28,4,3,1,0.75,3,1,2,0.3329999999999999
21900045,1610612745,1610612760,116.0,112.0,0.433,0.436,1,2019-10-28,3,2,1,0.667,4,1,3,0.25
21900046,1610612749,1610612739,129.0,112.0,0.522,0.45,1,2019-10-28,3,2,1,0.667,3,1,2,0.3329999999999999
21900047,1610612740,1610612744,123.0,134.0,0.466,0.49,0,2019-10-28,4,0,4,0.0,3,1,2,0.3329999999999999
21900048,1610612759,1610612757,113.0,110.0,0.482,0.39,1,2019-10-28,3,3,0,1.0,4,2,2,0.5
21900049,1610612756,1610612762,95.0,96.0,0.413,0.38,0,2019-10-28,4,2,2,0.5,4,3,1,0.75
21900050,1610612758,1610612743,94.0,101.0,0.396,0.3670000000000001,0,2019-10-28,4,0,4,0.0,3,3,0,1.0
21900051,1610612746,1610612766,111.0,96.0,0.482,0.434,1,2019-10-28,4,3,1,0.75,4,1,3,0.25
21900036,1610612760,1610612744,120.0,92.0,0.564,0.326,1,2019-10-27,3,1,2,0.3329999999999999,2,0,2,0.0
21900037,1610612763,1610612751,134.0,133.0,0.485,0.436,1,2019-10-27,3,1,2,0.3329999999999999,3,1,2,0.3329999999999999
21900038,1610612742,1610612757,119.0,121.0,0.3939999999999999,0.517,0,2019-10-27,3,2,1,0.667,3,2,1,0.667
21900039,1610612750,1610612748,116.0,109.0,0.429,0.494,1,2019-10-27,3,3,0,1.0,3,2,1,0.667
21900040,1610612747,1610612766,120.0,101.0,0.527,0.385,1,2019-10-27,3,2,1,0.667,3,1,2,0.3329999999999999
21900026,1610612749,1610612748,126.0,131.0,0.436,0.455,0,2019-10-26,2,1,1,0.5,2,2,0,1.0
21900027,1610612765,1610612755,111.0,117.0,0.539,0.483,0,2019-10-26,3,1,2,0.3329999999999999,2,2,0,1.0
21900028,1610612737,1610612753,103.0,99.0,0.512,0.354,1,2019-10-26,2,2,0,1.0,2,1,1,0.5
21900029,1610612752,1610612738,95.0,118.0,0.3779999999999999,0.452,0,2019-10-26,3,0,3,0.0,3,2,1,0.667
21900030,1610612739,1610612754,110.0,99.0,0.5,0.4479999999999999,1,2019-10-26,2,1,1,0.5,2,0,2,0.0
21900031,1610612741,1610612761,84.0,108.0,0.299,0.4629999999999999,0,2019-10-26,3,1,2,0.3329999999999999,3,2,1,0.667
21900032,1610612745,1610612740,126.0,123.0,0.457,0.46,1,2019-10-26,2,1,1,0.5,3,0,3,0.0
21900033,1610612759,1610612764,124.0,122.0,0.4629999999999999,0.495,1,2019-10-26,2,2,0,1.0,3,1,2,0.3329999999999999
21900034,1610612762,1610612758,113.0,81.0,0.564,0.37,1,2019-10-26,3,2,1,0.667,3,0,3,0.0
21900035,1610612756,1610612746,130.0,122.0,0.5,0.46,1,2019-10-26,3,2,1,0.667,3,2,1,0.667
21900017,1610612738,1610612761,112.0,106.0,0.385,0.474,1,2019-10-25,2,1,1,0.5,2,1,1,0.5
21900018,1610612766,1610612750,99.0,121.0,0.44,0.473,0,2019-10-25,2,1,1,0.5,2,2,0,1.0
21900019,1610612751,1610612752,113.0,109.0,0.474,0.469,1,2019-10-25,2,1,1,0.5,2,0,2,0.0
21900020,1610612763,1610612741,102.0,110.0,0.415,0.43,0,2019-10-25,2,0,2,0.0,2,1,1,0.5
21900021,1610612740,1610612742,116.0,123.0,0.4589999999999999,0.484,0,2019-10-25,2,0,2,0.0,2,2,0,1.0
21900022,1610612760,1610612764,85.0,97.0,0.3979999999999999,0.402,0,2019-10-25,2,0,2,0.0,2,1,1,0.5
21900023,1610612743,1610612756,108.0,107.0,0.391,0.395,1,2019-10-25,2,2,0,1.0,2,1,1,0.5
21900024,1610612758,1610612757,112.0,122.0,0.425,0.541,0,2019-10-25,2,0,2,0.0,2,1,1,0.5
21900025,1610612747,1610612762,95.0,86.0,0.395,0.414,1,2019-10-25,2,1,1,0.5,2,1,1,0.5
21900014,1610612765,1610612737,100.0,117.0,0.412,0.512,0,2019-10-24,2,1,1,0.5,1,1,0,1.0
21900015,1610612745,1610612749,111.0,117.0,0.3670000000000001,0.465,0,2019-10-24,1,0,1,0.0,1,1,0,1.0
21900016,1610612744,1610612746,122.0,141.0,0.3939999999999999,0.625,0,2019-10-24,1,0,1,0.0,2,2,0,1.0
21900003,1610612766,1610612741,126.0,125.0,0.511,0.467,1,2019-10-23,1,1,0,1.0,1,0,1,0.0
21900004,1610612754,1610612765,110.0,119.0,0.461,0.526,0,2019-10-23,1,0,1,0.0,1,1,0,1.0
21900005,1610612753,1610612739,94.0,85.0,0.43,0.375,1,2019-10-23,1,1,0,1.0,1,0,1,0.0
21900006,1610612751,1610612750,126.0,127.0,0.475,0.426,0,2019-10-23,1,0,1,0.0,1,1,0,1.0
21900007,1610612748,1610612763,120.0,101.0,0.471,0.4270000000000001,1,2019-10-23,1,1,0,1.0,1,0,1,0.0
21900008,1610612755,1610612738,107.0,93.0,0.435,0.3670000000000001,1,2019-10-23,1,1,0,1.0,1,0,1,0.0
21900009,1610612742,1610612764,108.0,100.0,0.461,0.3979999999999999,1,2019-10-23,1,1,0,1.0,1,0,1,0.0
21900010,1610612759,1610612752,120.0,111.0,0.506,0.4679999999999999,1,2019-10-23,1,1,0,1.0,1,0,1,0.0
21900011,1610612762,1610612760,100.0,95.0,0.444,0.386,1,2019-10-23,1,1,0,1.0,1,0,1,0.0
21900012,1610612756,1610612758,124.0,95.0,0.5,0.391,1,2019-10-23,1,1,0,1.0,1,0,1,0.0
21900013,1610612757,1610612743,100.0,108.0,0.414,0.42,0,2019-10-23,1,0,1,0.0,1,1,0,1.0
21900001,1610612761,1610612740,130.0,122.0,0.408,0.422,1,2019-10-22,1,1,0,1.0,1,0,1,0.0
21900002,1610612746,1610612747,112.0,102.0,0.519,0.435,1,2019-10-22,1,1,0,1.0,1,0,1,0.0
11900074,1610612755,1610612764,93.0,112.0,0.405,0.482,0,2019-10-18,5,4,1,0.8,5,3,2,0.6
11900075,1610612751,1610612761,107.0,123.0,0.3879999999999999,0.4629999999999999,0,2019-10-18,4,3,1,0.75,4,2,2,0.5
11900076,1610612748,1610612745,133.0,144.0,0.5429999999999999,0.523,0,2019-10-18,5,4,1,0.8,6,4,2,0.667
11900077,1610612752,1610612740,116.0,117.0,0.473,0.488,0,2019-10-18,4,1,3,0.25,5,5,0,1.0
11900078,1610612759,1610612763,104.0,91.0,0.396,0.344,1,2019-10-18,5,2,3,0.4,5,3,2,0.6
11900079,1610612744,1610612747,124.0,103.0,0.409,0.41,1,2019-10-18,5,2,3,0.4,6,3,3,0.5
11900069,1610612753,1610612748,98.0,107.0,0.429,0.506,0,2019-10-17,6,3,3,0.5,4,4,0,1.0
11900070,1610612741,1610612737,111.0,93.0,0.441,0.418,1,2019-10-17,5,2,3,0.4,5,1,4,0.2
11900071,1610612749,1610612750,118.0,96.0,0.512,0.313,1,2019-10-17,5,5,0,1.0,5,2,3,0.4
11900072,1610612743,1610612757,110.0,104.0,0.461,0.475,1,2019-10-17,4,4,0,1.0,5,2,3,0.4
11900073,1610612746,1610612742,87.0,102.0,0.366,0.449,0,2019-10-17,5,2,3,0.4,5,2,3,0.4
11900062,1610612766,1610612765,110.0,116.0,0.513,0.483,0,2019-10-16,5,1,4,0.2,5,3,2,0.6
11900063,1610612752,1610612737,96.0,100.0,0.395,0.3670000000000001,0,2019-10-16,3,1,2,0.3329999999999999,4,1,3,0.25
11900064,1610612745,1610612759,114.0,128.0,0.4379999999999999,0.5710000000000001,0,2019-10-16,5,3,2,0.6,4,1,3,0.25
11900065,1610612760,1610612763,119.0,124.0,0.461,0.4679999999999999,0,2019-10-16,4,2,2,0.5,4,3,1,0.75
11900066,1610612762,1610612757,118.0,126.0,0.451,0.578,0,2019-10-16,5,1,4,0.2,4,2,2,0.5
11900068,1610612747,1610612744,126.0,93.0,0.598,0.365,1,2019-10-16,5,3,2,0.6,4,1,3,0.25
11900059,1610612739,1610612738,95.0,118.0,0.429,0.547,0,2019-10-15,4,1,3,0.25,4,4,0,1.0
11900060,1610612754,1610612750,111.0,119.0,0.402,0.43,0,2019-10-15,4,3,1,0.75,4,2,2,0.5
11900061,1610612755,1610612765,106.0,86.0,0.457,0.326,1,2019-10-15,4,4,0,1.0,4,2,2,0.5
11900053,1610612748,1610612737,120.0,87.0,0.457,0.41,1,2019-10-14,3,3,0,1.0,3,0,3,0.0
11900054,1610612763,1610612766,99.0,120.0,0.376,0.479,0,2019-10-14,3,2,1,0.667,4,1,3,0.25
11900055,1610612742,1610612760,107.0,70.0,0.422,0.326,1,2019-10-14,4,1,3,0.25,3,2,1,0.667
11900057,1610612762,1610612758,115.0,128.0,0.488,0.46,0,2019-10-14,4,1,3,0.25,4,2,2,0.5
11900056,1610612756,1610612743,102.0,107.0,0.4,0.4629999999999999,0,2019-10-14,4,2,2,0.5,3,3,0,1.0
11900058,1610612747,1610612744,104.0,98.0,0.418,0.362,1,2019-10-14,4,2,2,0.5,3,1,2,0.3329999999999999
11900046,1610612738,1610612739,118.0,72.0,0.511,0.3289999999999999,1,2019-10-13,3,3,0,1.0,3,1,2,0.3329999999999999
11900048,1610612759,1610612740,114.0,123.0,0.4629999999999999,0.489,0,2019-10-13,3,0,3,0.0,4,4,0,1.0
11900049,1610612753,1610612755,94.0,126.0,0.391,0.525,0,2019-10-13,5,3,2,0.6,3,3,0,1.0
11900050,1610612761,1610612741,91.0,105.0,0.4,0.411,0,2019-10-13,3,1,2,0.3329999999999999,4,1,3,0.25
11900051,1610612764,1610612749,108.0,115.0,0.4320000000000001,0.5,0,2019-10-13,4,2,2,0.5,4,4,0,1.0
11900044,1610612751,1610612747,91.0,77.0,0.4579999999999999,0.337,1,2019-10-12,3,3,0,1.0,3,1,2,0.3329999999999999
11900045,1610612757,1610612756,118.0,134.0,0.532,0.506,0,2019-10-12,3,1,2,0.3329999999999999,3,2,1,0.667
11900037,1610612765,1610612739,109.0,105.0,0.482,0.43,1,2019-10-11,3,2,1,0.667,2,1,1,0.5
11900038,1610612754,1610612741,105.0,87.0,0.439,0.376,1,2019-10-11,3,3,0,1.0,3,0,3,0.0
11900039,1610612753,1610612738,75.0,100.0,0.313,0.419,0,2019-10-11,4,3,1,0.75,2,2,0,1.0
11900040,1610612766,1610612755,87.0,100.0,0.363,0.4579999999999999,0,2019-10-11,3,0,3,0.0,2,2,0,1.0
11900041,1610612752,1610612764,99.0,115.0,0.39,0.449,0,2019-10-11,2,1,1,0.5,3,2,1,0.667
11900042,1610612740,1610612762,128.0,127.0,0.517,0.59,1,2019-10-11,3,3,0,1.0,3,1,2,0.3329999999999999
11900043,1610612742,1610612749,111.0,118.0,0.3939999999999999,0.5,0,2019-10-11,3,0,3,0.0,3,3,0,1.0
11900030,1610612745,1610612761,118.0,111.0,0.3879999999999999,0.391,1,2019-10-10,4,3,1,0.75,2,1,1,0.5
11900031,1610612747,1610612751,111.0,114.0,0.4320000000000001,0.45,0,2019-10-10,2,1,1,0.5,2,2,0,1.0
11900034,1610612758,1610612756,105.0,88.0,0.411,0.314,1,2019-10-10,3,1,2,0.3329999999999999,2,1,1,0.5
11900035,1610612744,1610612750,143.0,123.0,0.526,0.407,1,2019-10-10,2,1,1,0.5,2,0,2,0.0
11900036,1610612746,1610612743,91.0,111.0,0.4379999999999999,0.506,0,2019-10-10,3,1,2,0.3329999999999999,2,2,0,1.0
11900024,1610612765,1610612742,124.0,117.0,0.517,0.4679999999999999,1,2019-10-09,2,1,1,0.5,2,0,2,0.0
11900026,1610612737,1610612753,88.0,97.0,0.3379999999999999,0.376,0,2019-10-09,2,0,2,0.0,3,3,0,1.0
11900027,1610612766,1610612748,94.0,108.0,0.412,0.483,0,2019-10-09,2,0,2,0.0,2,2,0,1.0
11900028,1610612741,1610612740,125.0,127.0,0.471,0.545,0,2019-10-09,2,0,2,0.0,2,2,0,1.0
11900029,1610612749,1610612762,133.0,99.0,0.568,0.3720000000000001,1,2019-10-09,2,2,0,1.0,2,1,1,0.5
11900017,1610612761,1610612745,134.0,129.0,0.506,0.479,1,2019-10-08,1,1,0,1.0,3,2,1,0.667
11900019,1610612748,1610612759,107.0,89.0,0.461,0.4,1,2019-10-08,1,1,0,1.0,2,0,2,0.0
11900021,1610612760,1610612742,119.0,104.0,0.532,0.362,1,2019-10-08,1,1,0,1.0,1,0,1,0.0
11900022,1610612756,1610612750,111.0,106.0,0.5,0.419,1,2019-10-08,1,1,0,1.0,1,0,1,0.0
11900023,1610612757,1610612743,94.0,105.0,0.341,0.447,0,2019-10-08,1,0,1,0.0,1,1,0,1.0
11900013,1610612765,1610612753,91.0,115.0,0.337,0.455,0,2019-10-07,1,0,1,0.0,2,2,0,1.0
11900014,1610612764,1610612752,99.0,104.0,0.351,0.418,0,2019-10-07,1,0,1,0.0,1,1,0,1.0
11900015,1610612737,1610612740,109.0,133.0,0.46,0.455,0,2019-10-07,1,0,1,0.0,1,1,0,1.0
11900016,1610612741,1610612749,112.0,122.0,0.3779999999999999,0.477,0,2019-10-07,1,0,1,0.0,1,1,0,1.0
11900010,1610612738,1610612766,107.0,106.0,0.46,0.444,1,2019-10-06,1,1,0,1.0,1,0,1,0.0
11900005,1610612754,1610612758,130.0,106.0,0.521,0.3779999999999999,1,2019-10-05,2,2,0,1.0,2,0,2,0.0
11900006,1610612744,1610612747,101.0,123.0,0.3929999999999999,0.475,0,2019-10-05,1,0,1,0.0,1,1,0,1.0
11900007,1610612759,1610612753,89.0,125.0,0.3879999999999999,0.526,0,2019-10-05,1,0,1,0.0,1,1,0,1.0
11900002,1610612746,1610612745,96.0,109.0,0.384,0.375,0,2019-10-04,1,0,1,0.0,2,2,0,1.0
11900003,1610612758,1610612754,131.0,132.0,0.494,0.516,0,2019-10-04,1,0,1,0.0,1,1,0,1.0
41800406,1610612744,1610612761,110.0,114.0,0.488,0.476,0,2019-06-13,82,57,25,0.695,82,58,24,0.7070000000000001
41800405,1610612761,1610612744,105.0,106.0,0.447,0.4629999999999999,0,2019-06-10,82,58,24,0.7070000000000001,82,57,25,0.695
41800404,1610612744,1610612761,92.0,105.0,0.449,0.419,0,2019-06-07,82,57,25,0.695,82,58,24,0.7070000000000001
41800403,1610612744,1610612761,109.0,123.0,0.396,0.524,0,2019-06-05,82,57,25,0.695,82,58,24,0.7070000000000001
41800402,1610612761,1610612744,104.0,109.0,0.3720000000000001,0.4629999999999999,0,2019-06-02,82,58,24,0.7070000000000001,82,57,25,0.695
41800401,1610612761,1610612744,118.0,109.0,0.506,0.436,1,2019-05-30,82,58,24,0.7070000000000001,82,57,25,0.695
41800306,1610612761,1610612749,100.0,94.0,0.486,0.4,1,2019-05-25,82,58,24,0.7070000000000001,82,60,22,0.732
41800305,1610612749,1610612761,99.0,105.0,0.452,0.369,0,2019-05-23,82,60,22,0.732,82,58,24,0.7070000000000001
41800304,1610612761,1610612749,120.0,102.0,0.471,0.4629999999999999,1,2019-05-21,82,58,24,0.7070000000000001,82,60,22,0.732
41800314,1610612757,1610612744,117.0,119.0,0.48,0.465,0,2019-05-20,82,53,29,0.6459999999999999,82,57,25,0.695
41800303,1610612761,1610612749,118.0,112.0,0.392,0.373,1,2019-05-19,82,58,24,0.7070000000000001,82,60,22,0.732
41800313,1610612757,1610612744,99.0,110.0,0.4,0.488,0,2019-05-18,82,53,29,0.6459999999999999,82,57,25,0.695
41800302,1610612749,1610612761,125.0,103.0,0.467,0.425,1,2019-05-17,82,60,22,0.732,82,58,24,0.7070000000000001
41800312,1610612744,1610612757,114.0,111.0,0.512,0.442,1,2019-05-16,82,57,25,0.695,82,53,29,0.6459999999999999
41800301,1610612749,1610612761,108.0,100.0,0.3979999999999999,0.37,1,2019-05-15,82,60,22,0.732,82,58,24,0.7070000000000001
41800311,1610612744,1610612757,116.0,94.0,0.5,0.361,1,2019-05-14,82,57,25,0.695,82,53,29,0.6459999999999999
41800237,1610612743,1610612757,96.0,100.0,0.371,0.409,0,2019-05-12,82,54,28,0.659,82,53,29,0.6459999999999999
41800217,1610612761,1610612755,92.0,90.0,0.382,0.431,1,2019-05-12,82,58,24,0.7070000000000001,82,51,31,0.622
41800226,1610612745,1610612744,113.0,118.0,0.472,0.494,0,2019-05-10,82,53,29,0.6459999999999999,82,57,25,0.695
41800216,1610612755,1610612761,112.0,101.0,0.461,0.4320000000000001,1,2019-05-09,82,51,31,0.622,82,58,24,0.7070000000000001
41800236,1610612757,1610612743,119.0,108.0,0.461,0.384,1,2019-05-09,82,53,29,0.6459999999999999,82,54,28,0.659
41800205,1610612749,1610612738,116.0,91.0,0.447,0.312,1,2019-05-08,82,60,22,0.732,82,49,33,0.598
41800225,1610612744,1610612745,104.0,99.0,0.4589999999999999,0.418,1,2019-05-08,82,57,25,0.695,82,53,29,0.6459999999999999
41800215,1610612761,1610612755,125.0,89.0,0.488,0.418,1,2019-05-07,82,58,24,0.7070000000000001,82,51,31,0.622
41800235,1610612743,1610612757,124.0,98.0,0.494,0.3670000000000001,1,2019-05-07,82,54,28,0.659,82,53,29,0.6459999999999999
41800204,1610612738,1610612749,101.0,113.0,0.3779999999999999,0.44,0,2019-05-06,82,49,33,0.598,82,60,22,0.732
41800224,1610612745,1610612744,112.0,108.0,0.4379999999999999,0.467,1,2019-05-06,82,53,29,0.6459999999999999,82,57,25,0.695
41800214,1610612755,1610612761,96.0,101.0,0.402,0.461,0,2019-05-05,82,51,31,0.622,82,58,24,0.7070000000000001
41800234,1610612757,1610612743,112.0,116.0,0.476,0.435,0,2019-05-05,82,53,29,0.6459999999999999,82,54,28,0.659
41800223,1610612745,1610612744,126.0,121.0,0.484,0.442,1,2019-05-04,82,53,29,0.6459999999999999,82,57,25,0.695
41800203,1610612738,1610612749,116.0,123.0,0.4320000000000001,0.506,0,2019-05-03,82,49,33,0.598,82,60,22,0.732
41800233,1610612757,1610612743,140.0,137.0,0.419,0.4539999999999999,1,2019-05-03,82,53,29,0.6459999999999999,82,54,28,0.659
41800213,1610612755,1610612761,116.0,95.0,0.512,0.422,1,2019-05-02,82,51,31,0.622,82,58,24,0.7070000000000001
41800232,1610612743,1610612757,90.0,97.0,0.347,0.424,0,2019-05-01,82,54,28,0.659,82,53,29,0.6459999999999999
41800202,1610612749,1610612738,123.0,102.0,0.4429999999999999,0.395,1,2019-04-30,82,60,22,0.732,82,49,33,0.598
41800222,1610612744,1610612745,115.0,109.0,0.462,0.4679999999999999,1,2019-04-30,82,57,25,0.695,82,53,29,0.6459999999999999
41800212,1610612761,1610612755,89.0,94.0,0.3670000000000001,0.395,0,2019-04-29,82,58,24,0.7070000000000001,82,51,31,0.622
41800231,1610612743,1610612757,121.0,113.0,0.506,0.519,1,2019-04-29,82,54,28,0.659,82,53,29,0.6459999999999999
41800201,1610612749,1610612738,90.0,112.0,0.348,0.54,0,2019-04-28,82,60,22,0.732,82,49,33,0.598
41800221,1610612744,1610612745,104.0,100.0,0.507,0.419,1,2019-04-28,82,57,25,0.695,82,53,29,0.6459999999999999
41800211,1610612761,1610612755,108.0,95.0,0.519,0.3929999999999999,1,2019-04-27,82,58,24,0.7070000000000001,82,51,31,0.622
41800157,1610612743,1610612759,90.0,86.0,0.3979999999999999,0.365,1,2019-04-27,82,54,28,0.659,82,48,34,0.585
41800146,1610612746,1610612744,110.0,129.0,0.396,0.528,0,2019-04-26,82,48,34,0.585,82,57,25,0.695
41800156,1610612759,1610612743,120.0,103.0,0.5710000000000001,0.4579999999999999,1,2019-04-25,82,48,34,0.585,82,54,28,0.659
41800175,1610612745,1610612762,100.0,93.0,0.444,0.3720000000000001,1,2019-04-24,82,53,29,0.6459999999999999,82,50,32,0.61
41800145,1610612744,1610612746,121.0,129.0,0.4479999999999999,0.541,0,2019-04-24,82,57,25,0.695,82,48,34,0.585
41800115,1610612761,1610612753,115.0,96.0,0.482,0.386,1,2019-04-23,82,58,24,0.7070000000000001,82,42,40,0.512
41800125,1610612755,1610612751,122.0,100.0,0.51,0.387,1,2019-04-23,82,51,31,0.622,82,42,40,0.512
41800155,1610612743,1610612759,108.0,90.0,0.5,0.411,1,2019-04-23,82,54,28,0.659,82,48,34,0.585
41800165,1610612757,1610612760,118.0,115.0,0.469,0.547,1,2019-04-23,82,53,29,0.6459999999999999,82,49,33,0.598
41800104,1610612765,1610612749,104.0,127.0,0.41,0.544,0,2019-04-22,82,41,41,0.5,82,60,22,0.732
41800174,1610612762,1610612745,107.0,91.0,0.43,0.354,1,2019-04-22,82,50,32,0.61,82,53,29,0.6459999999999999
41800134,1610612754,1610612738,106.0,110.0,0.409,0.462,0,2019-04-21,82,48,34,0.585,82,49,33,0.598
41800144,1610612746,1610612744,105.0,113.0,0.425,0.472,0,2019-04-21,82,48,34,0.585,82,57,25,0.695
41800114,1610612753,1610612761,85.0,107.0,0.42,0.5329999999999999,0,2019-04-21,82,42,40,0.512,82,58,24,0.7070000000000001
41800164,1610612760,1610612757,98.0,111.0,0.375,0.411,0,2019-04-21,82,49,33,0.598,82,53,29,0.6459999999999999
41800124,1610612751,1610612755,108.0,112.0,0.4,0.5,0,2019-04-20,82,42,40,0.512,82,51,31,0.622
41800154,1610612759,1610612743,103.0,117.0,0.4679999999999999,0.449,0,2019-04-20,82,48,34,0.585,82,54,28,0.659
41800103,1610612765,1610612749,103.0,119.0,0.385,0.488,0,2019-04-20,82,41,41,0.5,82,60,22,0.732
41800173,1610612762,1610612745,101.0,104.0,0.416,0.384,0,2019-04-20,82,50,32,0.61,82,53,29,0.6459999999999999
41800113,1610612753,1610612761,93.0,98.0,0.363,0.4479999999999999,0,2019-04-19,82,42,40,0.512,82,58,24,0.7070000000000001
41800133,1610612754,1610612738,96.0,104.0,0.42,0.469,0,2019-04-19,82,48,34,0.585,82,49,33,0.598
41800163,1610612760,1610612757,120.0,108.0,0.481,0.47,1,2019-04-19,82,49,33,0.598,82,53,29,0.6459999999999999
41800123,1610612751,1610612755,115.0,131.0,0.406,0.479,0,2019-04-18,82,42,40,0.512,82,51,31,0.622
41800153,1610612759,1610612743,118.0,108.0,0.494,0.519,1,2019-04-18,82,48,34,0.585,82,54,28,0.659
41800143,1610612746,1610612744,105.0,132.0,0.3720000000000001,0.5479999999999999,0,2019-04-18,82,48,34,0.585,82,57,25,0.695
41800132,1610612738,1610612754,99.0,91.0,0.476,0.444,1,2019-04-17,82,49,33,0.598,82,48,34,0.585
41800102,1610612749,1610612765,120.0,99.0,0.522,0.374,1,2019-04-17,82,60,22,0.732,82,41,41,0.5
41800172,1610612745,1610612762,118.0,98.0,0.475,0.3979999999999999,1,2019-04-17,82,53,29,0.6459999999999999,82,50,32,0.61
41800112,1610612761,1610612753,111.0,82.0,0.483,0.37,1,2019-04-16,82,58,24,0.7070000000000001,82,42,40,0.512
41800152,1610612743,1610612759,114.0,105.0,0.483,0.4529999999999999,1,2019-04-16,82,54,28,0.659,82,48,34,0.585
41800162,1610612757,1610612760,114.0,94.0,0.467,0.407,1,2019-04-16,82,53,29,0.6459999999999999,82,49,33,0.598
41800122,1610612755,1610612751,145.0,123.0,0.561,0.478,1,2019-04-15,82,51,31,0.622,82,42,40,0.512
41800142,1610612744,1610612746,131.0,135.0,0.5329999999999999,0.565,0,2019-04-15,82,57,25,0.695,82,48,34,0.585
41800131,1610612738,1610612754,84.0,74.0,0.364,0.3329999999999999,1,2019-04-14,82,49,33,0.598,82,48,34,0.585
41800161,1610612757,1610612760,104.0,99.0,0.419,0.3979999999999999,1,2019-04-14,82,53,29,0.6459999999999999,82,49,33,0.598
41800101,1610612749,1610612765,121.0,86.0,0.489,0.38,1,2019-04-14,82,60,22,0.732,82,41,41,0.5
41800171,1610612745,1610612762,122.0,90.0,0.505,0.39,1,2019-04-14,82,53,29,0.6459999999999999,82,50,32,0.61
41800121,1610612755,1610612751,102.0,111.0,0.407,0.4320000000000001,0,2019-04-13,82,51,31,0.622,82,42,40,0.512
41800111,1610612761,1610612753,101.0,104.0,0.455,0.4,0,2019-04-13,82,58,24,0.7070000000000001,82,42,40,0.512
41800141,1610612744,1610612746,121.0,104.0,0.489,0.4,1,2019-04-13,82,57,25,0.695,82,48,34,0.585
41800151,1610612743,1610612759,96.0,101.0,0.42,0.482,0,2019-04-13,82,54,28,0.659,82,48,34,0.585
21801220,1610612737,1610612754,134.0,135.0,0.417,0.4589999999999999,0,2019-04-10,82,29,53,0.354,82,48,34,0.585
21801221,1610612751,1610612748,113.0,94.0,0.377,0.3879999999999999,1,2019-04-10,82,42,40,0.512,82,39,43,0.476
21801222,1610612766,1610612753,114.0,122.0,0.526,0.545,0,2019-04-10,82,39,43,0.476,82,42,40,0.512
21801223,1610612752,1610612765,89.0,115.0,0.4029999999999999,0.482,0,2019-04-10,82,17,65,0.207,82,41,41,0.5
21801224,1610612755,1610612741,125.0,109.0,0.5589999999999999,0.474,1,2019-04-10,82,51,31,0.622,82,22,60,0.268
21801225,1610612763,1610612744,132.0,117.0,0.49,0.5,1,2019-04-10,82,33,49,0.402,82,57,25,0.695
21801226,1610612749,1610612760,116.0,127.0,0.43,0.485,0,2019-04-10,82,60,22,0.732,82,49,33,0.598
21801227,1610612759,1610612742,105.0,94.0,0.466,0.407,1,2019-04-10,82,48,34,0.585,82,33,49,0.402
21801228,1610612743,1610612750,99.0,95.0,0.4479999999999999,0.429,1,2019-04-10,82,54,28,0.659,82,36,46,0.439
21801229,1610612746,1610612762,143.0,137.0,0.509,0.4429999999999999,1,2019-04-10,82,48,34,0.585,82,50,32,0.61
21801230,1610612757,1610612758,136.0,131.0,0.5820000000000001,0.521,1,2019-04-10,82,53,29,0.6459999999999999,82,39,43,0.476
21801209,1610612739,1610612766,97.0,124.0,0.449,0.5770000000000001,0,2019-04-09,82,19,63,0.2319999999999999,81,39,42,0.481
21801210,1610612765,1610612763,100.0,93.0,0.3979999999999999,0.478,1,2019-04-09,81,40,41,0.494,81,32,49,0.395
21801211,1610612764,1610612738,110.0,116.0,0.423,0.455,0,2019-04-09,82,32,50,0.39,82,49,33,0.598
21801212,1610612748,1610612755,122.0,99.0,0.529,0.408,1,2019-04-09,81,39,42,0.481,81,50,31,0.617
21801213,1610612741,1610612752,86.0,96.0,0.361,0.3979999999999999,0,2019-04-09,81,22,59,0.272,81,17,64,0.21
21801214,1610612750,1610612761,100.0,120.0,0.418,0.523,0,2019-04-09,81,36,45,0.444,82,58,24,0.7070000000000001
21801215,1610612740,1610612744,103.0,112.0,0.444,0.483,0,2019-04-09,82,33,49,0.402,81,57,24,0.7040000000000001
21801216,1610612742,1610612756,120.0,109.0,0.451,0.4320000000000001,1,2019-04-09,81,33,48,0.407,82,19,63,0.2319999999999999
21801217,1610612762,1610612743,118.0,108.0,0.526,0.466,1,2019-04-09,81,50,31,0.617,81,53,28,0.654
21801218,1610612760,1610612745,112.0,111.0,0.417,0.4320000000000001,1,2019-04-09,81,48,33,0.593,82,53,29,0.6459999999999999
21801219,1610612747,1610612757,101.0,104.0,0.426,0.411,0,2019-04-09,82,37,45,0.451,81,52,29,0.642
21801195,1610612761,1610612748,117.0,109.0,0.4479999999999999,0.41,1,2019-04-07,81,57,24,0.7040000000000001,80,38,42,0.475
21801196,1610612739,1610612759,90.0,112.0,0.392,0.524,0,2019-04-07,81,19,62,0.235,81,47,34,0.58
21801197,1610612750,1610612760,126.0,132.0,0.541,0.522,0,2019-04-07,80,36,44,0.45,80,47,33,0.588
21801198,1610612765,1610612766,91.0,104.0,0.37,0.4320000000000001,0,2019-04-07,80,39,41,0.488,80,38,42,0.475
21801199,1610612754,1610612751,96.0,108.0,0.482,0.455,0,2019-04-07,81,47,34,0.58,81,41,40,0.506
21801201,1610612763,1610612742,127.0,129.0,0.429,0.4589999999999999,0,2019-04-07,80,32,48,0.4,80,32,48,0.4
21801200,1610612745,1610612756,149.0,113.0,0.53,0.462,1,2019-04-07,81,53,28,0.654,81,19,62,0.235
21801202,1610612749,1610612737,115.0,107.0,0.44,0.4,1,2019-04-07,81,60,21,0.741,81,29,52,0.358
21801203,1610612738,1610612753,108.0,116.0,0.472,0.456,0,2019-04-07,81,48,33,0.593,81,41,40,0.506
21801204,1610612752,1610612764,113.0,110.0,0.513,0.417,1,2019-04-07,80,16,64,0.2,81,32,49,0.395
21801205,1610612744,1610612746,131.0,104.0,0.546,0.481,1,2019-04-07,80,56,24,0.7,81,47,34,0.58
21801206,1610612757,1610612743,115.0,108.0,0.461,0.442,1,2019-04-07,80,51,29,0.638,80,53,27,0.6629999999999999
21801207,1610612758,1610612740,129.0,133.0,0.4589999999999999,0.515,0,2019-04-07,81,39,42,0.481,81,33,48,0.407
21801208,1610612747,1610612762,113.0,109.0,0.517,0.452,1,2019-04-07,81,37,44,0.457,80,49,31,0.613
21801193,1610612749,1610612751,128.0,133.0,0.557,0.495,0,2019-04-06,80,59,21,0.738,80,40,40,0.5
21801194,1610612741,1610612755,96.0,116.0,0.4270000000000001,0.523,0,2019-04-06,80,22,58,0.275,80,50,30,0.625
21801180,1610612766,1610612761,113.0,111.0,0.4679999999999999,0.5379999999999999,1,2019-04-05,79,37,42,0.4679999999999999,80,56,24,0.7
21801181,1610612753,1610612737,149.0,113.0,0.609,0.436,1,2019-04-05,80,40,40,0.5,80,29,51,0.363
21801182,1610612764,1610612759,112.0,129.0,0.477,0.56,0,2019-04-05,80,32,48,0.4,80,46,34,0.575
21801183,1610612754,1610612738,97.0,117.0,0.413,0.522,0,2019-04-05,80,47,33,0.588,80,48,32,0.6
21801184,1610612745,1610612752,120.0,96.0,0.426,0.451,1,2019-04-05,80,52,28,0.65,79,15,64,0.19
21801185,1610612750,1610612748,111.0,109.0,0.5,0.511,1,2019-04-05,79,36,43,0.456,79,38,41,0.481
21801186,1610612760,1610612765,123.0,110.0,0.475,0.4320000000000001,1,2019-04-05,79,46,33,0.5820000000000001,79,39,40,0.494
21801187,1610612742,1610612763,112.0,122.0,0.4270000000000001,0.479,0,2019-04-05,79,31,48,0.392,79,32,47,0.405
21801188,1610612762,1610612758,119.0,98.0,0.518,0.413,1,2019-04-05,79,49,30,0.62,80,39,41,0.488
21801189,1610612756,1610612740,133.0,126.0,0.49,0.485,1,2019-04-05,80,19,61,0.238,80,32,48,0.4
21801190,1610612743,1610612757,119.0,110.0,0.512,0.488,1,2019-04-05,79,53,26,0.6709999999999999,79,50,29,0.633
21801191,1610612744,1610612739,120.0,114.0,0.529,0.4429999999999999,1,2019-04-05,79,55,24,0.696,80,19,61,0.238
21801192,1610612746,1610612747,117.0,122.0,0.44,0.4479999999999999,0,2019-04-05,80,47,33,0.588,80,36,44,0.45
21801177,1610612755,1610612749,122.0,128.0,0.474,0.452,0,2019-04-04,79,49,30,0.62,79,59,20,0.747
21801178,1610612758,1610612739,117.0,104.0,0.495,0.5429999999999999,1,2019-04-04,79,39,40,0.494,79,19,60,0.241
21801179,1610612747,1610612744,90.0,108.0,0.356,0.439,0,2019-04-04,79,35,44,0.4429999999999999,78,54,24,0.6920000000000001
21801165,1610612765,1610612754,89.0,108.0,0.3879999999999999,0.467,0,2019-04-03,78,39,39,0.5,79,47,32,0.595
21801166,1610612753,1610612752,114.0,100.0,0.455,0.447,1,2019-04-03,79,39,40,0.494,78,15,63,0.192
21801167,1610612764,1610612741,114.0,115.0,0.4639999999999999,0.5329999999999999,0,2019-04-03,79,32,47,0.405,79,22,57,0.278
21801168,1610612737,1610612755,130.0,122.0,0.522,0.4589999999999999,1,2019-04-03,79,29,50,0.3670000000000001,78,49,29,0.628
21801169,1610612751,1610612761,105.0,115.0,0.477,0.419,0,2019-04-03,79,39,40,0.494,79,56,23,0.7090000000000001
21801170,1610612748,1610612738,102.0,112.0,0.411,0.475,0,2019-04-03,78,38,40,0.487,79,47,32,0.595
21801171,1610612740,1610612766,109.0,115.0,0.471,0.422,0,2019-04-03,79,32,47,0.405,78,36,42,0.462
21801172,1610612742,1610612750,108.0,110.0,0.457,0.488,0,2019-04-03,78,31,47,0.397,78,35,43,0.449
21801173,1610612743,1610612759,113.0,85.0,0.54,0.3829999999999999,1,2019-04-03,78,52,26,0.667,79,45,34,0.57
21801174,1610612756,1610612762,97.0,118.0,0.462,0.5710000000000001,0,2019-04-03,79,18,61,0.228,78,48,30,0.615
21801175,1610612757,1610612763,116.0,89.0,0.511,0.3879999999999999,1,2019-04-03,78,50,28,0.6409999999999999,78,31,47,0.397
21801176,1610612746,1610612745,103.0,135.0,0.4629999999999999,0.534,0,2019-04-03,79,47,32,0.595,79,51,28,0.6459999999999999
21801161,1610612760,1610612747,119.0,103.0,0.461,0.476,1,2019-04-02,78,45,33,0.5770000000000001,78,35,43,0.449
21801162,1610612759,1610612737,117.0,111.0,0.525,0.457,1,2019-04-02,78,45,33,0.5770000000000001,78,28,50,0.359
21801163,1610612758,1610612745,105.0,130.0,0.442,0.489,0,2019-04-02,78,38,40,0.487,78,50,28,0.6409999999999999
21801164,1610612744,1610612743,116.0,102.0,0.5429999999999999,0.375,1,2019-04-02,77,53,24,0.688,77,51,26,0.662
21801152,1610612754,1610612765,111.0,102.0,0.545,0.4320000000000001,1,2019-04-01,78,46,32,0.59,77,39,38,0.506
21801153,1610612738,1610612748,110.0,105.0,0.396,0.455,1,2019-04-01,78,46,32,0.59,77,38,39,0.494
21801154,1610612751,1610612749,121.0,131.0,0.415,0.5,0,2019-04-01,78,39,39,0.5,78,58,20,0.7440000000000001
21801155,1610612752,1610612741,113.0,105.0,0.5,0.447,1,2019-04-01,77,15,62,0.195,78,21,57,0.2689999999999999
21801156,1610612761,1610612753,121.0,109.0,0.5,0.462,1,2019-04-01,78,55,23,0.705,78,38,40,0.487
21801157,1610612750,1610612757,122.0,132.0,0.49,0.5489999999999999,0,2019-04-01,77,34,43,0.442,77,49,28,0.636
21801158,1610612742,1610612755,122.0,102.0,0.474,0.387,1,2019-04-01,77,31,46,0.4029999999999999,77,49,28,0.636
21801159,1610612762,1610612766,111.0,102.0,0.481,0.4,1,2019-04-01,77,47,30,0.61,77,35,42,0.455
21801160,1610612756,1610612739,122.0,113.0,0.5479999999999999,0.455,1,2019-04-01,78,18,60,0.231,78,19,59,0.244
21801145,1610612737,1610612749,136.0,135.0,0.441,0.414,1,2019-03-31,77,28,49,0.364,77,57,20,0.74
21801146,1610612760,1610612742,103.0,106.0,0.3879999999999999,0.425,0,2019-03-31,77,44,33,0.5710000000000001,76,30,46,0.395
21801147,1610612740,1610612747,102.0,130.0,0.4579999999999999,0.475,0,2019-03-31,78,32,46,0.41,77,35,42,0.455
21801149,1610612759,1610612758,106.0,113.0,0.4679999999999999,0.481,0,2019-03-31,77,44,33,0.5710000000000001,77,38,39,0.494
21801148,1610612743,1610612764,90.0,95.0,0.376,0.402,0,2019-03-31,76,51,25,0.6709999999999999,78,32,46,0.41
21801150,1610612744,1610612766,137.0,90.0,0.602,0.353,1,2019-03-31,76,52,24,0.684,76,35,41,0.461
21801151,1610612746,1610612763,113.0,96.0,0.48,0.376,1,2019-03-31,78,47,31,0.603,77,31,46,0.4029999999999999
21801136,1610612746,1610612739,132.0,108.0,0.624,0.446,1,2019-03-30,77,46,31,0.597,77,19,58,0.247
21801137,1610612751,1610612738,110.0,96.0,0.4579999999999999,0.422,1,2019-03-30,77,39,38,0.506,77,45,32,0.584
21801138,1610612745,1610612758,119.0,108.0,0.47,0.447,1,2019-03-30,77,49,28,0.636,76,37,39,0.487
21801139,1610612765,1610612757,99.0,90.0,0.43,0.373,1,2019-03-30,76,39,37,0.513,76,48,28,0.632
21801140,1610612754,1610612753,116.0,121.0,0.5329999999999999,0.511,0,2019-03-30,77,45,32,0.584,77,38,39,0.494
21801141,1610612752,1610612748,92.0,100.0,0.4029999999999999,0.433,0,2019-03-30,76,14,62,0.184,76,38,38,0.5
21801142,1610612741,1610612761,101.0,124.0,0.423,0.517,0,2019-03-30,77,21,56,0.273,77,54,23,0.701
21801143,1610612750,1610612755,109.0,118.0,0.4529999999999999,0.4679999999999999,0,2019-03-30,76,34,42,0.447,76,49,27,0.645
21801144,1610612756,1610612763,115.0,120.0,0.531,0.461,0,2019-03-30,77,17,60,0.221,76,31,45,0.408
21801130,1610612738,1610612754,114.0,112.0,0.512,0.467,1,2019-03-29,76,45,31,0.5920000000000001,76,45,31,0.5920000000000001
21801131,1610612737,1610612757,98.0,118.0,0.4039999999999999,0.469,0,2019-03-29,76,27,49,0.355,75,48,27,0.64
21801132,1610612750,1610612744,131.0,130.0,0.4370000000000001,0.469,1,2019-03-29,75,34,41,0.4529999999999999,75,51,24,0.68
21801133,1610612760,1610612743,105.0,115.0,0.489,0.565,0,2019-03-29,76,44,32,0.579,75,51,24,0.68
21801134,1610612762,1610612764,128.0,124.0,0.552,0.49,1,2019-03-29,76,46,30,0.605,77,31,46,0.4029999999999999
21801135,1610612747,1610612766,129.0,115.0,0.56,0.477,1,2019-03-29,76,34,42,0.447,75,35,40,0.467
21801122,1610612765,1610612753,115.0,98.0,0.535,0.3939999999999999,1,2019-03-28,75,38,37,0.507,76,37,39,0.487
21801123,1610612755,1610612751,123.0,110.0,0.5,0.444,1,2019-03-28,75,48,27,0.64,76,38,38,0.5
21801124,1610612748,1610612742,105.0,99.0,0.4379999999999999,0.391,1,2019-03-28,75,37,38,0.493,75,29,46,0.387
21801125,1610612752,1610612761,92.0,117.0,0.365,0.449,0,2019-03-28,75,14,61,0.187,76,53,23,0.6970000000000001
21801126,1610612745,1610612743,112.0,85.0,0.46,0.369,1,2019-03-28,76,48,28,0.632,74,50,24,0.6759999999999999
21801127,1610612749,1610612746,128.0,118.0,0.523,0.457,1,2019-03-28,76,57,19,0.75,76,45,31,0.5920000000000001
21801128,1610612740,1610612758,121.0,118.0,0.505,0.495,1,2019-03-28,77,32,45,0.416,75,37,38,0.493
21801129,1610612759,1610612739,116.0,110.0,0.529,0.489,1,2019-03-28,76,44,32,0.579,76,19,57,0.25
21801117,1610612741,1610612757,98.0,118.0,0.429,0.518,0,2019-03-27,76,21,55,0.276,74,47,27,0.635
21801118,1610612763,1610612744,103.0,118.0,0.39,0.536,0,2019-03-27,75,30,45,0.4,74,51,23,0.6890000000000001
21801119,1610612760,1610612754,107.0,99.0,0.446,0.435,1,2019-03-27,75,44,31,0.5870000000000001,75,45,30,0.6
21801120,1610612756,1610612764,121.0,124.0,0.494,0.478,0,2019-03-27,76,17,59,0.2239999999999999,76,31,45,0.408
21801121,1610612762,1610612747,115.0,100.0,0.494,0.381,1,2019-03-27,75,45,30,0.6,75,33,42,0.44
21801107,1610612766,1610612759,125.0,116.0,0.46,0.407,1,2019-03-26,74,35,39,0.473,75,43,32,0.573
21801108,1610612739,1610612738,106.0,116.0,0.488,0.505,0,2019-03-26,75,19,56,0.253,75,44,31,0.5870000000000001
21801109,1610612748,1610612753,99.0,104.0,0.419,0.416,0,2019-03-26,74,36,38,0.486,75,37,38,0.493
21801110,1610612761,1610612741,112.0,103.0,0.488,0.4529999999999999,1,2019-03-26,75,52,23,0.693,75,21,54,0.28
21801111,1610612749,1610612745,108.0,94.0,0.447,0.364,1,2019-03-26,75,56,19,0.747,75,47,28,0.627
21801112,1610612750,1610612746,111.0,122.0,0.436,0.541,0,2019-03-26,74,33,41,0.446,75,45,30,0.6
21801113,1610612740,1610612737,120.0,130.0,0.47,0.4539999999999999,0,2019-03-26,76,31,45,0.408,75,27,48,0.36
21801114,1610612742,1610612758,121.0,125.0,0.506,0.506,0,2019-03-26,74,29,45,0.392,74,37,37,0.5
21801115,1610612743,1610612765,95.0,92.0,0.425,0.353,1,2019-03-26,73,50,23,0.685,74,37,37,0.5
21801116,1610612747,1610612764,124.0,106.0,0.539,0.433,1,2019-03-26,74,33,41,0.446,75,30,45,0.4
21801103,1610612753,1610612755,119.0,98.0,0.517,0.493,1,2019-03-25,74,36,38,0.486,74,47,27,0.635
21801104,1610612763,1610612760,115.0,103.0,0.449,0.4,1,2019-03-25,74,30,44,0.405,74,43,31,0.581
21801105,1610612762,1610612756,125.0,92.0,0.5579999999999999,0.408,1,2019-03-25,74,44,30,0.595,75,17,58,0.2269999999999999
21801106,1610612757,1610612751,148.0,144.0,0.4379999999999999,0.476,1,2019-03-25,73,46,27,0.63,75,38,37,0.507
21801095,1610612752,1610612746,113.0,124.0,0.477,0.442,0,2019-03-24,74,14,60,0.1889999999999999,74,44,30,0.595
21801096,1610612749,1610612739,127.0,105.0,0.552,0.4270000000000001,1,2019-03-24,74,55,19,0.743,74,19,55,0.257
21801097,1610612754,1610612743,124.0,88.0,0.56,0.355,1,2019-03-24,74,45,29,0.608,72,49,23,0.6809999999999999
21801098,1610612761,1610612766,114.0,115.0,0.584,0.441,0,2019-03-24,74,51,23,0.6890000000000001,73,34,39,0.466
21801099,1610612740,1610612745,90.0,113.0,0.413,0.488,0,2019-03-24,75,31,44,0.413,74,47,27,0.635
21801100,1610612738,1610612759,96.0,115.0,0.4039999999999999,0.51,0,2019-03-24,74,43,31,0.581,74,43,31,0.581
21801101,1610612744,1610612765,121.0,114.0,0.622,0.4639999999999999,1,2019-03-24,73,50,23,0.685,73,37,36,0.507
21801102,1610612747,1610612758,111.0,106.0,0.4589999999999999,0.375,1,2019-03-24,73,32,41,0.4379999999999999,73,36,37,0.493
21801087,1610612766,1610612738,124.0,117.0,0.442,0.473,1,2019-03-23,72,33,39,0.4579999999999999,73,43,30,0.589
21801089,1610612764,1610612748,108.0,113.0,0.4270000000000001,0.5,0,2019-03-23,74,30,44,0.405,73,36,37,0.493
21801088,1610612737,1610612755,129.0,127.0,0.462,0.462,1,2019-03-23,74,26,48,0.351,73,47,26,0.644
21801090,1610612741,1610612762,83.0,114.0,0.359,0.484,0,2019-03-23,74,21,53,0.284,73,43,30,0.589
21801091,1610612763,1610612750,99.0,112.0,0.375,0.482,0,2019-03-23,73,29,44,0.397,73,33,40,0.452
21801092,1610612744,1610612742,91.0,126.0,0.4,0.53,0,2019-03-23,72,49,23,0.6809999999999999,73,29,44,0.397
21801093,1610612757,1610612765,117.0,112.0,0.544,0.5,1,2019-03-23,72,45,27,0.625,72,37,35,0.514
21801094,1610612758,1610612756,112.0,103.0,0.424,0.409,1,2019-03-23,72,36,36,0.5,74,17,57,0.23
21801080,1610612753,1610612763,123.0,119.0,0.473,0.505,1,2019-03-22,73,35,38,0.479,72,29,43,0.4029999999999999
21801081,1610612739,1610612746,108.0,110.0,0.478,0.512,0,2019-03-22,73,19,54,0.26,73,43,30,0.589
21801082,1610612752,1610612743,93.0,111.0,0.3779999999999999,0.417,0,2019-03-22,73,14,59,0.192,71,49,22,0.69
21801083,1610612761,1610612760,109.0,116.0,0.5,0.447,0,2019-03-22,73,51,22,0.6990000000000001,73,43,30,0.589
21801084,1610612745,1610612759,111.0,105.0,0.419,0.456,1,2019-03-22,73,46,27,0.63,73,42,31,0.575
21801085,1610612749,1610612748,116.0,87.0,0.506,0.376,1,2019-03-22,73,54,19,0.74,72,35,37,0.486
21801086,1610612747,1610612751,106.0,111.0,0.385,0.402,0,2019-03-22,72,31,41,0.431,74,38,36,0.514
21801074,1610612766,1610612750,113.0,106.0,0.43,0.4429999999999999,1,2019-03-21,71,32,39,0.451,72,32,40,0.444
21801075,1610612764,1610612743,108.0,113.0,0.506,0.529,0,2019-03-21,73,30,43,0.411,70,48,22,0.6859999999999999
21801076,1610612737,1610612762,117.0,114.0,0.471,0.457,1,2019-03-21,73,25,48,0.342,72,42,30,0.583
21801077,1610612756,1610612765,98.0,118.0,0.479,0.422,0,2019-03-21,73,17,56,0.233,71,37,34,0.521
21801078,1610612758,1610612742,116.0,100.0,0.471,0.391,1,2019-03-21,71,35,36,0.493,72,28,44,0.389
21801079,1610612744,1610612754,112.0,89.0,0.494,0.385,1,2019-03-21,71,49,22,0.69,73,44,29,0.603
21801065,1610612739,1610612749,107.0,102.0,0.419,0.396,1,2019-03-20,72,19,53,0.264,72,53,19,0.736
21801066,1610612753,1610612740,119.0,96.0,0.451,0.373,1,2019-03-20,72,34,38,0.472,74,31,43,0.419
21801067,1610612755,1610612738,118.0,115.0,0.3779999999999999,0.469,1,2019-03-20,72,47,25,0.653,72,43,29,0.597
21801068,1610612752,1610612762,116.0,137.0,0.523,0.565,0,2019-03-20,72,14,58,0.1939999999999999,71,42,29,0.5920000000000001
21801069,1610612741,1610612764,126.0,120.0,0.472,0.473,1,2019-03-20,73,21,52,0.288,72,30,42,0.417
21801070,1610612763,1610612745,126.0,125.0,0.461,0.447,1,2019-03-20,71,29,42,0.408,72,45,27,0.625
21801071,1610612759,1610612748,105.0,110.0,0.4320000000000001,0.465,0,2019-03-20,72,42,30,0.583,71,35,36,0.493
21801072,1610612760,1610612761,114.0,123.0,0.417,0.517,0,2019-03-20,72,42,30,0.583,72,51,21,0.708
21801073,1610612757,1610612742,126.0,118.0,0.495,0.494,1,2019-03-20,71,44,27,0.62,71,28,43,0.3939999999999999
21801059,1610612766,1610612755,114.0,118.0,0.434,0.5,0,2019-03-19,70,31,39,0.4429999999999999,71,46,25,0.648
21801060,1610612737,1610612745,105.0,121.0,0.4639999999999999,0.513,0,2019-03-19,72,24,48,0.3329999999999999,71,45,26,0.634
21801061,1610612749,1610612747,115.0,101.0,0.461,0.384,1,2019-03-19,71,53,18,0.746,71,31,40,0.4370000000000001
21801062,1610612750,1610612744,107.0,117.0,0.4039999999999999,0.484,0,2019-03-19,71,32,39,0.451,70,48,22,0.6859999999999999
21801063,1610612758,1610612751,121.0,123.0,0.516,0.5,0,2019-03-19,70,34,36,0.486,73,37,36,0.507
21801064,1610612746,1610612754,115.0,109.0,0.483,0.517,1,2019-03-19,72,42,30,0.583,72,44,28,0.611
21801050,1610612739,1610612765,126.0,119.0,0.5820000000000001,0.447,1,2019-03-18,71,18,53,0.254,70,36,34,0.514
21801051,1610612764,1610612762,95.0,116.0,0.42,0.5379999999999999,0,2019-03-18,71,30,41,0.423,70,41,29,0.586
21801052,1610612738,1610612743,105.0,114.0,0.419,0.489,0,2019-03-18,71,43,28,0.606,69,47,22,0.6809999999999999
21801053,1610612761,1610612752,128.0,92.0,0.557,0.3289999999999999,1,2019-03-18,71,50,21,0.7040000000000001,71,14,57,0.1969999999999999
21801054,1610612760,1610612748,107.0,116.0,0.4370000000000001,0.474,0,2019-03-18,71,42,29,0.5920000000000001,70,34,36,0.486
21801055,1610612759,1610612744,111.0,105.0,0.466,0.466,1,2019-03-18,71,42,29,0.5920000000000001,69,47,22,0.6809999999999999
21801056,1610612742,1610612740,125.0,129.0,0.4379999999999999,0.471,0,2019-03-18,70,28,42,0.4,73,31,42,0.425
21801057,1610612756,1610612741,101.0,116.0,0.4639999999999999,0.517,0,2019-03-18,72,17,55,0.236,72,20,52,0.278
21801058,1610612757,1610612754,106.0,98.0,0.4679999999999999,0.422,1,2019-03-18,70,43,27,0.614,71,44,27,0.62
21801042,1610612752,1610612747,124.0,123.0,0.579,0.485,1,2019-03-17,70,14,56,0.2,70,31,39,0.4429999999999999
21801045,1610612748,1610612766,93.0,75.0,0.395,0.313,1,2019-03-17,69,33,36,0.478,69,31,38,0.449
21801043,1610612749,1610612755,125.0,130.0,0.4529999999999999,0.47,0,2019-03-17,70,52,18,0.743,70,45,25,0.643
21801044,1610612765,1610612761,110.0,107.0,0.47,0.476,1,2019-03-17,69,36,33,0.522,70,49,21,0.7
21801046,1610612753,1610612737,101.0,91.0,0.3879999999999999,0.418,1,2019-03-17,71,33,38,0.465,71,24,47,0.3379999999999999
21801047,1610612758,1610612741,129.0,102.0,0.524,0.4429999999999999,1,2019-03-17,69,34,35,0.493,71,19,52,0.268
21801048,1610612745,1610612750,117.0,102.0,0.457,0.413,1,2019-03-17,70,44,26,0.629,70,32,38,0.457
21801049,1610612746,1610612751,119.0,116.0,0.433,0.42,1,2019-03-17,71,41,30,0.5770000000000001,72,36,36,0.5
21801034,1610612738,1610612737,129.0,120.0,0.473,0.43,1,2019-03-16,70,43,27,0.614,70,24,46,0.3429999999999999
21801035,1610612764,1610612763,135.0,128.0,0.506,0.5329999999999999,1,2019-03-16,70,30,40,0.429,70,28,42,0.4
21801036,1610612740,1610612756,136.0,138.0,0.461,0.51,0,2019-03-16,72,30,42,0.417,71,17,54,0.239
21801037,1610612742,1610612739,121.0,116.0,0.517,0.465,1,2019-03-16,69,28,41,0.406,70,17,53,0.243
21801038,1610612760,1610612744,88.0,110.0,0.3229999999999999,0.47,0,2019-03-16,70,42,28,0.6,68,47,21,0.691
21801039,1610612759,1610612757,108.0,103.0,0.4679999999999999,0.416,1,2019-03-16,70,41,29,0.586,69,42,27,0.609
21801040,1610612743,1610612754,102.0,100.0,0.476,0.4529999999999999,1,2019-03-16,68,46,22,0.6759999999999999,70,44,26,0.629
21801041,1610612762,1610612751,114.0,98.0,0.429,0.347,1,2019-03-16,69,40,29,0.58,71,36,35,0.507
21801026,1610612765,1610612747,111.0,97.0,0.43,0.419,1,2019-03-15,68,35,33,0.515,69,31,38,0.449
21801027,1610612755,1610612758,123.0,114.0,0.505,0.457,1,2019-03-15,69,44,25,0.638,68,33,35,0.485
21801028,1610612764,1610612766,110.0,116.0,0.488,0.455,0,2019-03-15,69,29,40,0.42,68,31,37,0.456
21801029,1610612748,1610612749,98.0,113.0,0.409,0.477,0,2019-03-15,68,32,36,0.471,69,52,17,0.754
21801030,1610612745,1610612756,108.0,102.0,0.434,0.4270000000000001,1,2019-03-15,69,43,26,0.623,70,16,54,0.2289999999999999
21801031,1610612740,1610612757,110.0,122.0,0.479,0.4479999999999999,0,2019-03-15,71,30,41,0.423,68,42,26,0.618
21801032,1610612759,1610612752,109.0,83.0,0.534,0.407,1,2019-03-15,69,40,29,0.58,69,13,56,0.188
21801033,1610612746,1610612741,128.0,121.0,0.444,0.525,1,2019-03-15,70,40,30,0.5710000000000001,70,19,51,0.271
21801020,1610612754,1610612760,108.0,106.0,0.451,0.442,1,2019-03-14,69,44,25,0.638,69,42,27,0.609
21801021,1610612753,1610612739,120.0,91.0,0.484,0.407,1,2019-03-14,70,32,38,0.457,69,17,52,0.246
21801022,1610612738,1610612758,126.0,120.0,0.505,0.505,1,2019-03-14,69,42,27,0.609,67,33,34,0.493
21801023,1610612761,1610612747,111.0,98.0,0.396,0.447,1,2019-03-14,69,49,20,0.71,68,31,37,0.456
21801024,1610612762,1610612750,120.0,100.0,0.494,0.462,1,2019-03-14,68,39,29,0.574,69,32,37,0.4639999999999999
21801025,1610612743,1610612742,100.0,99.0,0.481,0.425,1,2019-03-14,67,45,22,0.672,68,27,41,0.397
21801015,1610612764,1610612753,100.0,90.0,0.467,0.389,1,2019-03-13,68,29,39,0.426,69,31,38,0.449
21801017,1610612760,1610612751,108.0,96.0,0.4270000000000001,0.417,1,2019-03-13,68,42,26,0.618,70,36,34,0.514
21801014,1610612748,1610612765,108.0,74.0,0.4639999999999999,0.351,1,2019-03-13,67,32,35,0.478,67,34,33,0.507
21801016,1610612737,1610612763,132.0,111.0,0.505,0.4270000000000001,1,2019-03-13,69,24,45,0.348,69,28,41,0.406
21801018,1610612745,1610612744,104.0,106.0,0.474,0.494,0,2019-03-13,68,42,26,0.618,67,46,21,0.687
21801019,1610612756,1610612762,97.0,114.0,0.439,0.467,0,2019-03-13,69,16,53,0.2319999999999999,67,38,29,0.5670000000000001
21801007,1610612754,1610612752,103.0,98.0,0.435,0.4379999999999999,1,2019-03-12,68,43,25,0.632,68,13,55,0.191
21801008,1610612755,1610612739,106.0,99.0,0.494,0.396,1,2019-03-12,68,43,25,0.632,68,17,51,0.25
21801009,1610612741,1610612747,107.0,123.0,0.462,0.547,0,2019-03-12,69,19,50,0.275,67,31,36,0.4629999999999999
21801010,1610612740,1610612749,113.0,130.0,0.43,0.495,0,2019-03-12,70,30,40,0.429,68,51,17,0.75
21801011,1610612742,1610612759,105.0,112.0,0.4629999999999999,0.524,0,2019-03-12,67,27,40,0.4029999999999999,68,39,29,0.574
21801012,1610612743,1610612750,133.0,107.0,0.6,0.461,1,2019-03-12,66,44,22,0.667,68,32,36,0.471
21801013,1610612746,1610612757,104.0,125.0,0.4,0.49,0,2019-03-12,69,39,30,0.565,67,41,26,0.612
21801001,1610612739,1610612761,126.0,101.0,0.4679999999999999,0.476,1,2019-03-11,67,17,50,0.254,68,48,20,0.706
21801002,1610612764,1610612758,121.0,115.0,0.465,0.451,1,2019-03-11,67,28,39,0.418,66,33,33,0.5
21801003,1610612751,1610612765,103.0,75.0,0.494,0.278,1,2019-03-11,69,36,33,0.522,66,34,32,0.515
21801004,1610612745,1610612766,118.0,106.0,0.418,0.4270000000000001,1,2019-03-11,67,42,25,0.627,67,30,37,0.4479999999999999
21801005,1610612762,1610612760,89.0,98.0,0.364,0.456,0,2019-03-11,66,37,29,0.561,67,41,26,0.612
21801006,1610612746,1610612738,140.0,115.0,0.616,0.484,1,2019-03-11,68,39,29,0.574,68,41,27,0.603
21800992,1610612765,1610612741,131.0,108.0,0.5379999999999999,0.5,1,2019-03-10,65,34,31,0.523,68,19,49,0.2789999999999999
21800993,1610612748,1610612761,104.0,125.0,0.457,0.568,0,2019-03-10,66,31,35,0.47,67,48,19,0.716
21800994,1610612755,1610612754,106.0,89.0,0.4370000000000001,0.373,1,2019-03-10,67,42,25,0.627,67,42,25,0.627
21800995,1610612737,1610612740,128.0,116.0,0.49,0.446,1,2019-03-10,68,23,45,0.3379999999999999,69,30,39,0.435
21800996,1610612763,1610612753,105.0,97.0,0.415,0.356,1,2019-03-10,68,28,40,0.412,68,31,37,0.456
21800997,1610612742,1610612745,93.0,94.0,0.413,0.364,0,2019-03-10,66,27,39,0.409,66,41,25,0.621
21800998,1610612750,1610612752,103.0,92.0,0.447,0.43,1,2019-03-10,67,32,35,0.478,67,13,54,0.1939999999999999
21800999,1610612759,1610612749,121.0,114.0,0.49,0.471,1,2019-03-10,67,38,29,0.5670000000000001,67,50,17,0.746
21801000,1610612744,1610612756,111.0,115.0,0.442,0.488,0,2019-03-10,66,45,21,0.682,68,16,52,0.235
21800986,1610612752,1610612758,94.0,102.0,0.3720000000000001,0.379,0,2019-03-09,66,13,53,0.1969999999999999,65,33,32,0.508
21800987,1610612737,1610612751,112.0,114.0,0.371,0.384,0,2019-03-09,67,22,45,0.3279999999999999,68,35,33,0.515
21800988,1610612750,1610612764,135.0,130.0,0.447,0.48,1,2019-03-09,66,31,35,0.47,66,27,39,0.409
21800989,1610612747,1610612738,107.0,120.0,0.484,0.516,0,2019-03-09,66,30,36,0.455,67,41,26,0.612
21800990,1610612749,1610612766,131.0,114.0,0.489,0.473,1,2019-03-09,66,50,16,0.758,66,30,36,0.455
21800991,1610612757,1610612756,127.0,120.0,0.5,0.417,1,2019-03-09,66,40,26,0.606,67,15,52,0.2239999999999999
21800977,1610612766,1610612764,112.0,111.0,0.417,0.465,1,2019-03-08,65,30,35,0.462,65,27,38,0.415
21800978,1610612753,1610612742,111.0,106.0,0.483,0.472,1,2019-03-08,67,31,36,0.4629999999999999,65,27,38,0.415
21800979,1610612748,1610612739,126.0,110.0,0.57,0.481,1,2019-03-08,65,31,34,0.477,66,16,50,0.242
21800980,1610612741,1610612765,104.0,112.0,0.512,0.542,0,2019-03-08,67,19,48,0.284,64,33,31,0.516
21800981,1610612745,1610612755,107.0,91.0,0.494,0.368,1,2019-03-08,65,40,25,0.615,66,41,25,0.621
21800982,1610612763,1610612762,114.0,104.0,0.511,0.4270000000000001,1,2019-03-08,67,27,40,0.4029999999999999,65,37,28,0.569
21800983,1610612740,1610612761,104.0,127.0,0.41,0.535,0,2019-03-08,68,30,38,0.441,66,47,19,0.7120000000000001
21800984,1610612744,1610612743,122.0,105.0,0.536,0.379,1,2019-03-08,65,45,20,0.6920000000000001,65,43,22,0.662
21800985,1610612746,1610612760,118.0,110.0,0.4529999999999999,0.402,1,2019-03-08,67,38,29,0.5670000000000001,66,40,26,0.606
21800975,1610612749,1610612754,117.0,98.0,0.5,0.389,1,2019-03-07,65,49,16,0.754,66,42,24,0.636
21800976,1610612757,1610612760,121.0,129.0,0.3939999999999999,0.457,0,2019-03-07,65,39,26,0.6,65,40,25,0.615
21800965,1610612766,1610612748,84.0,91.0,0.366,0.422,0,2019-03-06,64,29,35,0.4529999999999999,64,30,34,0.469
21800966,1610612765,1610612750,131.0,114.0,0.5379999999999999,0.488,1,2019-03-06,63,32,31,0.508,65,30,35,0.462
21800967,1610612764,1610612742,132.0,123.0,0.5379999999999999,0.484,1,2019-03-06,64,27,37,0.422,64,27,37,0.422
21800968,1610612737,1610612759,104.0,111.0,0.391,0.494,0,2019-03-06,66,22,44,0.3329999999999999,66,37,29,0.561
21800969,1610612751,1610612739,113.0,107.0,0.473,0.402,1,2019-03-06,67,34,33,0.507,65,16,49,0.246
21800970,1610612741,1610612755,108.0,107.0,0.441,0.46,1,2019-03-06,66,19,47,0.288,65,41,24,0.631
21800971,1610612740,1610612762,104.0,114.0,0.461,0.523,0,2019-03-06,67,30,37,0.4479999999999999,64,37,27,0.578
21800972,1610612756,1610612752,107.0,96.0,0.481,0.455,1,2019-03-06,66,15,51,0.2269999999999999,65,13,52,0.2
21800973,1610612758,1610612738,109.0,111.0,0.5,0.506,0,2019-03-06,64,32,32,0.5,66,40,26,0.606
21800974,1610612747,1610612743,99.0,115.0,0.476,0.4589999999999999,0,2019-03-06,65,30,35,0.462,64,43,21,0.672
21800959,1610612754,1610612741,105.0,96.0,0.452,0.387,1,2019-03-05,65,42,23,0.6459999999999999,65,18,47,0.2769999999999999
21800960,1610612755,1610612753,114.0,106.0,0.472,0.452,1,2019-03-05,64,41,23,0.6409999999999999,66,30,36,0.455
21800961,1610612761,1610612745,95.0,107.0,0.416,0.447,0,2019-03-05,65,46,19,0.708,64,39,25,0.609
21800962,1610612763,1610612757,120.0,111.0,0.5329999999999999,0.532,1,2019-03-05,66,26,40,0.3939999999999999,64,39,25,0.609
21800963,1610612750,1610612760,131.0,120.0,0.528,0.447,1,2019-03-05,64,30,34,0.469,64,39,25,0.609
21800964,1610612744,1610612738,95.0,128.0,0.4,0.51,0,2019-03-05,64,44,20,0.688,65,39,26,0.6
21800952,1610612751,1610612742,127.0,88.0,0.565,0.356,1,2019-03-04,66,33,33,0.5,63,27,36,0.429
21800953,1610612748,1610612737,114.0,113.0,0.557,0.418,1,2019-03-04,63,29,34,0.46,65,22,43,0.3379999999999999
21800954,1610612759,1610612743,104.0,103.0,0.482,0.4320000000000001,1,2019-03-04,65,36,29,0.5539999999999999,63,42,21,0.667
21800955,1610612756,1610612749,114.0,105.0,0.451,0.368,1,2019-03-04,65,14,51,0.215,64,48,16,0.75
21800956,1610612762,1610612740,112.0,115.0,0.467,0.479,0,2019-03-04,63,36,27,0.5710000000000001,66,30,36,0.455
21800957,1610612758,1610612752,115.0,108.0,0.47,0.4589999999999999,1,2019-03-04,63,32,31,0.508,64,13,51,0.203
21800958,1610612747,1610612746,105.0,113.0,0.418,0.494,0,2019-03-04,64,30,34,0.469,66,37,29,0.561
21800944,1610612766,1610612757,108.0,118.0,0.446,0.4479999999999999,0,2019-03-03,63,29,34,0.46,63,39,24,0.619
21800945,1610612738,1610612745,104.0,115.0,0.481,0.475,0,2019-03-03,64,38,26,0.594,63,38,25,0.603
21800946,1610612741,1610612737,118.0,123.0,0.511,0.472,0,2019-03-03,64,18,46,0.281,64,22,42,0.344
21800947,1610612746,1610612752,128.0,107.0,0.49,0.3979999999999999,1,2019-03-03,65,36,29,0.5539999999999999,63,13,50,0.206
21800948,1610612739,1610612753,107.0,93.0,0.434,0.4429999999999999,1,2019-03-03,64,16,48,0.25,65,30,35,0.462
21800949,1610612765,1610612761,112.0,107.0,0.465,0.385,1,2019-03-03,62,31,31,0.5,64,46,18,0.7190000000000001
21800950,1610612764,1610612750,135.0,121.0,0.5,0.525,1,2019-03-03,63,26,37,0.413,63,29,34,0.46
21800951,1610612760,1610612763,99.0,95.0,0.355,0.4429999999999999,1,2019-03-03,63,39,24,0.619,65,25,40,0.385
21800935,1610612739,1610612765,93.0,129.0,0.342,0.54,0,2019-03-02,63,15,48,0.238,61,30,31,0.4920000000000001
21800936,1610612754,1610612753,112.0,117.0,0.545,0.505,0,2019-03-02,64,41,23,0.6409999999999999,64,30,34,0.469
21800937,1610612748,1610612751,117.0,88.0,0.489,0.352,1,2019-03-02,62,28,34,0.452,65,32,33,0.4920000000000001
21800938,1610612755,1610612744,117.0,120.0,0.4479999999999999,0.506,0,2019-03-02,63,40,23,0.635,63,44,19,0.698
21800939,1610612742,1610612763,81.0,111.0,0.306,0.5,0,2019-03-02,62,27,35,0.435,64,25,39,0.391
21800940,1610612759,1610612760,116.0,102.0,0.495,0.455,1,2019-03-02,64,35,29,0.547,62,38,24,0.613
21800941,1610612743,1610612740,112.0,120.0,0.424,0.489,0,2019-03-02,62,42,20,0.677,65,29,36,0.446
21800942,1610612756,1610612747,118.0,109.0,0.513,0.483,1,2019-03-02,64,13,51,0.203,63,30,33,0.476
21800943,1610612762,1610612749,115.0,111.0,0.4579999999999999,0.385,1,2019-03-02,62,36,26,0.581,63,48,15,0.762
21800928,1610612737,1610612741,161.0,168.0,0.496,0.471,0,2019-03-01,63,21,42,0.3329999999999999,63,18,45,0.286
21800929,1610612751,1610612766,112.0,123.0,0.512,0.532,0,2019-03-01,64,32,32,0.5,62,29,33,0.4679999999999999
21800930,1610612761,1610612757,119.0,117.0,0.556,0.494,1,2019-03-01,63,46,17,0.73,62,38,24,0.613
21800931,1610612738,1610612764,107.0,96.0,0.447,0.4039999999999999,1,2019-03-01,63,38,25,0.603,62,25,37,0.4029999999999999
21800932,1610612756,1610612740,116.0,130.0,0.426,0.575,0,2019-03-01,63,12,51,0.19,64,28,36,0.4379999999999999
21800933,1610612758,1610612746,109.0,116.0,0.441,0.435,0,2019-03-01,62,31,31,0.5,64,35,29,0.547
21800934,1610612747,1610612749,120.0,131.0,0.479,0.516,0,2019-03-01,62,30,32,0.484,62,48,14,0.774
21800922,1610612754,1610612750,122.0,115.0,0.476,0.472,1,2019-02-28,63,41,22,0.6509999999999999,62,29,33,0.4679999999999999
21800923,1610612753,1610612744,103.0,96.0,0.449,0.402,1,2019-02-28,63,29,34,0.46,62,43,19,0.6940000000000001
21800924,1610612752,1610612739,118.0,125.0,0.484,0.513,0,2019-02-28,62,13,49,0.21,62,15,47,0.242
21800925,1610612745,1610612748,121.0,118.0,0.494,0.519,1,2019-02-28,62,37,25,0.597,61,27,34,0.4429999999999999
21800927,1610612760,1610612755,104.0,108.0,0.4370000000000001,0.462,0,2019-02-28,61,38,23,0.623,62,40,22,0.645
21800926,1610612743,1610612762,104.0,111.0,0.4039999999999999,0.44,0,2019-02-28,61,42,19,0.6890000000000001,61,35,26,0.574
21800911,1610612766,1610612745,113.0,118.0,0.47,0.462,0,2019-02-27,61,28,33,0.4589999999999999,61,36,25,0.59
21800912,1610612737,1610612750,131.0,123.0,0.426,0.431,1,2019-02-27,62,21,41,0.3389999999999999,61,29,32,0.475
21800914,1610612751,1610612764,116.0,125.0,0.4589999999999999,0.4579999999999999,0,2019-02-27,63,32,31,0.508,61,25,36,0.41
21800915,1610612748,1610612744,126.0,125.0,0.506,0.494,1,2019-02-27,60,27,33,0.45,61,43,18,0.705
21800913,1610612738,1610612757,92.0,97.0,0.465,0.422,0,2019-02-27,62,37,25,0.597,61,38,23,0.623
21800916,1610612763,1610612741,107.0,109.0,0.436,0.476,0,2019-02-27,63,24,39,0.381,62,17,45,0.2739999999999999
21800917,1610612759,1610612765,105.0,93.0,0.519,0.36,1,2019-02-27,63,34,29,0.54,60,29,31,0.483
21800918,1610612742,1610612754,110.0,101.0,0.494,0.481,1,2019-02-27,61,27,34,0.4429999999999999,62,40,22,0.645
21800919,1610612762,1610612746,111.0,105.0,0.413,0.3939999999999999,1,2019-02-27,60,34,26,0.5670000000000001,63,34,29,0.54
21800920,1610612758,1610612749,140.0,141.0,0.449,0.482,0,2019-02-27,61,31,30,0.508,61,47,14,0.77
21800921,1610612747,1610612740,125.0,119.0,0.521,0.451,1,2019-02-27,61,30,31,0.4920000000000001,63,27,36,0.429
21800908,1610612752,1610612753,108.0,103.0,0.4270000000000001,0.4379999999999999,1,2019-02-26,61,13,48,0.213,62,28,34,0.452
21800909,1610612761,1610612738,118.0,95.0,0.489,0.384,1,2019-02-26,62,45,17,0.726,61,37,24,0.607
21800910,1610612743,1610612760,121.0,112.0,0.466,0.4529999999999999,1,2019-02-26,60,42,18,0.7,60,38,22,0.633
21800897,1610612766,1610612744,110.0,121.0,0.44,0.505,0,2019-02-25,60,28,32,0.467,60,43,17,0.7170000000000001
21800898,1610612739,1610612757,110.0,123.0,0.416,0.564,0,2019-02-25,61,14,47,0.23,60,37,23,0.617
21800899,1610612765,1610612754,113.0,109.0,0.4429999999999999,0.46,1,2019-02-25,59,29,30,0.4920000000000001,61,40,21,0.6559999999999999
21800900,1610612751,1610612759,101.0,85.0,0.4320000000000001,0.365,1,2019-02-25,62,32,30,0.516,62,33,29,0.532
21800901,1610612748,1610612756,121.0,124.0,0.495,0.506,0,2019-02-25,59,26,33,0.441,62,12,50,0.1939999999999999
21800902,1610612741,1610612749,106.0,117.0,0.446,0.462,0,2019-02-25,61,16,45,0.262,60,46,14,0.767
21800903,1610612745,1610612737,119.0,111.0,0.433,0.488,1,2019-02-25,60,35,25,0.583,61,20,41,0.3279999999999999
21800904,1610612763,1610612747,110.0,105.0,0.441,0.449,1,2019-02-25,62,24,38,0.387,60,29,31,0.483
21800905,1610612750,1610612758,112.0,105.0,0.506,0.389,1,2019-02-25,60,29,31,0.483,60,31,29,0.517
21800906,1610612740,1610612755,110.0,111.0,0.423,0.436,0,2019-02-25,62,27,35,0.435,61,39,22,0.639
21800907,1610612746,1610612742,121.0,112.0,0.45,0.487,1,2019-02-25,62,34,28,0.5479999999999999,60,26,34,0.433
21800894,1610612761,1610612753,98.0,113.0,0.418,0.462,0,2019-02-24,61,44,17,0.721,61,28,33,0.4589999999999999
21800895,1610612743,1610612746,123.0,96.0,0.518,0.345,1,2019-02-24,59,41,18,0.695,61,33,28,0.541
21800896,1610612752,1610612759,130.0,118.0,0.51,0.447,1,2019-02-24,60,12,48,0.2,61,33,28,0.541
21800882,1610612755,1610612757,115.0,130.0,0.483,0.495,0,2019-02-23,60,38,22,0.633,59,36,23,0.61
21800883,1610612737,1610612756,120.0,112.0,0.413,0.441,1,2019-02-23,60,20,40,0.3329999999999999,61,11,50,0.18
21800884,1610612766,1610612751,115.0,117.0,0.4529999999999999,0.46,0,2019-02-23,59,28,31,0.475,61,31,30,0.508
21800885,1610612739,1610612763,112.0,107.0,0.4429999999999999,0.444,1,2019-02-23,60,14,46,0.233,61,23,38,0.377
21800886,1610612764,1610612754,112.0,119.0,0.532,0.5660000000000001,0,2019-02-23,60,24,36,0.4,60,40,20,0.667
21800887,1610612740,1610612747,128.0,115.0,0.521,0.5429999999999999,1,2019-02-23,61,27,34,0.4429999999999999,59,29,30,0.4920000000000001
21800888,1610612748,1610612765,96.0,119.0,0.4270000000000001,0.525,0,2019-02-23,58,26,32,0.4479999999999999,58,28,30,0.483
21800889,1610612741,1610612738,126.0,116.0,0.534,0.489,1,2019-02-23,60,16,44,0.267,60,37,23,0.617
21800890,1610612760,1610612758,116.0,119.0,0.381,0.4539999999999999,0,2019-02-23,59,38,21,0.644,59,31,28,0.525
21800891,1610612749,1610612750,140.0,128.0,0.526,0.49,1,2019-02-23,59,45,14,0.763,59,28,31,0.475
21800892,1610612744,1610612745,112.0,118.0,0.467,0.435,0,2019-02-23,59,42,17,0.7120000000000001,59,34,25,0.5760000000000001
21800893,1610612762,1610612742,125.0,109.0,0.482,0.423,1,2019-02-23,59,33,26,0.5589999999999999,59,26,33,0.441
21800873,1610612766,1610612764,123.0,110.0,0.479,0.433,1,2019-02-22,58,28,30,0.483,59,24,35,0.407
21800874,1610612754,1610612740,126.0,111.0,0.473,0.462,1,2019-02-22,59,39,20,0.6609999999999999,60,26,34,0.433
21800875,1610612753,1610612741,109.0,110.0,0.506,0.444,0,2019-02-22,60,27,33,0.45,59,15,44,0.254
21800876,1610612761,1610612759,120.0,117.0,0.426,0.483,1,2019-02-22,60,44,16,0.733,60,33,27,0.55
21800877,1610612737,1610612765,122.0,125.0,0.489,0.484,0,2019-02-22,59,19,40,0.322,57,27,30,0.474
21800878,1610612752,1610612750,104.0,115.0,0.43,0.471,0,2019-02-22,59,11,48,0.186,58,28,30,0.483
21800879,1610612763,1610612746,106.0,112.0,0.3670000000000001,0.467,0,2019-02-22,60,23,37,0.3829999999999999,60,33,27,0.55
21800880,1610612742,1610612743,104.0,114.0,0.405,0.408,0,2019-02-22,58,26,32,0.4479999999999999,58,40,18,0.69
21800881,1610612760,1610612762,148.0,147.0,0.466,0.495,1,2019-02-22,58,38,20,0.655,58,32,26,0.552
21800867,1610612739,1610612756,111.0,98.0,0.494,0.417,1,2019-02-21,59,13,46,0.22,60,11,49,0.183
21800868,1610612755,1610612748,106.0,102.0,0.451,0.479,1,2019-02-21,59,38,21,0.644,57,26,31,0.456
21800869,1610612751,1610612757,99.0,113.0,0.391,0.4379999999999999,0,2019-02-21,60,30,30,0.5,58,35,23,0.603
21800870,1610612749,1610612738,98.0,97.0,0.42,0.382,1,2019-02-21,58,44,14,0.759,59,37,22,0.627
21800871,1610612744,1610612758,125.0,123.0,0.457,0.434,1,2019-02-21,58,42,16,0.7240000000000001,58,30,28,0.517
21800872,1610612747,1610612745,111.0,106.0,0.442,0.455,1,2019-02-21,58,29,29,0.5,58,33,25,0.569
21800864,1610612753,1610612766,127.0,89.0,0.522,0.351,1,2019-02-14,59,27,32,0.4579999999999999,57,27,30,0.474
21800865,1610612737,1610612752,91.0,106.0,0.363,0.452,0,2019-02-14,58,19,39,0.3279999999999999,58,11,47,0.19
21800866,1610612740,1610612760,131.0,122.0,0.5429999999999999,0.472,1,2019-02-14,59,26,33,0.441,57,37,20,0.649
21800853,1610612739,1610612751,139.0,148.0,0.45,0.46,0,2019-02-13,58,12,46,0.207,59,30,29,0.508
21800854,1610612754,1610612749,97.0,106.0,0.42,0.442,0,2019-02-13,58,38,20,0.655,57,43,14,0.754
21800855,1610612738,1610612765,118.0,110.0,0.511,0.429,1,2019-02-13,58,37,21,0.638,56,26,30,0.4639999999999999
21800856,1610612752,1610612755,111.0,126.0,0.4,0.5379999999999999,0,2019-02-13,57,10,47,0.175,58,37,21,0.638
21800857,1610612761,1610612764,129.0,120.0,0.478,0.44,1,2019-02-13,59,43,16,0.7290000000000001,58,24,34,0.414
21800858,1610612741,1610612763,122.0,110.0,0.563,0.483,1,2019-02-13,58,14,44,0.241,59,23,36,0.39
21800861,1610612750,1610612745,121.0,111.0,0.544,0.408,1,2019-02-13,57,27,30,0.474,57,33,24,0.579
21800859,1610612742,1610612748,101.0,112.0,0.386,0.5429999999999999,0,2019-02-13,57,26,31,0.456,56,26,30,0.4639999999999999
21800860,1610612743,1610612758,120.0,118.0,0.455,0.452,1,2019-02-13,57,39,18,0.684,57,30,27,0.526
21800862,1610612757,1610612744,129.0,107.0,0.462,0.402,1,2019-02-13,57,34,23,0.596,57,41,16,0.7190000000000001
21800863,1610612746,1610612756,134.0,107.0,0.595,0.465,1,2019-02-13,59,32,27,0.542,59,11,48,0.186
21800848,1610612737,1610612747,117.0,113.0,0.435,0.4320000000000001,1,2019-02-12,57,19,38,0.3329999999999999,57,28,29,0.491
21800849,1610612755,1610612738,109.0,112.0,0.488,0.466,0,2019-02-12,57,36,21,0.632,57,36,21,0.632
21800850,1610612763,1610612759,107.0,108.0,0.494,0.419,0,2019-02-12,58,23,35,0.397,59,33,26,0.5589999999999999
21800851,1610612740,1610612753,88.0,118.0,0.3829999999999999,0.442,0,2019-02-12,58,25,33,0.431,58,26,32,0.4479999999999999
21800852,1610612744,1610612762,115.0,108.0,0.494,0.471,1,2019-02-12,56,41,15,0.732,57,32,25,0.561
21800839,1610612739,1610612752,107.0,104.0,0.4,0.457,1,2019-02-11,57,12,45,0.211,56,10,46,0.179
21800840,1610612765,1610612764,121.0,112.0,0.518,0.5,1,2019-02-11,55,26,29,0.473,57,24,33,0.421
21800841,1610612754,1610612766,99.0,90.0,0.514,0.322,1,2019-02-11,57,38,19,0.667,56,27,29,0.482
21800842,1610612761,1610612751,127.0,125.0,0.5429999999999999,0.523,1,2019-02-11,58,42,16,0.7240000000000001,58,29,29,0.5
21800843,1610612741,1610612749,99.0,112.0,0.385,0.475,0,2019-02-11,57,13,44,0.228,56,42,14,0.75
21800844,1610612745,1610612742,120.0,104.0,0.467,0.479,1,2019-02-11,56,33,23,0.589,56,26,30,0.4639999999999999
21800845,1610612750,1610612746,130.0,120.0,0.522,0.514,1,2019-02-11,56,26,30,0.4639999999999999,58,31,27,0.534
21800846,1610612760,1610612757,120.0,111.0,0.477,0.414,1,2019-02-11,56,37,19,0.6609999999999999,56,33,23,0.589
21800847,1610612743,1610612748,103.0,87.0,0.4270000000000001,0.415,1,2019-02-11,56,38,18,0.679,55,25,30,0.455
21800834,1610612742,1610612757,102.0,101.0,0.414,0.488,1,2019-02-10,55,26,29,0.473,55,33,22,0.6
21800835,1610612755,1610612747,143.0,120.0,0.5770000000000001,0.516,1,2019-02-10,56,36,20,0.643,56,28,28,0.5
21800836,1610612758,1610612756,117.0,104.0,0.452,0.418,1,2019-02-10,56,30,26,0.536,58,11,47,0.19
21800837,1610612737,1610612753,108.0,124.0,0.4629999999999999,0.473,0,2019-02-10,56,18,38,0.321,57,25,32,0.439
21800838,1610612744,1610612748,120.0,118.0,0.537,0.457,1,2019-02-10,55,40,15,0.727,54,25,29,0.4629999999999999
21800825,1610612762,1610612759,125.0,105.0,0.522,0.449,1,2019-02-09,56,32,24,0.5710000000000001,58,32,26,0.552
21800826,1610612754,1610612739,105.0,90.0,0.536,0.4429999999999999,1,2019-02-09,56,37,19,0.6609999999999999,56,11,45,0.196
21800827,1610612737,1610612766,120.0,129.0,0.535,0.545,0,2019-02-09,55,18,37,0.327,55,27,28,0.491
21800828,1610612752,1610612761,99.0,104.0,0.415,0.384,0,2019-02-09,55,10,45,0.182,57,41,16,0.7190000000000001
21800829,1610612738,1610612746,112.0,123.0,0.424,0.476,0,2019-02-09,56,35,21,0.625,57,31,26,0.544
21800830,1610612741,1610612764,125.0,134.0,0.505,0.579,0,2019-02-09,56,13,43,0.2319999999999999,56,24,32,0.429
21800831,1610612763,1610612740,99.0,90.0,0.4320000000000001,0.395,1,2019-02-09,57,23,34,0.4039999999999999,57,25,32,0.439
21800832,1610612745,1610612760,112.0,117.0,0.43,0.449,0,2019-02-09,55,32,23,0.5820000000000001,55,36,19,0.655
21800833,1610612749,1610612753,83.0,103.0,0.326,0.4679999999999999,0,2019-02-09,55,41,14,0.745,56,24,32,0.429
21800817,1610612765,1610612752,120.0,103.0,0.488,0.449,1,2019-02-08,54,25,29,0.4629999999999999,54,10,44,0.185
21800818,1610612755,1610612743,117.0,110.0,0.5,0.489,1,2019-02-08,55,35,20,0.636,55,37,18,0.6729999999999999
21800819,1610612764,1610612739,119.0,106.0,0.5,0.375,1,2019-02-08,55,23,32,0.418,55,11,44,0.2
21800820,1610612751,1610612741,106.0,125.0,0.415,0.541,0,2019-02-08,57,29,28,0.509,55,13,42,0.236
21800821,1610612742,1610612749,107.0,122.0,0.414,0.5479999999999999,0,2019-02-08,54,25,29,0.4629999999999999,54,41,13,0.759
21800822,1610612756,1610612744,107.0,117.0,0.386,0.506,0,2019-02-08,57,11,46,0.193,54,39,15,0.722
21800823,1610612740,1610612750,122.0,117.0,0.473,0.505,1,2019-02-08,56,25,31,0.446,55,25,30,0.455
21800824,1610612758,1610612748,102.0,96.0,0.411,0.4320000000000001,1,2019-02-08,55,29,26,0.527,53,25,28,0.472
21800811,1610612754,1610612746,116.0,92.0,0.563,0.435,1,2019-02-07,55,36,19,0.655,56,30,26,0.536
21800812,1610612753,1610612750,122.0,112.0,0.542,0.465,1,2019-02-07,55,23,32,0.418,54,25,29,0.4629999999999999
21800813,1610612737,1610612761,101.0,119.0,0.45,0.46,0,2019-02-07,54,18,36,0.3329999999999999,56,40,16,0.7140000000000001
21800814,1610612738,1610612747,128.0,129.0,0.489,0.515,0,2019-02-07,55,35,20,0.636,55,28,27,0.509
21800815,1610612760,1610612763,117.0,95.0,0.478,0.442,1,2019-02-07,54,35,19,0.648,56,22,34,0.3929999999999999
21800816,1610612757,1610612759,127.0,118.0,0.5379999999999999,0.527,1,2019-02-07,54,33,21,0.611,57,32,25,0.561
21800804,1610612751,1610612743,135.0,130.0,0.511,0.505,1,2019-02-06,56,29,27,0.518,54,37,17,0.685
21800805,1610612741,1610612740,120.0,125.0,0.495,0.529,0,2019-02-06,54,12,42,0.222,55,24,31,0.436
21800806,1610612749,1610612764,148.0,129.0,0.602,0.522,1,2019-02-06,53,40,13,0.755,54,22,32,0.407
21800807,1610612742,1610612766,99.0,93.0,0.4039999999999999,0.4039999999999999,1,2019-02-06,53,25,28,0.472,54,26,28,0.481
21800808,1610612762,1610612756,116.0,88.0,0.5,0.467,1,2019-02-06,55,31,24,0.564,56,11,45,0.196
21800809,1610612758,1610612745,101.0,127.0,0.429,0.45,0,2019-02-06,54,28,26,0.519,54,32,22,0.593
21800810,1610612744,1610612759,141.0,102.0,0.579,0.4320000000000001,1,2019-02-06,53,38,15,0.7170000000000001,56,32,24,0.5710000000000001
21800796,1610612766,1610612746,115.0,117.0,0.419,0.483,0,2019-02-05,53,26,27,0.491,55,30,25,0.545
21800797,1610612739,1610612738,96.0,103.0,0.417,0.488,0,2019-02-05,54,11,43,0.204,54,35,19,0.648
21800798,1610612754,1610612747,136.0,94.0,0.5710000000000001,0.467,1,2019-02-05,54,35,19,0.648,54,27,27,0.5
21800799,1610612752,1610612765,92.0,105.0,0.4,0.4679999999999999,0,2019-02-05,53,10,43,0.1889999999999999,53,24,29,0.4529999999999999
21800800,1610612755,1610612761,107.0,119.0,0.4429999999999999,0.461,0,2019-02-05,54,34,20,0.63,55,39,16,0.7090000000000001
21800801,1610612763,1610612750,108.0,106.0,0.419,0.4479999999999999,1,2019-02-05,55,22,33,0.4,53,25,28,0.472
21800802,1610612760,1610612753,132.0,122.0,0.5,0.467,1,2019-02-05,53,34,19,0.642,54,22,32,0.407
21800803,1610612757,1610612748,108.0,118.0,0.452,0.542,0,2019-02-05,53,32,21,0.604,52,25,27,0.481
21800790,1610612765,1610612743,129.0,103.0,0.545,0.446,1,2019-02-04,52,23,29,0.442,53,37,16,0.698
21800791,1610612764,1610612737,129.0,137.0,0.495,0.505,0,2019-02-04,53,22,31,0.415,53,18,35,0.34
21800792,1610612751,1610612749,94.0,113.0,0.324,0.426,0,2019-02-04,55,28,27,0.509,52,39,13,0.75
21800793,1610612740,1610612754,107.0,109.0,0.433,0.451,0,2019-02-04,54,23,31,0.426,53,34,19,0.642
21800794,1610612756,1610612745,110.0,118.0,0.536,0.494,0,2019-02-04,55,11,44,0.2,53,31,22,0.585
21800795,1610612758,1610612759,127.0,112.0,0.556,0.429,1,2019-02-04,53,28,25,0.528,55,32,23,0.5820000000000001
21800787,1610612752,1610612763,84.0,96.0,0.3779999999999999,0.407,0,2019-02-03,52,10,42,0.192,54,21,33,0.389
21800788,1610612738,1610612760,134.0,129.0,0.593,0.489,1,2019-02-03,53,34,19,0.642,52,33,19,0.635
21800789,1610612761,1610612746,121.0,103.0,0.457,0.4270000000000001,1,2019-02-03,54,38,16,0.7040000000000001,54,29,25,0.537
21800775,1610612765,1610612746,101.0,111.0,0.422,0.488,0,2019-02-02,51,22,29,0.431,53,29,24,0.547
21800776,1610612766,1610612741,125.0,118.0,0.524,0.519,1,2019-02-02,52,26,26,0.5,53,12,41,0.226
21800777,1610612753,1610612751,102.0,89.0,0.436,0.363,1,2019-02-02,53,22,31,0.415,54,28,26,0.519
21800778,1610612764,1610612749,115.0,131.0,0.462,0.495,0,2019-02-02,52,22,30,0.423,51,38,13,0.745
21800780,1610612739,1610612742,98.0,111.0,0.4,0.476,0,2019-02-02,53,11,42,0.208,52,24,28,0.462
21800781,1610612748,1610612754,88.0,95.0,0.423,0.4270000000000001,0,2019-02-02,51,24,27,0.471,52,33,19,0.635
21800779,1610612759,1610612740,113.0,108.0,0.478,0.4479999999999999,1,2019-02-02,54,32,22,0.593,53,23,30,0.434
21800782,1610612744,1610612747,115.0,101.0,0.473,0.4379999999999999,1,2019-02-02,52,37,15,0.7120000000000001,53,27,26,0.509
21800783,1610612750,1610612743,106.0,107.0,0.472,0.472,0,2019-02-02,52,25,27,0.481,52,37,15,0.7120000000000001
21800784,1610612756,1610612737,112.0,118.0,0.469,0.512,0,2019-02-02,54,11,43,0.204,52,17,35,0.327
21800786,1610612762,1610612745,98.0,125.0,0.36,0.46,0,2019-02-02,54,30,24,0.556,52,30,22,0.5770000000000001
21800785,1610612758,1610612755,115.0,108.0,0.457,0.441,1,2019-02-02,52,27,25,0.519,53,34,19,0.642
21800770,1610612766,1610612763,100.0,92.0,0.4379999999999999,0.4379999999999999,1,2019-02-01,51,25,26,0.49,53,20,33,0.377
21800771,1610612752,1610612738,99.0,113.0,0.4529999999999999,0.46,0,2019-02-01,51,10,41,0.196,52,33,19,0.635
21800772,1610612748,1610612760,102.0,118.0,0.446,0.484,0,2019-02-01,50,24,26,0.48,51,33,18,0.647
21800773,1610612762,1610612737,128.0,112.0,0.529,0.3979999999999999,1,2019-02-01,53,30,23,0.5660000000000001,51,16,35,0.314
21800774,1610612743,1610612745,136.0,122.0,0.622,0.529,1,2019-02-01,51,36,15,0.706,51,29,22,0.569
21800764,1610612765,1610612742,93.0,89.0,0.384,0.409,1,2019-01-31,50,22,28,0.44,51,23,28,0.451
21800765,1610612753,1610612754,107.0,100.0,0.4629999999999999,0.451,1,2019-01-31,52,21,31,0.4039999999999999,51,32,19,0.627
21800766,1610612761,1610612749,92.0,105.0,0.3979999999999999,0.494,0,2019-01-31,53,37,16,0.698,50,37,13,0.74
21800767,1610612759,1610612751,117.0,114.0,0.4,0.472,1,2019-01-31,53,31,22,0.585,53,28,25,0.528
21800768,1610612744,1610612755,104.0,113.0,0.466,0.466,0,2019-01-31,51,36,15,0.706,52,34,18,0.654
21800769,1610612746,1610612747,120.0,123.0,0.442,0.457,0,2019-01-31,52,28,24,0.5379999999999999,52,27,25,0.519
21800756,1610612738,1610612766,126.0,94.0,0.556,0.4379999999999999,1,2019-01-30,51,32,19,0.627,50,24,26,0.48
21800757,1610612748,1610612741,89.0,105.0,0.382,0.513,0,2019-01-30,49,24,25,0.49,52,12,40,0.231
21800758,1610612752,1610612742,90.0,114.0,0.41,0.536,0,2019-01-30,50,10,40,0.2,50,23,27,0.46
21800759,1610612764,1610612754,107.0,89.0,0.526,0.3929999999999999,1,2019-01-30,51,22,29,0.431,50,32,18,0.64
21800760,1610612750,1610612763,99.0,97.0,0.389,0.414,1,2019-01-30,51,25,26,0.49,52,20,32,0.385
21800761,1610612740,1610612743,99.0,105.0,0.416,0.472,0,2019-01-30,52,23,29,0.442,50,35,15,0.7
21800762,1610612758,1610612737,135.0,113.0,0.545,0.442,1,2019-01-30,51,26,25,0.51,50,16,34,0.32
21800763,1610612757,1610612762,132.0,105.0,0.5329999999999999,0.447,1,2019-01-30,52,32,20,0.615,52,29,23,0.5579999999999999
21800749,1610612739,1610612764,116.0,113.0,0.536,0.483,1,2019-01-29,52,11,41,0.212,50,21,29,0.42
21800750,1610612765,1610612749,105.0,115.0,0.472,0.54,0,2019-01-29,49,21,28,0.429,49,36,13,0.735
21800751,1610612753,1610612760,117.0,126.0,0.431,0.5379999999999999,0,2019-01-29,51,20,31,0.392,50,32,18,0.64
21800752,1610612751,1610612741,122.0,117.0,0.447,0.5,1,2019-01-29,52,28,24,0.5379999999999999,51,11,40,0.216
21800753,1610612745,1610612740,116.0,121.0,0.396,0.511,0,2019-01-29,50,29,21,0.58,51,23,28,0.451
21800754,1610612759,1610612756,126.0,124.0,0.47,0.6,1,2019-01-29,52,30,22,0.5770000000000001,53,11,42,0.208
21800755,1610612747,1610612755,105.0,121.0,0.467,0.452,0,2019-01-29,51,26,25,0.51,51,33,18,0.647
21800744,1610612766,1610612752,101.0,92.0,0.415,0.4,1,2019-01-28,49,24,25,0.49,49,10,39,0.204
21800745,1610612754,1610612744,100.0,132.0,0.426,0.541,0,2019-01-28,49,32,17,0.653,50,36,14,0.72
21800746,1610612738,1610612751,112.0,104.0,0.45,0.379,1,2019-01-28,50,31,19,0.62,51,27,24,0.529
21800747,1610612763,1610612743,92.0,95.0,0.449,0.44,0,2019-01-28,51,20,31,0.392,49,34,15,0.6940000000000001
21800748,1610612746,1610612737,118.0,123.0,0.482,0.506,0,2019-01-28,51,28,23,0.5489999999999999,49,16,33,0.327
21800735,1610612741,1610612739,101.0,104.0,0.4429999999999999,0.424,0,2019-01-27,50,11,39,0.22,51,10,41,0.196
21800736,1610612746,1610612758,122.0,108.0,0.477,0.3979999999999999,1,2019-01-27,50,28,22,0.56,50,25,25,0.5
21800738,1610612760,1610612749,118.0,112.0,0.4679999999999999,0.429,1,2019-01-27,49,31,18,0.633,48,35,13,0.7290000000000001
21800737,1610612745,1610612753,103.0,98.0,0.475,0.402,1,2019-01-27,49,29,20,0.5920000000000001,50,20,30,0.4
21800739,1610612742,1610612761,120.0,123.0,0.489,0.446,0,2019-01-27,49,22,27,0.449,52,37,15,0.7120000000000001
21800740,1610612750,1610612762,111.0,125.0,0.481,0.535,0,2019-01-27,50,24,26,0.48,51,29,22,0.569
21800742,1610612759,1610612764,132.0,119.0,0.57,0.449,1,2019-01-27,51,29,22,0.569,49,21,28,0.429
21800741,1610612752,1610612748,97.0,106.0,0.429,0.4639999999999999,0,2019-01-27,48,10,38,0.208,48,24,24,0.5
21800743,1610612747,1610612756,116.0,102.0,0.528,0.4,1,2019-01-27,50,26,24,0.52,52,11,41,0.212
21800730,1610612740,1610612759,114.0,126.0,0.469,0.516,0,2019-01-26,50,22,28,0.44,50,28,22,0.56
21800731,1610612763,1610612754,106.0,103.0,0.488,0.4320000000000001,1,2019-01-26,50,20,30,0.4,48,32,16,0.667
21800732,1610612738,1610612744,111.0,115.0,0.414,0.446,0,2019-01-26,49,30,19,0.612,49,35,14,0.7140000000000001
21800733,1610612743,1610612755,126.0,110.0,0.511,0.418,1,2019-01-26,48,33,15,0.688,50,32,18,0.64
21800734,1610612757,1610612737,120.0,111.0,0.5,0.457,1,2019-01-26,51,31,20,0.608,48,15,33,0.313
21800720,1610612753,1610612764,91.0,95.0,0.452,0.4429999999999999,0,2019-01-25,49,20,29,0.408,48,21,27,0.4379999999999999
21800721,1610612751,1610612752,109.0,99.0,0.405,0.425,1,2019-01-25,50,27,23,0.54,47,10,37,0.213
21800722,1610612739,1610612748,94.0,100.0,0.435,0.4679999999999999,0,2019-01-25,50,9,41,0.18,47,23,24,0.489
21800723,1610612741,1610612746,101.0,106.0,0.392,0.4629999999999999,0,2019-01-25,49,11,38,0.2239999999999999,49,27,22,0.551
21800724,1610612745,1610612761,121.0,119.0,0.451,0.484,1,2019-01-25,48,28,20,0.583,51,36,15,0.706
21800725,1610612763,1610612758,96.0,99.0,0.425,0.407,0,2019-01-25,49,19,30,0.3879999999999999,49,25,24,0.51
21800726,1610612742,1610612765,106.0,101.0,0.457,0.412,1,2019-01-25,48,22,26,0.4579999999999999,48,21,27,0.4379999999999999
21800727,1610612749,1610612766,108.0,99.0,0.461,0.4,1,2019-01-25,47,35,12,0.745,48,23,25,0.479
21800728,1610612743,1610612756,132.0,95.0,0.5,0.421,1,2019-01-25,47,32,15,0.6809999999999999,51,11,40,0.216
21800729,1610612762,1610612750,106.0,102.0,0.3939999999999999,0.422,1,2019-01-25,50,28,22,0.56,49,24,25,0.49
21800716,1610612764,1610612744,118.0,126.0,0.4629999999999999,0.568,0,2019-01-24,47,20,27,0.426,48,34,14,0.708
21800717,1610612760,1610612740,122.0,116.0,0.495,0.485,1,2019-01-24,48,30,18,0.625,49,22,27,0.449
21800718,1610612756,1610612757,106.0,120.0,0.409,0.4679999999999999,0,2019-01-24,50,11,39,0.22,50,30,20,0.6
21800719,1610612747,1610612750,105.0,120.0,0.506,0.431,0,2019-01-24,49,25,24,0.51,48,24,24,0.5
21800706,1610612754,1610612761,110.0,106.0,0.435,0.413,1,2019-01-23,47,32,15,0.6809999999999999,50,36,14,0.72
21800707,1610612738,1610612739,123.0,103.0,0.523,0.4370000000000001,1,2019-01-23,48,30,18,0.625,49,9,40,0.184
21800708,1610612751,1610612753,114.0,110.0,0.478,0.4270000000000001,1,2019-01-23,49,26,23,0.531,48,20,28,0.417
21800709,1610612748,1610612746,99.0,111.0,0.47,0.529,0,2019-01-23,46,22,24,0.478,48,26,22,0.542
21800710,1610612752,1610612745,110.0,114.0,0.457,0.411,0,2019-01-23,46,10,36,0.217,47,27,20,0.574
21800711,1610612755,1610612759,122.0,120.0,0.505,0.573,1,2019-01-23,49,32,17,0.653,49,27,22,0.551
21800712,1610612741,1610612737,101.0,121.0,0.4429999999999999,0.5,0,2019-01-23,48,11,37,0.2289999999999999,47,15,32,0.319
21800713,1610612763,1610612766,107.0,118.0,0.469,0.532,0,2019-01-23,48,19,29,0.396,47,23,24,0.489
21800714,1610612740,1610612765,94.0,98.0,0.462,0.4039999999999999,0,2019-01-23,48,22,26,0.4579999999999999,47,21,26,0.447
21800715,1610612762,1610612743,114.0,108.0,0.4320000000000001,0.477,1,2019-01-23,49,27,22,0.551,46,31,15,0.674
21800702,1610612761,1610612758,120.0,105.0,0.44,0.451,1,2019-01-22,49,36,13,0.735,48,24,24,0.5
21800703,1610612760,1610612757,123.0,114.0,0.506,0.4529999999999999,1,2019-01-22,47,29,18,0.617,49,29,20,0.5920000000000001
21800704,1610612742,1610612746,106.0,98.0,0.469,0.363,1,2019-01-22,47,21,26,0.447,47,25,22,0.532
21800705,1610612756,1610612750,91.0,118.0,0.425,0.4370000000000001,0,2019-01-22,49,11,38,0.2239999999999999,47,23,24,0.489
21800691,1610612752,1610612760,109.0,127.0,0.4479999999999999,0.542,0,2019-01-21,45,10,35,0.222,46,28,18,0.609
21800692,1610612739,1610612741,88.0,104.0,0.356,0.474,0,2019-01-21,48,9,39,0.188,47,11,36,0.2339999999999999
21800693,1610612764,1610612765,101.0,87.0,0.456,0.4029999999999999,1,2019-01-21,46,20,26,0.435,46,20,26,0.435
21800694,1610612749,1610612742,116.0,106.0,0.462,0.414,1,2019-01-21,46,34,12,0.7390000000000001,46,20,26,0.435
21800695,1610612737,1610612753,103.0,122.0,0.4529999999999999,0.505,0,2019-01-21,46,14,32,0.304,47,20,27,0.426
21800696,1610612751,1610612758,123.0,94.0,0.5,0.419,1,2019-01-21,48,25,23,0.521,47,24,23,0.511
21800697,1610612763,1610612740,85.0,105.0,0.375,0.527,0,2019-01-21,47,19,28,0.4039999999999999,47,22,25,0.4679999999999999
21800698,1610612738,1610612748,107.0,99.0,0.494,0.419,1,2019-01-21,47,29,18,0.617,45,22,23,0.489
21800699,1610612755,1610612745,121.0,93.0,0.489,0.36,1,2019-01-21,48,31,17,0.6459999999999999,46,26,20,0.565
21800700,1610612762,1610612757,104.0,109.0,0.396,0.5,0,2019-01-21,48,26,22,0.542,48,29,19,0.604
21800701,1610612747,1610612744,111.0,130.0,0.5,0.51,0,2019-01-21,48,25,23,0.521,47,33,14,0.7020000000000001
21800688,1610612754,1610612766,120.0,95.0,0.47,0.402,1,2019-01-20,46,31,15,0.674,46,22,24,0.478
21800689,1610612750,1610612756,116.0,114.0,0.429,0.465,1,2019-01-20,46,22,24,0.478,48,11,37,0.2289999999999999
21800690,1610612759,1610612746,95.0,103.0,0.4639999999999999,0.4589999999999999,0,2019-01-20,48,27,21,0.563,46,25,21,0.5429999999999999
21800678,1610612755,1610612760,115.0,117.0,0.469,0.441,0,2019-01-19,47,30,17,0.638,45,27,18,0.6
21800679,1610612766,1610612756,135.0,115.0,0.545,0.4479999999999999,1,2019-01-19,45,22,23,0.489,47,11,36,0.2339999999999999
21800680,1610612765,1610612758,101.0,103.0,0.439,0.449,0,2019-01-19,45,20,25,0.444,46,24,22,0.522
21800681,1610612754,1610612742,111.0,99.0,0.494,0.42,1,2019-01-19,45,30,15,0.667,45,20,25,0.444
21800682,1610612753,1610612749,108.0,118.0,0.473,0.5529999999999999,0,2019-01-19,46,19,27,0.413,45,33,12,0.733
21800683,1610612737,1610612738,105.0,113.0,0.435,0.4429999999999999,0,2019-01-19,45,14,31,0.311,46,28,18,0.609
21800684,1610612761,1610612763,119.0,90.0,0.489,0.425,1,2019-01-19,48,35,13,0.7290000000000001,46,19,27,0.413
21800685,1610612741,1610612748,103.0,117.0,0.3929999999999999,0.57,0,2019-01-19,46,10,36,0.217,44,22,22,0.5
21800686,1610612745,1610612747,138.0,134.0,0.42,0.521,1,2019-01-19,45,26,19,0.578,47,25,22,0.532
21800687,1610612743,1610612739,124.0,102.0,0.562,0.486,1,2019-01-19,45,31,14,0.6890000000000001,47,9,38,0.191
21800671,1610612738,1610612763,122.0,116.0,0.512,0.446,1,2019-01-18,45,27,18,0.6,45,19,26,0.422
21800672,1610612765,1610612748,98.0,93.0,0.4270000000000001,0.506,1,2019-01-18,44,20,24,0.455,43,21,22,0.488
21800673,1610612753,1610612751,115.0,117.0,0.5,0.4539999999999999,0,2019-01-18,45,19,26,0.422,47,24,23,0.511
21800674,1610612750,1610612759,113.0,116.0,0.44,0.5,0,2019-01-18,45,21,24,0.467,47,27,20,0.574
21800675,1610612762,1610612739,115.0,99.0,0.518,0.414,1,2019-01-18,47,26,21,0.5529999999999999,46,9,37,0.196
21800676,1610612746,1610612744,94.0,112.0,0.365,0.488,0,2019-01-18,45,24,21,0.5329999999999999,46,32,14,0.696
21800677,1610612757,1610612740,128.0,112.0,0.466,0.488,1,2019-01-18,47,28,19,0.596,46,21,25,0.457
21800665,1610612764,1610612752,101.0,100.0,0.435,0.4479999999999999,1,2019-01-17,45,19,26,0.422,44,10,34,0.2269999999999999
21800666,1610612766,1610612758,114.0,95.0,0.4479999999999999,0.4429999999999999,1,2019-01-17,44,21,23,0.477,45,23,22,0.511
21800667,1610612754,1610612755,96.0,120.0,0.402,0.529,0,2019-01-17,44,29,15,0.659,46,30,16,0.652
21800668,1610612761,1610612756,111.0,109.0,0.5,0.429,1,2019-01-17,47,34,13,0.723,46,11,35,0.239
21800669,1610612743,1610612741,135.0,105.0,0.521,0.473,1,2019-01-17,44,30,14,0.682,45,10,35,0.222
21800670,1610612760,1610612747,128.0,138.0,0.3939999999999999,0.505,0,2019-01-17,44,26,18,0.591,46,25,21,0.5429999999999999
21800657,1610612765,1610612753,120.0,115.0,0.478,0.5,1,2019-01-16,43,19,24,0.442,44,19,25,0.4320000000000001
21800658,1610612738,1610612761,117.0,108.0,0.5,0.446,1,2019-01-16,44,26,18,0.591,46,33,13,0.7170000000000001
21800659,1610612745,1610612751,142.0,145.0,0.429,0.519,0,2019-01-16,44,25,19,0.568,46,23,23,0.5
21800660,1610612763,1610612749,101.0,111.0,0.389,0.476,0,2019-01-16,44,19,25,0.4320000000000001,44,32,12,0.727
21800661,1610612742,1610612759,101.0,105.0,0.43,0.494,0,2019-01-16,44,20,24,0.455,46,26,20,0.565
21800662,1610612757,1610612739,129.0,112.0,0.528,0.474,1,2019-01-16,46,27,19,0.5870000000000001,45,9,36,0.2
21800663,1610612744,1610612740,147.0,140.0,0.48,0.48,1,2019-01-16,45,31,14,0.6890000000000001,45,21,24,0.467
21800664,1610612746,1610612762,109.0,129.0,0.4589999999999999,0.512,0,2019-01-16,44,24,20,0.545,46,25,21,0.5429999999999999
21800651,1610612754,1610612756,131.0,97.0,0.517,0.421,1,2019-01-15,43,29,14,0.674,45,11,34,0.244
21800652,1610612755,1610612750,149.0,107.0,0.598,0.389,1,2019-01-15,45,29,16,0.644,44,21,23,0.477
21800653,1610612737,1610612760,142.0,126.0,0.622,0.457,1,2019-01-15,44,14,30,0.318,43,26,17,0.605
21800654,1610612749,1610612748,124.0,86.0,0.5,0.419,1,2019-01-15,43,31,12,0.721,42,21,21,0.5
21800655,1610612743,1610612744,111.0,142.0,0.457,0.6,0,2019-01-15,43,29,14,0.674,44,30,14,0.682
21800656,1610612747,1610612741,107.0,100.0,0.4629999999999999,0.402,1,2019-01-15,45,24,21,0.5329999999999999,44,10,34,0.2269999999999999
21800645,1610612751,1610612738,109.0,102.0,0.43,0.407,1,2019-01-14,45,22,23,0.489,43,25,18,0.581
21800646,1610612745,1610612763,112.0,94.0,0.44,0.507,1,2019-01-14,43,25,18,0.581,43,19,24,0.442
21800647,1610612759,1610612766,93.0,108.0,0.4629999999999999,0.467,0,2019-01-14,45,25,20,0.556,43,20,23,0.465
21800648,1610612762,1610612765,100.0,94.0,0.3879999999999999,0.389,1,2019-01-14,45,24,21,0.5329999999999999,42,18,24,0.429
21800649,1610612758,1610612757,115.0,107.0,0.494,0.402,1,2019-01-14,44,23,21,0.523,45,26,19,0.578
21800650,1610612746,1610612740,117.0,121.0,0.477,0.4379999999999999,0,2019-01-14,43,24,19,0.5579999999999999,44,21,23,0.477
21800638,1610612752,1610612755,105.0,108.0,0.43,0.46,0,2019-01-13,43,10,33,0.233,44,28,16,0.636
21800639,1610612764,1610612761,138.0,140.0,0.4579999999999999,0.471,0,2019-01-13,44,18,26,0.409,45,33,12,0.733
21800640,1610612737,1610612749,114.0,133.0,0.406,0.5329999999999999,0,2019-01-13,43,13,30,0.302,42,30,12,0.7140000000000001
21800641,1610612753,1610612745,116.0,109.0,0.482,0.442,1,2019-01-13,43,19,24,0.442,42,24,18,0.5710000000000001
21800642,1610612742,1610612744,114.0,119.0,0.418,0.455,0,2019-01-13,43,20,23,0.465,43,29,14,0.674
21800643,1610612743,1610612757,116.0,113.0,0.556,0.455,1,2019-01-13,42,29,13,0.69,44,26,18,0.591
21800644,1610612747,1610612739,95.0,101.0,0.396,0.4270000000000001,0,2019-01-13,44,23,21,0.523,44,9,35,0.205
21800630,1610612746,1610612765,104.0,109.0,0.486,0.435,0,2019-01-12,42,24,18,0.5710000000000001,41,18,23,0.439
21800631,1610612748,1610612763,112.0,108.0,0.5,0.481,1,2019-01-12,41,21,20,0.512,42,19,23,0.452
21800632,1610612753,1610612738,105.0,103.0,0.429,0.422,1,2019-01-12,42,18,24,0.429,42,25,17,0.595
21800633,1610612750,1610612740,110.0,106.0,0.43,0.46,1,2019-01-12,43,21,22,0.488,43,20,23,0.465
21800634,1610612760,1610612759,122.0,112.0,0.462,0.4579999999999999,1,2019-01-12,42,26,16,0.619,44,25,19,0.568
21800635,1610612756,1610612743,102.0,93.0,0.413,0.386,1,2019-01-12,44,11,33,0.25,41,28,13,0.6829999999999999
21800636,1610612758,1610612766,104.0,97.0,0.414,0.409,1,2019-01-12,43,22,21,0.512,42,19,23,0.452
21800637,1610612762,1610612741,110.0,102.0,0.4320000000000001,0.412,1,2019-01-12,44,23,21,0.523,43,10,33,0.233
21800621,1610612755,1610612737,121.0,123.0,0.517,0.556,0,2019-01-11,43,27,16,0.628,42,13,29,0.31
21800622,1610612764,1610612749,113.0,106.0,0.488,0.449,1,2019-01-11,43,18,25,0.419,41,29,12,0.7070000000000001
21800623,1610612752,1610612754,106.0,121.0,0.4429999999999999,0.521,0,2019-01-11,42,10,32,0.238,42,28,14,0.667
21800624,1610612761,1610612751,122.0,105.0,0.457,0.42,1,2019-01-11,44,32,12,0.727,44,21,23,0.477
21800625,1610612745,1610612739,141.0,113.0,0.517,0.449,1,2019-01-11,41,24,17,0.585,43,8,35,0.186
21800626,1610612750,1610612742,115.0,119.0,0.461,0.4539999999999999,0,2019-01-11,42,20,22,0.476,42,20,22,0.476
21800627,1610612762,1610612747,113.0,95.0,0.396,0.359,1,2019-01-11,43,22,21,0.512,43,23,20,0.535
21800628,1610612757,1610612766,127.0,96.0,0.5589999999999999,0.4,1,2019-01-11,43,26,17,0.605,41,19,22,0.4629999999999999
21800629,1610612744,1610612741,146.0,109.0,0.5760000000000001,0.449,1,2019-01-11,42,28,14,0.667,42,10,32,0.238
21800617,1610612748,1610612738,115.0,99.0,0.479,0.4039999999999999,1,2019-01-10,40,20,20,0.5,41,25,16,0.61
21800618,1610612743,1610612746,121.0,100.0,0.505,0.4370000000000001,1,2019-01-10,40,28,12,0.7,41,24,17,0.585
21800619,1610612759,1610612760,154.0,147.0,0.5660000000000001,0.509,1,2019-01-10,43,25,18,0.581,41,25,16,0.61
21800620,1610612758,1610612765,112.0,102.0,0.512,0.4270000000000001,1,2019-01-10,42,21,21,0.5,40,17,23,0.425
21800607,1610612738,1610612754,135.0,108.0,0.568,0.429,1,2019-01-09,40,25,15,0.625,41,27,14,0.659
21800608,1610612764,1610612755,123.0,106.0,0.54,0.43,1,2019-01-09,42,17,25,0.405,42,27,15,0.643
21800609,1610612751,1610612737,116.0,100.0,0.4529999999999999,0.364,1,2019-01-09,43,21,22,0.488,41,12,29,0.293
21800610,1610612745,1610612749,109.0,116.0,0.376,0.484,0,2019-01-09,40,23,17,0.575,40,29,11,0.725
21800611,1610612763,1610612759,96.0,86.0,0.411,0.361,1,2019-01-09,41,19,22,0.4629999999999999,42,24,18,0.5710000000000001
21800612,1610612740,1610612739,140.0,124.0,0.5479999999999999,0.477,1,2019-01-09,42,20,22,0.476,42,8,34,0.19
21800613,1610612742,1610612756,104.0,94.0,0.429,0.429,1,2019-01-09,41,19,22,0.4629999999999999,43,10,33,0.233
21800614,1610612762,1610612753,106.0,93.0,0.488,0.3979999999999999,1,2019-01-09,42,21,21,0.5,41,17,24,0.415
21800615,1610612757,1610612741,124.0,112.0,0.5660000000000001,0.462,1,2019-01-09,42,25,17,0.595,41,10,31,0.244
21800616,1610612747,1610612765,113.0,100.0,0.561,0.4529999999999999,1,2019-01-09,42,23,19,0.5479999999999999,39,17,22,0.436
21800599,1610612739,1610612754,115.0,123.0,0.539,0.5379999999999999,0,2019-01-08,41,8,33,0.195,40,27,13,0.675
21800600,1610612755,1610612764,132.0,115.0,0.557,0.5,1,2019-01-08,41,27,14,0.659,41,16,25,0.39
21800601,1610612748,1610612743,99.0,103.0,0.4579999999999999,0.471,0,2019-01-08,39,19,20,0.487,39,27,12,0.6920000000000001
21800602,1610612761,1610612737,104.0,101.0,0.4629999999999999,0.46,1,2019-01-08,43,31,12,0.721,40,12,28,0.3
21800603,1610612760,1610612750,117.0,119.0,0.506,0.422,0,2019-01-08,40,25,15,0.625,41,20,21,0.488
21800604,1610612756,1610612758,115.0,111.0,0.511,0.475,1,2019-01-08,42,10,32,0.238,41,20,21,0.488
21800605,1610612744,1610612752,122.0,95.0,0.51,0.3979999999999999,1,2019-01-08,41,27,14,0.659,41,10,31,0.244
21800606,1610612746,1610612766,128.0,109.0,0.516,0.4,1,2019-01-08,40,24,16,0.6,40,19,21,0.475
21800591,1610612765,1610612759,107.0,119.0,0.494,0.544,0,2019-01-07,38,17,21,0.447,41,24,17,0.585
21800592,1610612738,1610612751,116.0,95.0,0.505,0.405,1,2019-01-07,39,24,15,0.615,42,20,22,0.476
21800593,1610612745,1610612743,125.0,113.0,0.5,0.473,1,2019-01-07,39,23,16,0.59,38,26,12,0.684
21800594,1610612749,1610612762,114.0,102.0,0.469,0.419,1,2019-01-07,39,28,11,0.718,41,20,21,0.488
21800595,1610612740,1610612763,114.0,95.0,0.557,0.449,1,2019-01-07,41,19,22,0.4629999999999999,40,18,22,0.45
21800596,1610612742,1610612747,97.0,107.0,0.419,0.436,0,2019-01-07,40,18,22,0.45,41,22,19,0.537
21800597,1610612757,1610612752,111.0,101.0,0.471,0.4039999999999999,1,2019-01-07,41,24,17,0.585,40,10,30,0.25
21800598,1610612758,1610612753,111.0,95.0,0.4589999999999999,0.368,1,2019-01-07,40,20,20,0.5,40,17,23,0.425
21800584,1610612741,1610612751,100.0,117.0,0.466,0.506,0,2019-01-06,40,10,30,0.25,41,20,21,0.488
21800585,1610612750,1610612747,108.0,86.0,0.461,0.368,1,2019-01-06,40,19,21,0.475,40,21,19,0.525
21800586,1610612746,1610612753,106.0,96.0,0.43,0.371,1,2019-01-06,39,23,16,0.59,39,17,22,0.436
21800587,1610612737,1610612748,106.0,82.0,0.473,0.356,1,2019-01-06,39,12,27,0.308,38,19,19,0.5
21800588,1610612760,1610612764,98.0,116.0,0.4320000000000001,0.436,0,2019-01-06,39,25,14,0.6409999999999999,40,16,24,0.4
21800589,1610612761,1610612754,121.0,105.0,0.518,0.457,1,2019-01-06,42,30,12,0.7140000000000001,39,26,13,0.667
21800590,1610612756,1610612766,113.0,119.0,0.518,0.484,0,2019-01-06,41,9,32,0.22,39,19,20,0.487
21800576,1610612743,1610612766,123.0,110.0,0.461,0.476,1,2019-01-05,37,26,11,0.703,38,18,20,0.474
21800577,1610612765,1610612762,105.0,110.0,0.476,0.476,0,2019-01-05,37,17,20,0.4589999999999999,40,20,20,0.5
21800578,1610612755,1610612742,106.0,100.0,0.47,0.4320000000000001,1,2019-01-05,40,26,14,0.65,39,18,21,0.462
21800579,1610612739,1610612740,98.0,133.0,0.409,0.58,0,2019-01-05,40,8,32,0.2,40,18,22,0.45
21800580,1610612749,1610612761,116.0,123.0,0.494,0.512,0,2019-01-05,38,27,11,0.711,41,29,12,0.7070000000000001
21800581,1610612759,1610612763,108.0,88.0,0.493,0.3779999999999999,1,2019-01-05,40,23,17,0.575,39,18,21,0.462
21800582,1610612757,1610612745,110.0,101.0,0.457,0.4639999999999999,1,2019-01-05,40,23,17,0.575,38,22,16,0.579
21800583,1610612758,1610612744,123.0,127.0,0.474,0.505,0,2019-01-05,39,19,20,0.487,40,26,14,0.65
21800567,1610612739,1610612762,91.0,117.0,0.39,0.512,0,2019-01-04,39,8,31,0.205,39,19,20,0.487
21800566,1610612738,1610612742,114.0,93.0,0.4379999999999999,0.386,1,2019-01-04,38,23,15,0.605,38,18,20,0.474
21800568,1610612748,1610612764,115.0,109.0,0.484,0.429,1,2019-01-04,37,19,18,0.514,39,15,24,0.385
21800569,1610612741,1610612754,116.0,119.0,0.516,0.527,0,2019-01-04,39,10,29,0.256,38,26,12,0.684
21800570,1610612763,1610612751,100.0,109.0,0.452,0.456,0,2019-01-04,38,18,20,0.474,40,19,21,0.475
21800571,1610612750,1610612753,120.0,103.0,0.516,0.477,1,2019-01-04,39,18,21,0.462,38,17,21,0.447
21800572,1610612749,1610612737,144.0,112.0,0.55,0.435,1,2019-01-04,37,27,10,0.73,38,11,27,0.289
21800573,1610612756,1610612746,111.0,121.0,0.532,0.512,0,2019-01-04,40,9,31,0.225,38,22,16,0.579
21800574,1610612747,1610612752,112.0,119.0,0.439,0.374,0,2019-01-04,39,21,18,0.5379999999999999,39,10,29,0.256
21800575,1610612757,1610612760,109.0,111.0,0.4320000000000001,0.426,0,2019-01-04,39,22,17,0.564,38,25,13,0.6579999999999999
21800563,1610612759,1610612761,125.0,107.0,0.5529999999999999,0.4479999999999999,1,2019-01-03,39,22,17,0.564,40,28,12,0.7
21800564,1610612758,1610612743,113.0,117.0,0.5,0.461,0,2019-01-03,38,19,19,0.5,36,25,11,0.6940000000000001
21800565,1610612744,1610612745,134.0,135.0,0.52,0.455,0,2019-01-03,39,25,14,0.6409999999999999,37,22,15,0.595
21800554,1610612766,1610612742,84.0,122.0,0.356,0.4629999999999999,0,2019-01-02,37,18,19,0.486,37,18,19,0.486
21800555,1610612739,1610612748,92.0,117.0,0.4529999999999999,0.512,0,2019-01-02,38,8,30,0.211,36,18,18,0.5
21800556,1610612764,1610612737,114.0,98.0,0.467,0.421,1,2019-01-02,38,15,23,0.395,37,11,26,0.297
21800557,1610612751,1610612740,126.0,121.0,0.505,0.529,1,2019-01-02,39,18,21,0.462,39,17,22,0.436
21800558,1610612738,1610612750,115.0,102.0,0.5920000000000001,0.476,1,2019-01-02,37,22,15,0.595,38,17,21,0.447
21800559,1610612741,1610612753,84.0,112.0,0.419,0.579,0,2019-01-02,38,10,28,0.263,37,17,20,0.4589999999999999
21800560,1610612763,1610612765,94.0,101.0,0.462,0.434,0,2019-01-02,37,18,19,0.486,36,17,19,0.472
21800561,1610612756,1610612755,127.0,132.0,0.4529999999999999,0.541,0,2019-01-02,39,9,30,0.231,39,25,14,0.6409999999999999
21800562,1610612747,1610612760,100.0,107.0,0.416,0.381,0,2019-01-02,38,21,17,0.5529999999999999,37,24,13,0.649
21800549,1610612761,1610612762,122.0,116.0,0.5489999999999999,0.433,1,2019-01-01,39,28,11,0.718,38,18,20,0.474
21800550,1610612749,1610612765,121.0,98.0,0.595,0.38,1,2019-01-01,36,26,10,0.722,35,16,19,0.457
21800551,1610612743,1610612752,115.0,108.0,0.4629999999999999,0.452,1,2019-01-01,35,24,11,0.6859999999999999,38,9,29,0.237
21800552,1610612758,1610612757,108.0,113.0,0.3829999999999999,0.433,0,2019-01-01,37,19,18,0.514,38,22,16,0.579
21800553,1610612746,1610612755,113.0,119.0,0.462,0.483,0,2019-01-01,37,21,16,0.568,38,24,14,0.632
21800542,1610612754,1610612737,116.0,108.0,0.5,0.4320000000000001,1,2018-12-31,37,25,12,0.6759999999999999,36,11,25,0.306
21800543,1610612766,1610612753,125.0,100.0,0.494,0.413,1,2018-12-31,36,18,18,0.5,36,16,20,0.444
21800544,1610612745,1610612763,113.0,101.0,0.4429999999999999,0.4629999999999999,1,2018-12-31,36,21,15,0.583,36,18,18,0.5
21800545,1610612759,1610612738,120.0,111.0,0.495,0.489,1,2018-12-31,38,21,17,0.5529999999999999,36,21,15,0.583
21800546,1610612740,1610612750,123.0,114.0,0.517,0.462,1,2018-12-31,38,17,21,0.447,37,17,20,0.4589999999999999
21800547,1610612760,1610612742,122.0,102.0,0.447,0.419,1,2018-12-31,36,23,13,0.639,36,17,19,0.472
21800548,1610612756,1610612744,109.0,132.0,0.435,0.5479999999999999,0,2018-12-31,38,9,29,0.237,38,25,13,0.6579999999999999
21800536,1610612753,1610612765,109.0,107.0,0.471,0.424,1,2018-12-30,35,16,19,0.457,34,16,18,0.471
21800537,1610612748,1610612750,104.0,113.0,0.411,0.4039999999999999,0,2018-12-30,35,17,18,0.486,36,17,19,0.472
21800538,1610612761,1610612741,95.0,89.0,0.37,0.413,1,2018-12-30,38,27,11,0.711,37,10,27,0.27
21800539,1610612742,1610612760,105.0,103.0,0.457,0.43,1,2018-12-30,35,17,18,0.486,35,22,13,0.629
21800540,1610612757,1610612755,129.0,95.0,0.59,0.354,1,2018-12-30,37,21,16,0.568,37,23,14,0.622
21800541,1610612747,1610612758,121.0,114.0,0.48,0.484,1,2018-12-30,37,21,16,0.568,36,19,17,0.528
21800527,1610612749,1610612751,129.0,115.0,0.49,0.481,1,2018-12-29,35,25,10,0.7140000000000001,38,17,21,0.447
21800528,1610612740,1610612745,104.0,108.0,0.446,0.4320000000000001,0,2018-12-29,37,16,21,0.4320000000000001,35,20,15,0.5710000000000001
21800530,1610612764,1610612766,130.0,126.0,0.516,0.522,1,2018-12-29,37,14,23,0.3779999999999999,35,17,18,0.486
21800529,1610612737,1610612739,111.0,108.0,0.439,0.471,1,2018-12-29,35,11,24,0.314,37,8,29,0.216
21800531,1610612763,1610612738,103.0,112.0,0.474,0.5,0,2018-12-29,35,18,17,0.514,35,21,14,0.6
21800532,1610612762,1610612752,129.0,97.0,0.5479999999999999,0.3720000000000001,1,2018-12-29,37,18,19,0.486,37,9,28,0.243
21800533,1610612756,1610612743,118.0,122.0,0.5379999999999999,0.5529999999999999,0,2018-12-29,37,9,28,0.243,34,23,11,0.6759999999999999
21800534,1610612757,1610612744,105.0,115.0,0.429,0.5,0,2018-12-29,36,20,16,0.556,37,24,13,0.649
21800535,1610612746,1610612759,111.0,122.0,0.439,0.506,0,2018-12-29,36,21,15,0.583,37,20,17,0.541
21800517,1610612766,1610612751,100.0,87.0,0.41,0.3979999999999999,1,2018-12-28,34,17,17,0.5,37,17,20,0.4589999999999999
21800518,1610612754,1610612765,125.0,88.0,0.609,0.374,1,2018-12-28,36,24,12,0.667,33,16,17,0.485
21800519,1610612753,1610612761,116.0,87.0,0.473,0.295,1,2018-12-28,34,15,19,0.441,37,26,11,0.703
21800520,1610612764,1610612741,92.0,101.0,0.4,0.4679999999999999,0,2018-12-28,36,13,23,0.361,36,10,26,0.278
21800521,1610612748,1610612739,118.0,94.0,0.527,0.3829999999999999,1,2018-12-28,34,17,17,0.5,36,8,28,0.222
21800522,1610612750,1610612737,120.0,123.0,0.449,0.47,0,2018-12-28,35,16,19,0.457,34,10,24,0.294
21800523,1610612740,1610612742,114.0,112.0,0.4579999999999999,0.474,1,2018-12-28,36,16,20,0.444,34,16,18,0.471
21800524,1610612743,1610612759,102.0,99.0,0.4589999999999999,0.449,1,2018-12-28,33,22,11,0.667,36,19,17,0.528
21800525,1610612756,1610612760,102.0,118.0,0.433,0.537,0,2018-12-28,36,9,27,0.25,34,22,12,0.647
21800526,1610612747,1610612746,107.0,118.0,0.414,0.44,0,2018-12-28,36,20,16,0.556,35,21,14,0.6
21800512,1610612745,1610612738,127.0,113.0,0.477,0.469,1,2018-12-27,34,19,15,0.5589999999999999,34,20,14,0.588
21800513,1610612749,1610612752,112.0,96.0,0.452,0.371,1,2018-12-27,34,24,10,0.706,36,9,27,0.25
21800514,1610612758,1610612747,117.0,116.0,0.446,0.511,1,2018-12-27,35,19,16,0.5429999999999999,35,20,15,0.5710000000000001
21800515,1610612762,1610612755,97.0,114.0,0.384,0.5,0,2018-12-27,36,17,19,0.472,36,23,13,0.639
21800516,1610612744,1610612757,109.0,110.0,0.425,0.362,0,2018-12-27,36,23,13,0.639,35,20,15,0.5710000000000001
21800502,1610612765,1610612764,106.0,95.0,0.4629999999999999,0.4579999999999999,1,2018-12-26,32,16,16,0.5,35,13,22,0.371
21800503,1610612753,1610612756,120.0,122.0,0.4579999999999999,0.505,0,2018-12-26,33,14,19,0.424,35,9,26,0.257
21800504,1610612737,1610612754,121.0,129.0,0.506,0.5539999999999999,0,2018-12-26,33,9,24,0.273,35,23,12,0.657
21800505,1610612751,1610612766,134.0,132.0,0.49,0.4429999999999999,1,2018-12-26,36,17,19,0.472,33,16,17,0.485
21800506,1610612748,1610612761,104.0,106.0,0.518,0.4679999999999999,0,2018-12-26,33,16,17,0.485,36,26,10,0.722
21800507,1610612741,1610612750,94.0,119.0,0.411,0.495,0,2018-12-26,35,9,26,0.257,34,16,18,0.471
21800508,1610612763,1610612739,95.0,87.0,0.5,0.355,1,2018-12-26,34,18,16,0.529,35,8,27,0.2289999999999999
21800509,1610612742,1610612740,122.0,119.0,0.481,0.467,1,2018-12-26,33,16,17,0.485,35,15,20,0.429
21800510,1610612759,1610612743,111.0,103.0,0.467,0.389,1,2018-12-26,35,19,16,0.5429999999999999,32,21,11,0.6559999999999999
21800511,1610612746,1610612758,127.0,118.0,0.5,0.471,1,2018-12-26,34,20,14,0.588,34,18,16,0.529
21800497,1610612752,1610612749,95.0,109.0,0.361,0.449,0,2018-12-25,35,9,26,0.257,33,23,10,0.6970000000000001
21800498,1610612745,1610612760,113.0,109.0,0.4539999999999999,0.439,1,2018-12-25,33,18,15,0.545,33,21,12,0.636
21800499,1610612738,1610612755,121.0,114.0,0.417,0.413,1,2018-12-25,33,20,13,0.606,35,22,13,0.629
21800500,1610612744,1610612747,101.0,127.0,0.409,0.5529999999999999,0,2018-12-25,35,23,12,0.657,34,20,14,0.588
21800501,1610612762,1610612757,117.0,96.0,0.5539999999999999,0.3929999999999999,1,2018-12-25,35,17,18,0.486,34,19,15,0.5589999999999999
21800486,1610612765,1610612737,95.0,98.0,0.41,0.396,0,2018-12-23,31,15,16,0.484,32,9,23,0.281
21800487,1610612754,1610612764,105.0,89.0,0.4429999999999999,0.368,1,2018-12-23,34,22,12,0.647,34,13,21,0.382
21800488,1610612738,1610612766,119.0,103.0,0.5,0.4320000000000001,1,2018-12-23,32,19,13,0.594,32,16,16,0.5
21800489,1610612751,1610612756,111.0,103.0,0.471,0.483,1,2018-12-23,35,16,19,0.457,34,8,26,0.235
21800490,1610612739,1610612741,92.0,112.0,0.452,0.551,0,2018-12-23,34,8,26,0.235,34,9,25,0.265
21800491,1610612753,1610612748,91.0,115.0,0.414,0.506,0,2018-12-23,32,14,18,0.4379999999999999,32,16,16,0.5
21800492,1610612758,1610612740,122.0,117.0,0.42,0.4679999999999999,1,2018-12-23,33,18,15,0.545,34,15,19,0.441
21800493,1610612760,1610612750,112.0,114.0,0.478,0.494,0,2018-12-23,32,21,11,0.6559999999999999,33,15,18,0.455
21800494,1610612744,1610612746,129.0,127.0,0.452,0.5379999999999999,1,2018-12-23,34,23,11,0.6759999999999999,33,19,14,0.5760000000000001
21800495,1610612757,1610612742,121.0,118.0,0.471,0.417,1,2018-12-23,33,19,14,0.5760000000000001,32,15,17,0.469
21800496,1610612747,1610612763,99.0,107.0,0.493,0.467,0,2018-12-23,33,19,14,0.5760000000000001,33,17,16,0.515
21800479,1610612746,1610612743,132.0,111.0,0.5760000000000001,0.423,1,2018-12-22,32,19,13,0.594,31,21,10,0.677
21800480,1610612764,1610612756,149.0,146.0,0.505,0.478,1,2018-12-22,33,13,20,0.3939999999999999,33,8,25,0.242
21800481,1610612755,1610612761,126.0,101.0,0.541,0.389,1,2018-12-22,34,22,12,0.647,35,25,10,0.7140000000000001
21800482,1610612748,1610612749,94.0,87.0,0.382,0.369,1,2018-12-22,31,15,16,0.484,32,22,10,0.688
21800483,1610612745,1610612759,108.0,101.0,0.389,0.477,1,2018-12-22,32,17,15,0.531,34,18,16,0.529
21800484,1610612744,1610612742,120.0,116.0,0.4589999999999999,0.457,1,2018-12-22,33,22,11,0.667,31,15,16,0.484
21800485,1610612762,1610612760,106.0,107.0,0.452,0.472,0,2018-12-22,34,16,18,0.471,31,21,10,0.677
21800469,1610612766,1610612765,98.0,86.0,0.44,0.39,1,2018-12-21,31,16,15,0.516,30,15,15,0.5
21800470,1610612761,1610612739,126.0,110.0,0.527,0.476,1,2018-12-21,34,25,9,0.735,33,8,25,0.242
21800471,1610612751,1610612754,106.0,114.0,0.4579999999999999,0.537,0,2018-12-21,34,15,19,0.441,33,21,12,0.636
21800472,1610612752,1610612737,107.0,114.0,0.488,0.473,0,2018-12-21,34,9,25,0.265,31,8,23,0.258
21800473,1610612738,1610612749,107.0,120.0,0.385,0.513,0,2018-12-21,31,18,13,0.581,31,22,9,0.71
21800474,1610612741,1610612753,90.0,80.0,0.44,0.326,1,2018-12-21,33,8,25,0.242,31,14,17,0.452
21800475,1610612759,1610612750,124.0,98.0,0.529,0.3979999999999999,1,2018-12-21,33,18,15,0.545,32,14,18,0.4379999999999999
21800476,1610612757,1610612762,90.0,120.0,0.402,0.5529999999999999,0,2018-12-21,32,18,14,0.563,33,16,17,0.485
21800477,1610612758,1610612763,102.0,99.0,0.375,0.4629999999999999,1,2018-12-21,32,17,15,0.531,32,16,16,0.5
21800478,1610612747,1610612740,112.0,104.0,0.467,0.431,1,2018-12-21,32,19,13,0.594,33,15,18,0.455
21800467,1610612748,1610612745,101.0,99.0,0.387,0.354,1,2018-12-20,30,14,16,0.467,31,16,15,0.516
21800468,1610612746,1610612742,125.0,121.0,0.5660000000000001,0.467,1,2018-12-20,31,18,13,0.581,30,15,15,0.5
21800455,1610612766,1610612739,110.0,99.0,0.511,0.482,1,2018-12-19,30,15,15,0.5,32,8,24,0.25
21800456,1610612753,1610612759,90.0,129.0,0.382,0.649,0,2018-12-19,30,14,16,0.467,32,17,15,0.531
21800457,1610612755,1610612752,131.0,109.0,0.534,0.43,1,2018-12-19,33,21,12,0.636,33,9,24,0.273
21800458,1610612738,1610612756,103.0,111.0,0.447,0.4270000000000001,0,2018-12-19,30,18,12,0.6,32,8,24,0.25
21800459,1610612761,1610612754,99.0,96.0,0.409,0.475,1,2018-12-19,33,24,9,0.727,32,20,12,0.625
21800460,1610612741,1610612751,93.0,96.0,0.44,0.4589999999999999,0,2018-12-19,32,7,25,0.2189999999999999,33,15,18,0.455
21800461,1610612745,1610612764,136.0,118.0,0.5529999999999999,0.536,1,2018-12-19,30,16,14,0.5329999999999999,32,12,20,0.375
21800462,1610612749,1610612740,123.0,115.0,0.506,0.467,1,2018-12-19,30,21,9,0.7,32,15,17,0.469
21800463,1610612750,1610612765,123.0,129.0,0.4370000000000001,0.489,0,2018-12-19,31,14,17,0.452,29,15,14,0.517
21800464,1610612762,1610612744,108.0,103.0,0.3979999999999999,0.4,1,2018-12-19,32,15,17,0.469,32,21,11,0.6559999999999999
21800465,1610612757,1610612763,99.0,92.0,0.467,0.423,1,2018-12-19,31,18,13,0.581,31,16,15,0.516
21800466,1610612758,1610612760,113.0,132.0,0.419,0.5,0,2018-12-19,31,16,15,0.516,30,20,10,0.667
21800451,1610612754,1610612739,91.0,92.0,0.3979999999999999,0.418,0,2018-12-18,31,20,11,0.645,31,8,23,0.258
21800452,1610612737,1610612764,118.0,110.0,0.4679999999999999,0.434,1,2018-12-18,30,7,23,0.233,31,12,19,0.387
21800453,1610612751,1610612747,115.0,110.0,0.484,0.467,1,2018-12-18,32,14,18,0.4379999999999999,31,18,13,0.581
21800454,1610612743,1610612742,126.0,118.0,0.556,0.465,1,2018-12-18,30,21,9,0.7,29,15,14,0.517
21800443,1610612765,1610612749,104.0,107.0,0.4429999999999999,0.5,0,2018-12-17,28,14,14,0.5,29,20,9,0.69
21800444,1610612752,1610612756,110.0,128.0,0.4039999999999999,0.522,0,2018-12-17,32,9,23,0.281,31,7,24,0.226
21800445,1610612745,1610612762,102.0,97.0,0.3720000000000001,0.39,1,2018-12-17,29,15,14,0.517,31,14,17,0.452
21800446,1610612750,1610612758,132.0,105.0,0.5,0.422,1,2018-12-17,30,14,16,0.467,30,16,14,0.5329999999999999
21800447,1610612760,1610612741,121.0,96.0,0.483,0.447,1,2018-12-17,29,19,10,0.655,31,7,24,0.226
21800448,1610612759,1610612755,123.0,96.0,0.563,0.408,1,2018-12-17,31,16,15,0.516,32,20,12,0.625
21800449,1610612744,1610612763,110.0,93.0,0.435,0.456,1,2018-12-17,31,21,10,0.677,30,16,14,0.5329999999999999
21800450,1610612746,1610612757,127.0,131.0,0.506,0.547,0,2018-12-17,30,17,13,0.5670000000000001,30,17,13,0.5670000000000001
21800436,1610612751,1610612737,144.0,127.0,0.557,0.5529999999999999,1,2018-12-16,31,13,18,0.419,29,6,23,0.207
21800437,1610612739,1610612755,105.0,128.0,0.466,0.56,0,2018-12-16,30,7,23,0.233,31,20,11,0.645
21800438,1610612754,1610612752,110.0,99.0,0.46,0.416,1,2018-12-16,30,20,10,0.667,31,9,22,0.29
21800439,1610612764,1610612747,128.0,110.0,0.509,0.484,1,2018-12-16,30,12,18,0.4,30,18,12,0.6
21800440,1610612742,1610612758,113.0,120.0,0.417,0.469,0,2018-12-16,28,15,13,0.536,29,16,13,0.552
21800441,1610612740,1610612748,96.0,102.0,0.407,0.418,0,2018-12-16,31,15,16,0.484,29,13,16,0.4479999999999999
21800442,1610612743,1610612761,95.0,86.0,0.424,0.3979999999999999,1,2018-12-16,29,20,9,0.69,32,23,9,0.7190000000000001
21800429,1610612753,1610612762,96.0,89.0,0.472,0.315,1,2018-12-15,29,14,15,0.483,30,14,16,0.467
21800430,1610612766,1610612747,100.0,128.0,0.424,0.5329999999999999,0,2018-12-15,29,14,15,0.483,29,18,11,0.621
21800431,1610612765,1610612738,113.0,104.0,0.488,0.415,1,2018-12-15,27,14,13,0.519,29,18,11,0.621
21800432,1610612763,1610612745,97.0,105.0,0.5329999999999999,0.479,0,2018-12-15,29,16,13,0.552,28,14,14,0.5
21800433,1610612759,1610612741,93.0,98.0,0.4379999999999999,0.43,0,2018-12-15,30,15,15,0.5,30,7,23,0.233
21800434,1610612760,1610612746,110.0,104.0,0.467,0.507,1,2018-12-15,28,18,10,0.643,29,17,12,0.586
21800435,1610612756,1610612750,107.0,99.0,0.456,0.406,1,2018-12-15,30,6,24,0.2,29,13,16,0.4479999999999999
21800420,1610612738,1610612737,129.0,108.0,0.484,0.419,1,2018-12-14,28,18,10,0.643,28,6,22,0.214
21800421,1610612766,1610612752,124.0,126.0,0.471,0.48,0,2018-12-14,28,14,14,0.5,30,9,21,0.3
21800422,1610612751,1610612764,125.0,118.0,0.524,0.544,1,2018-12-14,30,12,18,0.4,29,11,18,0.379
21800423,1610612739,1610612749,102.0,114.0,0.402,0.426,0,2018-12-14,29,7,22,0.241,28,19,9,0.679
21800424,1610612755,1610612754,101.0,113.0,0.409,0.442,0,2018-12-14,30,19,11,0.633,29,19,10,0.655
21800425,1610612763,1610612748,97.0,100.0,0.422,0.439,0,2018-12-14,28,16,12,0.5710000000000001,28,12,16,0.429
21800426,1610612743,1610612760,109.0,98.0,0.506,0.411,1,2018-12-14,28,19,9,0.679,27,17,10,0.63
21800427,1610612757,1610612761,128.0,122.0,0.511,0.551,1,2018-12-14,29,16,13,0.552,31,23,8,0.742
21800428,1610612758,1610612744,125.0,130.0,0.469,0.4579999999999999,0,2018-12-14,28,15,13,0.536,30,20,10,0.667
21800416,1610612745,1610612747,126.0,111.0,0.494,0.5379999999999999,1,2018-12-13,27,13,14,0.481,28,17,11,0.607
21800417,1610612759,1610612746,125.0,87.0,0.578,0.357,1,2018-12-13,29,15,14,0.517,28,17,11,0.607
21800418,1610612753,1610612741,97.0,91.0,0.415,0.479,1,2018-12-13,28,13,15,0.4639999999999999,29,6,23,0.207
21800419,1610612756,1610612742,99.0,89.0,0.402,0.397,1,2018-12-13,29,5,24,0.172,27,15,12,0.556
21800405,1610612766,1610612765,108.0,107.0,0.412,0.465,1,2018-12-12,27,14,13,0.519,26,13,13,0.5
21800406,1610612739,1610612752,113.0,106.0,0.473,0.436,1,2018-12-12,28,7,21,0.25,29,8,21,0.276
21800407,1610612754,1610612749,113.0,97.0,0.473,0.418,1,2018-12-12,28,18,10,0.643,27,18,9,0.667
21800408,1610612755,1610612751,124.0,127.0,0.5489999999999999,0.514,0,2018-12-12,29,19,10,0.655,29,11,18,0.379
21800409,1610612764,1610612738,125.0,130.0,0.505,0.452,0,2018-12-12,28,11,17,0.3929999999999999,27,17,10,0.63
21800410,1610612763,1610612757,92.0,83.0,0.415,0.368,1,2018-12-12,27,16,11,0.593,28,15,13,0.536
21800411,1610612740,1610612760,118.0,114.0,0.4639999999999999,0.483,1,2018-12-12,30,15,15,0.5,26,17,9,0.654
21800412,1610612742,1610612737,114.0,107.0,0.467,0.462,1,2018-12-12,26,15,11,0.5770000000000001,27,6,21,0.222
21800413,1610612762,1610612748,111.0,84.0,0.526,0.377,1,2018-12-12,29,14,15,0.483,27,11,16,0.407
21800414,1610612758,1610612750,141.0,130.0,0.581,0.5379999999999999,1,2018-12-12,27,15,12,0.556,28,13,15,0.4639999999999999
21800415,1610612744,1610612761,93.0,113.0,0.476,0.484,0,2018-12-12,29,19,10,0.655,30,23,7,0.767
21800402,1610612745,1610612757,111.0,104.0,0.494,0.4370000000000001,1,2018-12-11,26,12,14,0.462,27,15,12,0.556
21800403,1610612759,1610612756,111.0,86.0,0.494,0.402,1,2018-12-11,28,14,14,0.5,28,4,24,0.143
21800404,1610612746,1610612761,99.0,123.0,0.442,0.521,0,2018-12-11,27,17,10,0.63,29,22,7,0.759
21800391,1610612754,1610612764,109.0,101.0,0.539,0.42,1,2018-12-10,27,17,10,0.63,27,11,16,0.407
21800392,1610612755,1610612765,116.0,102.0,0.4429999999999999,0.488,1,2018-12-10,28,19,9,0.679,25,13,12,0.52
21800393,1610612738,1610612740,113.0,100.0,0.489,0.4479999999999999,1,2018-12-10,26,16,10,0.615,29,14,15,0.483
21800394,1610612741,1610612758,89.0,108.0,0.447,0.455,0,2018-12-10,28,6,22,0.214,26,14,12,0.5379999999999999
21800395,1610612749,1610612739,108.0,92.0,0.4379999999999999,0.375,1,2018-12-10,26,18,8,0.6920000000000001,27,6,21,0.222
21800396,1610612760,1610612762,122.0,113.0,0.506,0.512,1,2018-12-10,25,17,8,0.68,28,13,15,0.4639999999999999
21800397,1610612742,1610612753,101.0,76.0,0.4270000000000001,0.36,1,2018-12-10,25,14,11,0.56,27,12,15,0.444
21800398,1610612743,1610612763,105.0,99.0,0.506,0.5,1,2018-12-10,27,18,9,0.667,26,15,11,0.5770000000000001
21800399,1610612756,1610612746,119.0,123.0,0.5,0.529,0,2018-12-10,27,4,23,0.148,26,17,9,0.654
21800400,1610612744,1610612750,116.0,108.0,0.419,0.4579999999999999,1,2018-12-10,28,19,9,0.679,27,13,14,0.481
21800401,1610612747,1610612748,108.0,105.0,0.456,0.447,1,2018-12-10,27,17,10,0.63,26,11,15,0.423
21800387,1610612765,1610612740,108.0,116.0,0.439,0.532,0,2018-12-09,24,13,11,0.542,28,14,14,0.5
21800388,1610612761,1610612749,99.0,104.0,0.415,0.414,0,2018-12-09,28,21,7,0.75,25,17,8,0.68
21800390,1610612759,1610612762,110.0,97.0,0.528,0.435,1,2018-12-09,27,13,14,0.481,27,13,14,0.481
21800389,1610612752,1610612766,107.0,119.0,0.473,0.483,0,2018-12-09,28,8,20,0.286,26,13,13,0.5
21800378,1610612742,1610612745,107.0,104.0,0.494,0.4529999999999999,1,2018-12-08,24,13,11,0.542,25,11,14,0.44
21800379,1610612754,1610612758,107.0,97.0,0.435,0.422,1,2018-12-08,26,16,10,0.615,25,13,12,0.52
21800380,1610612737,1610612743,106.0,98.0,0.43,0.371,1,2018-12-08,26,6,20,0.231,26,17,9,0.654
21800381,1610612739,1610612764,116.0,101.0,0.528,0.442,1,2018-12-08,26,6,20,0.231,26,11,15,0.423
21800382,1610612752,1610612751,104.0,112.0,0.47,0.489,0,2018-12-08,27,8,19,0.296,28,10,18,0.357
21800383,1610612741,1610612738,77.0,133.0,0.3829999999999999,0.5379999999999999,0,2018-12-08,27,6,21,0.222,25,15,10,0.6
21800384,1610612763,1610612747,88.0,111.0,0.405,0.4429999999999999,0,2018-12-08,25,15,10,0.6,26,16,10,0.615
21800385,1610612757,1610612750,113.0,105.0,0.47,0.44,1,2018-12-08,26,15,11,0.5770000000000001,26,13,13,0.5
21800386,1610612746,1610612748,98.0,121.0,0.371,0.435,0,2018-12-08,25,16,9,0.64,25,11,14,0.44
21800368,1610612766,1610612743,113.0,107.0,0.384,0.386,1,2018-12-07,25,12,13,0.48,25,17,8,0.68
21800369,1610612765,1610612755,111.0,117.0,0.416,0.489,0,2018-12-07,23,13,10,0.565,27,18,9,0.667
21800370,1610612753,1610612754,90.0,112.0,0.4039999999999999,0.473,0,2018-12-07,26,12,14,0.462,25,15,10,0.6
21800371,1610612751,1610612761,106.0,105.0,0.439,0.3929999999999999,1,2018-12-07,27,9,18,0.3329999999999999,27,21,6,0.778
21800372,1610612739,1610612758,110.0,129.0,0.531,0.5710000000000001,0,2018-12-07,25,5,20,0.2,24,13,11,0.542
21800373,1610612741,1610612760,114.0,112.0,0.524,0.457,1,2018-12-07,26,6,20,0.231,24,16,8,0.667
21800374,1610612740,1610612763,103.0,107.0,0.452,0.47,0,2018-12-07,27,13,14,0.481,24,15,9,0.625
21800375,1610612759,1610612747,133.0,120.0,0.505,0.46,1,2018-12-07,26,12,14,0.462,25,15,10,0.6
21800376,1610612756,1610612748,98.0,115.0,0.456,0.488,0,2018-12-07,26,4,22,0.154,24,10,14,0.417
21800377,1610612749,1610612744,95.0,105.0,0.391,0.449,0,2018-12-07,24,16,8,0.667,27,18,9,0.667
21800365,1610612738,1610612752,128.0,100.0,0.5329999999999999,0.396,1,2018-12-06,24,14,10,0.583,26,8,18,0.308
21800366,1610612757,1610612756,108.0,86.0,0.482,0.385,1,2018-12-06,25,14,11,0.56,25,4,21,0.16
21800367,1610612762,1610612745,118.0,91.0,0.506,0.386,1,2018-12-06,26,13,13,0.5,24,11,13,0.4579999999999999
21800355,1610612739,1610612744,105.0,129.0,0.4379999999999999,0.529,0,2018-12-05,24,5,19,0.208,26,17,9,0.654
21800356,1610612753,1610612743,118.0,124.0,0.474,0.5489999999999999,0,2018-12-05,25,12,13,0.48,24,17,7,0.708
21800357,1610612737,1610612764,117.0,131.0,0.446,0.484,0,2018-12-05,25,5,20,0.2,25,11,14,0.44
21800358,1610612751,1610612760,112.0,114.0,0.43,0.434,0,2018-12-05,26,8,18,0.308,23,16,7,0.696
21800359,1610612761,1610612755,113.0,102.0,0.43,0.455,1,2018-12-05,26,21,5,0.8079999999999999,26,17,9,0.654
21800360,1610612763,1610612746,96.0,86.0,0.435,0.3379999999999999,1,2018-12-05,23,14,9,0.609,24,16,8,0.667
21800361,1610612749,1610612765,115.0,92.0,0.4629999999999999,0.368,1,2018-12-05,23,16,7,0.696,22,13,9,0.591
21800362,1610612750,1610612766,121.0,104.0,0.539,0.408,1,2018-12-05,25,13,12,0.52,24,11,13,0.4579999999999999
21800363,1610612740,1610612742,132.0,106.0,0.5539999999999999,0.429,1,2018-12-05,26,13,13,0.5,23,12,11,0.522
21800364,1610612747,1610612759,121.0,113.0,0.477,0.4479999999999999,1,2018-12-05,24,15,9,0.625,25,11,14,0.44
21800350,1610612754,1610612741,96.0,90.0,0.461,0.3939999999999999,1,2018-12-04,24,14,10,0.583,25,5,20,0.2
21800351,1610612748,1610612753,90.0,105.0,0.418,0.442,0,2018-12-04,23,9,14,0.391,24,12,12,0.5
21800352,1610612742,1610612757,111.0,102.0,0.4320000000000001,0.452,1,2018-12-04,22,12,10,0.545,24,13,11,0.542
21800353,1610612756,1610612758,105.0,122.0,0.4370000000000001,0.536,0,2018-12-04,24,4,20,0.1669999999999999,23,12,11,0.522
21800354,1610612762,1610612759,139.0,105.0,0.607,0.489,1,2018-12-04,25,12,13,0.48,24,11,13,0.4579999999999999
21800343,1610612765,1610612760,83.0,110.0,0.33,0.506,0,2018-12-03,21,13,8,0.619,22,15,7,0.682
21800344,1610612737,1610612744,111.0,128.0,0.489,0.585,0,2018-12-03,24,5,19,0.208,25,16,9,0.64
21800345,1610612751,1610612739,97.0,99.0,0.3939999999999999,0.4320000000000001,0,2018-12-03,25,8,17,0.32,23,5,18,0.217
21800346,1610612752,1610612764,107.0,110.0,0.411,0.478,0,2018-12-03,25,8,17,0.32,24,10,14,0.417
21800347,1610612761,1610612743,103.0,106.0,0.46,0.449,0,2018-12-03,25,20,5,0.8,23,16,7,0.696
21800348,1610612750,1610612745,103.0,91.0,0.439,0.4320000000000001,1,2018-12-03,24,12,12,0.5,23,11,12,0.478
21800349,1610612740,1610612746,126.0,129.0,0.5329999999999999,0.59,0,2018-12-03,25,12,13,0.48,23,16,7,0.696
21800337,1610612747,1610612756,120.0,96.0,0.5,0.3979999999999999,1,2018-12-02,23,14,9,0.609,23,4,19,0.174
21800338,1610612766,1610612740,109.0,119.0,0.429,0.512,0,2018-12-02,23,11,12,0.478,24,12,12,0.5
21800339,1610612748,1610612762,102.0,100.0,0.396,0.4379999999999999,1,2018-12-02,22,9,13,0.409,24,11,13,0.4579999999999999
21800340,1610612755,1610612763,103.0,95.0,0.486,0.418,1,2018-12-02,25,17,8,0.68,22,13,9,0.591
21800341,1610612742,1610612746,114.0,110.0,0.442,0.442,1,2018-12-02,21,11,10,0.524,22,15,7,0.682
21800342,1610612759,1610612757,131.0,118.0,0.602,0.523,1,2018-12-02,23,11,12,0.478,23,13,10,0.565
21800330,1610612752,1610612749,136.0,134.0,0.531,0.489,1,2018-12-01,24,8,16,0.3329999999999999,22,15,7,0.682
21800331,1610612765,1610612744,111.0,102.0,0.439,0.4589999999999999,1,2018-12-01,20,13,7,0.65,24,15,9,0.625
21800333,1610612764,1610612751,102.0,88.0,0.519,0.37,1,2018-12-01,23,9,14,0.391,24,8,16,0.3329999999999999
21800332,1610612739,1610612761,95.0,106.0,0.386,0.488,0,2018-12-01,22,4,18,0.182,24,20,4,0.833
21800334,1610612745,1610612741,121.0,105.0,0.5,0.4429999999999999,1,2018-12-01,22,11,11,0.5,24,5,19,0.208
21800335,1610612750,1610612738,109.0,118.0,0.451,0.471,0,2018-12-01,23,11,12,0.478,23,13,10,0.565
21800336,1610612758,1610612754,111.0,110.0,0.451,0.524,1,2018-12-01,22,11,11,0.5,23,13,10,0.565
21800319,1610612738,1610612739,128.0,95.0,0.5329999999999999,0.39,1,2018-11-30,22,12,10,0.545,21,4,17,0.19
21800320,1610612766,1610612762,111.0,119.0,0.495,0.5429999999999999,0,2018-11-30,22,11,11,0.5,23,11,12,0.478
21800321,1610612765,1610612741,107.0,88.0,0.446,0.43,1,2018-11-30,19,12,7,0.632,23,5,18,0.217
21800322,1610612755,1610612764,123.0,98.0,0.439,0.402,1,2018-11-30,24,16,8,0.667,22,8,14,0.364
21800323,1610612751,1610612763,125.0,131.0,0.447,0.495,0,2018-11-30,23,8,15,0.348,21,13,8,0.619
21800324,1610612748,1610612740,106.0,101.0,0.43,0.4270000000000001,1,2018-11-30,21,8,13,0.381,23,11,12,0.478
21800325,1610612760,1610612737,124.0,109.0,0.523,0.4479999999999999,1,2018-11-30,21,14,7,0.667,23,5,18,0.217
21800326,1610612759,1610612745,105.0,136.0,0.4529999999999999,0.5,0,2018-11-30,22,10,12,0.455,21,10,11,0.476
21800327,1610612756,1610612753,85.0,99.0,0.405,0.476,0,2018-11-30,22,4,18,0.182,23,11,12,0.478
21800328,1610612747,1610612742,114.0,103.0,0.488,0.395,1,2018-11-30,22,13,9,0.591,20,10,10,0.5
21800329,1610612757,1610612743,112.0,113.0,0.529,0.46,0,2018-11-30,22,13,9,0.591,22,15,7,0.682
21800316,1610612761,1610612744,131.0,128.0,0.522,0.485,1,2018-11-29,23,19,4,0.826,23,15,8,0.652
21800317,1610612747,1610612754,104.0,96.0,0.488,0.3720000000000001,1,2018-11-29,21,12,9,0.5710000000000001,22,13,9,0.591
21800318,1610612758,1610612746,121.0,133.0,0.479,0.556,0,2018-11-29,21,10,11,0.476,21,15,6,0.7140000000000001
21800306,1610612766,1610612737,108.0,94.0,0.4579999999999999,0.344,1,2018-11-28,21,11,10,0.524,22,5,17,0.2269999999999999
21800307,1610612755,1610612752,117.0,91.0,0.54,0.348,1,2018-11-28,23,15,8,0.652,23,7,16,0.304
21800308,1610612751,1610612762,91.0,101.0,0.349,0.476,0,2018-11-28,22,8,14,0.364,22,10,12,0.455
21800309,1610612745,1610612742,108.0,128.0,0.46,0.541,0,2018-11-28,20,9,11,0.45,19,10,9,0.526
21800310,1610612749,1610612741,116.0,113.0,0.494,0.449,1,2018-11-28,21,15,6,0.7140000000000001,22,5,17,0.2269999999999999
21800311,1610612750,1610612759,128.0,89.0,0.505,0.391,1,2018-11-28,22,11,11,0.5,21,10,11,0.476
21800312,1610612740,1610612764,125.0,104.0,0.484,0.4320000000000001,1,2018-11-28,22,11,11,0.5,21,8,13,0.381
21800313,1610612760,1610612739,100.0,83.0,0.477,0.3929999999999999,1,2018-11-28,20,13,7,0.65,20,4,16,0.2
21800314,1610612757,1610612753,115.0,112.0,0.435,0.519,1,2018-11-28,21,13,8,0.619,22,10,12,0.455
21800315,1610612746,1610612756,115.0,99.0,0.465,0.4379999999999999,1,2018-11-28,20,14,6,0.7,21,4,17,0.19
21800301,1610612765,1610612752,115.0,108.0,0.475,0.396,1,2018-11-27,18,11,7,0.611,22,7,15,0.318
21800302,1610612748,1610612737,113.0,115.0,0.46,0.475,0,2018-11-27,20,7,13,0.35,21,5,16,0.238
21800303,1610612763,1610612761,114.0,122.0,0.506,0.609,0,2018-11-27,20,12,8,0.6,22,18,4,0.818
21800304,1610612743,1610612747,117.0,85.0,0.485,0.391,1,2018-11-27,21,14,7,0.667,20,11,9,0.55
21800305,1610612756,1610612754,104.0,109.0,0.446,0.422,0,2018-11-27,20,4,16,0.2,21,13,8,0.619
21800294,1610612766,1610612749,110.0,107.0,0.469,0.411,1,2018-11-26,20,10,10,0.5,20,14,6,0.7
21800295,1610612739,1610612750,95.0,102.0,0.419,0.465,0,2018-11-26,19,4,15,0.211,21,10,11,0.476
21800296,1610612764,1610612745,135.0,131.0,0.562,0.474,1,2018-11-26,20,8,12,0.4,19,9,10,0.474
21800297,1610612741,1610612759,107.0,108.0,0.467,0.484,0,2018-11-26,21,5,16,0.238,20,10,10,0.5
21800298,1610612740,1610612738,107.0,124.0,0.442,0.495,0,2018-11-26,21,10,11,0.476,21,11,10,0.524
21800299,1610612762,1610612754,88.0,121.0,0.42,0.583,0,2018-11-26,21,9,12,0.429,20,12,8,0.6
21800300,1610612744,1610612753,116.0,110.0,0.488,0.444,1,2018-11-26,22,15,7,0.682,21,10,11,0.476
21800286,1610612747,1610612753,104.0,108.0,0.4679999999999999,0.452,0,2018-11-25,19,11,8,0.579,20,10,10,0.5
21800287,1610612765,1610612756,118.0,107.0,0.462,0.512,1,2018-11-25,17,10,7,0.588,19,4,15,0.211
21800288,1610612737,1610612766,124.0,123.0,0.532,0.446,1,2018-11-25,20,4,16,0.2,19,9,10,0.474
21800289,1610612751,1610612755,125.0,127.0,0.568,0.484,0,2018-11-25,21,8,13,0.381,22,14,8,0.636
21800290,1610612761,1610612748,125.0,115.0,0.522,0.411,1,2018-11-25,21,17,4,0.81,19,7,12,0.368
21800291,1610612763,1610612752,98.0,103.0,0.442,0.374,0,2018-11-25,19,12,7,0.632,21,7,14,0.3329999999999999
21800292,1610612758,1610612762,112.0,133.0,0.471,0.5329999999999999,0,2018-11-25,20,10,10,0.5,20,9,11,0.45
21800293,1610612757,1610612746,100.0,104.0,0.433,0.422,0,2018-11-25,20,12,8,0.6,19,13,6,0.684
21800279,1610612739,1610612745,117.0,108.0,0.489,0.5,1,2018-11-24,18,4,14,0.222,18,9,9,0.5
21800280,1610612764,1610612740,124.0,114.0,0.5670000000000001,0.478,1,2018-11-24,19,7,12,0.368,20,10,10,0.5
21800281,1610612750,1610612741,111.0,96.0,0.408,0.395,1,2018-11-24,20,9,11,0.45,20,5,15,0.25
21800282,1610612760,1610612743,98.0,105.0,0.359,0.411,0,2018-11-24,19,12,7,0.632,20,13,7,0.65
21800283,1610612742,1610612738,113.0,104.0,0.483,0.477,1,2018-11-24,18,9,9,0.5,20,10,10,0.5
21800284,1610612749,1610612759,135.0,129.0,0.57,0.5329999999999999,1,2018-11-24,19,14,5,0.737,19,9,10,0.474
21800285,1610612744,1610612758,117.0,116.0,0.466,0.433,1,2018-11-24,21,14,7,0.667,19,10,9,0.526
21800265,1610612751,1610612750,102.0,112.0,0.418,0.478,0,2018-11-23,20,8,12,0.4,19,8,11,0.421
21800266,1610612746,1610612763,112.0,107.0,0.426,0.457,1,2018-11-23,18,12,6,0.667,18,12,6,0.667
21800267,1610612765,1610612745,116.0,111.0,0.455,0.418,1,2018-11-23,16,9,7,0.563,17,9,8,0.529
21800268,1610612737,1610612738,96.0,114.0,0.4320000000000001,0.462,0,2018-11-23,19,3,16,0.158,19,10,9,0.526
21800269,1610612752,1610612740,114.0,109.0,0.451,0.396,1,2018-11-23,20,6,14,0.3,19,10,9,0.526
21800270,1610612755,1610612739,112.0,121.0,0.5329999999999999,0.527,0,2018-11-23,21,13,8,0.619,17,3,14,0.176
21800271,1610612761,1610612764,125.0,107.0,0.495,0.4,1,2018-11-23,20,16,4,0.8,18,6,12,0.3329999999999999
21800272,1610612754,1610612759,100.0,111.0,0.465,0.506,0,2018-11-23,19,11,8,0.579,18,9,9,0.5
21800273,1610612741,1610612748,96.0,103.0,0.3720000000000001,0.425,0,2018-11-23,19,5,14,0.263,18,7,11,0.389
21800274,1610612760,1610612766,109.0,104.0,0.441,0.457,1,2018-11-23,18,12,6,0.667,18,9,9,0.5
21800275,1610612749,1610612756,114.0,116.0,0.483,0.5,0,2018-11-23,18,13,5,0.722,18,4,14,0.222
21800276,1610612743,1610612753,112.0,87.0,0.473,0.405,1,2018-11-23,19,12,7,0.632,19,9,10,0.474
21800277,1610612744,1610612757,125.0,97.0,0.565,0.409,1,2018-11-23,20,13,7,0.65,19,12,7,0.632
21800278,1610612747,1610612762,90.0,83.0,0.456,0.3879999999999999,1,2018-11-23,18,11,7,0.611,19,8,11,0.421
21800252,1610612766,1610612754,127.0,109.0,0.563,0.488,1,2018-11-21,17,9,8,0.529,18,11,7,0.611
21800253,1610612755,1610612740,121.0,120.0,0.449,0.429,1,2018-11-21,20,13,7,0.65,18,10,8,0.556
21800254,1610612737,1610612761,108.0,124.0,0.452,0.5329999999999999,0,2018-11-21,18,3,15,0.1669999999999999,19,15,4,0.789
21800255,1610612738,1610612752,109.0,117.0,0.392,0.494,0,2018-11-21,18,9,9,0.5,19,5,14,0.263
21800256,1610612739,1610612747,105.0,109.0,0.382,0.513,0,2018-11-21,16,2,14,0.125,17,10,7,0.588
21800257,1610612741,1610612756,124.0,116.0,0.568,0.49,1,2018-11-21,18,5,13,0.278,17,3,14,0.176
21800258,1610612745,1610612765,126.0,124.0,0.556,0.471,1,2018-11-21,16,9,7,0.563,15,8,7,0.5329999999999999
21800259,1610612749,1610612757,143.0,100.0,0.528,0.366,1,2018-11-21,17,13,4,0.765,18,12,6,0.667
21800260,1610612750,1610612743,101.0,103.0,0.4429999999999999,0.472,0,2018-11-21,18,7,11,0.389,18,11,7,0.611
21800261,1610612742,1610612751,119.0,113.0,0.487,0.447,1,2018-11-21,17,8,9,0.471,19,8,11,0.421
21800262,1610612759,1610612763,103.0,104.0,0.4270000000000001,0.481,0,2018-11-21,17,8,9,0.471,17,12,5,0.706
21800263,1610612762,1610612758,110.0,119.0,0.4320000000000001,0.528,0,2018-11-21,18,8,10,0.444,18,10,8,0.556
21800264,1610612744,1610612760,95.0,123.0,0.434,0.481,0,2018-11-21,19,12,7,0.632,17,11,6,0.647
21800248,1610612753,1610612761,91.0,93.0,0.405,0.4479999999999999,0,2018-11-20,18,9,9,0.5,18,14,4,0.778
21800249,1610612764,1610612746,125.0,118.0,0.43,0.517,1,2018-11-20,17,6,11,0.353,17,11,6,0.647
21800250,1610612748,1610612751,92.0,104.0,0.36,0.4320000000000001,0,2018-11-20,17,6,11,0.353,18,8,10,0.444
21800251,1610612752,1610612757,114.0,118.0,0.506,0.474,0,2018-11-20,18,4,14,0.222,17,12,5,0.706
21800239,1610612766,1610612738,117.0,112.0,0.483,0.506,1,2018-11-19,16,8,8,0.5,17,9,8,0.529
21800240,1610612765,1610612739,113.0,102.0,0.461,0.4429999999999999,1,2018-11-19,14,8,6,0.5710000000000001,15,2,13,0.133
21800241,1610612754,1610612762,121.0,94.0,0.527,0.486,1,2018-11-19,17,11,6,0.647,17,8,9,0.471
21800242,1610612755,1610612756,119.0,114.0,0.488,0.506,1,2018-11-19,19,12,7,0.632,16,3,13,0.188
21800243,1610612737,1610612746,119.0,127.0,0.446,0.43,0,2018-11-19,17,3,14,0.176,16,11,5,0.688
21800244,1610612763,1610612742,98.0,88.0,0.4679999999999999,0.341,1,2018-11-19,16,11,5,0.688,16,7,9,0.4379999999999999
21800245,1610612749,1610612743,104.0,98.0,0.455,0.426,1,2018-11-19,16,12,4,0.75,17,10,7,0.588
21800246,1610612740,1610612759,140.0,126.0,0.578,0.479,1,2018-11-19,17,10,7,0.588,16,8,8,0.5
21800247,1610612758,1610612760,117.0,113.0,0.441,0.417,1,2018-11-19,17,9,8,0.529,16,10,6,0.625
21800234,1610612750,1610612763,87.0,100.0,0.3879999999999999,0.4270000000000001,0,2018-11-18,17,7,10,0.412,15,10,5,0.667
21800235,1610612748,1610612747,97.0,113.0,0.402,0.442,0,2018-11-18,16,6,10,0.375,16,9,7,0.563
21800236,1610612753,1610612752,131.0,117.0,0.5710000000000001,0.46,1,2018-11-18,17,9,8,0.529,17,4,13,0.235
21800237,1610612764,1610612757,109.0,119.0,0.4479999999999999,0.4529999999999999,0,2018-11-18,16,5,11,0.313,16,11,5,0.688
21800238,1610612759,1610612744,104.0,92.0,0.446,0.407,1,2018-11-18,15,8,7,0.5329999999999999,18,12,6,0.667
21800224,1610612751,1610612746,119.0,127.0,0.455,0.505,0,2018-11-17,17,7,10,0.412,15,10,5,0.667
21800225,1610612766,1610612755,119.0,122.0,0.424,0.419,0,2018-11-17,15,7,8,0.467,18,11,7,0.611
21800226,1610612754,1610612737,97.0,89.0,0.402,0.356,1,2018-11-17,16,10,6,0.625,16,3,13,0.188
21800227,1610612753,1610612747,130.0,117.0,0.5379999999999999,0.478,1,2018-11-17,16,8,8,0.5,15,8,7,0.5329999999999999
21800228,1610612740,1610612743,125.0,115.0,0.483,0.484,1,2018-11-17,16,9,7,0.563,16,10,6,0.625
21800229,1610612738,1610612762,86.0,98.0,0.385,0.449,0,2018-11-17,16,9,7,0.563,16,8,8,0.5
21800230,1610612741,1610612761,83.0,122.0,0.349,0.539,0,2018-11-17,17,4,13,0.235,17,13,4,0.765
21800231,1610612745,1610612758,132.0,112.0,0.568,0.451,1,2018-11-17,15,8,7,0.5329999999999999,16,8,8,0.5
21800232,1610612742,1610612744,112.0,109.0,0.465,0.447,1,2018-11-17,15,7,8,0.467,17,12,5,0.706
21800233,1610612756,1610612760,100.0,110.0,0.451,0.447,0,2018-11-17,15,3,12,0.2,15,10,5,0.667
21800216,1610612738,1610612761,123.0,116.0,0.528,0.433,1,2018-11-16,15,9,6,0.6,16,12,4,0.75
21800217,1610612754,1610612748,99.0,91.0,0.444,0.376,1,2018-11-16,15,9,6,0.6,15,6,9,0.4
21800218,1610612755,1610612762,113.0,107.0,0.506,0.466,1,2018-11-16,17,10,7,0.588,15,7,8,0.467
21800219,1610612764,1610612751,104.0,115.0,0.425,0.422,0,2018-11-16,15,5,10,0.3329999999999999,16,7,9,0.4379999999999999
21800220,1610612763,1610612758,112.0,104.0,0.506,0.4629999999999999,1,2018-11-16,14,9,5,0.643,15,8,7,0.5329999999999999
21800221,1610612750,1610612757,112.0,96.0,0.5,0.42,1,2018-11-16,16,7,9,0.4379999999999999,15,10,5,0.667
21800222,1610612740,1610612752,129.0,124.0,0.485,0.49,1,2018-11-16,15,8,7,0.5329999999999999,16,4,12,0.25
21800223,1610612749,1610612741,123.0,104.0,0.505,0.436,1,2018-11-16,15,11,4,0.733,16,4,12,0.25
21800213,1610612745,1610612744,107.0,86.0,0.402,0.421,1,2018-11-15,14,7,7,0.5,16,12,4,0.75
21800214,1610612743,1610612737,138.0,93.0,0.564,0.348,1,2018-11-15,15,10,5,0.667,15,3,12,0.2
21800215,1610612746,1610612759,116.0,111.0,0.471,0.402,1,2018-11-15,14,9,5,0.643,14,7,7,0.5
21800202,1610612753,1610612755,111.0,106.0,0.5,0.477,1,2018-11-14,15,7,8,0.467,16,9,7,0.563
21800203,1610612764,1610612739,119.0,95.0,0.478,0.455,1,2018-11-14,14,5,9,0.357,14,2,12,0.143
21800204,1610612738,1610612741,111.0,82.0,0.467,0.3929999999999999,1,2018-11-14,14,8,6,0.5710000000000001,15,4,11,0.267
21800205,1610612751,1610612748,107.0,120.0,0.406,0.541,0,2018-11-14,15,6,9,0.4,14,6,8,0.429
21800206,1610612761,1610612765,104.0,106.0,0.489,0.484,0,2018-11-14,15,12,3,0.8,13,7,6,0.5379999999999999
21800207,1610612749,1610612763,113.0,116.0,0.506,0.506,0,2018-11-14,14,10,4,0.7140000000000001,13,8,5,0.615
21800208,1610612750,1610612740,107.0,100.0,0.411,0.426,1,2018-11-14,15,6,9,0.4,14,7,7,0.5
21800209,1610612760,1610612752,128.0,103.0,0.537,0.4429999999999999,1,2018-11-14,14,9,5,0.643,15,4,11,0.267
21800210,1610612742,1610612762,118.0,68.0,0.584,0.309,1,2018-11-14,14,6,8,0.429,14,7,7,0.5
21800211,1610612756,1610612759,116.0,96.0,0.56,0.422,1,2018-11-14,14,3,11,0.214,13,7,6,0.5379999999999999
21800212,1610612747,1610612757,126.0,117.0,0.473,0.441,1,2018-11-14,14,8,6,0.5710000000000001,14,10,4,0.7140000000000001
21800199,1610612739,1610612766,113.0,89.0,0.529,0.347,1,2018-11-13,13,2,11,0.154,14,7,7,0.5
21800200,1610612743,1610612745,99.0,109.0,0.5,0.5489999999999999,0,2018-11-13,14,9,5,0.643,13,6,7,0.462
21800201,1610612744,1610612737,110.0,103.0,0.429,0.449,1,2018-11-13,15,12,3,0.8,14,3,11,0.214
21800190,1610612764,1610612753,117.0,109.0,0.506,0.483,1,2018-11-12,13,4,9,0.308,14,6,8,0.429
21800191,1610612748,1610612755,114.0,124.0,0.481,0.47,0,2018-11-12,13,5,8,0.385,15,9,6,0.6
21800192,1610612761,1610612740,110.0,126.0,0.402,0.545,0,2018-11-12,14,12,2,0.857,13,7,6,0.5379999999999999
21800193,1610612741,1610612742,98.0,103.0,0.3929999999999999,0.4679999999999999,0,2018-11-12,14,4,10,0.286,13,5,8,0.385
21800194,1610612763,1610612762,88.0,96.0,0.418,0.39,0,2018-11-12,12,7,5,0.583,13,7,6,0.5379999999999999
21800195,1610612750,1610612751,120.0,113.0,0.525,0.396,1,2018-11-12,14,5,9,0.357,14,6,8,0.429
21800196,1610612760,1610612756,118.0,101.0,0.467,0.481,1,2018-11-12,13,8,5,0.615,13,2,11,0.154
21800197,1610612758,1610612759,104.0,99.0,0.5,0.4370000000000001,1,2018-11-12,14,8,6,0.5710000000000001,12,7,5,0.583
21800198,1610612746,1610612744,121.0,116.0,0.473,0.4679999999999999,1,2018-11-12,13,8,5,0.615,14,11,3,0.7859999999999999
21800184,1610612765,1610612766,103.0,113.0,0.365,0.506,0,2018-11-11,12,6,6,0.5,13,7,6,0.5379999999999999
21800185,1610612745,1610612754,115.0,103.0,0.486,0.462,1,2018-11-11,12,5,7,0.417,14,8,6,0.5710000000000001
21800186,1610612752,1610612753,89.0,115.0,0.352,0.449,0,2018-11-11,14,4,10,0.286,13,6,7,0.462
21800187,1610612743,1610612749,114.0,121.0,0.461,0.5710000000000001,0,2018-11-11,13,9,4,0.6920000000000001,13,10,3,0.769
21800188,1610612757,1610612738,100.0,94.0,0.4529999999999999,0.387,1,2018-11-11,13,10,3,0.769,13,7,6,0.5379999999999999
21800189,1610612747,1610612737,107.0,106.0,0.424,0.4320000000000001,1,2018-11-11,13,7,6,0.5379999999999999,13,3,10,0.231
21800174,1610612761,1610612752,128.0,112.0,0.532,0.4579999999999999,1,2018-11-10,13,12,1,0.923,13,4,9,0.308
21800175,1610612746,1610612749,128.0,126.0,0.465,0.4479999999999999,1,2018-11-10,12,7,5,0.583,12,9,3,0.75
21800176,1610612740,1610612756,119.0,99.0,0.488,0.407,1,2018-11-10,12,6,6,0.5,12,2,10,0.1669999999999999
21800177,1610612748,1610612764,110.0,116.0,0.4429999999999999,0.482,0,2018-11-10,12,5,7,0.417,12,3,9,0.25
21800178,1610612741,1610612739,99.0,98.0,0.476,0.429,1,2018-11-10,13,4,9,0.308,12,1,11,0.083
21800179,1610612763,1610612755,112.0,106.0,0.4370000000000001,0.518,1,2018-11-10,11,7,4,0.636,14,8,6,0.5710000000000001
21800180,1610612759,1610612745,96.0,89.0,0.446,0.3329999999999999,1,2018-11-10,11,7,4,0.636,11,4,7,0.364
21800182,1610612744,1610612751,116.0,100.0,0.5539999999999999,0.4679999999999999,1,2018-11-10,13,11,2,0.846,13,6,7,0.462
21800181,1610612742,1610612760,111.0,96.0,0.5579999999999999,0.392,1,2018-11-10,12,4,8,0.3329999999999999,12,7,5,0.583
21800183,1610612758,1610612747,86.0,101.0,0.348,0.414,0,2018-11-10,13,7,6,0.5379999999999999,12,6,6,0.5
21800167,1610612753,1610612764,117.0,108.0,0.512,0.512,1,2018-11-09,12,5,7,0.417,11,2,9,0.182
21800168,1610612755,1610612766,133.0,132.0,0.479,0.391,1,2018-11-09,13,8,5,0.615,12,6,6,0.5
21800169,1610612737,1610612765,109.0,124.0,0.456,0.474,0,2018-11-09,12,3,9,0.25,11,6,5,0.545
21800170,1610612748,1610612754,102.0,110.0,0.45,0.544,0,2018-11-09,11,5,6,0.455,13,8,5,0.615
21800171,1610612743,1610612751,110.0,112.0,0.46,0.409,0,2018-11-09,12,9,3,0.75,12,6,6,0.5
21800172,1610612762,1610612738,123.0,115.0,0.5579999999999999,0.4429999999999999,1,2018-11-09,12,6,6,0.5,12,7,5,0.583
21800173,1610612758,1610612750,121.0,110.0,0.4529999999999999,0.415,1,2018-11-09,12,7,5,0.583,13,4,9,0.308
21800163,1610612760,1610612745,98.0,80.0,0.444,0.3779999999999999,1,2018-11-08,11,7,4,0.636,10,4,6,0.4
21800164,1610612756,1610612738,109.0,116.0,0.441,0.402,0,2018-11-08,11,2,9,0.182,11,7,4,0.636
21800165,1610612757,1610612746,116.0,105.0,0.412,0.461,1,2018-11-08,12,9,3,0.75,11,6,5,0.545
21800166,1610612744,1610612749,111.0,134.0,0.483,0.515,0,2018-11-08,12,10,2,0.833,11,9,2,0.818
21800153,1610612739,1610612760,86.0,95.0,0.371,0.417,0,2018-11-07,11,1,10,0.091,10,6,4,0.6
21800154,1610612753,1610612765,96.0,103.0,0.46,0.411,0,2018-11-07,11,4,7,0.364,10,5,5,0.5
21800155,1610612737,1610612752,107.0,112.0,0.402,0.442,0,2018-11-07,11,3,8,0.273,12,4,8,0.3329999999999999
21800156,1610612748,1610612759,95.0,88.0,0.387,0.33,1,2018-11-07,10,5,5,0.5,10,6,4,0.6
21800157,1610612754,1610612755,94.0,100.0,0.3939999999999999,0.456,0,2018-11-07,12,7,5,0.583,12,7,5,0.583
21800158,1610612763,1610612743,89.0,87.0,0.429,0.39,1,2018-11-07,10,6,4,0.6,11,9,2,0.818
21800159,1610612740,1610612741,107.0,98.0,0.447,0.396,1,2018-11-07,11,5,6,0.455,12,3,9,0.25
21800160,1610612762,1610612742,117.0,102.0,0.483,0.397,1,2018-11-07,11,5,6,0.455,11,3,8,0.273
21800161,1610612758,1610612761,105.0,114.0,0.477,0.461,0,2018-11-07,11,6,5,0.545,12,11,1,0.917
21800162,1610612747,1610612750,114.0,110.0,0.484,0.451,1,2018-11-07,11,5,6,0.455,12,4,8,0.3329999999999999
21800149,1610612766,1610612737,113.0,102.0,0.489,0.482,1,2018-11-06,11,6,5,0.545,10,3,7,0.3
21800150,1610612742,1610612764,119.0,100.0,0.476,0.425,1,2018-11-06,10,3,7,0.3,10,2,8,0.2
21800151,1610612756,1610612751,82.0,104.0,0.346,0.446,0,2018-11-06,10,2,8,0.2,11,5,6,0.455
21800152,1610612757,1610612749,118.0,103.0,0.527,0.435,1,2018-11-06,11,8,3,0.727,10,8,2,0.8
21800140,1610612765,1610612748,115.0,120.0,0.41,0.449,0,2018-11-05,9,4,5,0.444,9,4,5,0.444
21800141,1610612754,1610612745,94.0,98.0,0.44,0.447,0,2018-11-05,11,7,4,0.636,9,4,5,0.444
21800142,1610612753,1610612739,102.0,100.0,0.4479999999999999,0.513,1,2018-11-05,10,4,6,0.4,10,1,9,0.1
21800143,1610612752,1610612741,115.0,116.0,0.387,0.4529999999999999,0,2018-11-05,11,3,8,0.273,11,3,8,0.273
21800144,1610612760,1610612740,122.0,116.0,0.484,0.488,1,2018-11-05,9,5,4,0.556,10,4,6,0.4
21800145,1610612743,1610612738,115.0,107.0,0.456,0.506,1,2018-11-05,10,9,1,0.9,10,6,4,0.6
21800146,1610612762,1610612761,111.0,124.0,0.442,0.57,0,2018-11-05,10,4,6,0.4,11,10,1,0.909
21800147,1610612744,1610612763,117.0,101.0,0.506,0.4579999999999999,1,2018-11-05,11,10,1,0.909,9,5,4,0.556
21800148,1610612746,1610612750,120.0,109.0,0.489,0.471,1,2018-11-05,10,6,4,0.6,11,4,7,0.364
21800133,1610612749,1610612758,144.0,109.0,0.484,0.442,1,2018-11-04,9,8,1,0.889,10,6,4,0.6
21800134,1610612751,1610612755,122.0,97.0,0.476,0.477,1,2018-11-04,10,4,6,0.4,11,6,5,0.545
21800135,1610612764,1610612752,108.0,95.0,0.434,0.419,1,2018-11-04,9,2,7,0.222,10,3,7,0.3
21800137,1610612759,1610612753,110.0,117.0,0.4320000000000001,0.505,0,2018-11-04,9,6,3,0.667,9,3,6,0.3329999999999999
21800136,1610612756,1610612763,102.0,100.0,0.516,0.474,1,2018-11-04,9,2,7,0.222,8,5,3,0.625
21800138,1610612757,1610612750,111.0,81.0,0.442,0.312,1,2018-11-04,10,7,3,0.7,10,4,6,0.4
21800139,1610612747,1610612761,107.0,121.0,0.4589999999999999,0.5,0,2018-11-04,10,4,6,0.4,10,9,1,0.9
21800125,1610612755,1610612765,109.0,99.0,0.406,0.3979999999999999,1,2018-11-03,10,6,4,0.6,8,4,4,0.5
21800126,1610612766,1610612739,126.0,94.0,0.5710000000000001,0.4320000000000001,1,2018-11-03,10,5,5,0.5,9,1,8,0.111
21800127,1610612754,1610612738,102.0,101.0,0.419,0.4320000000000001,1,2018-11-03,10,7,3,0.7,9,6,3,0.667
21800128,1610612737,1610612748,123.0,118.0,0.523,0.482,1,2018-11-03,9,3,6,0.3329999999999999,8,3,5,0.375
21800129,1610612741,1610612745,88.0,96.0,0.3939999999999999,0.422,0,2018-11-03,10,2,8,0.2,8,3,5,0.375
21800130,1610612759,1610612740,109.0,95.0,0.469,0.4679999999999999,1,2018-11-03,8,6,2,0.75,9,4,5,0.444
21800131,1610612743,1610612762,103.0,88.0,0.494,0.407,1,2018-11-03,9,8,1,0.889,9,4,5,0.444
21800132,1610612757,1610612747,110.0,114.0,0.423,0.523,0,2018-11-03,9,6,3,0.667,9,4,5,0.444
21800117,1610612753,1610612746,95.0,120.0,0.444,0.477,0,2018-11-02,8,2,6,0.25,9,5,4,0.556
21800118,1610612751,1610612745,111.0,119.0,0.494,0.494,0,2018-11-02,9,3,6,0.3329999999999999,7,2,5,0.286
21800119,1610612764,1610612760,111.0,134.0,0.512,0.57,0,2018-11-02,8,1,7,0.125,8,4,4,0.5
21800120,1610612741,1610612754,105.0,107.0,0.472,0.471,0,2018-11-02,9,2,7,0.222,9,6,3,0.667
21800121,1610612742,1610612752,106.0,118.0,0.494,0.5479999999999999,0,2018-11-02,9,2,7,0.222,9,3,6,0.3329999999999999
21800122,1610612762,1610612763,100.0,110.0,0.4679999999999999,0.507,0,2018-11-02,8,4,4,0.5,7,5,2,0.7140000000000001
21800123,1610612756,1610612761,98.0,107.0,0.44,0.506,0,2018-11-02,8,1,7,0.125,9,8,1,0.889
21800124,1610612744,1610612750,116.0,99.0,0.489,0.376,1,2018-11-02,10,9,1,0.9,9,4,5,0.444
21800111,1610612766,1610612760,107.0,111.0,0.409,0.4270000000000001,0,2018-11-01,9,4,5,0.444,7,3,4,0.429
21800112,1610612739,1610612743,91.0,110.0,0.41,0.482,0,2018-11-01,8,1,7,0.125,8,7,1,0.875
21800113,1610612755,1610612746,122.0,113.0,0.473,0.442,1,2018-11-01,9,5,4,0.556,8,4,4,0.5
21800114,1610612737,1610612758,115.0,146.0,0.483,0.541,0,2018-11-01,8,2,6,0.25,9,6,3,0.667
21800115,1610612738,1610612749,117.0,113.0,0.446,0.482,1,2018-11-01,8,6,2,0.75,8,7,1,0.875
21800116,1610612757,1610612740,132.0,119.0,0.506,0.426,1,2018-11-01,8,6,2,0.75,8,4,4,0.5
21800104,1610612751,1610612765,120.0,119.0,0.426,0.419,1,2018-10-31,8,3,5,0.375,7,4,3,0.5710000000000001
21800105,1610612752,1610612754,101.0,107.0,0.43,0.542,0,2018-10-31,8,2,6,0.25,8,5,3,0.625
21800106,1610612741,1610612743,107.0,108.0,0.424,0.455,0,2018-10-31,8,2,6,0.25,7,6,1,0.857
21800107,1610612750,1610612762,128.0,125.0,0.581,0.485,1,2018-10-31,8,4,4,0.5,7,4,3,0.5710000000000001
21800108,1610612744,1610612740,131.0,121.0,0.528,0.478,1,2018-10-31,9,8,1,0.889,7,4,3,0.5710000000000001
21800109,1610612747,1610612742,114.0,113.0,0.512,0.5,1,2018-10-31,8,3,5,0.375,8,2,6,0.25
21800110,1610612756,1610612759,90.0,120.0,0.389,0.5539999999999999,0,2018-10-31,7,1,6,0.143,7,5,2,0.7140000000000001
21800096,1610612766,1610612748,125.0,113.0,0.5429999999999999,0.471,1,2018-10-30,8,4,4,0.5,7,3,4,0.429
21800097,1610612739,1610612737,136.0,114.0,0.5,0.537,1,2018-10-30,7,1,6,0.143,7,2,5,0.286
21800098,1610612753,1610612758,99.0,107.0,0.396,0.488,0,2018-10-30,7,2,5,0.286,8,5,3,0.625
21800099,1610612738,1610612765,108.0,105.0,0.44,0.42,1,2018-10-30,7,5,2,0.7140000000000001,6,4,2,0.667
21800100,1610612761,1610612755,129.0,112.0,0.511,0.418,1,2018-10-30,8,7,1,0.875,8,4,4,0.5
21800101,1610612745,1610612757,85.0,104.0,0.3229999999999999,0.475,0,2018-10-30,6,1,5,0.1669999999999999,7,5,2,0.7140000000000001
21800102,1610612763,1610612764,107.0,95.0,0.486,0.4320000000000001,1,2018-10-30,6,4,2,0.667,7,1,6,0.143
21800103,1610612760,1610612746,128.0,110.0,0.511,0.473,1,2018-10-30,6,2,4,0.3329999999999999,7,4,3,0.5710000000000001
21800087,1610612754,1610612757,93.0,103.0,0.411,0.487,0,2018-10-29,7,4,3,0.5710000000000001,6,4,2,0.667
21800088,1610612755,1610612737,113.0,92.0,0.414,0.3720000000000001,1,2018-10-29,7,4,3,0.5710000000000001,6,2,4,0.3329999999999999
21800089,1610612748,1610612758,113.0,123.0,0.413,0.495,0,2018-10-29,6,3,3,0.5,7,4,3,0.5710000000000001
21800090,1610612752,1610612751,115.0,96.0,0.489,0.405,1,2018-10-29,7,2,5,0.286,7,2,5,0.286
21800091,1610612741,1610612744,124.0,149.0,0.489,0.552,0,2018-10-29,7,2,5,0.286,8,7,1,0.875
21800092,1610612749,1610612761,124.0,109.0,0.489,0.379,1,2018-10-29,7,7,0,1.0,7,6,1,0.857
21800093,1610612750,1610612747,124.0,120.0,0.429,0.471,1,2018-10-29,7,3,4,0.429,7,2,5,0.286
21800094,1610612759,1610612742,113.0,108.0,0.462,0.473,1,2018-10-29,6,4,2,0.667,7,2,5,0.286
21800095,1610612743,1610612740,116.0,111.0,0.452,0.524,1,2018-10-29,6,5,1,0.833,6,4,2,0.667
21800083,1610612751,1610612744,114.0,120.0,0.483,0.494,0,2018-10-28,6,2,4,0.3329999999999999,7,6,1,0.857
21800084,1610612742,1610612762,104.0,113.0,0.418,0.525,0,2018-10-28,6,2,4,0.3329999999999999,6,4,2,0.667
21800085,1610612760,1610612756,117.0,110.0,0.506,0.442,1,2018-10-28,5,1,4,0.2,6,1,5,0.1669999999999999
21800086,1610612746,1610612764,136.0,104.0,0.544,0.392,1,2018-10-28,6,4,2,0.667,6,1,5,0.1669999999999999
21800074,1610612765,1610612738,89.0,109.0,0.371,0.4529999999999999,0,2018-10-27,5,4,1,0.8,6,4,2,0.667
21800075,1610612740,1610612762,111.0,132.0,0.421,0.523,0,2018-10-27,5,4,1,0.8,5,3,2,0.6
21800076,1610612737,1610612741,85.0,97.0,0.321,0.434,0,2018-10-27,5,2,3,0.4,6,2,4,0.3329999999999999
21800077,1610612739,1610612754,107.0,119.0,0.465,0.649,0,2018-10-27,6,0,6,0.0,6,4,2,0.667
21800078,1610612755,1610612766,105.0,103.0,0.385,0.389,1,2018-10-27,6,3,3,0.5,7,3,4,0.429
21800079,1610612748,1610612757,120.0,111.0,0.4579999999999999,0.42,1,2018-10-27,5,3,2,0.6,5,3,2,0.6
21800080,1610612763,1610612756,117.0,96.0,0.557,0.462,1,2018-10-27,5,3,2,0.6,5,1,4,0.2
21800081,1610612749,1610612753,113.0,91.0,0.5,0.327,1,2018-10-27,6,6,0,1.0,6,2,4,0.3329999999999999
21800082,1610612759,1610612747,110.0,106.0,0.484,0.477,1,2018-10-27,5,3,2,0.6,6,2,4,0.3329999999999999
21800067,1610612766,1610612741,135.0,106.0,0.57,0.435,1,2018-10-26,6,3,3,0.5,5,1,4,0.2
21800068,1610612752,1610612744,100.0,128.0,0.433,0.586,0,2018-10-26,6,1,5,0.1669999999999999,6,5,1,0.833
21800069,1610612761,1610612742,116.0,107.0,0.484,0.413,1,2018-10-26,6,6,0,1.0,5,2,3,0.4
21800070,1610612745,1610612746,113.0,133.0,0.3879999999999999,0.544,0,2018-10-26,5,1,4,0.2,5,3,2,0.6
21800071,1610612750,1610612749,95.0,125.0,0.321,0.5329999999999999,0,2018-10-26,6,2,4,0.3329999999999999,5,5,0,1.0
21800072,1610612740,1610612751,117.0,115.0,0.449,0.439,1,2018-10-26,4,4,0,1.0,5,2,3,0.4
21800073,1610612758,1610612764,116.0,112.0,0.4629999999999999,0.465,1,2018-10-26,6,3,3,0.5,5,1,4,0.2
21800063,1610612765,1610612739,110.0,103.0,0.526,0.461,1,2018-10-25,4,4,0,1.0,5,0,5,0.0
21800064,1610612753,1610612757,114.0,128.0,0.5,0.552,0,2018-10-25,5,2,3,0.4,4,3,1,0.75
21800065,1610612760,1610612738,95.0,101.0,0.3939999999999999,0.384,0,2018-10-25,4,0,4,0.0,5,3,2,0.6
21800066,1610612747,1610612743,121.0,114.0,0.5,0.5,1,2018-10-25,5,2,3,0.4,5,4,1,0.8
21800052,1610612737,1610612742,111.0,104.0,0.407,0.418,1,2018-10-24,4,2,2,0.5,4,2,2,0.5
21800053,1610612739,1610612751,86.0,102.0,0.382,0.4370000000000001,0,2018-10-24,4,0,4,0.0,4,2,2,0.5
21800054,1610612748,1610612752,110.0,87.0,0.476,0.363,1,2018-10-24,4,2,2,0.5,5,1,4,0.2
21800055,1610612761,1610612750,112.0,105.0,0.517,0.417,1,2018-10-24,5,5,0,1.0,5,2,3,0.4
21800056,1610612741,1610612766,112.0,110.0,0.481,0.435,1,2018-10-24,4,1,3,0.25,5,2,3,0.4
21800057,1610612745,1610612762,89.0,100.0,0.402,0.436,0,2018-10-24,4,1,3,0.25,4,2,2,0.5
21800058,1610612759,1610612754,96.0,116.0,0.402,0.529,0,2018-10-24,4,2,2,0.5,5,3,2,0.6
21800059,1610612749,1610612755,123.0,108.0,0.41,0.413,1,2018-10-24,4,4,0,1.0,5,2,3,0.4
21800060,1610612756,1610612747,113.0,131.0,0.524,0.52,0,2018-10-24,4,1,3,0.25,4,1,3,0.25
21800061,1610612758,1610612763,97.0,92.0,0.422,0.3829999999999999,1,2018-10-24,5,2,3,0.4,4,2,2,0.5
21800062,1610612744,1610612764,144.0,122.0,0.5760000000000001,0.452,1,2018-10-24,5,4,1,0.8,4,1,3,0.25
21800049,1610612765,1610612755,133.0,132.0,0.472,0.5,1,2018-10-23,3,3,0,1.0,4,2,2,0.5
21800050,1610612740,1610612746,116.0,109.0,0.43,0.471,1,2018-10-23,3,3,0,1.0,4,2,2,0.5
21800051,1610612743,1610612758,126.0,112.0,0.515,0.523,1,2018-10-23,4,4,0,1.0,4,1,3,0.25
21800040,1610612738,1610612753,90.0,93.0,0.407,0.409,0,2018-10-22,4,2,2,0.5,4,2,2,0.5
21800041,1610612761,1610612766,127.0,106.0,0.575,0.423,1,2018-10-22,4,4,0,1.0,4,2,2,0.5
21800042,1610612749,1610612752,124.0,113.0,0.469,0.455,1,2018-10-22,3,3,0,1.0,4,1,3,0.25
21800043,1610612750,1610612754,101.0,91.0,0.424,0.391,1,2018-10-22,4,2,2,0.5,4,2,2,0.5
21800044,1610612742,1610612741,115.0,109.0,0.43,0.513,1,2018-10-22,3,2,1,0.667,3,0,3,0.0
21800045,1610612762,1610612763,84.0,92.0,0.354,0.369,0,2018-10-22,3,1,2,0.3329999999999999,3,2,1,0.667
21800046,1610612757,1610612764,124.0,125.0,0.3979999999999999,0.418,0,2018-10-22,3,2,1,0.667,3,1,2,0.3329999999999999
21800047,1610612744,1610612756,123.0,103.0,0.511,0.4529999999999999,1,2018-10-22,4,3,1,0.75,3,1,2,0.3329999999999999
21800048,1610612747,1610612759,142.0,143.0,0.514,0.515,0,2018-10-22,3,0,3,0.0,3,2,1,0.667
21800036,1610612739,1610612737,111.0,133.0,0.465,0.49,0,2018-10-21,3,0,3,0.0,3,1,2,0.3329999999999999
21800037,1610612760,1610612758,120.0,131.0,0.442,0.5489999999999999,0,2018-10-21,3,0,3,0.0,3,1,2,0.3329999999999999
21800038,1610612743,1610612744,100.0,98.0,0.407,0.456,1,2018-10-21,3,3,0,1.0,3,2,1,0.667
21800039,1610612746,1610612745,115.0,112.0,0.472,0.483,1,2018-10-21,3,2,1,0.667,3,1,2,0.3329999999999999
21800026,1610612754,1610612751,132.0,112.0,0.5539999999999999,0.477,1,2018-10-20,3,2,1,0.667,3,1,2,0.3329999999999999
21800027,1610612764,1610612761,113.0,117.0,0.416,0.4429999999999999,0,2018-10-20,2,0,2,0.0,3,3,0,1.0
21800028,1610612752,1610612738,101.0,103.0,0.414,0.402,0,2018-10-20,3,1,2,0.3329999999999999,3,2,1,0.667
21800029,1610612755,1610612753,116.0,115.0,0.479,0.456,1,2018-10-20,3,2,1,0.667,3,1,2,0.3329999999999999
21800030,1610612748,1610612766,112.0,113.0,0.461,0.441,0,2018-10-20,3,1,2,0.3329999999999999,3,2,1,0.667
21800031,1610612741,1610612765,116.0,118.0,0.506,0.406,0,2018-10-20,2,0,2,0.0,2,2,0,1.0
21800032,1610612742,1610612750,140.0,136.0,0.5,0.524,1,2018-10-20,2,1,1,0.5,3,1,2,0.3329999999999999
21800033,1610612743,1610612756,119.0,91.0,0.506,0.377,1,2018-10-20,2,2,0,1.0,2,1,1,0.5
21800034,1610612757,1610612759,121.0,108.0,0.536,0.42,1,2018-10-20,2,2,0,1.0,2,1,1,0.5
21800035,1610612747,1610612745,115.0,124.0,0.48,0.4579999999999999,0,2018-10-20,2,0,2,0.0,2,1,1,0.5
21800017,1610612753,1610612766,88.0,120.0,0.3829999999999999,0.467,0,2018-10-19,2,1,1,0.5,2,1,1,0.5
21800018,1610612751,1610612752,107.0,105.0,0.493,0.402,1,2018-10-19,2,1,1,0.5,2,1,1,0.5
21800019,1610612761,1610612738,113.0,101.0,0.467,0.4039999999999999,1,2018-10-19,2,2,0,1.0,2,1,1,0.5
21800020,1610612763,1610612737,131.0,117.0,0.5429999999999999,0.494,1,2018-10-19,2,1,1,0.5,2,0,2,0.0
21800021,1610612750,1610612739,131.0,123.0,0.506,0.484,1,2018-10-19,2,1,1,0.5,2,0,2,0.0
21800022,1610612740,1610612758,149.0,129.0,0.589,0.521,1,2018-10-19,2,2,0,1.0,2,0,2,0.0
21800023,1610612749,1610612754,118.0,101.0,0.473,0.4370000000000001,1,2018-10-19,2,2,0,1.0,2,1,1,0.5
21800024,1610612762,1610612744,123.0,124.0,0.449,0.563,0,2018-10-19,2,1,1,0.5,2,2,0,1.0
21800025,1610612746,1610612760,108.0,92.0,0.4320000000000001,0.358,1,2018-10-19,2,1,1,0.5,2,0,2,0.0
21800014,1610612755,1610612741,127.0,108.0,0.473,0.436,1,2018-10-18,2,1,1,0.5,1,0,1,0.0
21800015,1610612764,1610612748,112.0,113.0,0.469,0.392,0,2018-10-18,1,0,1,0.0,2,1,1,0.5
21800016,1610612757,1610612747,128.0,119.0,0.44,0.484,1,2018-10-18,1,1,0,1.0,1,0,1,0.0
21800003,1610612766,1610612749,112.0,113.0,0.446,0.494,0,2018-10-17,1,0,1,0.0,1,1,0,1.0
21800004,1610612765,1610612751,103.0,100.0,0.424,0.488,1,2018-10-17,1,1,0,1.0,1,0,1,0.0
21800005,1610612754,1610612763,111.0,83.0,0.5660000000000001,0.298,1,2018-10-17,1,1,0,1.0,1,0,1,0.0
21800006,1610612753,1610612748,104.0,101.0,0.415,0.392,1,2018-10-17,1,1,0,1.0,1,0,1,0.0
21800007,1610612752,1610612737,126.0,107.0,0.455,0.456,1,2018-10-17,1,1,0,1.0,1,0,1,0.0
21800008,1610612761,1610612739,116.0,104.0,0.489,0.4,1,2018-10-17,1,1,0,1.0,1,0,1,0.0
21800009,1610612745,1610612740,112.0,131.0,0.424,0.531,0,2018-10-17,1,0,1,0.0,1,1,0,1.0
21800010,1610612759,1610612750,112.0,108.0,0.43,0.429,1,2018-10-17,1,1,0,1.0,1,0,1,0.0
21800011,1610612758,1610612762,117.0,123.0,0.516,0.519,0,2018-10-17,1,0,1,0.0,1,1,0,1.0
21800012,1610612746,1610612743,98.0,107.0,0.3979999999999999,0.379,0,2018-10-17,1,0,1,0.0,1,1,0,1.0
21800013,1610612756,1610612742,121.0,100.0,0.5429999999999999,0.4320000000000001,1,2018-10-17,1,1,0,1.0,1,0,1,0.0
21800001,1610612738,1610612755,105.0,87.0,0.433,0.391,1,2018-10-16,1,1,0,1.0,1,0,1,0.0
21800002,1610612744,1610612760,108.0,100.0,0.442,0.363,1,2018-10-16,1,1,0,1.0,1,0,1,0.0
11800069,1610612753,1610612759,81.0,100.0,0.371,0.41,0,2018-10-12,5,2,3,0.4,5,3,2,0.6
11800071,1610612742,1610612766,118.0,123.0,0.457,0.519,0,2018-10-12,4,2,2,0.5,5,4,1,0.8
11800075,1610612739,1610612765,110.0,129.0,0.471,0.511,0,2018-10-12,4,2,2,0.5,5,2,3,0.4
11800072,1610612752,1610612751,107.0,113.0,0.452,0.506,0,2018-10-12,5,3,2,0.6,4,2,2,0.5
11800073,1610612748,1610612737,119.0,113.0,0.494,0.452,1,2018-10-12,6,3,3,0.5,5,2,3,0.4
11800074,1610612741,1610612743,93.0,98.0,0.422,0.422,0,2018-10-12,5,2,3,0.4,5,4,1,0.8
11800076,1610612763,1610612745,103.0,121.0,0.514,0.43,0,2018-10-12,5,2,3,0.4,5,4,1,0.8
11800077,1610612749,1610612750,143.0,121.0,0.527,0.396,1,2018-10-12,4,3,1,0.75,5,1,4,0.2
11800078,1610612757,1610612758,118.0,115.0,0.4479999999999999,0.422,1,2018-10-12,5,3,2,0.6,6,2,4,0.3329999999999999
11800079,1610612744,1610612747,105.0,119.0,0.3979999999999999,0.5329999999999999,0,2018-10-12,5,1,4,0.2,6,3,3,0.5
11800066,1610612740,1610612761,119.0,134.0,0.469,0.53,0,2018-10-11,5,0,5,0.0,5,4,1,0.8
11800068,1610612758,1610612762,93.0,132.0,0.344,0.6,0,2018-10-11,5,2,3,0.4,5,5,0,1.0
11800058,1610612765,1610612764,97.0,102.0,0.356,0.47,0,2018-10-10,4,1,3,0.25,4,3,1,0.75
11800059,1610612753,1610612763,102.0,86.0,0.45,0.413,1,2018-10-10,4,2,2,0.5,4,2,2,0.5
11800060,1610612761,1610612751,118.0,91.0,0.455,0.402,1,2018-10-10,4,3,1,0.75,3,1,2,0.3329999999999999
11800061,1610612737,1610612759,130.0,127.0,0.583,0.552,1,2018-10-10,4,2,2,0.5,4,2,2,0.5
11800062,1610612748,1610612740,140.0,128.0,0.472,0.564,1,2018-10-10,5,2,3,0.4,4,0,4,0.0
11800063,1610612741,1610612754,104.0,89.0,0.4,0.392,1,2018-10-10,4,2,2,0.5,4,2,2,0.5
11800064,1610612757,1610612756,116.0,83.0,0.478,0.386,1,2018-10-10,4,2,2,0.5,5,2,3,0.4
11800065,1610612747,1610612744,123.0,113.0,0.433,0.4379999999999999,1,2018-10-10,5,2,3,0.4,4,1,3,0.25
11800056,1610612760,1610612749,119.0,115.0,0.387,0.426,1,2018-10-09,4,3,1,0.75,3,2,1,0.667
11800057,1610612746,1610612743,109.0,103.0,0.4320000000000001,0.411,1,2018-10-09,4,4,0,1.0,4,3,1,0.75
11800047,1610612755,1610612742,112.0,115.0,0.495,0.469,0,2018-10-08,4,3,1,0.75,3,2,1,0.667
11800048,1610612766,1610612741,110.0,104.0,0.4529999999999999,0.44,1,2018-10-08,4,3,1,0.75,3,1,2,0.3329999999999999
11800049,1610612739,1610612754,102.0,111.0,0.449,0.489,0,2018-10-08,3,2,1,0.667,3,2,1,0.667
11800050,1610612765,1610612751,108.0,110.0,0.363,0.4629999999999999,0,2018-10-08,3,1,2,0.3329999999999999,2,1,1,0.5
11800051,1610612748,1610612753,90.0,89.0,0.413,0.3779999999999999,1,2018-10-08,4,1,3,0.25,3,1,2,0.3329999999999999
11800052,1610612752,1610612764,98.0,110.0,0.43,0.462,0,2018-10-08,4,3,1,0.75,3,2,1,0.667
11800054,1610612744,1610612756,109.0,117.0,0.506,0.512,0,2018-10-08,3,1,2,0.3329999999999999,4,2,2,0.5
11800043,1610612760,1610612737,113.0,94.0,0.409,0.38,1,2018-10-07,3,2,1,0.667,3,1,2,0.3329999999999999
11800044,1610612759,1610612745,93.0,108.0,0.382,0.411,0,2018-10-07,3,2,1,0.667,3,2,1,0.667
11800045,1610612750,1610612749,107.0,125.0,0.4479999999999999,0.457,0,2018-10-07,4,1,3,0.25,2,2,0,1.0
11800046,1610612757,1610612762,112.0,123.0,0.519,0.471,0,2018-10-07,3,1,2,0.3329999999999999,4,4,0,1.0
11800040,1610612739,1610612738,113.0,102.0,0.433,0.3929999999999999,1,2018-10-06,2,2,0,1.0,4,1,3,0.25
11800041,1610612763,1610612754,109.0,104.0,0.413,0.375,1,2018-10-06,3,2,1,0.667,2,1,1,0.5
11800042,1610612747,1610612746,87.0,103.0,0.385,0.411,0,2018-10-06,4,1,3,0.25,3,3,0,1.0
11800028,1610612742,1610612755,114.0,120.0,0.447,0.484,0,2018-10-05,2,1,1,0.5,3,3,0,1.0
11800031,1610612764,1610612748,121.0,114.0,0.512,0.449,1,2018-10-05,2,1,1,0.5,3,0,3,0.0
11800032,1610612752,1610612740,106.0,100.0,0.358,0.3829999999999999,1,2018-10-05,3,3,0,1.0,3,0,3,0.0
11800033,1610612763,1610612737,120.0,110.0,0.47,0.44,1,2018-10-05,2,1,1,0.5,2,1,1,0.5
11800034,1610612750,1610612760,101.0,113.0,0.407,0.4529999999999999,0,2018-10-05,3,1,2,0.3329999999999999,2,1,1,0.5
11800035,1610612759,1610612765,117.0,93.0,0.561,0.348,1,2018-10-05,2,2,0,1.0,2,1,1,0.5
11800038,1610612756,1610612757,93.0,115.0,0.3879999999999999,0.457,0,2018-10-05,3,1,2,0.3329999999999999,2,1,1,0.5
11800039,1610612744,1610612758,122.0,94.0,0.516,0.347,1,2018-10-05,2,1,1,0.5,3,1,2,0.3329999999999999
11800026,1610612745,1610612754,100.0,110.0,0.439,0.44,0,2018-10-04,2,1,1,0.5,1,1,0,1.0
11800027,1610612747,1610612758,128.0,123.0,0.526,0.455,1,2018-10-04,3,1,2,0.3329999999999999,2,1,1,0.5
11800021,1610612751,1610612752,102.0,107.0,0.389,0.469,0,2018-10-03,1,0,1,0.0,2,2,0,1.0
11800022,1610612749,1610612741,116.0,82.0,0.494,0.324,1,2018-10-03,1,1,0,1.0,2,1,1,0.5
11800023,1610612760,1610612765,91.0,97.0,0.366,0.4639999999999999,0,2018-10-03,1,0,1,0.0,1,1,0,1.0
11800025,1610612746,1610612750,128.0,101.0,0.551,0.358,1,2018-10-03,2,2,0,1.0,2,1,1,0.5
11800016,1610612766,1610612748,122.0,113.0,0.506,0.415,1,2018-10-02,3,2,1,0.667,2,0,2,0.0
11800017,1610612738,1610612739,95.0,102.0,0.4270000000000001,0.413,0,2018-10-02,3,1,2,0.3329999999999999,1,1,0,1.0
11800018,1610612745,1610612763,131.0,115.0,0.5,0.471,1,2018-10-02,1,1,0,1.0,1,0,1,0.0
11800019,1610612762,1610612761,105.0,90.0,0.434,0.354,1,2018-10-02,2,2,0,1.0,2,1,1,0.5
11800020,1610612747,1610612743,111.0,113.0,0.512,0.476,0,2018-10-02,2,0,2,0.0,2,2,0,1.0
11800012,1610612755,1610612753,120.0,114.0,0.469,0.495,1,2018-10-01,2,2,0,1.0,1,0,1,0.0
11800013,1610612764,1610612752,121.0,124.0,0.412,0.4379999999999999,0,2018-10-01,1,0,1,0.0,1,1,0,1.0
11800014,1610612737,1610612740,116.0,102.0,0.457,0.365,1,2018-10-01,1,1,0,1.0,2,0,2,0.0
11800015,1610612756,1610612758,102.0,106.0,0.446,0.476,0,2018-10-01,1,0,1,0.0,1,1,0,1.0
11800007,1610612759,1610612748,104.0,100.0,0.435,0.368,1,2018-09-30,1,1,0,1.0,1,0,1,0.0
11800008,1610612738,1610612766,115.0,112.0,0.442,0.475,1,2018-09-30,2,1,1,0.5,2,1,1,0.5
11800009,1610612741,1610612740,128.0,116.0,0.495,0.4539999999999999,1,2018-09-30,1,1,0,1.0,1,0,1,0.0
11800010,1610612747,1610612743,107.0,124.0,0.46,0.46,0,2018-09-30,1,0,1,0.0,1,1,0,1.0
11800003,1610612761,1610612757,122.0,104.0,0.415,0.42,1,2018-09-29,1,1,0,1.0,1,0,1,0.0
11800005,1610612744,1610612750,110.0,114.0,0.473,0.426,0,2018-09-29,1,0,1,0.0,1,1,0,1.0
11800002,1610612766,1610612738,104.0,97.0,0.382,0.346,1,2018-09-28,1,1,0,1.0,1,0,1,0.0
41700404,1610612739,1610612744,85.0,108.0,0.345,0.4529999999999999,0,2018-06-08,82,50,32,0.61,82,58,24,0.7070000000000001
41700403,1610612739,1610612744,102.0,110.0,0.435,0.519,0,2018-06-06,82,50,32,0.61,82,58,24,0.7070000000000001
41700402,1610612744,1610612739,122.0,103.0,0.573,0.411,1,2018-06-03,82,58,24,0.7070000000000001,82,50,32,0.61
41700401,1610612744,1610612739,124.0,114.0,0.511,0.444,1,2018-05-31,82,58,24,0.7070000000000001,82,50,32,0.61
41700317,1610612745,1610612744,92.0,101.0,0.4,0.488,0,2018-05-28,82,65,17,0.7929999999999999,82,58,24,0.7070000000000001
41700307,1610612738,1610612739,79.0,87.0,0.341,0.455,0,2018-05-27,82,55,27,0.6709999999999999,82,50,32,0.61
41700316,1610612744,1610612745,115.0,86.0,0.494,0.4029999999999999,1,2018-05-26,82,58,24,0.7070000000000001,82,65,17,0.7929999999999999
41700306,1610612739,1610612738,109.0,99.0,0.471,0.514,1,2018-05-25,82,50,32,0.61,82,55,27,0.6709999999999999
41700315,1610612745,1610612744,98.0,94.0,0.3720000000000001,0.444,1,2018-05-24,82,65,17,0.7929999999999999,82,58,24,0.7070000000000001
41700305,1610612738,1610612739,96.0,83.0,0.365,0.419,1,2018-05-23,82,55,27,0.6709999999999999,82,50,32,0.61
41700314,1610612744,1610612745,92.0,95.0,0.3929999999999999,0.39,0,2018-05-22,82,58,24,0.7070000000000001,82,65,17,0.7929999999999999
41700304,1610612739,1610612738,111.0,102.0,0.506,0.412,1,2018-05-21,82,50,32,0.61,82,55,27,0.6709999999999999
41700313,1610612744,1610612745,126.0,85.0,0.522,0.395,1,2018-05-20,82,58,24,0.7070000000000001,82,65,17,0.7929999999999999
41700303,1610612739,1610612738,116.0,86.0,0.487,0.392,1,2018-05-19,82,50,32,0.61,82,55,27,0.6709999999999999
41700312,1610612745,1610612744,127.0,105.0,0.511,0.4589999999999999,1,2018-05-16,82,65,17,0.7929999999999999,82,58,24,0.7070000000000001
41700302,1610612738,1610612739,107.0,94.0,0.435,0.4629999999999999,1,2018-05-15,82,55,27,0.6709999999999999,82,50,32,0.61
41700311,1610612745,1610612744,106.0,119.0,0.4589999999999999,0.525,0,2018-05-14,82,65,17,0.7929999999999999,82,58,24,0.7070000000000001
41700301,1610612738,1610612739,108.0,83.0,0.512,0.36,1,2018-05-13,82,55,27,0.6709999999999999,82,50,32,0.61
41700215,1610612738,1610612755,114.0,112.0,0.447,0.488,1,2018-05-09,82,55,27,0.6709999999999999,82,52,30,0.634
41700225,1610612745,1610612762,112.0,102.0,0.482,0.469,1,2018-05-08,82,65,17,0.7929999999999999,82,48,34,0.585
41700235,1610612744,1610612740,113.0,104.0,0.485,0.466,1,2018-05-08,82,58,24,0.7070000000000001,82,48,34,0.585
41700214,1610612755,1610612738,103.0,92.0,0.4039999999999999,0.413,1,2018-05-07,82,52,30,0.634,82,55,27,0.6709999999999999
41700204,1610612739,1610612761,128.0,93.0,0.595,0.456,1,2018-05-07,82,50,32,0.61,82,59,23,0.72
41700234,1610612740,1610612744,92.0,118.0,0.364,0.484,0,2018-05-06,82,48,34,0.585,82,58,24,0.7070000000000001
41700224,1610612762,1610612745,87.0,100.0,0.386,0.42,0,2018-05-06,82,48,34,0.585,82,65,17,0.7929999999999999
41700213,1610612755,1610612738,98.0,101.0,0.392,0.451,0,2018-05-05,82,52,30,0.634,82,55,27,0.6709999999999999
41700203,1610612739,1610612761,105.0,103.0,0.481,0.467,1,2018-05-05,82,50,32,0.61,82,59,23,0.72
41700233,1610612740,1610612744,119.0,100.0,0.5,0.38,1,2018-05-04,82,48,34,0.585,82,58,24,0.7070000000000001
41700223,1610612762,1610612745,92.0,113.0,0.417,0.488,0,2018-05-04,82,48,34,0.585,82,65,17,0.7929999999999999
41700202,1610612761,1610612739,110.0,128.0,0.5429999999999999,0.595,0,2018-05-03,82,59,23,0.72,82,50,32,0.61
41700212,1610612738,1610612755,108.0,103.0,0.451,0.435,1,2018-05-03,82,55,27,0.6709999999999999,82,52,30,0.634
41700222,1610612745,1610612762,108.0,116.0,0.4,0.518,0,2018-05-02,82,65,17,0.7929999999999999,82,48,34,0.585
41700201,1610612761,1610612739,112.0,113.0,0.429,0.412,0,2018-05-01,82,59,23,0.72,82,50,32,0.61
41700232,1610612744,1610612740,121.0,116.0,0.473,0.457,1,2018-05-01,82,58,24,0.7070000000000001,82,48,34,0.585
41700211,1610612738,1610612755,117.0,101.0,0.482,0.422,1,2018-04-30,82,55,27,0.6709999999999999,82,52,30,0.634
41700137,1610612739,1610612754,105.0,101.0,0.4320000000000001,0.45,1,2018-04-29,82,50,32,0.61,82,48,34,0.585
41700221,1610612745,1610612762,110.0,96.0,0.451,0.5,1,2018-04-29,82,65,17,0.7929999999999999,82,48,34,0.585
41700117,1610612738,1610612749,112.0,96.0,0.536,0.473,1,2018-04-28,82,55,27,0.6709999999999999,82,44,38,0.537
41700231,1610612744,1610612740,123.0,101.0,0.484,0.4379999999999999,1,2018-04-28,82,58,24,0.7070000000000001,82,48,34,0.585
41700106,1610612764,1610612761,92.0,102.0,0.405,0.444,0,2018-04-27,82,43,39,0.524,82,59,23,0.72
41700136,1610612754,1610612739,121.0,87.0,0.563,0.418,1,2018-04-27,82,48,34,0.585,82,50,32,0.61
41700176,1610612762,1610612760,96.0,91.0,0.451,0.3979999999999999,1,2018-04-27,82,48,34,0.585,82,48,34,0.585
41700116,1610612749,1610612738,97.0,86.0,0.507,0.37,1,2018-04-26,82,44,38,0.537,82,55,27,0.6709999999999999
41700105,1610612761,1610612764,108.0,98.0,0.4629999999999999,0.411,1,2018-04-25,82,59,23,0.72,82,43,39,0.524
41700135,1610612739,1610612754,98.0,95.0,0.413,0.479,1,2018-04-25,82,50,32,0.61,82,48,34,0.585
41700145,1610612745,1610612750,122.0,104.0,0.511,0.506,1,2018-04-25,82,65,17,0.7929999999999999,82,47,35,0.573
41700175,1610612760,1610612762,107.0,99.0,0.4379999999999999,0.407,1,2018-04-25,82,48,34,0.585,82,48,34,0.585
41700115,1610612738,1610612749,92.0,87.0,0.42,0.368,1,2018-04-24,82,55,27,0.6709999999999999,82,44,38,0.537
41700125,1610612755,1610612748,104.0,91.0,0.42,0.386,1,2018-04-24,82,52,30,0.634,82,44,38,0.537
41700155,1610612744,1610612759,99.0,91.0,0.446,0.3720000000000001,1,2018-04-24,82,58,24,0.7070000000000001,82,47,35,0.573
41700144,1610612750,1610612745,100.0,119.0,0.4639999999999999,0.435,0,2018-04-23,82,47,35,0.573,82,65,17,0.7929999999999999
41700174,1610612762,1610612760,113.0,96.0,0.451,0.3929999999999999,1,2018-04-23,82,48,34,0.585,82,48,34,0.585
41700114,1610612749,1610612738,104.0,102.0,0.521,0.414,1,2018-04-22,82,44,38,0.537,82,55,27,0.6709999999999999
41700154,1610612759,1610612744,103.0,90.0,0.457,0.3779999999999999,1,2018-04-22,82,47,35,0.573,82,58,24,0.7070000000000001
41700104,1610612764,1610612761,106.0,98.0,0.4589999999999999,0.43,1,2018-04-22,82,43,39,0.524,82,59,23,0.72
41700134,1610612754,1610612739,100.0,104.0,0.43,0.449,0,2018-04-22,82,48,34,0.585,82,50,32,0.61
41700124,1610612748,1610612755,102.0,106.0,0.436,0.429,0,2018-04-21,82,44,38,0.537,82,52,30,0.634
41700164,1610612740,1610612757,131.0,123.0,0.5770000000000001,0.526,1,2018-04-21,82,48,34,0.585,82,49,33,0.598
41700143,1610612750,1610612745,121.0,105.0,0.5,0.457,1,2018-04-21,82,47,35,0.573,82,65,17,0.7929999999999999
41700173,1610612762,1610612760,115.0,102.0,0.525,0.474,1,2018-04-21,82,48,34,0.585,82,48,34,0.585
41700133,1610612754,1610612739,92.0,90.0,0.466,0.442,1,2018-04-20,82,48,34,0.585,82,50,32,0.61
41700103,1610612764,1610612761,122.0,103.0,0.5529999999999999,0.451,1,2018-04-20,82,43,39,0.524,82,59,23,0.72
41700113,1610612749,1610612738,116.0,92.0,0.57,0.4,1,2018-04-20,82,44,38,0.537,82,55,27,0.6709999999999999
41700123,1610612748,1610612755,108.0,128.0,0.452,0.506,0,2018-04-19,82,44,38,0.537,82,52,30,0.634
41700163,1610612740,1610612757,119.0,102.0,0.529,0.4629999999999999,1,2018-04-19,82,48,34,0.585,82,49,33,0.598
41700153,1610612759,1610612744,97.0,110.0,0.425,0.512,0,2018-04-19,82,47,35,0.573,82,58,24,0.7070000000000001
41700132,1610612739,1610612754,100.0,97.0,0.507,0.526,1,2018-04-18,82,50,32,0.61,82,48,34,0.585
41700172,1610612760,1610612762,95.0,102.0,0.4,0.417,0,2018-04-18,82,48,34,0.585,82,48,34,0.585
41700142,1610612745,1610612750,102.0,82.0,0.365,0.3879999999999999,1,2018-04-18,82,65,17,0.7929999999999999,82,47,35,0.573
41700102,1610612761,1610612764,130.0,119.0,0.517,0.488,1,2018-04-17,82,59,23,0.72,82,43,39,0.524
41700112,1610612738,1610612749,120.0,106.0,0.5329999999999999,0.597,1,2018-04-17,82,55,27,0.6709999999999999,82,44,38,0.537
41700162,1610612757,1610612740,102.0,111.0,0.451,0.512,0,2018-04-17,82,49,33,0.598,82,48,34,0.585
41700122,1610612755,1610612748,103.0,113.0,0.417,0.488,0,2018-04-16,82,52,30,0.634,82,44,38,0.537
41700152,1610612744,1610612759,116.0,101.0,0.526,0.412,1,2018-04-16,82,58,24,0.7070000000000001,82,47,35,0.573
41700111,1610612738,1610612749,113.0,107.0,0.415,0.482,1,2018-04-15,82,55,27,0.6709999999999999,82,44,38,0.537
41700131,1610612739,1610612754,80.0,98.0,0.385,0.456,0,2018-04-15,82,50,32,0.61,82,48,34,0.585
41700171,1610612760,1610612762,116.0,108.0,0.482,0.471,1,2018-04-15,82,48,34,0.585,82,48,34,0.585
41700141,1610612745,1610612750,104.0,101.0,0.47,0.4379999999999999,1,2018-04-15,82,65,17,0.7929999999999999,82,47,35,0.573
41700151,1610612744,1610612759,113.0,92.0,0.5429999999999999,0.4,1,2018-04-14,82,58,24,0.7070000000000001,82,47,35,0.573
41700101,1610612761,1610612764,114.0,106.0,0.532,0.477,1,2018-04-14,82,59,23,0.72,82,43,39,0.524
41700121,1610612755,1610612748,130.0,103.0,0.474,0.455,1,2018-04-14,82,52,30,0.634,82,44,38,0.537
41700161,1610612757,1610612740,95.0,97.0,0.3779999999999999,0.477,0,2018-04-14,82,49,33,0.598,82,48,34,0.585
21701219,1610612738,1610612751,110.0,97.0,0.451,0.407,1,2018-04-11,82,55,27,0.6709999999999999,82,28,54,0.341
21701220,1610612739,1610612752,98.0,110.0,0.3939999999999999,0.506,0,2018-04-11,82,50,32,0.61,82,29,53,0.354
21701221,1610612748,1610612761,116.0,109.0,0.434,0.457,1,2018-04-11,82,44,38,0.537,82,59,23,0.72
21701222,1610612753,1610612764,101.0,92.0,0.429,0.347,1,2018-04-11,82,25,57,0.305,82,43,39,0.524
21701223,1610612755,1610612749,130.0,95.0,0.495,0.411,1,2018-04-11,82,52,30,0.634,82,44,38,0.537
21701224,1610612741,1610612765,87.0,119.0,0.3720000000000001,0.528,0,2018-04-11,82,27,55,0.3289999999999999,82,39,43,0.476
21701225,1610612750,1610612743,112.0,106.0,0.472,0.456,1,2018-04-11,82,47,35,0.573,82,46,36,0.561
21701226,1610612740,1610612759,122.0,98.0,0.591,0.402,1,2018-04-11,82,48,34,0.585,82,47,35,0.573
21701227,1610612760,1610612763,137.0,123.0,0.5529999999999999,0.484,1,2018-04-11,82,48,34,0.585,82,22,60,0.268
21701228,1610612746,1610612747,100.0,115.0,0.494,0.477,0,2018-04-11,82,42,40,0.512,82,35,47,0.4270000000000001
21701229,1610612757,1610612762,102.0,93.0,0.461,0.371,1,2018-04-11,82,49,33,0.598,82,48,34,0.585
21701230,1610612758,1610612745,96.0,83.0,0.475,0.3779999999999999,1,2018-04-11,82,27,55,0.3289999999999999,82,65,17,0.7929999999999999
21701213,1610612754,1610612766,93.0,119.0,0.4039999999999999,0.465,0,2018-04-10,82,48,34,0.585,82,36,46,0.439
21701214,1610612737,1610612755,113.0,121.0,0.418,0.494,0,2018-04-10,82,24,58,0.293,81,51,30,0.63
21701215,1610612764,1610612738,113.0,101.0,0.494,0.379,1,2018-04-10,81,43,38,0.531,81,54,27,0.667
21701216,1610612742,1610612756,97.0,124.0,0.381,0.632,0,2018-04-10,82,24,58,0.293,82,21,61,0.256
21701217,1610612762,1610612744,119.0,79.0,0.5329999999999999,0.349,1,2018-04-10,81,48,33,0.593,82,58,24,0.7070000000000001
21701218,1610612747,1610612745,99.0,105.0,0.422,0.42,0,2018-04-10,81,34,47,0.42,81,65,16,0.802
21701204,1610612765,1610612761,98.0,108.0,0.449,0.529,0,2018-04-09,81,38,43,0.469,81,59,22,0.728
21701205,1610612751,1610612741,114.0,105.0,0.5,0.483,1,2018-04-09,81,28,53,0.346,81,27,54,0.3329999999999999
21701206,1610612748,1610612760,93.0,115.0,0.46,0.4320000000000001,0,2018-04-09,81,43,38,0.531,81,47,34,0.58
21701207,1610612752,1610612739,109.0,123.0,0.529,0.471,0,2018-04-09,81,28,53,0.346,81,50,31,0.617
21701208,1610612749,1610612753,102.0,86.0,0.429,0.415,1,2018-04-09,81,44,37,0.5429999999999999,81,24,57,0.296
21701209,1610612750,1610612763,113.0,94.0,0.483,0.412,1,2018-04-09,81,46,35,0.568,81,22,59,0.272
21701210,1610612759,1610612758,98.0,85.0,0.415,0.407,1,2018-04-09,81,47,34,0.58,81,26,55,0.321
21701211,1610612743,1610612757,88.0,82.0,0.373,0.33,1,2018-04-09,81,46,35,0.568,81,48,33,0.593
21701212,1610612746,1610612740,100.0,113.0,0.4589999999999999,0.4629999999999999,0,2018-04-09,81,42,39,0.519,81,47,34,0.58
21701197,1610612766,1610612754,117.0,123.0,0.5,0.5379999999999999,0,2018-04-08,81,35,46,0.4320000000000001,81,48,33,0.593
21701198,1610612755,1610612742,109.0,97.0,0.505,0.426,1,2018-04-08,80,50,30,0.625,81,24,57,0.296
21701202,1610612738,1610612737,106.0,112.0,0.512,0.5,0,2018-04-08,80,54,26,0.675,81,24,57,0.296
21701199,1610612763,1610612765,130.0,117.0,0.578,0.409,1,2018-04-08,80,22,58,0.275,80,38,42,0.475
21701200,1610612761,1610612753,112.0,101.0,0.5,0.472,1,2018-04-08,80,58,22,0.725,80,24,56,0.3
21701201,1610612747,1610612762,97.0,112.0,0.3979999999999999,0.506,0,2018-04-08,80,34,46,0.425,80,47,33,0.588
21701203,1610612756,1610612744,100.0,117.0,0.424,0.522,0,2018-04-08,81,20,61,0.247,81,58,23,0.716
21701191,1610612746,1610612743,115.0,134.0,0.494,0.624,0,2018-04-07,80,42,38,0.525,80,45,35,0.563
21701192,1610612752,1610612749,102.0,115.0,0.4320000000000001,0.484,0,2018-04-07,80,28,52,0.35,80,43,37,0.5379999999999999
21701193,1610612741,1610612751,96.0,124.0,0.409,0.5,0,2018-04-07,80,27,53,0.3379999999999999,80,27,53,0.3379999999999999
21701194,1610612745,1610612760,102.0,108.0,0.474,0.396,0,2018-04-07,80,64,16,0.8,80,46,34,0.575
21701195,1610612744,1610612740,120.0,126.0,0.544,0.563,0,2018-04-07,80,57,23,0.713,80,46,34,0.575
21701196,1610612759,1610612757,116.0,105.0,0.56,0.477,1,2018-04-07,80,46,34,0.575,80,48,32,0.6
21701181,1610612765,1610612742,113.0,106.0,0.5,0.435,1,2018-04-06,79,38,41,0.481,80,24,56,0.3
21701182,1610612753,1610612766,100.0,137.0,0.447,0.5579999999999999,0,2018-04-06,79,24,55,0.304,80,35,45,0.4379999999999999
21701183,1610612755,1610612739,132.0,130.0,0.495,0.517,1,2018-04-06,79,49,30,0.62,80,49,31,0.613
21701184,1610612764,1610612737,97.0,103.0,0.402,0.481,0,2018-04-06,80,42,38,0.525,80,23,57,0.288
21701185,1610612738,1610612741,111.0,104.0,0.556,0.465,1,2018-04-06,79,54,25,0.684,79,27,52,0.342
21701186,1610612752,1610612748,122.0,98.0,0.506,0.3979999999999999,1,2018-04-06,79,28,51,0.354,80,43,37,0.5379999999999999
21701187,1610612761,1610612754,92.0,73.0,0.429,0.299,1,2018-04-06,79,57,22,0.722,80,47,33,0.588
21701188,1610612763,1610612758,93.0,94.0,0.44,0.471,0,2018-04-06,79,21,58,0.266,80,26,54,0.325
21701189,1610612756,1610612740,103.0,122.0,0.3939999999999999,0.455,0,2018-04-06,80,20,60,0.25,79,45,34,0.57
21701190,1610612747,1610612750,96.0,113.0,0.392,0.43,0,2018-04-06,79,34,45,0.43,80,45,35,0.563
21701175,1610612754,1610612744,126.0,106.0,0.5379999999999999,0.446,1,2018-04-05,79,47,32,0.595,79,57,22,0.722
21701176,1610612739,1610612764,119.0,115.0,0.545,0.5,1,2018-04-05,79,49,30,0.62,79,42,37,0.532
21701177,1610612745,1610612757,96.0,94.0,0.466,0.4589999999999999,1,2018-04-05,79,64,15,0.81,79,48,31,0.608
21701178,1610612749,1610612751,111.0,119.0,0.441,0.547,0,2018-04-05,79,42,37,0.532,79,26,53,0.3289999999999999
21701179,1610612762,1610612746,117.0,95.0,0.53,0.4429999999999999,1,2018-04-05,79,46,33,0.5820000000000001,79,42,37,0.532
21701180,1610612743,1610612750,100.0,96.0,0.3929999999999999,0.429,1,2018-04-05,79,44,35,0.557,79,44,35,0.557
21701169,1610612765,1610612755,108.0,115.0,0.4429999999999999,0.494,0,2018-04-04,78,37,41,0.474,78,48,30,0.615
21701170,1610612753,1610612742,105.0,100.0,0.4529999999999999,0.4379999999999999,1,2018-04-04,78,24,54,0.308,79,24,55,0.304
21701172,1610612737,1610612748,86.0,115.0,0.3670000000000001,0.447,0,2018-04-04,79,22,57,0.278,79,43,36,0.544
21701171,1610612761,1610612738,96.0,78.0,0.435,0.3329999999999999,1,2018-04-04,78,56,22,0.718,78,53,25,0.679
21701173,1610612740,1610612763,123.0,95.0,0.523,0.3979999999999999,1,2018-04-04,78,44,34,0.564,78,21,57,0.2689999999999999
21701174,1610612747,1610612759,122.0,112.0,0.547,0.433,1,2018-04-04,78,34,44,0.436,79,45,34,0.57
21701156,1610612739,1610612761,112.0,106.0,0.494,0.447,1,2018-04-03,78,48,30,0.615,77,55,22,0.7140000000000001
21701157,1610612755,1610612751,121.0,95.0,0.5489999999999999,0.42,1,2018-04-03,77,47,30,0.61,78,25,53,0.321
21701158,1610612748,1610612737,101.0,98.0,0.451,0.42,1,2018-04-03,78,42,36,0.5379999999999999,78,22,56,0.282
21701159,1610612752,1610612753,73.0,97.0,0.349,0.42,0,2018-04-03,78,27,51,0.346,77,23,54,0.299
21701160,1610612741,1610612766,120.0,114.0,0.465,0.494,1,2018-04-03,78,27,51,0.346,79,34,45,0.43
21701161,1610612745,1610612764,120.0,104.0,0.512,0.528,1,2018-04-03,78,63,15,0.8079999999999999,78,42,36,0.5379999999999999
21701162,1610612749,1610612738,106.0,102.0,0.544,0.469,1,2018-04-03,78,42,36,0.5379999999999999,77,53,24,0.688
21701163,1610612760,1610612744,107.0,111.0,0.376,0.494,0,2018-04-03,79,45,34,0.57,78,57,21,0.731
21701164,1610612742,1610612757,115.0,109.0,0.457,0.4479999999999999,1,2018-04-03,78,24,54,0.308,78,48,30,0.615
21701165,1610612743,1610612754,107.0,104.0,0.461,0.488,1,2018-04-03,78,43,35,0.551,78,46,32,0.59
21701166,1610612762,1610612747,117.0,110.0,0.483,0.486,1,2018-04-03,78,45,33,0.5770000000000001,77,33,44,0.429
21701167,1610612756,1610612758,97.0,94.0,0.455,0.371,1,2018-04-03,79,20,59,0.253,79,25,54,0.316
21701168,1610612746,1610612759,113.0,110.0,0.451,0.4429999999999999,1,2018-04-03,78,42,36,0.5379999999999999,78,45,33,0.5770000000000001
21701143,1610612766,1610612755,102.0,119.0,0.402,0.511,0,2018-04-01,78,34,44,0.436,76,46,30,0.605
21701144,1610612741,1610612764,113.0,94.0,0.524,0.457,1,2018-04-01,77,26,51,0.3379999999999999,77,42,35,0.545
21701145,1610612759,1610612745,100.0,83.0,0.494,0.3379999999999999,1,2018-04-01,77,45,32,0.584,77,62,15,0.805
21701146,1610612746,1610612754,104.0,111.0,0.512,0.488,0,2018-04-01,77,41,36,0.532,77,46,31,0.597
21701147,1610612737,1610612753,94.0,88.0,0.482,0.344,1,2018-04-01,77,22,55,0.286,76,22,54,0.289
21701148,1610612751,1610612765,96.0,108.0,0.425,0.452,0,2018-04-01,77,25,52,0.325,77,37,40,0.481
21701149,1610612739,1610612742,98.0,87.0,0.412,0.405,1,2018-04-01,77,47,30,0.61,77,23,54,0.299
21701150,1610612740,1610612760,104.0,109.0,0.4579999999999999,0.4320000000000001,0,2018-04-01,77,43,34,0.5579999999999999,78,45,33,0.5770000000000001
21701151,1610612750,1610612762,97.0,121.0,0.422,0.605,0,2018-04-01,78,44,34,0.564,77,44,33,0.5710000000000001
21701152,1610612743,1610612749,128.0,125.0,0.444,0.45,1,2018-04-01,77,42,35,0.545,77,41,36,0.532
21701153,1610612744,1610612756,117.0,107.0,0.539,0.456,1,2018-04-01,77,56,21,0.727,78,19,59,0.244
21701154,1610612757,1610612763,113.0,98.0,0.4639999999999999,0.455,1,2018-04-01,77,48,29,0.623,77,21,56,0.273
21701155,1610612747,1610612758,83.0,84.0,0.4,0.38,0,2018-04-01,76,33,43,0.434,78,25,53,0.321
21701138,1610612764,1610612766,107.0,93.0,0.455,0.455,1,2018-03-31,76,42,34,0.5529999999999999,77,34,43,0.442
21701139,1610612752,1610612765,109.0,115.0,0.473,0.518,0,2018-03-31,77,27,50,0.351,76,36,40,0.474
21701140,1610612738,1610612761,110.0,99.0,0.455,0.4629999999999999,1,2018-03-31,76,53,23,0.6970000000000001,76,55,21,0.7240000000000001
21701141,1610612748,1610612751,109.0,110.0,0.4529999999999999,0.429,0,2018-03-31,77,41,36,0.532,76,25,51,0.3289999999999999
21701142,1610612758,1610612744,96.0,112.0,0.414,0.494,0,2018-03-31,77,24,53,0.312,76,55,21,0.7240000000000001
21701129,1610612753,1610612741,82.0,90.0,0.33,0.357,0,2018-03-30,75,22,53,0.293,76,25,51,0.3289999999999999
21701130,1610612737,1610612755,91.0,101.0,0.356,0.442,0,2018-03-30,76,21,55,0.276,75,45,30,0.6
21701131,1610612739,1610612740,107.0,102.0,0.478,0.483,1,2018-03-30,76,46,30,0.605,76,43,33,0.5660000000000001
21701132,1610612745,1610612756,104.0,103.0,0.4320000000000001,0.488,1,2018-03-30,76,62,14,0.816,77,19,58,0.247
21701133,1610612760,1610612743,125.0,126.0,0.417,0.521,0,2018-03-30,77,44,33,0.5710000000000001,76,41,35,0.539
21701134,1610612742,1610612750,92.0,93.0,0.442,0.422,0,2018-03-30,76,23,53,0.303,77,44,33,0.5710000000000001
21701135,1610612762,1610612763,107.0,97.0,0.541,0.481,1,2018-03-30,76,43,33,0.5660000000000001,76,21,55,0.276
21701136,1610612747,1610612749,122.0,124.0,0.511,0.479,0,2018-03-30,75,33,42,0.44,76,41,35,0.539
21701137,1610612757,1610612746,105.0,96.0,0.4320000000000001,0.4039999999999999,1,2018-03-30,76,47,29,0.618,76,41,35,0.539
21701124,1610612765,1610612764,103.0,92.0,0.488,0.416,1,2018-03-29,75,35,40,0.467,75,41,34,0.547
21701125,1610612748,1610612741,103.0,92.0,0.451,0.3670000000000001,1,2018-03-29,76,41,35,0.539,75,24,51,0.32
21701126,1610612759,1610612760,103.0,99.0,0.42,0.435,1,2018-03-29,76,44,32,0.579,76,44,32,0.579
21701127,1610612758,1610612754,103.0,106.0,0.5379999999999999,0.5,0,2018-03-29,76,24,52,0.316,76,45,31,0.5920000000000001
21701128,1610612744,1610612749,107.0,116.0,0.547,0.552,0,2018-03-29,75,54,21,0.72,75,40,35,0.5329999999999999
21701116,1610612766,1610612739,105.0,118.0,0.513,0.484,0,2018-03-28,76,34,42,0.447,75,45,30,0.6
21701117,1610612753,1610612751,104.0,111.0,0.435,0.46,0,2018-03-28,74,22,52,0.297,75,24,51,0.32
21701118,1610612755,1610612752,118.0,101.0,0.4589999999999999,0.3829999999999999,1,2018-03-28,74,44,30,0.595,76,27,49,0.355
21701119,1610612763,1610612757,108.0,103.0,0.488,0.481,1,2018-03-28,75,21,54,0.28,75,46,29,0.613
21701120,1610612750,1610612737,126.0,114.0,0.5329999999999999,0.532,1,2018-03-28,76,43,33,0.5660000000000001,75,21,54,0.28
21701121,1610612762,1610612738,94.0,97.0,0.415,0.4429999999999999,0,2018-03-28,75,42,33,0.56,75,52,23,0.693
21701122,1610612756,1610612746,99.0,111.0,0.4320000000000001,0.5379999999999999,0,2018-03-28,76,19,57,0.25,75,41,34,0.547
21701123,1610612747,1610612742,103.0,93.0,0.4679999999999999,0.3929999999999999,1,2018-03-28,74,33,41,0.446,75,23,52,0.307
21701108,1610612764,1610612759,116.0,106.0,0.541,0.4479999999999999,1,2018-03-27,74,41,33,0.5539999999999999,75,43,32,0.573
21701109,1610612761,1610612743,114.0,110.0,0.511,0.472,1,2018-03-27,75,55,20,0.733,75,40,35,0.5329999999999999
21701110,1610612748,1610612739,98.0,79.0,0.474,0.365,1,2018-03-27,75,40,35,0.5329999999999999,74,44,30,0.595
21701111,1610612745,1610612741,118.0,86.0,0.441,0.382,1,2018-03-27,75,61,14,0.813,74,24,50,0.324
21701112,1610612740,1610612757,103.0,107.0,0.457,0.419,0,2018-03-27,75,43,32,0.573,74,46,28,0.622
21701113,1610612758,1610612742,97.0,103.0,0.409,0.45,0,2018-03-27,75,24,51,0.32,74,23,51,0.311
21701114,1610612744,1610612754,81.0,92.0,0.407,0.481,0,2018-03-27,74,54,20,0.73,75,44,31,0.5870000000000001
21701115,1610612746,1610612749,105.0,98.0,0.465,0.4579999999999999,1,2018-03-27,74,40,34,0.541,74,39,35,0.527
21701103,1610612766,1610612752,137.0,128.0,0.5479999999999999,0.514,1,2018-03-26,75,34,41,0.4529999999999999,75,27,48,0.36
21701104,1610612765,1610612747,112.0,106.0,0.44,0.471,1,2018-03-26,74,34,40,0.4589999999999999,73,32,41,0.4379999999999999
21701105,1610612755,1610612743,123.0,104.0,0.505,0.429,1,2018-03-26,73,43,30,0.589,74,40,34,0.541
21701106,1610612750,1610612763,93.0,101.0,0.418,0.476,0,2018-03-26,75,42,33,0.56,74,20,54,0.27
21701107,1610612756,1610612738,94.0,102.0,0.444,0.425,0,2018-03-26,75,19,56,0.253,74,51,23,0.6890000000000001
21701094,1610612751,1610612739,114.0,121.0,0.4579999999999999,0.506,0,2018-03-25,74,23,51,0.311,73,44,29,0.603
21701095,1610612749,1610612759,106.0,103.0,0.488,0.446,1,2018-03-25,73,39,34,0.534,74,43,31,0.581
21701096,1610612754,1610612748,113.0,107.0,0.489,0.477,1,2018-03-25,74,43,31,0.581,74,39,35,0.527
21701097,1610612761,1610612746,106.0,117.0,0.446,0.4629999999999999,0,2018-03-25,74,54,20,0.73,73,39,34,0.534
21701098,1610612764,1610612752,97.0,101.0,0.425,0.466,0,2018-03-25,73,40,33,0.5479999999999999,74,27,47,0.365
21701099,1610612758,1610612738,93.0,104.0,0.4629999999999999,0.556,0,2018-03-25,74,24,50,0.324,73,50,23,0.685
21701100,1610612760,1610612757,105.0,108.0,0.44,0.467,0,2018-03-25,75,44,31,0.5870000000000001,73,45,28,0.616
21701101,1610612745,1610612737,118.0,99.0,0.489,0.4429999999999999,1,2018-03-25,74,60,14,0.8109999999999999,74,21,53,0.284
21701102,1610612744,1610612762,91.0,110.0,0.418,0.483,0,2018-03-25,73,54,19,0.74,74,42,32,0.568
21701088,1610612755,1610612750,120.0,108.0,0.477,0.385,1,2018-03-24,72,42,30,0.583,74,42,32,0.568
21701089,1610612765,1610612741,117.0,95.0,0.494,0.402,1,2018-03-24,73,33,40,0.452,73,24,49,0.3289999999999999
21701090,1610612753,1610612756,105.0,99.0,0.44,0.4039999999999999,1,2018-03-24,73,22,51,0.301,74,19,55,0.257
21701091,1610612745,1610612740,114.0,91.0,0.484,0.396,1,2018-03-24,73,59,14,0.8079999999999999,74,43,31,0.581
21701092,1610612763,1610612747,93.0,100.0,0.417,0.407,0,2018-03-24,73,19,54,0.26,72,32,40,0.444
21701093,1610612742,1610612766,98.0,102.0,0.396,0.38,0,2018-03-24,73,22,51,0.301,74,33,41,0.446
21701078,1610612754,1610612746,109.0,104.0,0.462,0.5529999999999999,1,2018-03-23,73,42,31,0.575,72,38,34,0.528
21701079,1610612764,1610612743,100.0,108.0,0.475,0.435,0,2018-03-23,72,40,32,0.556,73,40,33,0.5479999999999999
21701080,1610612739,1610612756,120.0,95.0,0.495,0.4370000000000001,1,2018-03-23,72,43,29,0.597,73,19,54,0.26
21701081,1610612752,1610612750,104.0,108.0,0.435,0.467,0,2018-03-23,73,26,47,0.356,73,42,31,0.575
21701082,1610612761,1610612751,116.0,112.0,0.477,0.488,1,2018-03-23,73,54,19,0.74,73,23,50,0.315
21701083,1610612741,1610612749,105.0,118.0,0.414,0.494,0,2018-03-23,72,24,48,0.3329999999999999,72,38,34,0.528
21701084,1610612760,1610612748,105.0,99.0,0.429,0.391,1,2018-03-23,74,44,30,0.595,73,39,34,0.534
21701085,1610612759,1610612762,124.0,120.0,0.511,0.489,1,2018-03-23,73,43,30,0.589,73,41,32,0.562
21701086,1610612757,1610612738,100.0,105.0,0.44,0.455,0,2018-03-23,72,44,28,0.611,72,49,23,0.6809999999999999
21701087,1610612744,1610612737,106.0,94.0,0.452,0.44,1,2018-03-23,72,54,18,0.75,73,21,52,0.288
21701072,1610612766,1610612763,140.0,79.0,0.5329999999999999,0.385,1,2018-03-22,73,32,41,0.4379999999999999,72,19,53,0.264
21701073,1610612753,1610612755,98.0,118.0,0.407,0.472,0,2018-03-22,72,21,51,0.292,71,41,30,0.5770000000000001
21701074,1610612745,1610612765,100.0,96.0,0.354,0.421,1,2018-03-22,72,58,14,0.8059999999999999,72,32,40,0.444
21701075,1610612740,1610612747,128.0,125.0,0.547,0.494,1,2018-03-22,73,43,30,0.589,71,31,40,0.4370000000000001
21701076,1610612742,1610612762,112.0,119.0,0.494,0.529,0,2018-03-22,72,22,50,0.306,72,41,31,0.569
21701077,1610612758,1610612737,105.0,90.0,0.462,0.3929999999999999,1,2018-03-22,73,24,49,0.3289999999999999,72,21,51,0.292
21701065,1610612739,1610612761,132.0,129.0,0.603,0.534,1,2018-03-21,71,42,29,0.5920000000000001,72,53,19,0.736
21701066,1610612755,1610612763,119.0,105.0,0.5479999999999999,0.4039999999999999,1,2018-03-21,70,40,30,0.5710000000000001,71,19,52,0.268
21701067,1610612751,1610612766,105.0,111.0,0.419,0.3829999999999999,0,2018-03-21,72,23,49,0.319,72,31,41,0.431
21701068,1610612748,1610612752,119.0,98.0,0.556,0.4379999999999999,1,2018-03-21,72,39,33,0.542,72,26,46,0.361
21700809,1610612740,1610612754,96.0,92.0,0.43,0.366,1,2018-03-21,72,42,30,0.583,72,41,31,0.569
21701069,1610612741,1610612743,102.0,135.0,0.4379999999999999,0.614,0,2018-03-21,71,24,47,0.3379999999999999,72,39,33,0.542
21701070,1610612749,1610612746,120.0,127.0,0.5489999999999999,0.523,0,2018-03-21,71,37,34,0.521,71,38,33,0.535
21701071,1610612759,1610612764,98.0,90.0,0.494,0.422,1,2018-03-21,72,42,30,0.583,71,40,31,0.563
21701058,1610612753,1610612761,86.0,93.0,0.411,0.455,0,2018-03-20,71,21,50,0.296,71,53,18,0.746
21701059,1610612738,1610612760,100.0,99.0,0.414,0.412,1,2018-03-20,71,48,23,0.6759999999999999,73,43,30,0.589
21701060,1610612750,1610612746,123.0,109.0,0.523,0.43,1,2018-03-20,72,41,31,0.569,70,37,33,0.529
21701061,1610612740,1610612742,115.0,105.0,0.527,0.478,1,2018-03-20,71,41,30,0.5770000000000001,71,22,49,0.31
21701062,1610612762,1610612737,94.0,99.0,0.371,0.4039999999999999,0,2018-03-20,71,40,31,0.563,71,21,50,0.296
21701063,1610612756,1610612765,88.0,115.0,0.3779999999999999,0.4429999999999999,0,2018-03-20,72,19,53,0.264,71,32,39,0.451
21701064,1610612757,1610612745,111.0,115.0,0.494,0.481,0,2018-03-20,71,44,27,0.62,71,57,14,0.8029999999999999
21701050,1610612739,1610612749,124.0,117.0,0.494,0.511,1,2018-03-19,70,41,29,0.586,70,37,33,0.529
21701051,1610612754,1610612747,110.0,100.0,0.494,0.442,1,2018-03-19,71,41,30,0.5770000000000001,70,31,39,0.4429999999999999
21701052,1610612755,1610612766,108.0,94.0,0.452,0.381,1,2018-03-19,69,39,30,0.565,71,30,41,0.423
21701053,1610612751,1610612763,118.0,115.0,0.5,0.523,1,2018-03-19,71,23,48,0.324,70,19,51,0.271
21701054,1610612748,1610612743,149.0,141.0,0.5489999999999999,0.46,1,2018-03-19,71,38,33,0.535,71,38,33,0.535
21701055,1610612752,1610612741,110.0,92.0,0.4479999999999999,0.359,1,2018-03-19,71,26,45,0.366,70,24,46,0.3429999999999999
21701056,1610612759,1610612744,89.0,75.0,0.402,0.405,1,2018-03-19,71,41,30,0.5770000000000001,71,53,18,0.746
21701057,1610612758,1610612765,90.0,106.0,0.455,0.4679999999999999,0,2018-03-19,72,23,49,0.319,70,31,39,0.4429999999999999
21701046,1610612761,1610612760,125.0,132.0,0.568,0.557,0,2018-03-18,70,52,18,0.743,72,43,29,0.597
21701047,1610612740,1610612738,108.0,89.0,0.5,0.402,1,2018-03-18,70,40,30,0.5710000000000001,70,47,23,0.6709999999999999
21701048,1610612750,1610612745,120.0,129.0,0.523,0.551,0,2018-03-18,71,40,31,0.563,70,56,14,0.8
21701049,1610612746,1610612757,109.0,122.0,0.449,0.5,0,2018-03-18,69,37,32,0.536,70,44,26,0.629
21701041,1610612749,1610612737,122.0,117.0,0.477,0.4589999999999999,1,2018-03-17,69,37,32,0.536,70,20,50,0.286
21701035,1610612764,1610612754,109.0,102.0,0.541,0.4529999999999999,1,2018-03-17,70,40,30,0.5710000000000001,70,40,30,0.5710000000000001
21701036,1610612740,1610612745,101.0,107.0,0.494,0.419,0,2018-03-17,69,39,30,0.565,69,55,14,0.797
21701037,1610612751,1610612742,114.0,106.0,0.512,0.446,1,2018-03-17,70,22,48,0.314,70,22,48,0.314
21701038,1610612752,1610612766,124.0,101.0,0.49,0.3670000000000001,1,2018-03-17,70,25,45,0.357,70,30,40,0.429
21701039,1610612741,1610612739,109.0,114.0,0.451,0.506,0,2018-03-17,69,24,45,0.348,69,40,29,0.58
21701040,1610612763,1610612743,101.0,94.0,0.407,0.368,1,2018-03-17,69,19,50,0.275,70,38,32,0.5429999999999999
21701042,1610612759,1610612750,117.0,101.0,0.51,0.481,1,2018-03-17,70,40,30,0.5710000000000001,70,40,30,0.5710000000000001
21701043,1610612762,1610612758,103.0,97.0,0.446,0.43,1,2018-03-17,70,40,30,0.5710000000000001,71,23,48,0.324
21701044,1610612756,1610612744,109.0,124.0,0.476,0.526,0,2018-03-17,71,19,52,0.268,70,53,17,0.757
21701045,1610612757,1610612765,100.0,87.0,0.4370000000000001,0.3879999999999999,1,2018-03-17,69,43,26,0.623,69,30,39,0.435
21701029,1610612753,1610612738,83.0,92.0,0.391,0.3779999999999999,0,2018-03-16,70,21,49,0.3,69,47,22,0.6809999999999999
21701030,1610612755,1610612751,120.0,116.0,0.4529999999999999,0.449,1,2018-03-16,68,38,30,0.5589999999999999,69,21,48,0.304
21701031,1610612761,1610612742,122.0,115.0,0.473,0.527,1,2018-03-16,69,52,17,0.754,69,22,47,0.319
21701032,1610612760,1610612746,121.0,113.0,0.489,0.488,1,2018-03-16,71,42,29,0.5920000000000001,68,37,31,0.544
21701033,1610612744,1610612758,93.0,98.0,0.42,0.434,0,2018-03-16,69,52,17,0.754,70,23,47,0.3289999999999999
21701034,1610612747,1610612748,91.0,92.0,0.421,0.3829999999999999,0,2018-03-16,69,31,38,0.449,70,37,33,0.529
21701020,1610612754,1610612761,99.0,106.0,0.43,0.4429999999999999,0,2018-03-15,69,40,29,0.58,68,51,17,0.75
21701021,1610612737,1610612766,117.0,129.0,0.467,0.529,0,2018-03-15,69,20,49,0.29,69,30,39,0.435
21701022,1610612752,1610612755,110.0,118.0,0.517,0.451,0,2018-03-15,69,24,45,0.348,67,37,30,0.552
21701023,1610612745,1610612746,101.0,96.0,0.389,0.4539999999999999,1,2018-03-15,68,54,14,0.794,67,37,30,0.552
21701024,1610612763,1610612741,110.0,111.0,0.4370000000000001,0.4379999999999999,0,2018-03-15,68,18,50,0.265,68,24,44,0.353
21701025,1610612759,1610612740,98.0,93.0,0.374,0.4,1,2018-03-15,69,39,30,0.565,68,39,29,0.574
21701026,1610612743,1610612765,120.0,113.0,0.506,0.478,1,2018-03-15,69,38,31,0.551,68,30,38,0.441
21701027,1610612762,1610612756,116.0,88.0,0.433,0.386,1,2018-03-15,69,39,30,0.565,70,19,51,0.271
21701028,1610612757,1610612739,113.0,105.0,0.4479999999999999,0.513,1,2018-03-15,68,42,26,0.618,68,39,29,0.574
21701016,1610612753,1610612749,126.0,117.0,0.506,0.5,1,2018-03-14,69,21,48,0.304,68,36,32,0.529
21701017,1610612738,1610612764,124.0,125.0,0.485,0.474,0,2018-03-14,68,46,22,0.6759999999999999,69,39,30,0.565
21701018,1610612758,1610612748,123.0,119.0,0.511,0.414,1,2018-03-14,69,22,47,0.319,69,36,33,0.522
21701019,1610612744,1610612747,117.0,106.0,0.5429999999999999,0.452,1,2018-03-14,68,52,16,0.765,68,31,37,0.456
21701005,1610612755,1610612754,98.0,101.0,0.467,0.4,0,2018-03-13,66,36,30,0.545,68,40,28,0.588
21701006,1610612764,1610612750,111.0,116.0,0.512,0.529,0,2018-03-13,68,38,30,0.5589999999999999,69,40,29,0.58
21701007,1610612737,1610612760,107.0,119.0,0.425,0.472,0,2018-03-13,68,20,48,0.294,70,41,29,0.586
21701008,1610612751,1610612761,102.0,116.0,0.407,0.484,0,2018-03-13,68,21,47,0.309,67,50,17,0.746
21701009,1610612752,1610612742,97.0,110.0,0.488,0.449,0,2018-03-13,68,24,44,0.353,68,22,46,0.324
21701010,1610612741,1610612746,106.0,112.0,0.426,0.487,0,2018-03-13,67,23,44,0.3429999999999999,66,37,29,0.561
21701011,1610612740,1610612766,119.0,115.0,0.5,0.484,1,2018-03-13,67,39,28,0.5820000000000001,68,29,39,0.426
21701012,1610612759,1610612753,108.0,72.0,0.476,0.341,1,2018-03-13,68,38,30,0.5589999999999999,68,20,48,0.294
21701013,1610612762,1610612765,110.0,79.0,0.5529999999999999,0.375,1,2018-03-13,68,38,30,0.5589999999999999,67,30,37,0.4479999999999999
21701014,1610612756,1610612739,107.0,129.0,0.3879999999999999,0.494,0,2018-03-13,69,19,50,0.275,67,39,28,0.5820000000000001
21701015,1610612747,1610612743,112.0,103.0,0.444,0.442,1,2018-03-13,67,31,36,0.4629999999999999,68,37,31,0.544
21701001,1610612745,1610612759,109.0,93.0,0.488,0.407,1,2018-03-12,67,53,14,0.7909999999999999,67,37,30,0.552
21701002,1610612763,1610612749,103.0,121.0,0.472,0.58,0,2018-03-12,67,18,49,0.2689999999999999,67,36,31,0.537
21701003,1610612760,1610612758,106.0,101.0,0.452,0.409,1,2018-03-12,69,40,29,0.58,68,21,47,0.309
21701004,1610612757,1610612748,115.0,99.0,0.4579999999999999,0.429,1,2018-03-12,67,41,26,0.612,68,36,32,0.529
21700992,1610612752,1610612761,106.0,132.0,0.455,0.505,0,2018-03-11,67,24,43,0.358,66,49,17,0.742
21700993,1610612737,1610612741,122.0,129.0,0.512,0.49,0,2018-03-11,67,20,47,0.299,66,23,43,0.348
21700994,1610612750,1610612744,109.0,103.0,0.4629999999999999,0.407,1,2018-03-11,68,39,29,0.574,67,51,16,0.7609999999999999
21700995,1610612740,1610612762,99.0,116.0,0.441,0.417,0,2018-03-11,66,38,28,0.5760000000000001,67,37,30,0.552
21700996,1610612743,1610612758,130.0,104.0,0.562,0.429,1,2018-03-11,67,37,30,0.552,67,21,46,0.313
21700997,1610612742,1610612745,82.0,105.0,0.351,0.4639999999999999,0,2018-03-11,67,21,46,0.313,66,52,14,0.7879999999999999
21700998,1610612738,1610612754,97.0,99.0,0.42,0.481,0,2018-03-11,67,46,21,0.687,67,39,28,0.5820000000000001
21700999,1610612751,1610612755,97.0,120.0,0.3879999999999999,0.526,0,2018-03-11,67,21,46,0.313,65,36,29,0.5539999999999999
21701000,1610612747,1610612739,127.0,113.0,0.5,0.466,1,2018-03-11,66,30,36,0.455,66,38,28,0.5760000000000001
21700987,1610612766,1610612756,122.0,115.0,0.506,0.506,1,2018-03-10,67,29,38,0.433,68,19,49,0.2789999999999999
21700988,1610612748,1610612764,129.0,102.0,0.591,0.442,1,2018-03-10,67,36,31,0.537,67,38,29,0.5670000000000001
21700989,1610612742,1610612763,114.0,80.0,0.481,0.357,1,2018-03-10,66,21,45,0.318,66,18,48,0.273
21700990,1610612760,1610612759,104.0,94.0,0.4589999999999999,0.465,1,2018-03-10,68,39,29,0.574,66,37,29,0.561
21700991,1610612746,1610612753,113.0,105.0,0.526,0.452,1,2018-03-10,65,36,29,0.5539999999999999,67,20,47,0.299
21700977,1610612765,1610612741,99.0,83.0,0.469,0.355,1,2018-03-09,66,30,36,0.455,65,22,43,0.3379999999999999
21700978,1610612754,1610612737,112.0,87.0,0.495,0.415,1,2018-03-09,66,38,28,0.5760000000000001,66,20,46,0.303
21700979,1610612761,1610612745,108.0,105.0,0.482,0.494,1,2018-03-09,65,48,17,0.738,65,51,14,0.785
21700980,1610612763,1610612762,78.0,95.0,0.373,0.446,0,2018-03-09,65,18,47,0.2769999999999999,66,36,30,0.545
21700981,1610612749,1610612752,120.0,112.0,0.562,0.48,1,2018-03-09,66,35,31,0.53,66,24,42,0.364
21700982,1610612740,1610612764,97.0,116.0,0.4629999999999999,0.479,0,2018-03-09,65,38,27,0.585,66,38,28,0.5760000000000001
21700983,1610612743,1610612747,125.0,116.0,0.506,0.489,1,2018-03-09,66,36,30,0.545,65,29,36,0.446
21700984,1610612757,1610612744,125.0,108.0,0.494,0.487,1,2018-03-09,66,40,26,0.606,66,51,15,0.773
21700985,1610612758,1610612753,94.0,88.0,0.434,0.423,1,2018-03-09,66,21,45,0.318,66,20,46,0.303
21700986,1610612746,1610612739,116.0,102.0,0.483,0.4479999999999999,1,2018-03-09,64,35,29,0.547,65,38,27,0.585
21700972,1610612766,1610612751,111.0,125.0,0.482,0.511,0,2018-03-08,66,28,38,0.424,66,21,45,0.318
21700973,1610612748,1610612755,108.0,99.0,0.472,0.395,1,2018-03-08,66,35,31,0.53,64,35,29,0.547
21700974,1610612750,1610612738,109.0,117.0,0.4679999999999999,0.494,0,2018-03-08,67,38,29,0.5670000000000001,66,46,20,0.6970000000000001
21700975,1610612760,1610612756,115.0,87.0,0.525,0.337,1,2018-03-08,67,38,29,0.5670000000000001,67,19,48,0.284
21700976,1610612744,1610612759,110.0,107.0,0.4320000000000001,0.4529999999999999,1,2018-03-08,65,51,14,0.785,65,37,28,0.569
21700965,1610612754,1610612762,84.0,104.0,0.386,0.513,0,2018-03-07,65,37,28,0.569,65,35,30,0.5379999999999999
21700966,1610612765,1610612761,119.0,121.0,0.489,0.446,0,2018-03-07,65,29,36,0.446,64,47,17,0.7340000000000001
21700967,1610612741,1610612763,119.0,110.0,0.532,0.488,1,2018-03-07,64,22,42,0.344,64,18,46,0.281
21700968,1610612749,1610612745,99.0,110.0,0.4579999999999999,0.476,0,2018-03-07,65,34,31,0.523,64,51,13,0.797
21700969,1610612758,1610612740,101.0,114.0,0.419,0.5660000000000001,0,2018-03-07,65,20,45,0.308,64,38,26,0.594
21700970,1610612743,1610612739,108.0,113.0,0.488,0.506,0,2018-03-07,65,35,30,0.5379999999999999,64,38,26,0.594
21700971,1610612747,1610612753,108.0,107.0,0.489,0.5,1,2018-03-07,64,29,35,0.4529999999999999,65,20,45,0.308
21700957,1610612766,1610612755,114.0,128.0,0.5,0.575,0,2018-03-06,65,28,37,0.431,63,35,28,0.556
21700958,1610612761,1610612737,106.0,90.0,0.386,0.425,1,2018-03-06,63,46,17,0.73,65,20,45,0.308
21700959,1610612764,1610612748,117.0,113.0,0.5,0.447,1,2018-03-06,65,37,28,0.569,65,34,31,0.523
21700960,1610612760,1610612745,112.0,122.0,0.495,0.528,0,2018-03-06,66,37,29,0.561,63,50,13,0.794
21700961,1610612742,1610612743,118.0,107.0,0.478,0.413,1,2018-03-06,65,20,45,0.308,64,35,29,0.547
21700962,1610612757,1610612752,111.0,87.0,0.4320000000000001,0.422,1,2018-03-06,65,39,26,0.6,65,24,41,0.369
21700963,1610612744,1610612751,114.0,101.0,0.5660000000000001,0.424,1,2018-03-06,64,50,14,0.7809999999999999,65,20,45,0.308
21700964,1610612746,1610612740,116.0,121.0,0.465,0.447,0,2018-03-06,63,34,29,0.54,63,37,26,0.5870000000000001
21700950,1610612739,1610612765,112.0,90.0,0.489,0.391,1,2018-03-05,63,37,26,0.5870000000000001,64,29,35,0.4529999999999999
21700951,1610612754,1610612749,92.0,89.0,0.429,0.447,1,2018-03-05,64,37,27,0.578,64,34,30,0.531
21700952,1610612748,1610612756,125.0,103.0,0.511,0.483,1,2018-03-05,64,34,30,0.531,66,19,47,0.288
21700953,1610612741,1610612738,89.0,105.0,0.395,0.488,0,2018-03-05,63,21,42,0.3329999999999999,65,45,20,0.6920000000000001
21700954,1610612759,1610612763,100.0,98.0,0.461,0.525,1,2018-03-05,64,37,27,0.578,63,18,45,0.286
21700955,1610612762,1610612753,94.0,80.0,0.493,0.341,1,2018-03-05,64,34,30,0.531,64,20,44,0.313
21700956,1610612747,1610612757,103.0,108.0,0.391,0.422,0,2018-03-05,63,28,35,0.444,64,38,26,0.594
21700943,1610612737,1610612756,113.0,112.0,0.457,0.5,1,2018-03-04,64,20,44,0.313,65,19,46,0.292
21700944,1610612761,1610612766,103.0,98.0,0.422,0.376,1,2018-03-04,62,45,17,0.726,64,28,36,0.4379999999999999
21700945,1610612764,1610612754,95.0,98.0,0.422,0.442,0,2018-03-04,64,36,28,0.563,63,36,27,0.5710000000000001
21700946,1610612742,1610612740,109.0,126.0,0.444,0.5379999999999999,0,2018-03-04,64,19,45,0.297,62,36,26,0.581
21700947,1610612749,1610612755,118.0,110.0,0.495,0.557,1,2018-03-04,63,34,29,0.54,62,34,28,0.5479999999999999
21700948,1610612746,1610612751,123.0,120.0,0.524,0.435,1,2018-03-04,62,34,28,0.5479999999999999,64,20,44,0.313
21700949,1610612758,1610612752,102.0,99.0,0.4529999999999999,0.455,1,2018-03-04,64,20,44,0.313,64,24,40,0.375
21700936,1610612753,1610612763,107.0,100.0,0.5,0.409,1,2018-03-03,63,20,43,0.317,62,18,44,0.29
21700937,1610612739,1610612743,117.0,126.0,0.523,0.547,0,2018-03-03,62,36,26,0.581,63,35,28,0.556
21700938,1610612748,1610612765,105.0,96.0,0.451,0.416,1,2018-03-03,63,33,30,0.524,63,29,34,0.46
21700939,1610612745,1610612738,123.0,120.0,0.4479999999999999,0.484,1,2018-03-03,62,49,13,0.79,64,44,20,0.688
21700940,1610612759,1610612747,112.0,116.0,0.449,0.435,0,2018-03-03,63,36,27,0.5710000000000001,62,28,34,0.452
21700941,1610612757,1610612760,108.0,100.0,0.4429999999999999,0.44,1,2018-03-03,63,37,26,0.5870000000000001,65,37,28,0.569
21700942,1610612758,1610612762,91.0,98.0,0.382,0.415,0,2018-03-03,63,19,44,0.302,63,33,30,0.524
21700926,1610612753,1610612765,115.0,106.0,0.512,0.435,1,2018-03-02,62,19,43,0.306,62,29,33,0.4679999999999999
21700927,1610612755,1610612766,110.0,99.0,0.506,0.42,1,2018-03-02,61,34,27,0.557,63,28,35,0.444
21700928,1610612737,1610612744,109.0,114.0,0.442,0.532,0,2018-03-02,63,19,44,0.302,63,49,14,0.778
21700929,1610612764,1610612761,95.0,102.0,0.456,0.462,0,2018-03-02,63,36,27,0.5710000000000001,61,44,17,0.721
21700930,1610612741,1610612742,108.0,100.0,0.472,0.417,1,2018-03-02,62,21,41,0.3389999999999999,63,19,44,0.302
21700931,1610612763,1610612743,102.0,108.0,0.44,0.5479999999999999,0,2018-03-02,61,18,43,0.295,62,34,28,0.5479999999999999
21700932,1610612749,1610612754,96.0,103.0,0.3829999999999999,0.446,0,2018-03-02,62,33,29,0.532,62,35,27,0.565
21700933,1610612756,1610612760,116.0,124.0,0.479,0.479,0,2018-03-02,64,19,45,0.297,64,37,27,0.578
21700934,1610612762,1610612750,116.0,108.0,0.513,0.514,1,2018-03-02,62,32,30,0.516,66,38,28,0.5760000000000001
21700935,1610612746,1610612752,128.0,105.0,0.562,0.461,1,2018-03-02,61,33,28,0.541,63,24,39,0.381
21700922,1610612748,1610612747,113.0,131.0,0.484,0.595,0,2018-03-01,62,32,30,0.516,61,27,34,0.4429999999999999
21700923,1610612739,1610612755,97.0,108.0,0.414,0.444,0,2018-03-01,61,36,25,0.59,60,33,27,0.55
21700924,1610612758,1610612751,116.0,111.0,0.515,0.417,1,2018-03-01,62,19,43,0.306,63,20,43,0.317
21700925,1610612757,1610612750,108.0,99.0,0.391,0.447,1,2018-03-01,62,36,26,0.581,65,38,27,0.585
21700913,1610612765,1610612749,110.0,87.0,0.442,0.384,1,2018-02-28,61,29,32,0.475,61,33,28,0.541
21700914,1610612753,1610612761,104.0,117.0,0.476,0.542,0,2018-02-28,61,18,43,0.295,60,43,17,0.7170000000000001
21700915,1610612737,1610612754,107.0,102.0,0.4370000000000001,0.422,1,2018-02-28,62,19,43,0.306,61,34,27,0.557
21700916,1610612738,1610612766,134.0,106.0,0.621,0.462,1,2018-02-28,63,44,19,0.698,62,28,34,0.452
21700917,1610612764,1610612744,101.0,109.0,0.4,0.514,0,2018-02-28,62,36,26,0.581,62,48,14,0.774
21700918,1610612763,1610612756,102.0,110.0,0.379,0.4579999999999999,0,2018-02-28,60,18,42,0.3,63,19,44,0.302
21700919,1610612742,1610612760,110.0,111.0,0.484,0.452,0,2018-02-28,62,19,43,0.306,63,36,27,0.5710000000000001
21700920,1610612759,1610612740,116.0,121.0,0.485,0.505,0,2018-02-28,62,36,26,0.581,61,35,26,0.574
21700921,1610612746,1610612745,92.0,105.0,0.456,0.424,0,2018-02-28,60,32,28,0.5329999999999999,61,48,13,0.787
21700907,1610612766,1610612741,118.0,103.0,0.537,0.481,1,2018-02-27,61,28,33,0.4589999999999999,61,20,41,0.3279999999999999
21700908,1610612739,1610612751,129.0,123.0,0.515,0.537,1,2018-02-27,60,36,24,0.6,62,20,42,0.3229999999999999
21700909,1610612748,1610612755,102.0,101.0,0.439,0.417,1,2018-02-27,61,32,29,0.525,59,32,27,0.542
21700910,1610612749,1610612764,104.0,107.0,0.455,0.477,0,2018-02-27,60,33,27,0.55,61,36,25,0.59
21700911,1610612757,1610612758,116.0,99.0,0.524,0.4429999999999999,1,2018-02-27,61,35,26,0.574,61,18,43,0.295
21700912,1610612743,1610612746,120.0,122.0,0.494,0.517,0,2018-02-27,61,33,28,0.541,59,32,27,0.542
21700897,1610612737,1610612747,104.0,123.0,0.375,0.522,0,2018-02-26,61,18,43,0.295,60,26,34,0.433
21700898,1610612738,1610612763,109.0,98.0,0.4529999999999999,0.436,1,2018-02-26,62,43,19,0.6940000000000001,59,18,41,0.305
21700899,1610612751,1610612741,104.0,87.0,0.444,0.355,1,2018-02-26,61,20,41,0.3279999999999999,60,20,40,0.3329999999999999
21700900,1610612752,1610612744,111.0,125.0,0.49,0.518,0,2018-02-26,62,24,38,0.387,61,47,14,0.77
21700901,1610612761,1610612765,123.0,94.0,0.525,0.3829999999999999,1,2018-02-26,59,42,17,0.7120000000000001,60,28,32,0.467
21700902,1610612740,1610612756,125.0,116.0,0.473,0.433,1,2018-02-26,60,34,26,0.5670000000000001,62,18,44,0.29
21700903,1610612760,1610612753,112.0,105.0,0.477,0.4639999999999999,1,2018-02-26,62,35,27,0.565,60,18,42,0.3
21700904,1610612742,1610612754,109.0,103.0,0.455,0.471,1,2018-02-26,61,19,42,0.311,60,34,26,0.5670000000000001
21700905,1610612762,1610612745,85.0,96.0,0.4370000000000001,0.43,0,2018-02-26,61,31,30,0.508,60,47,13,0.7829999999999999
21700906,1610612758,1610612750,100.0,118.0,0.476,0.513,0,2018-02-26,60,18,42,0.3,64,38,26,0.594
21700892,1610612766,1610612765,114.0,98.0,0.477,0.494,1,2018-02-25,60,27,33,0.45,59,28,31,0.475
21700893,1610612749,1610612740,121.0,123.0,0.4579999999999999,0.477,0,2018-02-25,59,33,26,0.5589999999999999,59,33,26,0.5589999999999999
21700894,1610612739,1610612759,94.0,110.0,0.418,0.442,0,2018-02-25,59,35,24,0.593,61,36,25,0.59
21700895,1610612764,1610612755,109.0,94.0,0.544,0.36,1,2018-02-25,60,35,25,0.583,58,32,26,0.552
21700896,1610612743,1610612745,114.0,119.0,0.484,0.506,0,2018-02-25,60,33,27,0.55,59,46,13,0.78
21700884,1610612755,1610612753,116.0,105.0,0.519,0.447,1,2018-02-24,57,32,25,0.561,59,18,41,0.305
21700885,1610612748,1610612763,115.0,89.0,0.461,0.4379999999999999,1,2018-02-24,60,31,29,0.517,58,18,40,0.31
21700886,1610612752,1610612738,112.0,121.0,0.469,0.452,0,2018-02-24,61,24,37,0.3929999999999999,61,42,19,0.6890000000000001
21700887,1610612744,1610612760,112.0,80.0,0.472,0.33,1,2018-02-24,60,46,14,0.767,61,34,27,0.557
21700888,1610612750,1610612741,122.0,104.0,0.489,0.467,1,2018-02-24,63,37,26,0.5870000000000001,59,20,39,0.3389999999999999
21700889,1610612756,1610612757,104.0,106.0,0.4479999999999999,0.3939999999999999,0,2018-02-24,61,18,43,0.295,60,34,26,0.5670000000000001
21700890,1610612762,1610612742,97.0,90.0,0.4,0.41,1,2018-02-24,60,31,29,0.517,60,18,42,0.3
21700891,1610612758,1610612747,108.0,113.0,0.447,0.451,0,2018-02-24,59,18,41,0.305,59,25,34,0.424
21700873,1610612765,1610612738,98.0,110.0,0.435,0.482,0,2018-02-23,58,28,30,0.483,60,41,19,0.6829999999999999
21700874,1610612754,1610612737,116.0,93.0,0.475,0.451,1,2018-02-23,59,34,25,0.5760000000000001,60,18,42,0.3
21700875,1610612764,1610612766,105.0,122.0,0.494,0.489,0,2018-02-23,59,34,25,0.5760000000000001,59,26,33,0.441
21700876,1610612761,1610612749,119.0,122.0,0.478,0.478,0,2018-02-23,58,41,17,0.7070000000000001,58,33,25,0.569
21700877,1610612745,1610612750,120.0,102.0,0.482,0.426,1,2018-02-23,58,45,13,0.7759999999999999,62,36,26,0.581
21700878,1610612763,1610612739,89.0,112.0,0.3929999999999999,0.46,0,2018-02-23,57,18,39,0.316,58,35,23,0.603
21700879,1610612740,1610612748,124.0,123.0,0.444,0.4629999999999999,1,2018-02-23,58,32,26,0.552,59,30,29,0.508
21700880,1610612743,1610612759,122.0,119.0,0.495,0.506,1,2018-02-23,59,33,26,0.5589999999999999,60,35,25,0.583
21700881,1610612756,1610612746,117.0,128.0,0.4370000000000001,0.517,0,2018-02-23,60,18,42,0.3,58,31,27,0.534
21700882,1610612762,1610612757,81.0,100.0,0.423,0.4479999999999999,0,2018-02-23,59,30,29,0.508,59,33,26,0.5589999999999999
21700883,1610612747,1610612742,124.0,102.0,0.516,0.407,1,2018-02-23,58,24,34,0.414,59,18,41,0.305
21700867,1610612766,1610612751,111.0,96.0,0.483,0.387,1,2018-02-22,58,25,33,0.431,60,19,41,0.317
21700868,1610612753,1610612752,113.0,120.0,0.518,0.485,0,2018-02-22,58,18,40,0.31,60,24,36,0.4
21700869,1610612739,1610612764,103.0,110.0,0.5,0.478,0,2018-02-22,57,34,23,0.596,58,34,24,0.586
21700870,1610612741,1610612755,115.0,116.0,0.4539999999999999,0.512,0,2018-02-22,58,20,38,0.345,56,31,25,0.5539999999999999
21700871,1610612758,1610612760,107.0,110.0,0.462,0.442,0,2018-02-22,58,18,40,0.31,60,34,26,0.5670000000000001
21700872,1610612744,1610612746,134.0,127.0,0.618,0.5,1,2018-02-22,59,45,14,0.763,57,30,27,0.526
21700865,1610612749,1610612743,123.0,134.0,0.5329999999999999,0.5529999999999999,0,2018-02-15,57,32,25,0.561,58,32,26,0.552
21700866,1610612750,1610612747,119.0,111.0,0.467,0.457,1,2018-02-15,61,36,25,0.59,57,23,34,0.4039999999999999
21700853,1610612765,1610612737,104.0,98.0,0.422,0.4270000000000001,1,2018-02-14,57,28,29,0.491,59,18,41,0.305
21700854,1610612753,1610612766,102.0,104.0,0.419,0.4320000000000001,0,2018-02-14,57,18,39,0.316,57,24,33,0.421
21700855,1610612755,1610612748,104.0,102.0,0.424,0.455,1,2018-02-14,55,30,25,0.545,58,30,28,0.517
21700856,1610612751,1610612754,103.0,108.0,0.422,0.433,0,2018-02-14,59,19,40,0.322,58,33,25,0.569
21700857,1610612752,1610612764,113.0,118.0,0.4639999999999999,0.545,0,2018-02-14,59,23,36,0.39,57,33,24,0.579
21700858,1610612738,1610612746,119.0,129.0,0.433,0.5,0,2018-02-14,59,40,19,0.6779999999999999,56,30,26,0.536
21700859,1610612741,1610612761,98.0,122.0,0.429,0.522,0,2018-02-14,57,20,37,0.351,57,41,16,0.7190000000000001
21700860,1610612745,1610612758,100.0,91.0,0.3979999999999999,0.4370000000000001,1,2018-02-14,57,44,13,0.772,57,18,39,0.316
21700861,1610612763,1610612760,114.0,121.0,0.512,0.494,0,2018-02-14,56,18,38,0.321,59,33,26,0.5589999999999999
21700862,1610612740,1610612747,139.0,117.0,0.535,0.511,1,2018-02-14,57,31,26,0.544,56,23,33,0.411
21700863,1610612762,1610612756,107.0,97.0,0.424,0.43,1,2018-02-14,58,30,28,0.517,59,18,41,0.305
21700864,1610612757,1610612744,123.0,117.0,0.484,0.478,1,2018-02-14,58,32,26,0.552,58,44,14,0.759
21700847,1610612761,1610612748,115.0,112.0,0.467,0.488,1,2018-02-13,56,40,16,0.7140000000000001,57,30,27,0.526
21700848,1610612749,1610612737,97.0,92.0,0.4320000000000001,0.384,1,2018-02-13,56,32,24,0.5710000000000001,58,18,40,0.31
21700849,1610612750,1610612745,108.0,126.0,0.476,0.494,0,2018-02-13,60,35,25,0.583,56,43,13,0.768
21700850,1610612760,1610612739,112.0,120.0,0.444,0.511,0,2018-02-13,58,32,26,0.552,56,34,22,0.607
21700851,1610612742,1610612758,109.0,114.0,0.4579999999999999,0.54,0,2018-02-13,58,18,40,0.31,56,18,38,0.321
21700852,1610612743,1610612759,117.0,109.0,0.495,0.537,1,2018-02-13,57,31,26,0.544,59,35,24,0.593
21700841,1610612765,1610612740,103.0,118.0,0.368,0.44,0,2018-02-12,56,27,29,0.482,56,30,26,0.536
21700842,1610612755,1610612752,108.0,92.0,0.547,0.392,1,2018-02-12,54,29,25,0.537,58,23,35,0.397
21700843,1610612751,1610612746,101.0,114.0,0.461,0.565,0,2018-02-12,58,19,39,0.3279999999999999,55,29,26,0.527
21700844,1610612741,1610612753,105.0,101.0,0.455,0.44,1,2018-02-12,56,20,36,0.357,56,18,38,0.321
21700845,1610612762,1610612759,101.0,99.0,0.417,0.447,1,2018-02-12,57,29,28,0.509,58,35,23,0.603
21700846,1610612744,1610612756,129.0,83.0,0.584,0.347,1,2018-02-12,57,44,13,0.772,58,18,40,0.31
21700833,1610612766,1610612761,103.0,123.0,0.4270000000000001,0.563,0,2018-02-11,56,23,33,0.411,55,39,16,0.7090000000000001
21700834,1610612737,1610612765,118.0,115.0,0.487,0.4579999999999999,1,2018-02-11,57,18,39,0.316,55,27,28,0.491
21700835,1610612738,1610612739,99.0,121.0,0.4039999999999999,0.536,0,2018-02-11,58,40,18,0.69,55,33,22,0.6
21700836,1610612754,1610612752,121.0,113.0,0.5,0.441,1,2018-02-11,57,32,25,0.561,57,23,34,0.4039999999999999
21700837,1610612745,1610612742,104.0,97.0,0.436,0.409,1,2018-02-11,55,42,13,0.764,57,18,39,0.316
21700838,1610612750,1610612758,111.0,106.0,0.5,0.477,1,2018-02-11,59,35,24,0.593,55,17,38,0.309
21700839,1610612760,1610612763,110.0,92.0,0.442,0.39,1,2018-02-11,57,32,25,0.561,55,18,37,0.327
21700840,1610612757,1610612762,96.0,115.0,0.407,0.466,0,2018-02-11,57,31,26,0.544,56,28,28,0.5
21700826,1610612751,1610612740,128.0,138.0,0.377,0.491,0,2018-02-10,57,19,38,0.3329999999999999,55,29,26,0.527
21700827,1610612753,1610612749,104.0,111.0,0.446,0.524,0,2018-02-10,55,18,37,0.327,55,31,24,0.564
21700828,1610612755,1610612746,112.0,98.0,0.478,0.4320000000000001,1,2018-02-10,53,28,25,0.528,54,28,26,0.519
21700829,1610612741,1610612764,90.0,101.0,0.425,0.4629999999999999,0,2018-02-10,55,19,36,0.345,56,32,24,0.5710000000000001
21700830,1610612742,1610612747,130.0,123.0,0.539,0.5479999999999999,1,2018-02-10,56,18,38,0.321,55,23,32,0.418
21700831,1610612744,1610612759,122.0,105.0,0.565,0.457,1,2018-02-10,56,43,13,0.768,57,35,22,0.614
21700832,1610612756,1610612743,113.0,123.0,0.5479999999999999,0.511,0,2018-02-10,57,18,39,0.316,56,30,26,0.536
21700817,1610612765,1610612746,95.0,108.0,0.409,0.462,0,2018-02-09,54,27,27,0.5,53,28,25,0.528
21700818,1610612755,1610612740,100.0,82.0,0.419,0.347,1,2018-02-09,52,27,25,0.519,54,28,26,0.519
21700819,1610612737,1610612739,107.0,123.0,0.446,0.535,0,2018-02-09,56,17,39,0.304,54,32,22,0.593
21700820,1610612738,1610612754,91.0,97.0,0.382,0.446,0,2018-02-09,57,40,17,0.7020000000000001,56,31,25,0.5539999999999999
21700821,1610612748,1610612749,91.0,85.0,0.364,0.421,1,2018-02-09,56,30,26,0.536,54,30,24,0.556
21700823,1610612745,1610612743,130.0,104.0,0.5,0.477,1,2018-02-09,54,41,13,0.759,55,29,26,0.527
21700824,1610612762,1610612766,106.0,94.0,0.488,0.412,1,2018-02-09,55,27,28,0.491,55,23,32,0.418
21700822,1610612741,1610612750,114.0,113.0,0.494,0.471,1,2018-02-09,54,19,35,0.352,58,34,24,0.586
21700825,1610612758,1610612757,100.0,118.0,0.422,0.489,0,2018-02-09,54,17,37,0.315,56,31,25,0.5539999999999999
21700811,1610612753,1610612737,100.0,98.0,0.429,0.425,1,2018-02-08,54,18,36,0.3329999999999999,55,17,38,0.309
21700812,1610612761,1610612752,113.0,88.0,0.4529999999999999,0.3979999999999999,1,2018-02-08,54,38,16,0.7040000000000001,56,23,33,0.411
21700813,1610612764,1610612738,104.0,110.0,0.4,0.4639999999999999,0,2018-02-08,55,31,24,0.564,56,40,16,0.7140000000000001
21700814,1610612757,1610612766,109.0,103.0,0.456,0.3879999999999999,1,2018-02-08,55,30,25,0.545,54,23,31,0.426
21700815,1610612744,1610612742,121.0,103.0,0.511,0.435,1,2018-02-08,55,42,13,0.764,55,17,38,0.309
21700816,1610612747,1610612760,106.0,81.0,0.4379999999999999,0.356,1,2018-02-08,54,23,31,0.426,56,31,25,0.5539999999999999
21700805,1610612765,1610612751,115.0,106.0,0.478,0.433,1,2018-02-07,53,27,26,0.509,56,19,37,0.3389999999999999
21700806,1610612748,1610612745,101.0,109.0,0.4429999999999999,0.514,0,2018-02-07,55,29,26,0.527,53,40,13,0.755
21700807,1610612739,1610612750,140.0,138.0,0.591,0.581,1,2018-02-07,53,31,22,0.585,57,34,23,0.596
21700808,1610612763,1610612762,88.0,92.0,0.42,0.42,0,2018-02-07,54,18,36,0.3329999999999999,54,26,28,0.481
21700810,1610612756,1610612759,81.0,129.0,0.34,0.495,0,2018-02-07,56,18,38,0.321,56,35,21,0.625
21700797,1610612753,1610612739,116.0,98.0,0.523,0.429,1,2018-02-06,53,17,36,0.321,52,30,22,0.5770000000000001
21700798,1610612761,1610612738,111.0,91.0,0.5,0.3979999999999999,1,2018-02-06,53,37,16,0.698,55,39,16,0.7090000000000001
21700799,1610612737,1610612763,108.0,82.0,0.506,0.43,1,2018-02-06,54,17,37,0.315,53,18,35,0.34
21700800,1610612751,1610612745,113.0,123.0,0.482,0.556,0,2018-02-06,55,19,36,0.345,52,39,13,0.75
21700801,1610612752,1610612749,89.0,103.0,0.416,0.451,0,2018-02-06,55,23,32,0.418,53,30,23,0.5660000000000001
21700802,1610612755,1610612764,115.0,102.0,0.5489999999999999,0.441,1,2018-02-06,51,26,25,0.51,54,31,23,0.574
21700803,1610612744,1610612760,105.0,125.0,0.487,0.473,0,2018-02-06,54,41,13,0.759,55,31,24,0.564
21700804,1610612747,1610612756,112.0,93.0,0.47,0.3829999999999999,1,2018-02-06,53,22,31,0.415,55,18,37,0.327
21700790,1610612765,1610612757,111.0,91.0,0.5,0.3939999999999999,1,2018-02-05,52,26,26,0.5,54,29,25,0.537
21700791,1610612754,1610612764,102.0,111.0,0.4629999999999999,0.5489999999999999,0,2018-02-05,55,30,25,0.545,53,31,22,0.585
21700792,1610612748,1610612753,109.0,111.0,0.43,0.488,0,2018-02-05,54,29,25,0.537,52,16,36,0.308
21700793,1610612740,1610612762,109.0,133.0,0.505,0.584,0,2018-02-05,53,28,25,0.528,53,25,28,0.472
21700794,1610612743,1610612766,121.0,104.0,0.568,0.506,1,2018-02-05,54,29,25,0.537,53,23,30,0.434
21700795,1610612758,1610612741,104.0,98.0,0.44,0.4,1,2018-02-05,53,17,36,0.321,53,18,35,0.34
21700796,1610612746,1610612742,104.0,101.0,0.483,0.413,1,2018-02-05,52,27,25,0.519,54,17,37,0.315
21700784,1610612738,1610612757,97.0,96.0,0.412,0.396,1,2018-02-04,54,39,15,0.722,53,29,24,0.547
21700785,1610612751,1610612749,94.0,109.0,0.411,0.519,0,2018-02-04,54,19,35,0.352,52,29,23,0.5579999999999999
21700786,1610612752,1610612737,96.0,99.0,0.436,0.402,0,2018-02-04,54,23,31,0.426,53,16,37,0.302
21700787,1610612761,1610612763,101.0,86.0,0.461,0.358,1,2018-02-04,52,36,16,0.6920000000000001,52,18,34,0.346
21700788,1610612760,1610612747,104.0,108.0,0.449,0.488,0,2018-02-04,54,30,24,0.556,52,21,31,0.4039999999999999
21700789,1610612756,1610612766,110.0,115.0,0.532,0.417,0,2018-02-04,54,18,36,0.3329999999999999,52,23,29,0.442
21700775,1610612746,1610612741,113.0,103.0,0.455,0.361,1,2018-02-03,51,26,25,0.51,52,18,34,0.346
21700776,1610612765,1610612748,111.0,107.0,0.524,0.484,1,2018-02-03,51,25,26,0.49,53,29,24,0.547
21700777,1610612754,1610612755,100.0,92.0,0.4429999999999999,0.379,1,2018-02-03,54,30,24,0.556,50,25,25,0.5
21700778,1610612753,1610612764,98.0,115.0,0.442,0.541,0,2018-02-03,51,15,36,0.294,52,30,22,0.5770000000000001
21700779,1610612739,1610612745,88.0,120.0,0.391,0.473,0,2018-02-03,51,30,21,0.588,51,38,13,0.745
21700780,1610612750,1610612740,118.0,107.0,0.505,0.416,1,2018-02-03,56,34,22,0.607,52,28,24,0.5379999999999999
21700781,1610612759,1610612762,111.0,120.0,0.484,0.565,0,2018-02-03,55,34,21,0.618,52,24,28,0.462
21700782,1610612743,1610612744,115.0,108.0,0.429,0.5,1,2018-02-03,53,28,25,0.528,53,41,12,0.774
21700783,1610612758,1610612742,99.0,106.0,0.524,0.494,0,2018-02-03,52,16,36,0.308,53,17,36,0.321
21700766,1610612766,1610612754,133.0,126.0,0.53,0.506,1,2018-02-02,51,22,29,0.431,53,29,24,0.547
21700767,1610612738,1610612737,119.0,110.0,0.506,0.425,1,2018-02-02,53,38,15,0.7170000000000001,52,15,37,0.288
21700768,1610612751,1610612747,99.0,102.0,0.451,0.424,0,2018-02-02,53,19,34,0.358,51,20,31,0.392
21700769,1610612761,1610612757,130.0,105.0,0.465,0.507,1,2018-02-02,51,35,16,0.6859999999999999,52,29,23,0.5579999999999999
21700770,1610612755,1610612748,103.0,97.0,0.494,0.391,1,2018-02-02,49,25,24,0.51,52,29,23,0.5579999999999999
21700771,1610612749,1610612752,92.0,90.0,0.434,0.4039999999999999,1,2018-02-02,51,28,23,0.5489999999999999,53,23,30,0.434
21700772,1610612760,1610612740,100.0,114.0,0.381,0.511,0,2018-02-02,53,30,23,0.5660000000000001,51,28,23,0.5489999999999999
21700773,1610612756,1610612762,97.0,129.0,0.414,0.5670000000000001,0,2018-02-02,53,18,35,0.34,51,23,28,0.451
21700774,1610612758,1610612744,104.0,119.0,0.442,0.55,0,2018-02-02,51,16,35,0.314,52,41,11,0.7879999999999999
21700761,1610612765,1610612763,104.0,102.0,0.461,0.417,1,2018-02-01,50,24,26,0.48,51,18,33,0.353
21700762,1610612764,1610612761,122.0,119.0,0.518,0.53,1,2018-02-01,51,29,22,0.569,50,34,16,0.68
21700763,1610612750,1610612749,108.0,89.0,0.5379999999999999,0.376,1,2018-02-01,55,33,22,0.6,50,27,23,0.54
21700764,1610612759,1610612745,91.0,102.0,0.422,0.446,0,2018-02-01,54,34,20,0.63,50,37,13,0.74
21700765,1610612743,1610612760,127.0,124.0,0.515,0.52,1,2018-02-01,52,27,25,0.519,52,30,22,0.5770000000000001
21700753,1610612754,1610612763,105.0,101.0,0.529,0.476,1,2018-01-31,52,29,23,0.5579999999999999,50,18,32,0.36
21700754,1610612753,1610612747,127.0,105.0,0.5429999999999999,0.47,1,2018-01-31,50,15,35,0.3,50,19,31,0.38
21700755,1610612737,1610612766,110.0,123.0,0.506,0.511,0,2018-01-31,51,15,36,0.294,50,21,29,0.42
21700756,1610612751,1610612755,116.0,108.0,0.506,0.474,1,2018-01-31,52,19,33,0.365,48,24,24,0.5
21700757,1610612739,1610612748,91.0,89.0,0.35,0.434,1,2018-01-31,50,30,20,0.6,51,29,22,0.569
21700758,1610612738,1610612752,103.0,73.0,0.482,0.322,1,2018-01-31,52,37,15,0.7120000000000001,52,23,29,0.442
21700759,1610612757,1610612741,124.0,108.0,0.561,0.414,1,2018-01-31,51,29,22,0.569,51,18,33,0.353
21700760,1610612756,1610612742,102.0,88.0,0.482,0.364,1,2018-01-31,52,18,34,0.346,52,16,36,0.308
21700744,1610612764,1610612760,102.0,96.0,0.382,0.375,1,2018-01-30,50,28,22,0.56,51,30,21,0.588
21700745,1610612752,1610612751,111.0,95.0,0.4379999999999999,0.414,1,2018-01-30,51,23,28,0.451,51,18,33,0.353
21700746,1610612761,1610612750,109.0,104.0,0.481,0.494,1,2018-01-30,49,34,15,0.6940000000000001,54,32,22,0.593
21700747,1610612765,1610612739,125.0,114.0,0.527,0.452,1,2018-01-30,49,23,26,0.469,49,29,20,0.5920000000000001
21700748,1610612745,1610612753,114.0,107.0,0.506,0.506,1,2018-01-30,49,36,13,0.735,49,14,35,0.286
21700749,1610612740,1610612758,103.0,114.0,0.506,0.474,0,2018-01-30,50,27,23,0.54,50,16,34,0.32
21700750,1610612759,1610612743,106.0,104.0,0.5,0.465,1,2018-01-30,53,34,19,0.642,51,26,25,0.51
21700751,1610612762,1610612744,129.0,99.0,0.5820000000000001,0.4589999999999999,1,2018-01-30,50,22,28,0.44,51,40,11,0.784
21700752,1610612746,1610612757,96.0,104.0,0.412,0.3670000000000001,0,2018-01-30,50,25,25,0.5,50,28,22,0.56
21700738,1610612754,1610612766,105.0,96.0,0.542,0.446,1,2018-01-29,51,28,23,0.5489999999999999,49,20,29,0.408
21700739,1610612737,1610612750,105.0,100.0,0.494,0.47,1,2018-01-29,50,15,35,0.3,53,32,21,0.604
21700740,1610612763,1610612756,120.0,109.0,0.5660000000000001,0.4629999999999999,1,2018-01-29,49,18,31,0.3670000000000001,51,17,34,0.3329999999999999
21700741,1610612749,1610612755,107.0,95.0,0.475,0.439,1,2018-01-29,49,27,22,0.551,47,24,23,0.511
21700742,1610612742,1610612748,88.0,95.0,0.384,0.4529999999999999,0,2018-01-29,51,16,35,0.314,50,29,21,0.58
21700743,1610612743,1610612738,110.0,111.0,0.452,0.473,0,2018-01-29,50,26,24,0.52,51,36,15,0.706
21700731,1610612741,1610612749,96.0,110.0,0.414,0.532,0,2018-01-28,50,18,32,0.36,48,26,22,0.542
21700732,1610612745,1610612756,113.0,102.0,0.444,0.424,1,2018-01-28,48,35,13,0.7290000000000001,50,17,33,0.34
21700733,1610612740,1610612746,103.0,112.0,0.447,0.469,0,2018-01-28,49,27,22,0.551,49,25,24,0.51
21700734,1610612739,1610612765,121.0,104.0,0.506,0.421,1,2018-01-28,48,29,19,0.604,48,22,26,0.4579999999999999
21700735,1610612761,1610612747,123.0,111.0,0.5,0.44,1,2018-01-28,48,33,15,0.688,49,19,30,0.3879999999999999
21700736,1610612760,1610612755,122.0,112.0,0.489,0.5,1,2018-01-28,50,30,20,0.6,46,24,22,0.522
21700737,1610612759,1610612758,113.0,98.0,0.5,0.4270000000000001,1,2018-01-28,52,33,19,0.635,49,15,34,0.306
21700724,1610612765,1610612760,108.0,121.0,0.4639999999999999,0.484,0,2018-01-27,47,22,25,0.4679999999999999,49,29,20,0.5920000000000001
21700725,1610612754,1610612753,114.0,112.0,0.54,0.545,1,2018-01-27,50,27,23,0.54,48,14,34,0.292
21700726,1610612737,1610612764,104.0,129.0,0.4320000000000001,0.5760000000000001,0,2018-01-27,49,14,35,0.286,49,27,22,0.551
21700727,1610612748,1610612766,95.0,91.0,0.447,0.345,1,2018-01-27,49,28,21,0.5710000000000001,48,20,28,0.417
21700728,1610612744,1610612738,109.0,105.0,0.452,0.435,1,2018-01-27,50,40,10,0.8,50,35,15,0.7
21700729,1610612750,1610612751,111.0,97.0,0.4379999999999999,0.4629999999999999,1,2018-01-27,52,32,20,0.615,50,18,32,0.36
21700730,1610612743,1610612742,91.0,89.0,0.42,0.4,1,2018-01-27,49,26,23,0.531,50,16,34,0.32
21700714,1610612766,1610612737,121.0,110.0,0.455,0.4679999999999999,1,2018-01-26,47,20,27,0.426,48,14,34,0.292
21700715,1610612739,1610612754,115.0,108.0,0.561,0.473,1,2018-01-26,47,28,19,0.596,49,26,23,0.531
21700716,1610612761,1610612762,93.0,97.0,0.389,0.414,0,2018-01-26,47,32,15,0.6809999999999999,49,21,28,0.429
21700717,1610612741,1610612747,103.0,108.0,0.376,0.451,0,2018-01-26,49,18,31,0.3670000000000001,48,19,29,0.396
21700718,1610612763,1610612746,100.0,109.0,0.481,0.488,0,2018-01-26,48,17,31,0.354,48,24,24,0.5
21700719,1610612749,1610612751,116.0,91.0,0.518,0.371,1,2018-01-26,47,25,22,0.532,49,18,31,0.3670000000000001
21700720,1610612740,1610612745,115.0,113.0,0.537,0.462,1,2018-01-26,48,27,21,0.563,47,34,13,0.723
21700721,1610612742,1610612757,93.0,107.0,0.3929999999999999,0.494,0,2018-01-26,49,16,33,0.327,49,27,22,0.551
21700722,1610612759,1610612755,78.0,97.0,0.4,0.481,0,2018-01-26,51,32,19,0.627,45,24,21,0.5329999999999999
21700723,1610612756,1610612752,85.0,107.0,0.351,0.482,0,2018-01-26,49,17,32,0.347,50,22,28,0.44
21700710,1610612748,1610612758,88.0,89.0,0.3779999999999999,0.469,0,2018-01-25,48,27,21,0.563,48,15,33,0.313
21700711,1610612760,1610612764,121.0,112.0,0.517,0.488,1,2018-01-25,48,28,20,0.583,48,26,22,0.542
21700712,1610612743,1610612752,130.0,118.0,0.6,0.5489999999999999,1,2018-01-25,48,25,23,0.521,49,21,28,0.429
21700713,1610612744,1610612750,126.0,113.0,0.539,0.455,1,2018-01-25,49,39,10,0.7959999999999999,51,31,20,0.608
21700701,1610612766,1610612740,96.0,101.0,0.424,0.4479999999999999,0,2018-01-24,46,19,27,0.413,47,26,21,0.5529999999999999
21700702,1610612765,1610612762,95.0,98.0,0.392,0.396,0,2018-01-24,46,22,24,0.478,48,20,28,0.417
21700703,1610612754,1610612756,116.0,101.0,0.563,0.417,1,2018-01-24,48,26,22,0.542,48,17,31,0.354
21700704,1610612755,1610612741,115.0,101.0,0.519,0.3829999999999999,1,2018-01-24,44,23,21,0.523,48,18,30,0.375
21700705,1610612737,1610612761,93.0,108.0,0.3939999999999999,0.4379999999999999,0,2018-01-24,47,14,33,0.298,46,32,14,0.696
21700706,1610612742,1610612745,97.0,104.0,0.4270000000000001,0.439,0,2018-01-24,48,16,32,0.3329999999999999,46,34,12,0.7390000000000001
21700707,1610612763,1610612759,85.0,108.0,0.434,0.4629999999999999,0,2018-01-24,47,17,30,0.362,50,32,18,0.64
21700708,1610612757,1610612750,123.0,114.0,0.5489999999999999,0.536,1,2018-01-24,48,26,22,0.542,50,31,19,0.62
21700709,1610612746,1610612738,102.0,113.0,0.4429999999999999,0.419,0,2018-01-24,47,23,24,0.489,49,35,14,0.7140000000000001
21700696,1610612753,1610612758,99.0,105.0,0.434,0.494,0,2018-01-23,47,14,33,0.298,47,14,33,0.298
21700697,1610612760,1610612751,109.0,108.0,0.426,0.4679999999999999,1,2018-01-23,47,27,20,0.574,48,18,30,0.375
21700698,1610612759,1610612739,114.0,102.0,0.5,0.486,1,2018-01-23,49,31,18,0.633,46,27,19,0.5870000000000001
21700699,1610612744,1610612752,123.0,112.0,0.5539999999999999,0.518,1,2018-01-23,48,38,10,0.792,48,21,27,0.4379999999999999
21700700,1610612747,1610612738,108.0,107.0,0.44,0.467,1,2018-01-23,47,18,29,0.3829999999999999,48,34,14,0.708
21700687,1610612766,1610612758,112.0,107.0,0.442,0.4429999999999999,1,2018-01-22,45,19,26,0.422,46,13,33,0.283
21700688,1610612737,1610612762,104.0,90.0,0.482,0.434,1,2018-01-22,46,14,32,0.304,47,19,28,0.4039999999999999
21700689,1610612745,1610612748,99.0,90.0,0.444,0.476,1,2018-01-22,45,33,12,0.733,47,27,20,0.574
21700690,1610612763,1610612755,105.0,101.0,0.423,0.451,1,2018-01-22,46,17,29,0.37,43,22,21,0.512
21700691,1610612749,1610612756,109.0,105.0,0.535,0.494,1,2018-01-22,46,24,22,0.522,47,17,30,0.362
21700692,1610612740,1610612741,132.0,128.0,0.416,0.489,1,2018-01-22,46,25,21,0.5429999999999999,47,18,29,0.3829999999999999
21700693,1610612742,1610612764,98.0,75.0,0.4370000000000001,0.302,1,2018-01-22,47,16,31,0.34,47,26,21,0.5529999999999999
21700694,1610612743,1610612757,104.0,101.0,0.41,0.424,1,2018-01-22,47,24,23,0.511,47,25,22,0.532
21700695,1610612746,1610612750,118.0,126.0,0.56,0.473,0,2018-01-22,46,23,23,0.5,49,31,18,0.633
21700683,1610612738,1610612753,95.0,103.0,0.435,0.467,0,2018-01-21,47,34,13,0.723,46,14,32,0.304
21700684,1610612747,1610612752,127.0,107.0,0.56,0.5429999999999999,1,2018-01-21,46,17,29,0.37,47,21,26,0.447
21700685,1610612765,1610612751,100.0,101.0,0.422,0.4629999999999999,0,2018-01-21,45,22,23,0.489,47,18,29,0.3829999999999999
21700686,1610612759,1610612754,86.0,94.0,0.4270000000000001,0.44,0,2018-01-21,48,30,18,0.625,47,25,22,0.532
21700674,1610612739,1610612760,124.0,148.0,0.517,0.58,0,2018-01-20,45,27,18,0.6,46,26,20,0.565
21700675,1610612737,1610612741,97.0,113.0,0.38,0.5,0,2018-01-20,45,13,32,0.289,46,18,28,0.391
21700676,1610612766,1610612748,105.0,106.0,0.456,0.494,0,2018-01-20,44,18,26,0.409,46,27,19,0.5870000000000001
21700677,1610612740,1610612763,111.0,104.0,0.5,0.451,1,2018-01-20,45,24,21,0.5329999999999999,45,16,29,0.356
21700678,1610612755,1610612749,116.0,94.0,0.529,0.402,1,2018-01-20,42,22,20,0.524,45,23,22,0.511
21700679,1610612745,1610612744,116.0,108.0,0.471,0.488,1,2018-01-20,44,32,12,0.727,47,37,10,0.787
21700680,1610612750,1610612761,115.0,109.0,0.469,0.47,1,2018-01-20,48,30,18,0.625,45,31,14,0.6890000000000001
21700681,1610612762,1610612746,125.0,113.0,0.5489999999999999,0.439,1,2018-01-20,46,19,27,0.413,45,23,22,0.511
21700682,1610612757,1610612742,117.0,108.0,0.523,0.4579999999999999,1,2018-01-20,46,25,21,0.5429999999999999,46,15,31,0.326
21700667,1610612761,1610612759,86.0,83.0,0.4,0.341,1,2018-01-19,44,31,13,0.705,47,30,17,0.638
21700668,1610612751,1610612748,101.0,95.0,0.474,0.417,1,2018-01-19,46,17,29,0.37,45,26,19,0.578
21700669,1610612765,1610612764,112.0,122.0,0.5,0.5,0,2018-01-19,44,22,22,0.5,46,26,20,0.565
21700670,1610612763,1610612758,106.0,88.0,0.4429999999999999,0.4,1,2018-01-19,44,16,28,0.364,45,13,32,0.289
21700671,1610612743,1610612756,100.0,108.0,0.449,0.494,0,2018-01-19,46,23,23,0.5,46,17,29,0.37
21700672,1610612762,1610612752,115.0,117.0,0.462,0.494,0,2018-01-19,45,18,27,0.4,46,21,25,0.457
21700673,1610612747,1610612754,99.0,86.0,0.55,0.381,1,2018-01-19,45,16,29,0.356,46,24,22,0.522
21700663,1610612738,1610612755,80.0,89.0,0.405,0.466,0,2018-01-18,46,34,12,0.7390000000000001,41,21,20,0.512
21700664,1610612739,1610612753,104.0,103.0,0.447,0.466,1,2018-01-18,44,27,17,0.614,45,13,32,0.289
21700665,1610612745,1610612750,116.0,98.0,0.477,0.469,1,2018-01-18,43,31,12,0.721,47,29,18,0.617
21700666,1610612757,1610612754,100.0,86.0,0.3939999999999999,0.396,1,2018-01-18,45,24,21,0.5329999999999999,45,24,21,0.5329999999999999
21700653,1610612766,1610612764,133.0,109.0,0.49,0.488,1,2018-01-17,43,18,25,0.419,45,25,20,0.556
21700654,1610612737,1610612740,94.0,93.0,0.416,0.4379999999999999,1,2018-01-17,44,13,31,0.295,44,23,21,0.523
21700655,1610612751,1610612759,95.0,100.0,0.422,0.415,0,2018-01-17,45,16,29,0.356,46,30,16,0.652
21700656,1610612761,1610612765,96.0,91.0,0.425,0.42,1,2018-01-17,43,30,13,0.698,43,22,21,0.512
21700657,1610612741,1610612744,112.0,119.0,0.425,0.5,0,2018-01-17,45,17,28,0.3779999999999999,46,37,9,0.804
21700658,1610612763,1610612752,105.0,99.0,0.451,0.4270000000000001,1,2018-01-17,43,15,28,0.349,45,20,25,0.444
21700659,1610612749,1610612748,101.0,106.0,0.434,0.4629999999999999,0,2018-01-17,44,23,21,0.523,44,26,18,0.591
21700660,1610612760,1610612747,114.0,90.0,0.484,0.469,1,2018-01-17,45,25,20,0.556,44,15,29,0.341
21700661,1610612758,1610612762,105.0,120.0,0.528,0.568,0,2018-01-17,44,13,31,0.295,44,18,26,0.409
21700662,1610612746,1610612743,109.0,104.0,0.46,0.433,1,2018-01-17,44,23,21,0.523,45,23,22,0.511
21700649,1610612753,1610612750,108.0,102.0,0.444,0.439,1,2018-01-16,44,13,31,0.295,46,29,17,0.63
21700650,1610612738,1610612740,113.0,116.0,0.396,0.45,0,2018-01-16,45,34,11,0.7559999999999999,43,23,20,0.535
21700651,1610612743,1610612742,105.0,102.0,0.465,0.487,1,2018-01-16,44,23,21,0.523,45,15,30,0.3329999999999999
21700652,1610612757,1610612756,118.0,111.0,0.505,0.416,1,2018-01-16,44,23,21,0.523,45,16,29,0.356
21700638,1610612765,1610612766,107.0,118.0,0.488,0.512,0,2018-01-15,42,22,20,0.524,42,17,25,0.405
21700639,1610612755,1610612761,117.0,111.0,0.494,0.4,1,2018-01-15,40,20,20,0.5,42,29,13,0.69
21700640,1610612764,1610612749,95.0,104.0,0.421,0.469,0,2018-01-15,44,25,19,0.568,43,23,20,0.535
21700641,1610612737,1610612759,102.0,99.0,0.465,0.425,1,2018-01-15,43,12,31,0.2789999999999999,45,29,16,0.644
21700642,1610612751,1610612752,104.0,119.0,0.368,0.512,0,2018-01-15,44,16,28,0.364,44,20,24,0.455
21700644,1610612741,1610612748,119.0,111.0,0.477,0.476,1,2018-01-15,44,17,27,0.386,43,25,18,0.581
21700645,1610612763,1610612747,123.0,114.0,0.512,0.396,1,2018-01-15,42,14,28,0.3329999999999999,43,15,28,0.349
21700643,1610612760,1610612758,95.0,88.0,0.419,0.3929999999999999,1,2018-01-15,44,24,20,0.545,43,13,30,0.302
21700646,1610612739,1610612744,108.0,118.0,0.457,0.482,0,2018-01-15,43,26,17,0.605,45,36,9,0.8
21700647,1610612762,1610612754,94.0,109.0,0.444,0.532,0,2018-01-15,43,17,26,0.395,44,24,20,0.545
21700648,1610612746,1610612745,113.0,102.0,0.557,0.4039999999999999,1,2018-01-15,43,22,21,0.512,42,30,12,0.7140000000000001
21700634,1610612748,1610612749,97.0,79.0,0.461,0.316,1,2018-01-14,42,25,17,0.595,42,22,20,0.524
21700635,1610612752,1610612740,118.0,123.0,0.474,0.474,0,2018-01-14,43,19,24,0.442,42,22,20,0.524
21700636,1610612756,1610612754,97.0,120.0,0.412,0.545,0,2018-01-14,44,16,28,0.364,43,23,20,0.535
21700637,1610612750,1610612757,120.0,103.0,0.5379999999999999,0.494,1,2018-01-14,45,29,16,0.644,43,22,21,0.512
21700627,1610612742,1610612747,101.0,107.0,0.3779999999999999,0.4529999999999999,0,2018-01-13,44,15,29,0.341,42,15,27,0.357
21700628,1610612746,1610612758,126.0,105.0,0.561,0.506,1,2018-01-13,42,21,21,0.5,42,13,29,0.31
21700629,1610612766,1610612760,91.0,101.0,0.3979999999999999,0.402,0,2018-01-13,41,16,25,0.39,43,23,20,0.535
21700630,1610612764,1610612751,119.0,113.0,0.495,0.424,1,2018-01-13,43,25,18,0.581,43,16,27,0.3720000000000001
21700631,1610612761,1610612744,125.0,127.0,0.484,0.58,0,2018-01-13,41,29,12,0.7070000000000001,44,35,9,0.795
21700632,1610612741,1610612765,107.0,105.0,0.483,0.446,1,2018-01-13,43,16,27,0.3720000000000001,41,22,19,0.537
21700633,1610612759,1610612743,112.0,80.0,0.519,0.349,1,2018-01-13,44,29,15,0.659,43,22,21,0.512
21700618,1610612766,1610612762,99.0,88.0,0.41,0.364,1,2018-01-12,40,16,24,0.4,42,17,25,0.405
21700619,1610612754,1610612739,97.0,95.0,0.4589999999999999,0.435,1,2018-01-12,42,22,20,0.524,42,26,16,0.619
21700620,1610612764,1610612753,125.0,119.0,0.568,0.513,1,2018-01-12,42,24,18,0.5710000000000001,43,12,31,0.2789999999999999
21700621,1610612737,1610612751,105.0,110.0,0.4629999999999999,0.46,0,2018-01-12,42,11,31,0.262,42,16,26,0.381
21700622,1610612749,1610612744,94.0,108.0,0.424,0.557,0,2018-01-12,41,22,19,0.537,43,34,9,0.7909999999999999
21700623,1610612750,1610612752,118.0,108.0,0.516,0.542,1,2018-01-12,44,28,16,0.636,42,19,23,0.452
21700624,1610612740,1610612757,119.0,113.0,0.5489999999999999,0.446,1,2018-01-12,41,21,20,0.512,42,22,20,0.524
21700625,1610612743,1610612763,87.0,78.0,0.386,0.39,1,2018-01-12,42,22,20,0.524,41,13,28,0.317
21700626,1610612756,1610612745,95.0,112.0,0.4629999999999999,0.415,0,2018-01-12,43,16,27,0.3720000000000001,41,30,11,0.732
21700614,1610612755,1610612738,103.0,114.0,0.4629999999999999,0.483,0,2018-01-11,39,19,20,0.487,44,34,10,0.773
21700615,1610612761,1610612739,133.0,99.0,0.5,0.382,1,2018-01-11,40,29,11,0.725,41,26,15,0.634
21700616,1610612758,1610612746,115.0,121.0,0.494,0.512,0,2018-01-11,41,13,28,0.317,41,20,21,0.488
21700617,1610612747,1610612759,93.0,81.0,0.414,0.408,1,2018-01-11,41,14,27,0.341,43,28,15,0.6509999999999999
21700603,1610612766,1610612742,111.0,115.0,0.512,0.47,0,2018-01-10,39,15,24,0.385,43,15,28,0.349
21700604,1610612754,1610612748,106.0,114.0,0.494,0.531,0,2018-01-10,41,21,20,0.512,41,24,17,0.585
21700605,1610612764,1610612762,104.0,107.0,0.526,0.467,0,2018-01-10,41,23,18,0.561,41,17,24,0.415
21700606,1610612751,1610612765,80.0,114.0,0.365,0.516,0,2018-01-10,41,15,26,0.366,40,22,18,0.55
21700607,1610612752,1610612741,119.0,122.0,0.5,0.4589999999999999,0,2018-01-10,41,19,22,0.4629999999999999,42,15,27,0.357
21700608,1610612745,1610612757,121.0,112.0,0.45,0.482,1,2018-01-10,40,29,11,0.725,41,22,19,0.537
21700609,1610612763,1610612740,105.0,102.0,0.42,0.442,1,2018-01-10,40,13,27,0.325,40,20,20,0.5
21700610,1610612749,1610612753,110.0,103.0,0.5489999999999999,0.433,1,2018-01-10,40,22,18,0.55,42,12,30,0.286
21700611,1610612750,1610612760,104.0,88.0,0.488,0.4,1,2018-01-10,43,27,16,0.628,42,22,20,0.524
21700612,1610612743,1610612737,97.0,110.0,0.4,0.5,0,2018-01-10,41,21,20,0.512,41,11,30,0.268
21700613,1610612744,1610612746,106.0,125.0,0.481,0.489,0,2018-01-10,42,33,9,0.7859999999999999,40,19,21,0.475
21700599,1610612761,1610612748,89.0,90.0,0.389,0.402,0,2018-01-09,39,28,11,0.718,40,23,17,0.575
21700600,1610612760,1610612757,106.0,117.0,0.44,0.531,0,2018-01-09,41,22,19,0.537,40,22,18,0.55
21700601,1610612742,1610612753,114.0,99.0,0.518,0.456,1,2018-01-09,42,14,28,0.3329999999999999,41,12,29,0.293
21700602,1610612747,1610612758,99.0,86.0,0.481,0.345,1,2018-01-09,40,13,27,0.325,40,13,27,0.325
21700591,1610612754,1610612749,109.0,96.0,0.557,0.4589999999999999,1,2018-01-08,40,21,19,0.525,39,21,18,0.5379999999999999
21700592,1610612751,1610612761,113.0,114.0,0.39,0.426,0,2018-01-08,40,15,25,0.375,38,28,10,0.737
21700593,1610612741,1610612745,107.0,116.0,0.465,0.4529999999999999,0,2018-01-08,41,14,27,0.341,39,28,11,0.718
21700594,1610612750,1610612739,127.0,99.0,0.52,0.44,1,2018-01-08,42,26,16,0.619,40,26,14,0.65
21700595,1610612740,1610612765,112.0,109.0,0.561,0.441,1,2018-01-08,39,20,19,0.513,39,21,18,0.5379999999999999
21700596,1610612758,1610612759,100.0,107.0,0.488,0.489,0,2018-01-08,39,13,26,0.3329999999999999,42,28,14,0.667
21700597,1610612744,1610612743,124.0,114.0,0.565,0.495,1,2018-01-08,41,33,8,0.805,40,21,19,0.525
21700598,1610612746,1610612737,108.0,107.0,0.447,0.396,1,2018-01-08,39,18,21,0.462,40,10,30,0.25
21700586,1610612748,1610612762,103.0,102.0,0.482,0.451,1,2018-01-07,39,22,17,0.564,40,16,24,0.4
21700587,1610612742,1610612752,96.0,100.0,0.38,0.4579999999999999,0,2018-01-07,41,13,28,0.317,40,19,21,0.475
21700588,1610612756,1610612760,114.0,100.0,0.4429999999999999,0.465,1,2018-01-07,42,16,26,0.381,40,22,18,0.55
21700589,1610612757,1610612759,111.0,110.0,0.522,0.494,1,2018-01-07,39,21,18,0.5379999999999999,41,27,14,0.659
21700590,1610612747,1610612737,132.0,113.0,0.5579999999999999,0.436,1,2018-01-07,39,12,27,0.308,39,10,29,0.256
21700578,1610612746,1610612744,105.0,121.0,0.429,0.415,0,2018-01-06,38,17,21,0.447,40,32,8,0.8
21700579,1610612751,1610612738,85.0,87.0,0.33,0.3779999999999999,0,2018-01-06,39,15,24,0.385,43,33,10,0.767
21700580,1610612765,1610612745,108.0,101.0,0.507,0.422,1,2018-01-06,38,21,17,0.5529999999999999,38,27,11,0.711
21700581,1610612754,1610612741,125.0,86.0,0.5579999999999999,0.375,1,2018-01-06,39,20,19,0.513,40,14,26,0.35
21700582,1610612753,1610612739,127.0,131.0,0.5,0.5,0,2018-01-06,40,12,28,0.3,39,26,13,0.667
21700583,1610612764,1610612749,103.0,110.0,0.474,0.488,0,2018-01-06,40,23,17,0.575,38,21,17,0.5529999999999999
21700584,1610612750,1610612740,116.0,98.0,0.489,0.423,1,2018-01-06,41,25,16,0.61,38,19,19,0.5
21700585,1610612758,1610612743,106.0,98.0,0.447,0.461,1,2018-01-06,38,13,25,0.342,39,21,18,0.5379999999999999
21700569,1610612755,1610612765,114.0,78.0,0.489,0.385,1,2018-01-05,38,19,19,0.5,37,20,17,0.541
21700570,1610612738,1610612750,91.0,84.0,0.4039999999999999,0.368,1,2018-01-05,42,32,10,0.762,40,24,16,0.6
21700568,1610612748,1610612752,107.0,103.0,0.4039999999999999,0.488,1,2018-01-05,38,21,17,0.5529999999999999,39,18,21,0.462
21700571,1610612749,1610612761,110.0,129.0,0.532,0.5579999999999999,0,2018-01-05,37,20,17,0.541,37,27,10,0.73
21700572,1610612742,1610612741,124.0,127.0,0.5329999999999999,0.564,0,2018-01-05,40,13,27,0.325,39,14,25,0.359
21700573,1610612759,1610612756,103.0,89.0,0.471,0.422,1,2018-01-05,40,27,13,0.675,41,15,26,0.366
21700574,1610612743,1610612762,99.0,91.0,0.442,0.452,1,2018-01-05,38,21,17,0.5529999999999999,39,16,23,0.41
21700575,1610612763,1610612764,100.0,102.0,0.407,0.3929999999999999,0,2018-01-05,39,12,27,0.308,39,23,16,0.59
21700576,1610612757,1610612737,110.0,89.0,0.5379999999999999,0.361,1,2018-01-05,38,20,18,0.526,38,10,28,0.263
21700577,1610612747,1610612766,94.0,108.0,0.4039999999999999,0.424,0,2018-01-05,38,11,27,0.289,38,15,23,0.395
21700566,1610612745,1610612744,114.0,124.0,0.472,0.552,0,2018-01-04,37,27,10,0.73,39,31,8,0.795
21700567,1610612746,1610612760,117.0,127.0,0.45,0.537,0,2018-01-04,37,17,20,0.4589999999999999,39,22,17,0.564
21700554,1610612753,1610612745,98.0,116.0,0.385,0.472,0,2018-01-03,39,12,27,0.308,36,27,9,0.75
21700555,1610612755,1610612759,112.0,106.0,0.45,0.4479999999999999,1,2018-01-03,37,18,19,0.486,39,26,13,0.667
21700556,1610612764,1610612752,121.0,103.0,0.593,0.477,1,2018-01-03,38,22,16,0.579,38,18,20,0.474
21700557,1610612751,1610612750,98.0,97.0,0.514,0.45,1,2018-01-03,38,15,23,0.395,39,24,15,0.615
21700558,1610612748,1610612765,111.0,104.0,0.512,0.477,1,2018-01-03,37,20,17,0.541,36,20,16,0.556
21700559,1610612738,1610612739,102.0,88.0,0.446,0.348,1,2018-01-03,41,31,10,0.7559999999999999,38,25,13,0.6579999999999999
21700560,1610612741,1610612761,115.0,124.0,0.462,0.489,0,2018-01-03,38,13,25,0.342,36,26,10,0.722
21700561,1610612749,1610612754,122.0,101.0,0.5870000000000001,0.488,1,2018-01-03,36,20,16,0.556,38,19,19,0.5
21700562,1610612742,1610612744,122.0,125.0,0.478,0.527,0,2018-01-03,39,13,26,0.3329999999999999,38,30,8,0.789
21700563,1610612743,1610612756,134.0,111.0,0.622,0.424,1,2018-01-03,37,20,17,0.541,40,15,25,0.375
21700564,1610612762,1610612740,98.0,108.0,0.452,0.5,0,2018-01-03,38,16,22,0.421,37,19,18,0.514
21700565,1610612747,1610612760,96.0,133.0,0.413,0.602,0,2018-01-03,37,11,26,0.297,38,21,17,0.5529999999999999
21700549,1610612739,1610612757,127.0,110.0,0.518,0.467,1,2018-01-02,37,25,12,0.6759999999999999,37,19,18,0.514
21700550,1610612752,1610612759,91.0,100.0,0.402,0.3779999999999999,0,2018-01-02,37,18,19,0.486,38,26,12,0.684
21700551,1610612756,1610612737,104.0,103.0,0.506,0.414,1,2018-01-02,39,15,24,0.385,37,10,27,0.27
21700552,1610612758,1610612766,111.0,131.0,0.517,0.573,0,2018-01-02,37,12,25,0.324,37,14,23,0.3779999999999999
21700553,1610612746,1610612763,113.0,105.0,0.5489999999999999,0.481,1,2018-01-02,36,17,19,0.472,38,12,26,0.316
21700545,1610612751,1610612753,98.0,95.0,0.439,0.365,1,2018-01-01,37,14,23,0.3779999999999999,38,12,26,0.316
21700546,1610612761,1610612749,131.0,127.0,0.495,0.473,1,2018-01-01,35,25,10,0.7140000000000001,35,19,16,0.5429999999999999
21700547,1610612741,1610612757,120.0,124.0,0.433,0.435,0,2018-01-01,37,13,24,0.351,36,19,17,0.528
21700548,1610612750,1610612747,114.0,96.0,0.494,0.447,1,2018-01-01,38,24,14,0.632,36,11,25,0.306
21700537,1610612764,1610612741,114.0,110.0,0.462,0.457,1,2017-12-31,37,21,16,0.568,36,13,23,0.361
21700538,1610612754,1610612750,90.0,107.0,0.3879999999999999,0.477,0,2017-12-31,37,19,18,0.514,37,23,14,0.622
21700539,1610612738,1610612751,108.0,105.0,0.494,0.411,1,2017-12-31,40,30,10,0.75,36,13,23,0.361
21700540,1610612745,1610612747,148.0,142.0,0.462,0.505,1,2017-12-31,35,26,9,0.743,35,11,24,0.314
21700541,1610612760,1610612742,113.0,116.0,0.483,0.517,0,2017-12-31,37,20,17,0.541,38,13,25,0.342
21700542,1610612746,1610612766,106.0,98.0,0.474,0.387,1,2017-12-31,35,16,19,0.457,36,13,23,0.361
21700543,1610612758,1610612763,96.0,114.0,0.43,0.539,0,2017-12-31,36,12,24,0.3329999999999999,37,12,25,0.324
21700544,1610612756,1610612755,110.0,123.0,0.42,0.5579999999999999,0,2017-12-31,38,14,24,0.368,36,17,19,0.472
21700530,1610612765,1610612759,93.0,79.0,0.444,0.369,1,2017-12-30,35,20,15,0.5710000000000001,37,25,12,0.6759999999999999
21700531,1610612753,1610612748,111.0,117.0,0.5429999999999999,0.511,0,2017-12-30,37,12,25,0.324,36,19,17,0.528
21700532,1610612740,1610612752,103.0,105.0,0.452,0.436,0,2017-12-30,36,18,18,0.5,36,18,18,0.5
21700533,1610612737,1610612757,104.0,89.0,0.449,0.424,1,2017-12-30,36,10,26,0.278,35,18,17,0.514
21700534,1610612762,1610612739,104.0,101.0,0.4629999999999999,0.42,1,2017-12-30,37,16,21,0.4320000000000001,36,24,12,0.667
21700535,1610612744,1610612763,141.0,128.0,0.588,0.521,1,2017-12-30,37,29,8,0.784,36,11,25,0.306
21700536,1610612743,1610612755,102.0,107.0,0.402,0.484,0,2017-12-30,36,19,17,0.528,35,16,19,0.457
21700521,1610612764,1610612745,121.0,103.0,0.534,0.4270000000000001,1,2017-12-29,36,20,16,0.556,34,25,9,0.735
21700522,1610612761,1610612737,111.0,98.0,0.4379999999999999,0.4320000000000001,1,2017-12-29,34,24,10,0.706,35,9,26,0.257
21700523,1610612748,1610612751,87.0,111.0,0.337,0.494,0,2017-12-29,35,18,17,0.514,35,13,22,0.371
21700524,1610612741,1610612754,119.0,107.0,0.506,0.462,1,2017-12-29,35,13,22,0.371,36,19,17,0.528
21700525,1610612740,1610612742,120.0,128.0,0.494,0.5539999999999999,0,2017-12-29,35,18,17,0.514,37,12,25,0.324
21700526,1610612760,1610612749,95.0,97.0,0.4579999999999999,0.471,0,2017-12-29,36,20,16,0.556,34,19,15,0.5589999999999999
21700527,1610612758,1610612756,101.0,111.0,0.4629999999999999,0.482,0,2017-12-29,35,12,23,0.3429999999999999,37,14,23,0.3779999999999999
21700528,1610612744,1610612766,100.0,111.0,0.46,0.461,0,2017-12-29,36,28,8,0.778,35,13,22,0.371
21700529,1610612747,1610612746,106.0,121.0,0.489,0.488,0,2017-12-29,34,11,23,0.324,34,15,19,0.441
21700516,1610612753,1610612765,102.0,89.0,0.451,0.402,1,2017-12-28,36,12,24,0.3329999999999999,34,19,15,0.5589999999999999
21700517,1610612738,1610612745,99.0,98.0,0.451,0.375,1,2017-12-28,39,29,10,0.7440000000000001,33,25,8,0.758
21700518,1610612749,1610612750,102.0,96.0,0.547,0.479,1,2017-12-28,33,18,15,0.545,36,22,14,0.611
21700519,1610612759,1610612752,119.0,107.0,0.513,0.456,1,2017-12-28,36,25,11,0.6940000000000001,35,17,18,0.486
21700520,1610612757,1610612755,114.0,110.0,0.467,0.483,1,2017-12-28,34,18,16,0.529,34,15,19,0.441
21700506,1610612766,1610612738,91.0,102.0,0.368,0.474,0,2017-12-27,34,12,22,0.353,38,28,10,0.737
21700507,1610612754,1610612742,94.0,98.0,0.481,0.513,0,2017-12-27,35,19,16,0.5429999999999999,36,11,25,0.306
21700508,1610612737,1610612764,113.0,99.0,0.436,0.4320000000000001,1,2017-12-27,34,9,25,0.265,35,19,16,0.5429999999999999
21700509,1610612741,1610612752,92.0,87.0,0.407,0.407,1,2017-12-27,34,12,22,0.353,34,17,17,0.5
21700510,1610612750,1610612743,128.0,125.0,0.522,0.462,1,2017-12-27,35,22,13,0.629,35,19,16,0.5429999999999999
21700511,1610612740,1610612751,128.0,113.0,0.5329999999999999,0.456,1,2017-12-27,34,18,16,0.529,34,12,22,0.353
21700512,1610612760,1610612761,124.0,107.0,0.529,0.424,1,2017-12-27,35,20,15,0.5710000000000001,33,23,10,0.6970000000000001
21700513,1610612758,1610612739,109.0,95.0,0.519,0.4320000000000001,1,2017-12-27,34,12,22,0.353,35,24,11,0.6859999999999999
21700514,1610612744,1610612762,126.0,101.0,0.593,0.402,1,2017-12-27,35,28,7,0.8,36,15,21,0.417
21700515,1610612747,1610612763,99.0,109.0,0.376,0.493,0,2017-12-27,33,11,22,0.3329999999999999,35,11,24,0.314
21700498,1610612765,1610612754,107.0,83.0,0.5,0.442,1,2017-12-26,33,19,14,0.5760000000000001,34,19,15,0.5589999999999999
21700499,1610612742,1610612761,98.0,93.0,0.426,0.337,1,2017-12-26,35,10,25,0.286,32,23,9,0.7190000000000001
21700500,1610612748,1610612753,107.0,89.0,0.451,0.407,1,2017-12-26,34,18,16,0.529,35,11,24,0.314
21700501,1610612749,1610612741,106.0,115.0,0.47,0.4370000000000001,0,2017-12-26,32,17,15,0.531,33,11,22,0.3329999999999999
21700502,1610612759,1610612751,109.0,97.0,0.513,0.419,1,2017-12-26,35,24,11,0.6859999999999999,33,12,21,0.364
21700503,1610612743,1610612762,107.0,83.0,0.481,0.321,1,2017-12-26,34,19,15,0.5589999999999999,35,15,20,0.429
21700504,1610612756,1610612763,99.0,97.0,0.444,0.402,1,2017-12-26,36,13,23,0.361,34,10,24,0.294
21700505,1610612746,1610612758,122.0,95.0,0.5429999999999999,0.417,1,2017-12-26,33,14,19,0.424,33,11,22,0.3329999999999999
21700493,1610612752,1610612755,98.0,105.0,0.4039999999999999,0.4270000000000001,0,2017-12-25,33,17,16,0.515,33,15,18,0.455
21700494,1610612744,1610612739,99.0,92.0,0.4629999999999999,0.318,1,2017-12-25,34,27,7,0.794,34,24,10,0.706
21700495,1610612738,1610612764,103.0,111.0,0.481,0.462,0,2017-12-25,37,27,10,0.73,34,19,15,0.5589999999999999
21700496,1610612760,1610612745,112.0,107.0,0.544,0.4320000000000001,1,2017-12-25,34,19,15,0.5589999999999999,32,25,7,0.7809999999999999
21700497,1610612747,1610612750,104.0,121.0,0.435,0.583,0,2017-12-25,32,11,21,0.344,34,21,13,0.618
21700480,1610612761,1610612755,102.0,86.0,0.412,0.413,1,2017-12-23,31,23,8,0.742,32,14,18,0.4379999999999999
21700481,1610612766,1610612749,111.0,106.0,0.486,0.483,1,2017-12-23,33,12,21,0.364,31,17,14,0.5479999999999999
21700482,1610612754,1610612751,123.0,119.0,0.522,0.429,1,2017-12-23,33,19,14,0.5760000000000001,32,12,20,0.375
21700483,1610612764,1610612753,130.0,103.0,0.547,0.483,1,2017-12-23,33,18,15,0.545,34,11,23,0.324
21700484,1610612737,1610612742,112.0,107.0,0.56,0.506,1,2017-12-23,33,8,25,0.242,34,9,25,0.265
21700485,1610612738,1610612741,117.0,92.0,0.478,0.395,1,2017-12-23,36,27,9,0.75,32,10,22,0.313
21700486,1610612748,1610612740,94.0,109.0,0.424,0.534,0,2017-12-23,33,17,16,0.515,33,17,16,0.515
21700487,1610612763,1610612746,115.0,112.0,0.444,0.494,1,2017-12-23,33,10,23,0.303,32,13,19,0.406
21700488,1610612762,1610612760,89.0,103.0,0.4579999999999999,0.4429999999999999,0,2017-12-23,34,15,19,0.441,33,18,15,0.545
21700489,1610612744,1610612743,81.0,96.0,0.381,0.4629999999999999,0,2017-12-23,33,26,7,0.7879999999999999,33,18,15,0.545
21700490,1610612756,1610612750,106.0,115.0,0.465,0.5,0,2017-12-23,35,12,23,0.3429999999999999,33,20,13,0.606
21700491,1610612747,1610612757,92.0,95.0,0.424,0.411,0,2017-12-23,31,11,20,0.355,33,17,16,0.515
21700492,1610612758,1610612759,99.0,108.0,0.465,0.5,0,2017-12-23,32,11,21,0.344,34,23,11,0.6759999999999999
21700471,1610612765,1610612752,104.0,101.0,0.4320000000000001,0.4539999999999999,1,2017-12-22,32,18,14,0.563,32,17,15,0.531
21700472,1610612753,1610612740,97.0,111.0,0.424,0.5,0,2017-12-22,33,11,22,0.3329999999999999,32,16,16,0.5
21700473,1610612751,1610612764,119.0,84.0,0.5,0.366,1,2017-12-22,31,12,19,0.387,32,17,15,0.531
21700474,1610612748,1610612742,113.0,101.0,0.639,0.507,1,2017-12-22,32,17,15,0.531,33,9,24,0.273
21700475,1610612745,1610612746,118.0,128.0,0.462,0.473,0,2017-12-22,31,25,6,0.8059999999999999,31,13,18,0.419
21700476,1610612749,1610612766,109.0,104.0,0.471,0.4429999999999999,1,2017-12-22,30,17,13,0.5670000000000001,32,11,21,0.344
21700477,1610612760,1610612737,120.0,117.0,0.537,0.518,1,2017-12-22,32,17,15,0.531,32,7,25,0.2189999999999999
21700478,1610612757,1610612743,85.0,102.0,0.422,0.494,0,2017-12-22,32,16,16,0.5,32,17,15,0.531
21700479,1610612744,1610612747,113.0,106.0,0.494,0.426,1,2017-12-22,32,26,6,0.813,30,11,19,0.3670000000000001
21700466,1610612739,1610612741,115.0,112.0,0.512,0.5529999999999999,1,2017-12-21,33,24,9,0.727,31,10,21,0.3229999999999999
21700467,1610612755,1610612761,109.0,114.0,0.523,0.412,0,2017-12-21,31,14,17,0.452,30,22,8,0.733
21700468,1610612752,1610612738,102.0,93.0,0.456,0.384,1,2017-12-21,31,17,14,0.5479999999999999,35,26,9,0.743
21700469,1610612756,1610612763,97.0,95.0,0.407,0.433,1,2017-12-21,34,12,22,0.353,32,9,23,0.281
21700470,1610612762,1610612759,100.0,89.0,0.4589999999999999,0.436,1,2017-12-21,33,15,18,0.455,33,22,11,0.667
21700454,1610612766,1610612761,111.0,129.0,0.4589999999999999,0.5379999999999999,0,2017-12-20,31,11,20,0.355,29,21,8,0.7240000000000001
21700455,1610612737,1610612754,95.0,105.0,0.4320000000000001,0.488,0,2017-12-20,31,7,24,0.226,32,18,14,0.563
21700456,1610612738,1610612748,89.0,90.0,0.375,0.44,0,2017-12-20,34,26,8,0.765,31,16,15,0.516
21700457,1610612751,1610612758,99.0,104.0,0.39,0.488,0,2017-12-20,30,11,19,0.3670000000000001,31,11,20,0.355
21700458,1610612741,1610612753,112.0,94.0,0.506,0.3929999999999999,1,2017-12-20,30,10,20,0.3329999999999999,32,11,21,0.344
21700459,1610612745,1610612747,116.0,122.0,0.411,0.471,0,2017-12-20,30,25,5,0.833,29,11,18,0.379
21700460,1610612760,1610612762,107.0,79.0,0.519,0.356,1,2017-12-20,31,16,15,0.516,32,14,18,0.4379999999999999
21700461,1610612742,1610612765,110.0,93.0,0.5329999999999999,0.429,1,2017-12-20,32,9,23,0.281,31,17,14,0.5479999999999999
21700462,1610612743,1610612750,104.0,112.0,0.5,0.494,0,2017-12-20,31,16,15,0.516,32,19,13,0.594
21700463,1610612757,1610612759,91.0,93.0,0.396,0.519,0,2017-12-20,31,16,15,0.516,32,22,10,0.688
21700464,1610612744,1610612763,97.0,84.0,0.4589999999999999,0.3329999999999999,1,2017-12-20,31,25,6,0.8059999999999999,31,9,22,0.29
21700465,1610612746,1610612756,108.0,95.0,0.471,0.361,1,2017-12-20,30,12,18,0.4,33,11,22,0.3329999999999999
21700451,1610612755,1610612758,95.0,101.0,0.42,0.451,0,2017-12-19,30,14,16,0.467,30,10,20,0.3329999999999999
21700452,1610612764,1610612740,116.0,106.0,0.5,0.425,1,2017-12-19,31,17,14,0.5479999999999999,31,15,16,0.484
21700453,1610612749,1610612739,119.0,116.0,0.524,0.5,1,2017-12-19,29,16,13,0.552,32,23,9,0.7190000000000001
21700441,1610612766,1610612752,109.0,91.0,0.489,0.419,1,2017-12-18,30,11,19,0.3670000000000001,30,16,14,0.5329999999999999
21700442,1610612754,1610612738,111.0,112.0,0.4679999999999999,0.557,0,2017-12-18,31,17,14,0.5479999999999999,33,26,7,0.7879999999999999
21700443,1610612737,1610612748,110.0,104.0,0.4579999999999999,0.456,1,2017-12-18,30,7,23,0.233,30,15,15,0.5
21700444,1610612741,1610612755,117.0,115.0,0.478,0.484,1,2017-12-18,29,9,20,0.31,29,14,15,0.483
21700445,1610612745,1610612762,120.0,99.0,0.519,0.462,1,2017-12-18,29,25,4,0.862,31,14,17,0.452
21700446,1610612750,1610612757,108.0,107.0,0.462,0.5479999999999999,1,2017-12-18,31,18,13,0.581,30,16,14,0.5329999999999999
21700447,1610612760,1610612743,95.0,94.0,0.481,0.43,1,2017-12-18,30,15,15,0.5,30,16,14,0.5329999999999999
21700448,1610612742,1610612756,91.0,97.0,0.364,0.4429999999999999,0,2017-12-18,31,8,23,0.258,32,11,21,0.344
21700449,1610612759,1610612746,109.0,91.0,0.488,0.44,1,2017-12-18,31,21,10,0.677,29,11,18,0.379
21700450,1610612747,1610612744,114.0,116.0,0.446,0.402,0,2017-12-18,28,10,18,0.357,30,24,6,0.8
21700437,1610612761,1610612758,108.0,93.0,0.424,0.469,1,2017-12-17,28,20,8,0.7140000000000001,29,9,20,0.31
21700438,1610612765,1610612753,114.0,110.0,0.472,0.482,1,2017-12-17,30,17,13,0.5670000000000001,31,11,20,0.355
21700439,1610612751,1610612754,97.0,109.0,0.42,0.5660000000000001,0,2017-12-17,29,11,18,0.379,30,17,13,0.5670000000000001
21700440,1610612764,1610612739,99.0,106.0,0.429,0.471,0,2017-12-17,30,16,14,0.5329999999999999,31,23,8,0.742
21700429,1610612766,1610612757,91.0,93.0,0.344,0.4679999999999999,0,2017-12-16,29,10,19,0.345,29,16,13,0.552
21700430,1610612739,1610612762,109.0,100.0,0.532,0.457,1,2017-12-16,30,22,8,0.733,30,14,16,0.467
21700431,1610612752,1610612760,111.0,96.0,0.551,0.424,1,2017-12-16,29,16,13,0.552,29,14,15,0.483
21700432,1610612748,1610612746,90.0,85.0,0.3779999999999999,0.4379999999999999,1,2017-12-16,29,15,14,0.517,28,11,17,0.3929999999999999
21700433,1610612745,1610612749,115.0,111.0,0.461,0.4629999999999999,1,2017-12-16,28,24,4,0.857,28,15,13,0.536
21700434,1610612750,1610612756,106.0,108.0,0.421,0.4579999999999999,0,2017-12-16,30,17,13,0.5670000000000001,31,10,21,0.3229999999999999
21700435,1610612759,1610612742,98.0,96.0,0.4529999999999999,0.488,1,2017-12-16,30,20,10,0.667,30,8,22,0.267
21700436,1610612763,1610612738,93.0,102.0,0.405,0.488,0,2017-12-16,30,9,21,0.3,32,25,7,0.7809999999999999
21700418,1610612766,1610612748,98.0,104.0,0.41,0.5,0,2017-12-15,28,10,18,0.357,28,14,14,0.5
21700419,1610612754,1610612765,98.0,104.0,0.402,0.419,0,2017-12-15,29,16,13,0.552,29,16,13,0.552
21700420,1610612753,1610612757,88.0,95.0,0.381,0.43,0,2017-12-15,30,11,19,0.3670000000000001,28,15,13,0.536
21700421,1610612755,1610612760,117.0,119.0,0.44,0.416,0,2017-12-15,28,14,14,0.5,28,14,14,0.5
21700422,1610612764,1610612746,100.0,91.0,0.4429999999999999,0.384,1,2017-12-15,29,16,13,0.552,27,11,16,0.407
21700423,1610612738,1610612762,95.0,107.0,0.407,0.482,0,2017-12-15,31,24,7,0.774,29,14,15,0.483
21700424,1610612761,1610612751,120.0,87.0,0.557,0.421,1,2017-12-15,27,19,8,0.7040000000000001,28,11,17,0.3929999999999999
21700425,1610612763,1610612737,96.0,94.0,0.462,0.442,1,2017-12-15,29,9,20,0.31,29,6,23,0.207
21700426,1610612749,1610612741,109.0,115.0,0.482,0.488,0,2017-12-15,27,15,12,0.556,28,8,20,0.286
21700427,1610612743,1610612740,117.0,111.0,0.46,0.473,1,2017-12-15,29,16,13,0.552,30,15,15,0.5
21700428,1610612745,1610612759,124.0,109.0,0.473,0.489,1,2017-12-15,27,23,4,0.852,29,19,10,0.655
21700413,1610612737,1610612765,91.0,105.0,0.457,0.456,0,2017-12-14,28,6,22,0.214,28,15,13,0.536
21700414,1610612751,1610612752,104.0,111.0,0.446,0.461,0,2017-12-14,27,11,16,0.407,28,15,13,0.536
21700415,1610612739,1610612747,121.0,112.0,0.5,0.495,1,2017-12-14,29,21,8,0.7240000000000001,27,10,17,0.37
21700416,1610612750,1610612758,119.0,96.0,0.561,0.414,1,2017-12-14,29,17,12,0.586,28,9,19,0.321
21700417,1610612744,1610612742,112.0,97.0,0.603,0.451,1,2017-12-14,29,23,6,0.7929999999999999,29,8,21,0.276
21700404,1610612754,1610612760,95.0,100.0,0.449,0.409,0,2017-12-13,28,16,12,0.5710000000000001,27,13,14,0.481
21700405,1610612753,1610612746,95.0,106.0,0.42,0.4429999999999999,0,2017-12-13,29,11,18,0.379,26,11,15,0.423
21700406,1610612764,1610612763,93.0,87.0,0.4679999999999999,0.3829999999999999,1,2017-12-13,28,15,13,0.536,28,8,20,0.286
21700407,1610612738,1610612743,124.0,118.0,0.595,0.495,1,2017-12-13,30,24,6,0.8,28,15,13,0.536
21700408,1610612748,1610612757,95.0,102.0,0.472,0.5,0,2017-12-13,27,13,14,0.481,27,14,13,0.519
21700409,1610612741,1610612762,103.0,100.0,0.441,0.462,1,2017-12-13,27,7,20,0.259,28,13,15,0.4639999999999999
21700410,1610612740,1610612749,115.0,108.0,0.563,0.4629999999999999,1,2017-12-13,29,15,14,0.517,26,15,11,0.5770000000000001
21700411,1610612756,1610612761,109.0,115.0,0.446,0.435,0,2017-12-13,30,9,21,0.3,26,18,8,0.6920000000000001
21700412,1610612745,1610612766,108.0,96.0,0.4429999999999999,0.414,1,2017-12-13,26,22,4,0.846,27,10,17,0.37
21700397,1610612739,1610612737,123.0,114.0,0.5579999999999999,0.467,1,2017-12-12,28,20,8,0.7140000000000001,27,6,21,0.222
21700398,1610612765,1610612743,84.0,103.0,0.354,0.506,0,2017-12-12,27,14,13,0.519,27,15,12,0.556
21700399,1610612752,1610612747,113.0,109.0,0.475,0.412,1,2017-12-12,27,14,13,0.519,26,10,16,0.385
21700400,1610612751,1610612764,103.0,98.0,0.405,0.4,1,2017-12-12,26,11,15,0.423,27,14,13,0.519
21700402,1610612742,1610612759,95.0,89.0,0.4270000000000001,0.402,1,2017-12-12,28,8,20,0.286,28,19,9,0.679
21700401,1610612750,1610612755,112.0,118.0,0.407,0.5,0,2017-12-12,28,16,12,0.5710000000000001,27,14,13,0.519
21700403,1610612758,1610612756,99.0,92.0,0.4270000000000001,0.411,1,2017-12-12,27,9,18,0.3329999999999999,29,9,20,0.31
21700391,1610612741,1610612738,108.0,85.0,0.481,0.3979999999999999,1,2017-12-11,26,6,20,0.231,29,23,6,0.7929999999999999
21700392,1610612745,1610612740,130.0,123.0,0.545,0.5760000000000001,1,2017-12-11,25,21,4,0.84,28,14,14,0.5
21700393,1610612763,1610612748,82.0,107.0,0.389,0.561,0,2017-12-11,27,8,19,0.296,26,13,13,0.5
21700394,1610612760,1610612766,103.0,116.0,0.412,0.531,0,2017-12-11,26,12,14,0.462,26,10,16,0.385
21700395,1610612744,1610612757,111.0,104.0,0.55,0.42,1,2017-12-11,28,22,6,0.7859999999999999,26,13,13,0.5
21700396,1610612746,1610612761,96.0,91.0,0.37,0.4,1,2017-12-11,25,10,15,0.4,25,17,8,0.68
21700385,1610612758,1610612761,87.0,102.0,0.479,0.4479999999999999,0,2017-12-10,26,8,18,0.308,24,17,7,0.708
21700386,1610612765,1610612738,81.0,91.0,0.3329999999999999,0.418,0,2017-12-10,26,14,12,0.5379999999999999,28,23,5,0.821
21700387,1610612754,1610612743,126.0,116.0,0.527,0.4529999999999999,1,2017-12-10,27,16,11,0.593,26,14,12,0.5379999999999999
21700388,1610612750,1610612742,97.0,92.0,0.5,0.457,1,2017-12-10,27,16,11,0.593,27,7,20,0.259
21700389,1610612740,1610612755,131.0,124.0,0.575,0.4579999999999999,1,2017-12-10,27,14,13,0.519,26,13,13,0.5
21700390,1610612752,1610612737,111.0,107.0,0.488,0.481,1,2017-12-10,26,13,13,0.5,26,6,20,0.231
21700375,1610612746,1610612764,113.0,112.0,0.488,0.512,1,2017-12-09,24,9,15,0.375,26,14,12,0.5379999999999999
21700376,1610612751,1610612748,89.0,101.0,0.407,0.467,0,2017-12-09,25,10,15,0.4,25,12,13,0.48
21700377,1610612766,1610612747,99.0,110.0,0.441,0.506,0,2017-12-09,25,9,16,0.36,25,10,15,0.4
21700378,1610612737,1610612753,117.0,110.0,0.513,0.489,1,2017-12-09,25,6,19,0.24,28,11,17,0.3929999999999999
21700379,1610612739,1610612755,105.0,98.0,0.48,0.474,1,2017-12-09,27,19,8,0.7040000000000001,25,13,12,0.52
21700380,1610612741,1610612752,104.0,102.0,0.512,0.473,1,2017-12-09,25,5,20,0.2,25,12,13,0.48
21700381,1610612749,1610612762,117.0,100.0,0.5429999999999999,0.434,1,2017-12-09,25,15,10,0.6,27,13,14,0.481
21700382,1610612763,1610612760,101.0,102.0,0.4429999999999999,0.391,0,2017-12-09,26,8,18,0.308,25,12,13,0.48
21700383,1610612756,1610612759,101.0,104.0,0.4379999999999999,0.46,0,2017-12-09,28,9,19,0.321,27,19,8,0.7040000000000001
21700384,1610612757,1610612745,117.0,124.0,0.511,0.5329999999999999,0,2017-12-09,25,13,12,0.52,24,20,4,0.833
21700367,1610612766,1610612741,111.0,119.0,0.4,0.485,0,2017-12-08,24,9,15,0.375,24,4,20,0.1669999999999999
21700368,1610612765,1610612744,98.0,102.0,0.413,0.481,0,2017-12-08,25,14,11,0.56,27,21,6,0.778
21700369,1610612754,1610612739,106.0,102.0,0.442,0.435,1,2017-12-08,26,15,11,0.5770000000000001,26,18,8,0.6920000000000001
21700370,1610612753,1610612743,89.0,103.0,0.3979999999999999,0.494,0,2017-12-08,27,11,16,0.407,25,14,11,0.56
21700371,1610612763,1610612761,107.0,116.0,0.5,0.474,0,2017-12-08,25,8,17,0.32,23,16,7,0.696
21700372,1610612749,1610612742,109.0,102.0,0.456,0.467,1,2017-12-08,24,14,10,0.583,26,7,19,0.2689999999999999
21700373,1610612740,1610612758,109.0,116.0,0.461,0.485,0,2017-12-08,26,13,13,0.5,25,8,17,0.32
21700374,1610612759,1610612738,105.0,102.0,0.469,0.4579999999999999,1,2017-12-08,26,18,8,0.6920000000000001,27,22,5,0.815
21700363,1610612755,1610612747,104.0,107.0,0.481,0.4379999999999999,0,2017-12-07,24,13,11,0.542,24,9,15,0.375
21700364,1610612756,1610612764,99.0,109.0,0.462,0.506,0,2017-12-07,27,9,18,0.3329999999999999,25,14,11,0.56
21700365,1610612751,1610612760,100.0,95.0,0.4379999999999999,0.3879999999999999,1,2017-12-07,24,10,14,0.417,24,11,13,0.4579999999999999
21700366,1610612762,1610612745,101.0,112.0,0.442,0.469,0,2017-12-07,26,13,13,0.5,23,19,4,0.826
21700353,1610612739,1610612758,101.0,95.0,0.474,0.4529999999999999,1,2017-12-06,25,18,7,0.72,24,7,17,0.292
21700354,1610612754,1610612741,98.0,96.0,0.4479999999999999,0.47,1,2017-12-06,25,14,11,0.56,23,3,20,0.13
21700355,1610612753,1610612737,110.0,106.0,0.469,0.43,1,2017-12-06,26,11,15,0.423,24,5,19,0.208
21700356,1610612738,1610612742,97.0,90.0,0.414,0.395,1,2017-12-06,26,22,4,0.846,25,7,18,0.28
21700357,1610612752,1610612763,99.0,88.0,0.522,0.414,1,2017-12-06,24,12,12,0.5,24,8,16,0.3329999999999999
21700358,1610612766,1610612744,87.0,101.0,0.351,0.476,0,2017-12-06,23,9,14,0.391,26,20,6,0.769
21700359,1610612749,1610612765,104.0,100.0,0.494,0.414,1,2017-12-06,23,13,10,0.565,24,14,10,0.583
21700360,1610612740,1610612743,123.0,114.0,0.535,0.436,1,2017-12-06,25,13,12,0.52,24,13,11,0.542
21700361,1610612759,1610612748,117.0,105.0,0.529,0.542,1,2017-12-06,25,17,8,0.68,24,11,13,0.4579999999999999
21700362,1610612746,1610612750,107.0,113.0,0.444,0.5489999999999999,0,2017-12-06,23,8,15,0.348,26,15,11,0.5770000000000001
21700350,1610612761,1610612756,126.0,113.0,0.478,0.493,1,2017-12-05,22,15,7,0.682,26,9,17,0.346
21700351,1610612760,1610612762,100.0,94.0,0.481,0.43,1,2017-12-05,23,11,12,0.478,25,13,12,0.52
21700352,1610612757,1610612764,92.0,106.0,0.41,0.472,0,2017-12-05,24,13,11,0.542,24,13,11,0.542
21700339,1610612766,1610612753,104.0,94.0,0.405,0.439,1,2017-12-04,22,9,13,0.409,25,10,15,0.4
21700340,1610612754,1610612752,115.0,97.0,0.535,0.44,1,2017-12-04,24,13,11,0.542,23,11,12,0.478
21700341,1610612755,1610612756,101.0,115.0,0.429,0.484,0,2017-12-04,23,13,10,0.565,25,9,16,0.36
21700342,1610612737,1610612751,90.0,110.0,0.366,0.482,0,2017-12-04,23,5,18,0.217,23,9,14,0.391
21700343,1610612738,1610612749,111.0,100.0,0.551,0.449,1,2017-12-04,25,21,4,0.84,22,12,10,0.545
21700344,1610612741,1610612739,91.0,113.0,0.415,0.519,0,2017-12-04,22,3,19,0.136,24,17,7,0.708
21700345,1610612763,1610612750,95.0,92.0,0.472,0.4429999999999999,1,2017-12-04,23,8,15,0.348,25,14,11,0.56
21700346,1610612740,1610612744,115.0,125.0,0.495,0.517,0,2017-12-04,24,12,12,0.5,25,19,6,0.76
21700347,1610612742,1610612743,122.0,105.0,0.57,0.418,1,2017-12-04,24,7,17,0.292,23,13,10,0.565
21700348,1610612759,1610612765,96.0,93.0,0.4270000000000001,0.412,1,2017-12-04,24,16,8,0.667,23,14,9,0.609
21700349,1610612762,1610612764,116.0,69.0,0.5660000000000001,0.288,1,2017-12-04,24,13,11,0.542,23,12,11,0.522
21700334,1610612752,1610612753,100.0,105.0,0.462,0.451,0,2017-12-03,22,11,11,0.5,24,10,14,0.417
21700335,1610612748,1610612744,95.0,123.0,0.407,0.56,0,2017-12-03,23,11,12,0.478,24,18,6,0.75
21700336,1610612750,1610612746,112.0,106.0,0.4320000000000001,0.507,1,2017-12-03,24,14,10,0.583,22,8,14,0.364
21700337,1610612760,1610612759,90.0,87.0,0.425,0.408,1,2017-12-03,22,10,12,0.455,23,15,8,0.652
21700338,1610612747,1610612745,95.0,118.0,0.381,0.5,0,2017-12-03,23,8,15,0.348,22,18,4,0.818
21700326,1610612738,1610612756,116.0,111.0,0.525,0.475,1,2017-12-02,24,20,4,0.833,24,8,16,0.3329999999999999
21700327,1610612742,1610612746,108.0,82.0,0.456,0.349,1,2017-12-02,23,6,17,0.261,21,8,13,0.381
21700328,1610612751,1610612737,102.0,114.0,0.415,0.475,0,2017-12-02,22,8,14,0.364,22,5,17,0.2269999999999999
21700329,1610612739,1610612763,116.0,111.0,0.56,0.512,1,2017-12-02,23,16,7,0.696,22,7,15,0.318
21700330,1610612755,1610612765,108.0,103.0,0.407,0.436,1,2017-12-02,22,13,9,0.591,22,14,8,0.636
21700331,1610612749,1610612758,109.0,104.0,0.493,0.481,1,2017-12-02,21,12,9,0.5710000000000001,23,7,16,0.304
21700332,1610612743,1610612747,115.0,100.0,0.46,0.442,1,2017-12-02,22,13,9,0.591,22,8,14,0.364
21700333,1610612757,1610612740,116.0,123.0,0.4479999999999999,0.523,0,2017-12-02,23,13,10,0.565,23,12,11,0.522
21700318,1610612753,1610612744,112.0,133.0,0.4579999999999999,0.625,0,2017-12-01,23,9,14,0.391,23,17,6,0.7390000000000001
21700320,1610612764,1610612765,109.0,91.0,0.483,0.4429999999999999,1,2017-12-01,22,12,10,0.545,21,14,7,0.667
21700319,1610612761,1610612754,120.0,115.0,0.495,0.441,1,2017-12-01,21,14,7,0.667,23,12,11,0.522
21700321,1610612748,1610612766,105.0,100.0,0.488,0.481,1,2017-12-01,22,11,11,0.5,21,8,13,0.381
21700322,1610612741,1610612758,106.0,107.0,0.467,0.529,0,2017-12-01,21,3,18,0.143,22,7,15,0.318
21700323,1610612763,1610612759,79.0,95.0,0.405,0.4429999999999999,0,2017-12-01,21,7,14,0.3329999999999999,22,15,7,0.682
21700324,1610612760,1610612750,111.0,107.0,0.519,0.513,1,2017-12-01,21,9,12,0.429,23,13,10,0.565
21700325,1610612762,1610612740,114.0,108.0,0.494,0.483,1,2017-12-01,23,12,11,0.522,22,11,11,0.5
21700313,1610612737,1610612739,114.0,121.0,0.519,0.519,0,2017-11-30,21,4,17,0.19,22,15,7,0.682
21700314,1610612738,1610612755,108.0,97.0,0.506,0.417,1,2017-11-30,23,19,4,0.826,21,12,9,0.5710000000000001
21700315,1610612743,1610612741,111.0,110.0,0.4579999999999999,0.537,1,2017-11-30,21,12,9,0.5710000000000001,20,3,17,0.15
21700316,1610612757,1610612749,91.0,103.0,0.422,0.483,0,2017-11-30,22,13,9,0.591,20,11,9,0.55
21700317,1610612746,1610612762,107.0,126.0,0.5429999999999999,0.5760000000000001,0,2017-11-30,20,8,12,0.4,22,11,11,0.5
21700303,1610612765,1610612756,131.0,107.0,0.573,0.4639999999999999,1,2017-11-29,20,14,6,0.7,23,8,15,0.348
21700304,1610612753,1610612760,121.0,108.0,0.5920000000000001,0.396,1,2017-11-29,22,9,13,0.409,20,8,12,0.4
21700305,1610612755,1610612764,118.0,113.0,0.457,0.4039999999999999,1,2017-11-29,20,12,8,0.6,21,11,10,0.524
21700306,1610612752,1610612748,115.0,86.0,0.603,0.381,1,2017-11-29,21,11,10,0.524,21,10,11,0.476
21700307,1610612761,1610612766,126.0,113.0,0.531,0.4679999999999999,1,2017-11-29,20,13,7,0.65,20,8,12,0.4
21700308,1610612745,1610612754,118.0,97.0,0.488,0.477,1,2017-11-29,21,17,4,0.81,22,12,10,0.545
21700309,1610612740,1610612750,102.0,120.0,0.4639999999999999,0.58,0,2017-11-29,21,11,10,0.524,22,13,9,0.591
21700310,1610612742,1610612751,104.0,109.0,0.4639999999999999,0.467,0,2017-11-29,22,5,17,0.2269999999999999,21,8,13,0.381
21700311,1610612759,1610612763,104.0,95.0,0.507,0.455,1,2017-11-29,21,14,7,0.667,20,7,13,0.35
21700312,1610612747,1610612744,123.0,127.0,0.495,0.5,0,2017-11-29,21,8,13,0.381,22,16,6,0.727
21700298,1610612739,1610612748,108.0,97.0,0.494,0.44,1,2017-11-28,21,14,7,0.667,20,10,10,0.5
21700299,1610612741,1610612756,99.0,104.0,0.4039999999999999,0.4370000000000001,0,2017-11-28,19,3,16,0.158,22,8,14,0.364
21700300,1610612750,1610612764,89.0,92.0,0.412,0.434,0,2017-11-28,21,12,9,0.5710000000000001,20,11,9,0.55
21700301,1610612762,1610612743,106.0,77.0,0.483,0.359,1,2017-11-28,21,10,11,0.476,20,11,9,0.55
21700302,1610612758,1610612749,87.0,112.0,0.4029999999999999,0.5920000000000001,0,2017-11-28,21,6,15,0.286,19,10,9,0.526
21700290,1610612754,1610612753,121.0,109.0,0.532,0.435,1,2017-11-27,21,12,9,0.5710000000000001,21,8,13,0.381
21700291,1610612755,1610612739,91.0,113.0,0.375,0.477,0,2017-11-27,19,11,8,0.579,20,13,7,0.65
21700292,1610612738,1610612765,108.0,118.0,0.519,0.518,0,2017-11-27,22,18,4,0.818,19,13,6,0.684
21700293,1610612752,1610612757,91.0,103.0,0.3979999999999999,0.446,0,2017-11-27,20,10,10,0.5,21,13,8,0.619
21700294,1610612745,1610612751,117.0,103.0,0.488,0.465,1,2017-11-27,20,16,4,0.8,20,7,13,0.35
21700295,1610612759,1610612742,115.0,108.0,0.524,0.482,1,2017-11-27,20,13,7,0.65,21,5,16,0.238
21700296,1610612744,1610612758,106.0,110.0,0.5,0.532,0,2017-11-27,21,15,6,0.7140000000000001,20,6,14,0.3
21700297,1610612746,1610612747,120.0,115.0,0.482,0.484,1,2017-11-27,19,8,11,0.421,20,8,12,0.4
21700287,1610612741,1610612748,93.0,100.0,0.371,0.4529999999999999,0,2017-11-26,18,3,15,0.1669999999999999,19,10,9,0.526
21700288,1610612750,1610612756,119.0,108.0,0.527,0.506,1,2017-11-26,20,12,8,0.6,21,7,14,0.3329999999999999
21700289,1610612763,1610612751,88.0,98.0,0.4,0.446,0,2017-11-26,19,7,12,0.368,19,7,12,0.368
21700277,1610612766,1610612759,86.0,106.0,0.369,0.481,0,2017-11-25,19,8,11,0.421,19,12,7,0.632
21700278,1610612755,1610612753,130.0,111.0,0.505,0.4529999999999999,1,2017-11-25,18,11,7,0.611,20,8,12,0.4
21700279,1610612764,1610612757,105.0,108.0,0.461,0.513,0,2017-11-25,19,10,9,0.526,20,12,8,0.6
21700280,1610612737,1610612761,78.0,112.0,0.347,0.5479999999999999,0,2017-11-25,20,4,16,0.2,19,12,7,0.632
21700281,1610612754,1610612738,98.0,108.0,0.487,0.563,0,2017-11-25,20,11,9,0.55,21,18,3,0.857
21700282,1610612745,1610612752,117.0,102.0,0.436,0.494,1,2017-11-25,19,15,4,0.789,19,10,9,0.526
21700283,1610612742,1610612760,97.0,81.0,0.493,0.363,1,2017-11-25,20,5,15,0.25,19,8,11,0.421
21700284,1610612744,1610612740,110.0,95.0,0.415,0.405,1,2017-11-25,20,15,5,0.75,20,11,9,0.55
21700285,1610612762,1610612749,121.0,108.0,0.568,0.532,1,2017-11-25,20,9,11,0.45,18,9,9,0.5
21700286,1610612758,1610612746,95.0,97.0,0.4579999999999999,0.475,0,2017-11-25,19,5,14,0.263,18,7,11,0.389
21700267,1610612751,1610612757,125.0,127.0,0.5,0.5,0,2017-11-24,18,6,12,0.3329999999999999,19,11,8,0.579
21700268,1610612737,1610612752,116.0,104.0,0.475,0.513,1,2017-11-24,19,4,15,0.211,18,10,8,0.556
21700269,1610612738,1610612753,118.0,103.0,0.462,0.4320000000000001,1,2017-11-24,20,17,3,0.85,19,8,11,0.421
21700270,1610612739,1610612766,100.0,99.0,0.4579999999999999,0.3829999999999999,1,2017-11-24,19,12,7,0.632,18,8,10,0.444
21700271,1610612754,1610612761,107.0,104.0,0.4579999999999999,0.494,1,2017-11-24,19,11,8,0.579,18,11,7,0.611
21700272,1610612750,1610612748,97.0,109.0,0.44,0.475,0,2017-11-24,19,11,8,0.579,18,9,9,0.5
21700273,1610612760,1610612765,98.0,99.0,0.429,0.4639999999999999,0,2017-11-24,18,8,10,0.444,18,12,6,0.667
21700274,1610612743,1610612763,104.0,92.0,0.506,0.493,1,2017-11-24,19,11,8,0.579,18,7,11,0.389
21700275,1610612756,1610612740,91.0,115.0,0.3939999999999999,0.495,0,2017-11-24,20,7,13,0.35,19,11,8,0.579
21700276,1610612744,1610612741,143.0,94.0,0.5820000000000001,0.354,1,2017-11-24,19,14,5,0.737,17,3,14,0.176
21700253,1610612766,1610612764,129.0,124.0,0.473,0.485,1,2017-11-22,17,8,9,0.471,18,10,8,0.556
21700254,1610612739,1610612751,119.0,109.0,0.524,0.519,1,2017-11-22,18,11,7,0.611,17,6,11,0.353
21700255,1610612755,1610612757,101.0,81.0,0.433,0.337,1,2017-11-22,17,10,7,0.588,18,10,8,0.556
21700256,1610612737,1610612746,103.0,116.0,0.482,0.579,0,2017-11-22,18,3,15,0.1669999999999999,17,6,11,0.353
21700257,1610612748,1610612738,104.0,98.0,0.494,0.417,1,2017-11-22,17,8,9,0.471,19,16,3,0.8420000000000001
21700258,1610612752,1610612761,108.0,100.0,0.462,0.425,1,2017-11-22,17,10,7,0.588,17,11,6,0.647
21700259,1610612745,1610612743,125.0,95.0,0.5489999999999999,0.402,1,2017-11-22,18,14,4,0.778,18,10,8,0.556
21700260,1610612763,1610612742,94.0,95.0,0.457,0.429,0,2017-11-22,17,7,10,0.412,19,4,15,0.211
21700261,1610612750,1610612753,124.0,118.0,0.46,0.505,1,2017-11-22,18,11,7,0.611,18,8,10,0.444
21700262,1610612740,1610612759,107.0,90.0,0.481,0.3979999999999999,1,2017-11-22,18,10,8,0.556,18,11,7,0.611
21700263,1610612760,1610612744,108.0,91.0,0.456,0.413,1,2017-11-22,17,8,9,0.471,18,13,5,0.722
21700264,1610612756,1610612749,107.0,113.0,0.3979999999999999,0.433,0,2017-11-22,19,7,12,0.368,17,9,8,0.529
21700265,1610612762,1610612741,110.0,80.0,0.465,0.3720000000000001,1,2017-11-22,19,8,11,0.421,16,3,13,0.188
21700266,1610612758,1610612747,113.0,102.0,0.5529999999999999,0.5,1,2017-11-22,18,5,13,0.278,19,8,11,0.421
21700252,1610612747,1610612741,103.0,94.0,0.4,0.3829999999999999,1,2017-11-21,18,8,10,0.444,15,3,12,0.2
21700241,1610612766,1610612750,118.0,102.0,0.494,0.411,1,2017-11-20,16,7,9,0.4379999999999999,17,10,7,0.588
21700242,1610612765,1610612739,88.0,116.0,0.442,0.525,0,2017-11-20,17,11,6,0.647,17,10,7,0.588
21700243,1610612753,1610612754,97.0,105.0,0.417,0.416,0,2017-11-20,17,8,9,0.471,18,10,8,0.556
21700244,1610612755,1610612762,107.0,86.0,0.518,0.353,1,2017-11-20,16,9,7,0.563,18,7,11,0.389
21700245,1610612752,1610612746,107.0,85.0,0.4320000000000001,0.375,1,2017-11-20,16,9,7,0.563,16,5,11,0.313
21700246,1610612763,1610612757,92.0,100.0,0.384,0.3979999999999999,0,2017-11-20,16,7,9,0.4379999999999999,17,10,7,0.588
21700247,1610612749,1610612764,88.0,99.0,0.4429999999999999,0.527,0,2017-11-20,16,8,8,0.5,17,10,7,0.588
21700248,1610612740,1610612760,114.0,107.0,0.513,0.4270000000000001,1,2017-11-20,17,9,8,0.529,16,7,9,0.4379999999999999
21700249,1610612742,1610612738,102.0,110.0,0.406,0.452,0,2017-11-20,18,3,15,0.1669999999999999,18,16,2,0.889
21700250,1610612759,1610612737,96.0,85.0,0.449,0.435,1,2017-11-20,17,11,6,0.647,17,3,14,0.176
21700251,1610612758,1610612743,98.0,114.0,0.477,0.488,0,2017-11-20,17,4,13,0.235,17,10,7,0.588
21700237,1610612761,1610612764,100.0,91.0,0.444,0.42,1,2017-11-19,16,11,5,0.688,16,9,7,0.563
21700235,1610612748,1610612754,95.0,120.0,0.422,0.6,0,2017-11-19,16,7,9,0.4379999999999999,17,9,8,0.529
21700236,1610612751,1610612744,111.0,118.0,0.358,0.511,0,2017-11-19,16,6,10,0.375,17,13,4,0.765
21700238,1610612750,1610612765,97.0,100.0,0.513,0.47,0,2017-11-19,16,10,6,0.625,16,11,5,0.688
21700239,1610612756,1610612741,113.0,105.0,0.506,0.416,1,2017-11-19,18,7,11,0.389,14,3,11,0.214
21700240,1610612747,1610612743,127.0,109.0,0.53,0.429,1,2017-11-19,17,7,10,0.412,16,9,7,0.563
21700228,1610612766,1610612746,102.0,87.0,0.391,0.3979999999999999,1,2017-11-18,15,6,9,0.4,15,5,10,0.3329999999999999
21700229,1610612753,1610612762,85.0,125.0,0.3829999999999999,0.48,0,2017-11-18,16,8,8,0.5,17,7,10,0.412
21700230,1610612737,1610612738,99.0,110.0,0.474,0.476,0,2017-11-18,16,3,13,0.188,17,15,2,0.882
21700231,1610612755,1610612744,116.0,124.0,0.485,0.5489999999999999,0,2017-11-18,15,8,7,0.5329999999999999,16,12,4,0.75
21700232,1610612763,1610612745,83.0,105.0,0.36,0.449,0,2017-11-18,15,7,8,0.467,17,13,4,0.765
21700233,1610612742,1610612749,111.0,79.0,0.481,0.3779999999999999,1,2017-11-18,17,3,14,0.176,15,8,7,0.5329999999999999
21700234,1610612757,1610612758,102.0,90.0,0.5429999999999999,0.382,1,2017-11-18,16,9,7,0.563,16,4,12,0.25
21700217,1610612754,1610612765,107.0,100.0,0.4379999999999999,0.419,1,2017-11-17,16,8,8,0.5,15,10,5,0.667
21700218,1610612764,1610612748,88.0,91.0,0.381,0.41,0,2017-11-17,15,9,6,0.6,15,7,8,0.467
21700219,1610612751,1610612762,118.0,107.0,0.512,0.494,1,2017-11-17,15,6,9,0.4,16,6,10,0.375
21700220,1610612739,1610612746,118.0,113.0,0.467,0.447,1,2017-11-17,16,9,7,0.563,14,5,9,0.357
21700221,1610612761,1610612752,107.0,84.0,0.564,0.33,1,2017-11-17,15,10,5,0.667,15,8,7,0.5329999999999999
21700222,1610612741,1610612766,123.0,120.0,0.516,0.519,1,2017-11-17,13,3,10,0.231,14,5,9,0.357
21700223,1610612759,1610612760,104.0,101.0,0.442,0.4379999999999999,1,2017-11-17,16,10,6,0.625,15,7,8,0.467
21700224,1610612742,1610612750,87.0,111.0,0.3720000000000001,0.4639999999999999,0,2017-11-17,16,2,14,0.125,15,10,5,0.667
21700225,1610612758,1610612757,86.0,82.0,0.424,0.37,1,2017-11-17,15,4,11,0.267,15,8,7,0.5329999999999999
21700226,1610612743,1610612740,146.0,114.0,0.629,0.527,1,2017-11-17,15,9,6,0.6,16,8,8,0.5
21700227,1610612747,1610612756,113.0,122.0,0.495,0.466,0,2017-11-17,16,6,10,0.375,17,6,11,0.353
21700215,1610612738,1610612744,92.0,88.0,0.3289999999999999,0.402,1,2017-11-16,16,14,2,0.875,15,11,4,0.733
21700216,1610612756,1610612745,116.0,142.0,0.452,0.478,0,2017-11-16,16,5,11,0.313,16,12,4,0.75
21700204,1610612737,1610612758,126.0,80.0,0.633,0.352,1,2017-11-15,15,3,12,0.2,14,3,11,0.214
21700205,1610612748,1610612764,93.0,102.0,0.41,0.41,0,2017-11-15,14,6,8,0.429,14,9,5,0.643
21700206,1610612752,1610612762,106.0,101.0,0.469,0.43,1,2017-11-15,14,8,6,0.5710000000000001,15,6,9,0.4
21700207,1610612766,1610612739,107.0,115.0,0.477,0.442,0,2017-11-15,13,5,8,0.385,15,8,7,0.5329999999999999
21700208,1610612763,1610612754,113.0,116.0,0.512,0.506,0,2017-11-15,14,7,7,0.5,15,7,8,0.467
21700209,1610612749,1610612765,99.0,95.0,0.487,0.353,1,2017-11-15,14,8,6,0.5710000000000001,14,10,4,0.7140000000000001
21700210,1610612750,1610612759,98.0,86.0,0.4479999999999999,0.418,1,2017-11-15,14,9,5,0.643,15,9,6,0.6
21700211,1610612740,1610612761,116.0,125.0,0.505,0.5920000000000001,0,2017-11-15,15,8,7,0.5329999999999999,14,9,5,0.643
21700212,1610612760,1610612741,92.0,79.0,0.361,0.347,1,2017-11-15,14,7,7,0.5,12,2,10,0.1669999999999999
21700213,1610612757,1610612753,99.0,94.0,0.4370000000000001,0.4679999999999999,1,2017-11-15,14,8,6,0.5710000000000001,15,8,7,0.5329999999999999
21700214,1610612747,1610612755,109.0,115.0,0.385,0.488,0,2017-11-15,15,6,9,0.4,14,8,6,0.5710000000000001
21700201,1610612751,1610612738,102.0,109.0,0.4429999999999999,0.4529999999999999,0,2017-11-14,14,5,9,0.357,15,13,2,0.867
21700202,1610612745,1610612761,113.0,129.0,0.418,0.526,0,2017-11-14,15,11,4,0.733,13,8,5,0.615
21700203,1610612742,1610612759,91.0,97.0,0.407,0.4429999999999999,0,2017-11-14,15,2,13,0.133,14,9,5,0.643
21700192,1610612764,1610612758,110.0,92.0,0.512,0.405,1,2017-11-13,13,8,5,0.615,13,3,10,0.231
21700193,1610612752,1610612739,101.0,104.0,0.4320000000000001,0.3979999999999999,0,2017-11-13,13,7,6,0.5379999999999999,14,7,7,0.5
21700194,1610612749,1610612763,110.0,103.0,0.488,0.487,1,2017-11-13,13,7,6,0.5379999999999999,13,7,6,0.5379999999999999
21700195,1610612740,1610612737,106.0,105.0,0.547,0.46,1,2017-11-13,14,8,6,0.5710000000000001,14,2,12,0.143
21700196,1610612756,1610612747,93.0,100.0,0.389,0.424,0,2017-11-13,15,5,10,0.3329999999999999,14,6,8,0.429
21700197,1610612762,1610612750,98.0,109.0,0.44,0.521,0,2017-11-13,14,6,8,0.429,13,8,5,0.615
21700198,1610612757,1610612743,99.0,82.0,0.521,0.357,1,2017-11-13,13,7,6,0.5379999999999999,14,8,6,0.5710000000000001
21700199,1610612744,1610612753,110.0,100.0,0.5,0.42,1,2017-11-13,14,11,3,0.7859999999999999,14,8,6,0.5710000000000001
21700200,1610612746,1610612755,105.0,109.0,0.439,0.494,0,2017-11-13,13,5,8,0.385,13,7,6,0.5379999999999999
21700188,1610612738,1610612761,95.0,94.0,0.402,0.4639999999999999,1,2017-11-12,14,12,2,0.857,12,7,5,0.583
21700189,1610612765,1610612748,112.0,103.0,0.483,0.433,1,2017-11-12,13,10,3,0.769,13,6,7,0.462
21700190,1610612754,1610612745,95.0,118.0,0.446,0.478,0,2017-11-12,14,6,8,0.429,14,11,3,0.7859999999999999
21700191,1610612760,1610612742,112.0,99.0,0.5,0.425,1,2017-11-12,13,6,7,0.462,14,2,12,0.143
21700177,1610612764,1610612737,113.0,94.0,0.5379999999999999,0.41,1,2017-11-11,12,7,5,0.583,13,2,11,0.154
21700178,1610612740,1610612746,111.0,103.0,0.5379999999999999,0.407,1,2017-11-11,13,7,6,0.5379999999999999,12,5,7,0.417
21700179,1610612752,1610612758,118.0,91.0,0.522,0.375,1,2017-11-11,12,7,5,0.583,12,3,9,0.25
21700180,1610612745,1610612763,111.0,96.0,0.446,0.481,1,2017-11-11,13,10,3,0.769,12,7,5,0.583
21700181,1610612742,1610612739,104.0,111.0,0.424,0.4320000000000001,0,2017-11-11,13,2,11,0.154,13,6,7,0.462
21700182,1610612749,1610612747,98.0,90.0,0.412,0.419,1,2017-11-11,12,6,6,0.5,13,5,8,0.385
21700183,1610612759,1610612741,133.0,94.0,0.6,0.465,1,2017-11-11,13,8,5,0.615,11,2,9,0.182
21700184,1610612744,1610612755,135.0,114.0,0.585,0.4679999999999999,1,2017-11-11,13,10,3,0.769,12,6,6,0.5
21700185,1610612743,1610612753,125.0,107.0,0.529,0.471,1,2017-11-11,13,8,5,0.615,13,8,5,0.615
21700186,1610612756,1610612750,118.0,110.0,0.535,0.406,1,2017-11-11,14,5,9,0.357,12,7,5,0.583
21700187,1610612762,1610612751,114.0,106.0,0.482,0.461,1,2017-11-11,13,6,7,0.462,13,5,8,0.385
21700169,1610612765,1610612737,111.0,104.0,0.4379999999999999,0.494,1,2017-11-10,12,9,3,0.75,12,2,10,0.1669999999999999
21700170,1610612738,1610612766,90.0,87.0,0.357,0.3879999999999999,1,2017-11-10,13,11,2,0.846,12,5,7,0.417
21700171,1610612741,1610612754,87.0,105.0,0.3979999999999999,0.512,0,2017-11-10,10,2,8,0.2,13,6,7,0.462
21700172,1610612760,1610612746,120.0,111.0,0.513,0.4639999999999999,1,2017-11-10,12,5,7,0.417,11,5,6,0.455
21700173,1610612759,1610612749,87.0,94.0,0.425,0.461,0,2017-11-10,12,7,5,0.583,11,5,6,0.455
21700174,1610612756,1610612753,112.0,128.0,0.4679999999999999,0.524,0,2017-11-10,13,4,9,0.308,12,8,4,0.667
21700175,1610612762,1610612748,74.0,84.0,0.3379999999999999,0.39,0,2017-11-10,12,5,7,0.417,12,6,6,0.5
21700176,1610612757,1610612751,97.0,101.0,0.421,0.429,0,2017-11-10,12,6,6,0.5,12,5,7,0.417
21700164,1610612764,1610612747,111.0,95.0,0.518,0.36,1,2017-11-09,11,6,5,0.545,12,5,7,0.417
21700165,1610612761,1610612740,122.0,118.0,0.4589999999999999,0.537,1,2017-11-09,11,7,4,0.636,12,6,6,0.5
21700166,1610612745,1610612739,117.0,113.0,0.4679999999999999,0.556,1,2017-11-09,12,9,3,0.75,12,5,7,0.417
21700167,1610612758,1610612755,109.0,108.0,0.43,0.425,1,2017-11-09,11,3,8,0.273,11,6,5,0.545
21700168,1610612743,1610612760,102.0,94.0,0.4629999999999999,0.422,1,2017-11-09,12,7,5,0.583,11,4,7,0.364
21700159,1610612765,1610612754,114.0,97.0,0.518,0.4320000000000001,1,2017-11-08,11,8,3,0.727,12,5,7,0.417
21700160,1610612753,1610612752,112.0,99.0,0.5379999999999999,0.525,1,2017-11-08,11,7,4,0.636,11,6,5,0.545
21700161,1610612738,1610612747,107.0,96.0,0.3879999999999999,0.435,1,2017-11-08,12,10,2,0.833,11,5,6,0.455
21700162,1610612756,1610612748,115.0,126.0,0.455,0.531,0,2017-11-08,12,4,8,0.3329999999999999,11,5,6,0.455
21700163,1610612744,1610612750,125.0,101.0,0.565,0.413,1,2017-11-08,12,9,3,0.75,11,7,4,0.636
21700149,1610612739,1610612749,124.0,119.0,0.5,0.5660000000000001,1,2017-11-07,11,5,6,0.455,10,4,6,0.4
21700150,1610612754,1610612740,112.0,117.0,0.473,0.506,0,2017-11-07,11,5,6,0.455,11,6,5,0.545
21700151,1610612764,1610612742,99.0,113.0,0.4270000000000001,0.473,0,2017-11-07,10,5,5,0.5,12,2,10,0.1669999999999999
21700152,1610612752,1610612766,118.0,113.0,0.6,0.462,1,2017-11-07,10,6,4,0.6,11,5,6,0.455
21700153,1610612761,1610612741,119.0,114.0,0.5429999999999999,0.5,1,2017-11-07,10,6,4,0.6,9,2,7,0.222
21700154,1610612759,1610612746,120.0,107.0,0.536,0.512,1,2017-11-07,11,7,4,0.636,10,5,5,0.5
21700155,1610612743,1610612751,112.0,104.0,0.473,0.4270000000000001,1,2017-11-07,11,6,5,0.545,11,4,7,0.364
21700156,1610612762,1610612755,97.0,104.0,0.303,0.42,0,2017-11-07,11,5,6,0.455,10,6,4,0.6
21700157,1610612757,1610612763,97.0,98.0,0.444,0.479,0,2017-11-07,11,6,5,0.545,11,7,4,0.636
21700158,1610612758,1610612760,94.0,86.0,0.4679999999999999,0.337,1,2017-11-07,10,2,8,0.2,10,4,6,0.4
21700146,1610612737,1610612738,107.0,110.0,0.481,0.481,0,2017-11-06,11,2,9,0.182,11,9,2,0.818
21700147,1610612756,1610612751,92.0,98.0,0.349,0.402,0,2017-11-06,11,4,7,0.364,10,4,6,0.4
21700148,1610612744,1610612748,97.0,80.0,0.368,0.361,1,2017-11-06,11,8,3,0.727,10,4,6,0.4
21700136,1610612739,1610612737,115.0,117.0,0.4379999999999999,0.477,0,2017-11-05,10,4,6,0.4,10,2,8,0.2
21700137,1610612746,1610612748,101.0,104.0,0.391,0.44,0,2017-11-05,9,5,4,0.556,9,4,5,0.444
21700138,1610612753,1610612738,88.0,104.0,0.363,0.4379999999999999,0,2017-11-05,10,6,4,0.6,10,8,2,0.8
21700139,1610612761,1610612764,96.0,107.0,0.4629999999999999,0.471,0,2017-11-05,9,5,4,0.556,9,5,4,0.556
21700140,1610612745,1610612762,137.0,110.0,0.593,0.4320000000000001,1,2017-11-05,11,8,3,0.727,10,5,5,0.5
21700141,1610612759,1610612756,112.0,95.0,0.5,0.457,1,2017-11-05,10,6,4,0.6,10,4,6,0.4
21700142,1610612752,1610612754,108.0,101.0,0.5,0.4679999999999999,1,2017-11-05,9,5,4,0.556,10,5,5,0.5
21700143,1610612750,1610612766,112.0,94.0,0.4579999999999999,0.416,1,2017-11-05,10,7,3,0.7,10,5,5,0.5
21700144,1610612757,1610612760,103.0,99.0,0.5,0.449,1,2017-11-05,10,6,4,0.6,9,4,5,0.444
21700145,1610612747,1610612763,107.0,102.0,0.471,0.46,1,2017-11-05,10,5,5,0.5,10,6,4,0.6
21700131,1610612746,1610612763,104.0,113.0,0.4579999999999999,0.476,0,2017-11-04,8,5,3,0.625,9,6,3,0.667
21700132,1610612765,1610612758,108.0,99.0,0.506,0.526,1,2017-11-04,10,7,3,0.7,9,1,8,0.111
21700133,1610612741,1610612740,90.0,96.0,0.354,0.402,0,2017-11-04,8,2,6,0.25,10,5,5,0.5
21700134,1610612750,1610612742,112.0,99.0,0.544,0.46,1,2017-11-04,9,6,3,0.667,11,1,10,0.091
21700135,1610612743,1610612744,108.0,127.0,0.46,0.5489999999999999,0,2017-11-04,10,5,5,0.5,10,7,3,0.7
21700119,1610612765,1610612749,105.0,96.0,0.474,0.47,1,2017-11-03,9,6,3,0.667,9,4,5,0.444
21700120,1610612753,1610612741,83.0,105.0,0.407,0.471,0,2017-11-03,9,6,3,0.667,7,2,5,0.286
21700121,1610612755,1610612754,121.0,110.0,0.5,0.4639999999999999,1,2017-11-03,9,5,4,0.556,9,5,4,0.556
21700122,1610612764,1610612739,122.0,130.0,0.536,0.561,0,2017-11-03,8,4,4,0.5,9,4,5,0.444
21700123,1610612737,1610612745,104.0,119.0,0.481,0.472,0,2017-11-03,9,1,8,0.111,10,7,3,0.7
21700124,1610612752,1610612756,120.0,107.0,0.517,0.351,1,2017-11-03,8,4,4,0.5,9,4,5,0.444
21700125,1610612742,1610612740,94.0,99.0,0.386,0.4039999999999999,0,2017-11-03,10,1,9,0.1,9,4,5,0.444
21700126,1610612759,1610612766,108.0,101.0,0.47,0.413,1,2017-11-03,9,5,4,0.556,9,5,4,0.556
21700127,1610612743,1610612748,95.0,94.0,0.45,0.4679999999999999,1,2017-11-03,9,5,4,0.556,8,3,5,0.375
21700128,1610612762,1610612761,100.0,109.0,0.4379999999999999,0.535,0,2017-11-03,9,5,4,0.556,8,5,3,0.625
21700129,1610612760,1610612738,94.0,101.0,0.402,0.429,0,2017-11-03,8,4,4,0.5,9,7,2,0.778
21700130,1610612747,1610612751,124.0,112.0,0.511,0.407,1,2017-11-03,9,4,5,0.444,9,3,6,0.3329999999999999
21700117,1610612759,1610612744,92.0,112.0,0.391,0.518,0,2017-11-02,8,4,4,0.5,9,6,3,0.667
21700118,1610612757,1610612747,113.0,110.0,0.465,0.544,1,2017-11-02,9,5,4,0.556,8,3,5,0.375
21700105,1610612766,1610612749,126.0,121.0,0.536,0.495,1,2017-11-01,8,5,3,0.625,8,4,4,0.5
21700106,1610612739,1610612754,107.0,124.0,0.5,0.544,0,2017-11-01,8,3,5,0.375,8,5,3,0.625
21700107,1610612755,1610612737,119.0,109.0,0.465,0.436,1,2017-11-01,8,4,4,0.5,8,1,7,0.125
21700108,1610612764,1610612756,116.0,122.0,0.446,0.494,0,2017-11-01,7,4,3,0.5710000000000001,8,4,4,0.5
21700109,1610612738,1610612758,113.0,86.0,0.488,0.4320000000000001,1,2017-11-01,8,6,2,0.75,8,1,7,0.125
21700110,1610612748,1610612741,97.0,91.0,0.41,0.4039999999999999,1,2017-11-01,7,3,4,0.429,6,1,5,0.1669999999999999
21700111,1610612752,1610612745,97.0,119.0,0.433,0.477,0,2017-11-01,7,3,4,0.429,9,6,3,0.667
21700112,1610612763,1610612753,99.0,101.0,0.476,0.507,0,2017-11-01,8,5,3,0.625,8,6,2,0.75
21700113,1610612740,1610612750,98.0,104.0,0.429,0.494,0,2017-11-01,8,3,5,0.375,8,5,3,0.625
21700114,1610612743,1610612761,129.0,111.0,0.534,0.494,1,2017-11-01,8,4,4,0.5,7,4,3,0.5710000000000001
21700115,1610612762,1610612757,112.0,103.0,0.3779999999999999,0.3979999999999999,1,2017-11-01,8,5,3,0.625,8,4,4,0.5
21700116,1610612746,1610612742,119.0,98.0,0.526,0.3929999999999999,1,2017-11-01,7,5,2,0.7140000000000001,9,1,8,0.111
21700101,1610612754,1610612758,101.0,83.0,0.424,0.42,1,2017-10-31,7,4,3,0.5710000000000001,7,1,6,0.143
21700102,1610612751,1610612756,114.0,122.0,0.412,0.469,0,2017-10-31,8,3,5,0.375,7,3,4,0.429
21700103,1610612749,1610612760,91.0,110.0,0.416,0.494,0,2017-10-31,7,4,3,0.5710000000000001,7,4,3,0.5710000000000001
21700104,1610612747,1610612765,113.0,93.0,0.495,0.436,1,2017-10-31,7,3,4,0.429,8,5,3,0.625
21700092,1610612738,1610612759,108.0,94.0,0.477,0.414,1,2017-10-30,7,5,2,0.7140000000000001,7,4,3,0.5710000000000001
21700093,1610612748,1610612750,122.0,125.0,0.527,0.451,0,2017-10-30,6,2,4,0.3329999999999999,7,4,3,0.5710000000000001
21700094,1610612752,1610612743,116.0,110.0,0.5,0.412,1,2017-10-30,6,3,3,0.5,7,3,4,0.429
21700095,1610612745,1610612755,107.0,115.0,0.3979999999999999,0.55,0,2017-10-30,8,5,3,0.625,7,3,4,0.429
21700096,1610612763,1610612766,99.0,104.0,0.344,0.416,0,2017-10-30,7,5,2,0.7140000000000001,7,4,3,0.5710000000000001
21700097,1610612740,1610612753,99.0,115.0,0.4589999999999999,0.506,0,2017-10-30,7,3,4,0.429,7,5,2,0.7140000000000001
21700098,1610612762,1610612742,104.0,89.0,0.469,0.447,1,2017-10-30,7,4,3,0.5710000000000001,8,1,7,0.125
21700099,1610612757,1610612761,85.0,99.0,0.3879999999999999,0.4479999999999999,0,2017-10-30,7,4,3,0.5710000000000001,6,4,2,0.667
21700100,1610612746,1610612744,113.0,141.0,0.4529999999999999,0.584,0,2017-10-30,6,4,2,0.667,8,5,3,0.625
21700085,1610612737,1610612749,106.0,117.0,0.4679999999999999,0.5429999999999999,0,2017-10-29,7,1,6,0.143,6,4,2,0.667
21700086,1610612754,1610612759,97.0,94.0,0.4679999999999999,0.4,1,2017-10-29,6,3,3,0.5,6,4,2,0.667
21700087,1610612751,1610612743,111.0,124.0,0.406,0.5,0,2017-10-29,7,3,4,0.429,6,3,3,0.5
21700088,1610612766,1610612753,120.0,113.0,0.546,0.423,1,2017-10-29,6,3,3,0.5,6,4,2,0.667
21700089,1610612758,1610612764,83.0,110.0,0.39,0.471,0,2017-10-29,6,1,5,0.1669999999999999,6,4,2,0.667
21700090,1610612739,1610612752,95.0,114.0,0.3829999999999999,0.472,0,2017-10-29,7,3,4,0.429,5,2,3,0.4
21700091,1610612744,1610612765,107.0,115.0,0.5710000000000001,0.462,0,2017-10-29,7,4,3,0.5710000000000001,7,5,2,0.7140000000000001
21700077,1610612740,1610612739,123.0,101.0,0.516,0.462,1,2017-10-28,6,3,3,0.5,6,3,3,0.5
21700078,1610612748,1610612738,90.0,96.0,0.43,0.42,0,2017-10-28,5,2,3,0.4,6,4,2,0.667
21700079,1610612741,1610612760,69.0,101.0,0.282,0.4429999999999999,0,2017-10-28,5,1,4,0.2,6,3,3,0.5
21700080,1610612763,1610612745,103.0,89.0,0.471,0.377,1,2017-10-28,6,5,1,0.833,7,5,2,0.7140000000000001
21700081,1610612742,1610612755,110.0,112.0,0.514,0.494,0,2017-10-28,7,1,6,0.143,6,2,4,0.3329999999999999
21700082,1610612762,1610612747,96.0,81.0,0.4679999999999999,0.3829999999999999,1,2017-10-28,6,3,3,0.5,6,2,4,0.3329999999999999
21700083,1610612757,1610612756,114.0,107.0,0.44,0.425,1,2017-10-28,6,4,2,0.667,6,2,4,0.3329999999999999
21700084,1610612746,1610612765,87.0,95.0,0.3329999999999999,0.409,0,2017-10-28,5,4,1,0.8,6,4,2,0.667
21700070,1610612766,1610612745,93.0,109.0,0.375,0.447,0,2017-10-27,5,2,3,0.4,6,5,1,0.833
21700071,1610612753,1610612759,114.0,87.0,0.5710000000000001,0.337,1,2017-10-27,5,4,1,0.8,5,4,1,0.8
21700072,1610612737,1610612743,100.0,105.0,0.416,0.462,0,2017-10-27,6,1,5,0.1669999999999999,5,2,3,0.4
21700073,1610612752,1610612751,107.0,86.0,0.449,0.4,1,2017-10-27,4,1,3,0.25,6,3,3,0.5
21700074,1610612750,1610612760,119.0,116.0,0.488,0.5,1,2017-10-27,6,3,3,0.5,5,2,3,0.4
21700075,1610612744,1610612764,120.0,117.0,0.484,0.4429999999999999,1,2017-10-27,6,4,2,0.667,5,3,2,0.6
21700076,1610612747,1610612761,92.0,101.0,0.456,0.43,0,2017-10-27,5,2,3,0.4,5,3,2,0.6
21700065,1610612741,1610612737,91.0,86.0,0.36,0.395,1,2017-10-26,4,1,3,0.25,5,1,4,0.2
21700066,1610612763,1610612742,96.0,91.0,0.411,0.34,1,2017-10-26,5,4,1,0.8,6,1,5,0.1669999999999999
21700067,1610612749,1610612738,89.0,96.0,0.455,0.423,0,2017-10-26,5,3,2,0.6,5,3,2,0.6
21700068,1610612757,1610612746,103.0,104.0,0.3929999999999999,0.4679999999999999,0,2017-10-26,5,3,2,0.6,4,4,0,1.0
21700069,1610612758,1610612740,106.0,114.0,0.469,0.488,0,2017-10-26,5,1,4,0.2,5,2,3,0.4
21700055,1610612766,1610612743,110.0,93.0,0.469,0.38,1,2017-10-25,4,2,2,0.5,4,1,3,0.25
21700056,1610612765,1610612750,122.0,101.0,0.522,0.435,1,2017-10-25,5,3,2,0.6,5,2,3,0.4
21700057,1610612755,1610612745,104.0,105.0,0.4429999999999999,0.48,0,2017-10-25,5,1,4,0.2,5,4,1,0.8
21700058,1610612751,1610612739,112.0,107.0,0.43,0.481,1,2017-10-25,5,3,2,0.6,5,3,2,0.6
21700059,1610612748,1610612759,100.0,117.0,0.4629999999999999,0.5529999999999999,0,2017-10-25,4,2,2,0.5,4,4,0,1.0
21700060,1610612760,1610612754,114.0,96.0,0.483,0.337,1,2017-10-25,4,2,2,0.5,5,2,3,0.4
21700061,1610612742,1610612763,103.0,94.0,0.486,0.4579999999999999,1,2017-10-25,5,1,4,0.2,4,3,1,0.75
21700062,1610612756,1610612762,97.0,88.0,0.4379999999999999,0.416,1,2017-10-25,5,2,3,0.4,5,2,3,0.4
21700063,1610612744,1610612761,117.0,112.0,0.5579999999999999,0.457,1,2017-10-25,5,3,2,0.6,4,2,2,0.5
21700064,1610612747,1610612764,102.0,99.0,0.446,0.411,1,2017-10-25,4,2,2,0.5,4,3,1,0.75
21700049,1610612739,1610612741,119.0,112.0,0.518,0.477,1,2017-10-24,4,3,1,0.75,3,0,3,0.0
21700050,1610612753,1610612751,125.0,121.0,0.494,0.417,1,2017-10-24,4,3,1,0.75,4,2,2,0.5
21700051,1610612738,1610612752,110.0,89.0,0.493,0.424,1,2017-10-24,4,2,2,0.5,3,0,3,0.0
21700052,1610612750,1610612754,107.0,130.0,0.488,0.667,0,2017-10-24,4,2,2,0.5,4,2,2,0.5
21700053,1610612757,1610612740,103.0,93.0,0.375,0.395,1,2017-10-24,4,3,1,0.75,4,1,3,0.25
21700054,1610612746,1610612762,102.0,84.0,0.47,0.43,1,2017-10-24,3,3,0,1.0,4,2,2,0.5
21700041,1610612765,1610612755,86.0,97.0,0.3879999999999999,0.467,0,2017-10-23,4,2,2,0.5,4,1,3,0.25
21700042,1610612748,1610612737,104.0,93.0,0.4589999999999999,0.474,1,2017-10-23,3,2,1,0.667,4,1,3,0.25
21700043,1610612745,1610612763,90.0,98.0,0.416,0.426,0,2017-10-23,4,3,1,0.75,3,3,0,1.0
21700044,1610612749,1610612766,103.0,94.0,0.471,0.423,1,2017-10-23,4,3,1,0.75,3,1,2,0.3329999999999999
21700045,1610612742,1610612744,103.0,133.0,0.396,0.5579999999999999,0,2017-10-23,4,0,4,0.0,4,2,2,0.5
21700046,1610612759,1610612761,101.0,97.0,0.444,0.425,1,2017-10-23,3,3,0,1.0,3,2,1,0.667
21700047,1610612743,1610612764,104.0,109.0,0.488,0.44,0,2017-10-23,3,1,2,0.3329999999999999,3,3,0,1.0
21700048,1610612756,1610612758,117.0,115.0,0.545,0.434,1,2017-10-23,4,1,3,0.25,4,1,3,0.25
21700038,1610612751,1610612737,116.0,104.0,0.471,0.34,1,2017-10-22,3,2,1,0.667,3,1,2,0.3329999999999999
21700039,1610612760,1610612750,113.0,115.0,0.479,0.5,0,2017-10-22,3,1,2,0.3329999999999999,3,2,1,0.667
21700040,1610612747,1610612740,112.0,119.0,0.489,0.5660000000000001,0,2017-10-22,3,1,2,0.3329999999999999,3,1,2,0.3329999999999999
21700027,1610612761,1610612755,128.0,94.0,0.472,0.39,1,2017-10-21,2,2,0,1.0,3,0,3,0.0
21700028,1610612739,1610612753,93.0,114.0,0.384,0.444,0,2017-10-21,3,2,1,0.667,3,2,1,0.667
21700029,1610612748,1610612754,112.0,108.0,0.517,0.4479999999999999,1,2017-10-21,2,1,1,0.5,3,1,2,0.3329999999999999
21700030,1610612752,1610612765,107.0,111.0,0.457,0.484,0,2017-10-21,2,0,2,0.0,3,2,1,0.667
21700031,1610612741,1610612759,77.0,87.0,0.3779999999999999,0.409,0,2017-10-21,2,0,2,0.0,2,2,0,1.0
21700032,1610612745,1610612742,107.0,91.0,0.476,0.369,1,2017-10-21,3,3,0,1.0,3,0,3,0.0
21700033,1610612763,1610612744,111.0,101.0,0.4679999999999999,0.3929999999999999,1,2017-10-21,2,2,0,1.0,3,1,2,0.3329999999999999
21700034,1610612749,1610612757,113.0,110.0,0.525,0.42,1,2017-10-21,3,2,1,0.667,3,2,1,0.667
21700035,1610612743,1610612758,96.0,79.0,0.435,0.365,1,2017-10-21,2,1,1,0.5,3,1,2,0.3329999999999999
21700036,1610612762,1610612760,96.0,87.0,0.494,0.41,1,2017-10-21,3,2,1,0.667,2,1,1,0.5
21700037,1610612746,1610612756,130.0,88.0,0.545,0.38,1,2017-10-21,2,2,0,1.0,3,0,3,0.0
21700017,1610612766,1610612737,109.0,91.0,0.43,0.379,1,2017-10-20,2,1,1,0.5,2,1,1,0.5
21700018,1610612754,1610612757,96.0,114.0,0.449,0.484,0,2017-10-20,2,1,1,0.5,2,2,0,1.0
21700019,1610612755,1610612738,92.0,102.0,0.38,0.417,0,2017-10-20,2,0,2,0.0,3,1,2,0.3329999999999999
21700020,1610612764,1610612765,115.0,111.0,0.5329999999999999,0.494,1,2017-10-20,2,2,0,1.0,2,1,1,0.5
21700021,1610612749,1610612739,97.0,116.0,0.4629999999999999,0.5429999999999999,0,2017-10-20,2,1,1,0.5,2,2,0,1.0
21700022,1610612751,1610612753,126.0,121.0,0.5,0.506,1,2017-10-20,2,1,1,0.5,2,1,1,0.5
21700023,1610612750,1610612762,100.0,97.0,0.444,0.481,1,2017-10-20,2,1,1,0.5,2,1,1,0.5
21700024,1610612742,1610612758,88.0,93.0,0.413,0.425,0,2017-10-20,2,0,2,0.0,2,1,1,0.5
21700025,1610612740,1610612744,120.0,128.0,0.4589999999999999,0.516,0,2017-10-20,2,0,2,0.0,2,1,1,0.5
21700026,1610612756,1610612747,130.0,132.0,0.489,0.516,0,2017-10-20,2,0,2,0.0,2,1,1,0.5
21700014,1610612761,1610612741,117.0,100.0,0.47,0.416,1,2017-10-19,1,1,0,1.0,1,0,1,0.0
21700015,1610612760,1610612752,105.0,84.0,0.433,0.405,1,2017-10-19,1,1,0,1.0,1,0,1,0.0
21700016,1610612747,1610612746,92.0,108.0,0.407,0.3929999999999999,0,2017-10-19,1,0,1,0.0,1,1,0,1.0
21700003,1610612765,1610612766,102.0,90.0,0.4270000000000001,0.397,1,2017-10-18,1,1,0,1.0,1,0,1,0.0
21700004,1610612754,1610612751,140.0,131.0,0.52,0.479,1,2017-10-18,1,1,0,1.0,1,0,1,0.0
21700005,1610612753,1610612748,116.0,109.0,0.478,0.436,1,2017-10-18,1,1,0,1.0,1,0,1,0.0
21700006,1610612764,1610612755,120.0,115.0,0.433,0.462,1,2017-10-18,1,1,0,1.0,1,0,1,0.0
21700007,1610612738,1610612749,100.0,108.0,0.429,0.5,0,2017-10-18,2,0,2,0.0,1,1,0,1.0
21700008,1610612763,1610612740,103.0,91.0,0.424,0.38,1,2017-10-18,1,1,0,1.0,1,0,1,0.0
21700009,1610612742,1610612737,111.0,117.0,0.442,0.511,0,2017-10-18,1,0,1,0.0,1,1,0,1.0
21700010,1610612762,1610612743,106.0,96.0,0.506,0.4679999999999999,1,2017-10-18,1,1,0,1.0,1,0,1,0.0
21700011,1610612759,1610612750,107.0,99.0,0.461,0.435,1,2017-10-18,1,1,0,1.0,1,0,1,0.0
21700012,1610612756,1610612757,76.0,124.0,0.315,0.489,0,2017-10-18,1,0,1,0.0,1,1,0,1.0
21700013,1610612758,1610612745,100.0,105.0,0.477,0.3979999999999999,0,2017-10-18,1,0,1,0.0,2,2,0,1.0
21700001,1610612739,1610612738,102.0,99.0,0.4579999999999999,0.409,1,2017-10-17,1,1,0,1.0,1,0,1,0.0
21700002,1610612744,1610612745,121.0,122.0,0.5379999999999999,0.485,0,2017-10-17,1,0,1,0.0,1,1,0,1.0
11700067,1610612766,1610612742,111.0,96.0,0.494,0.412,1,2017-10-13,5,2,3,0.4,6,4,2,0.667
11700069,1610612753,1610612739,106.0,113.0,0.477,0.5,0,2017-10-13,6,3,3,0.5,5,1,4,0.2
11700075,1610612752,1610612764,103.0,110.0,0.4579999999999999,0.526,0,2017-10-13,5,0,5,0.0,5,4,1,0.8
11700070,1610612741,1610612761,104.0,125.0,0.487,0.511,0,2017-10-13,6,3,3,0.5,5,3,2,0.6
11700071,1610612763,1610612740,142.0,101.0,0.5529999999999999,0.447,1,2017-10-13,5,3,2,0.6,4,1,3,0.25
11700072,1610612745,1610612759,97.0,106.0,0.386,0.529,0,2017-10-13,5,4,1,0.8,5,3,2,0.6
11700068,1610612755,1610612748,119.0,95.0,0.467,0.3979999999999999,1,2017-10-13,5,2,3,0.4,6,3,3,0.5
11700076,1610612749,1610612765,107.0,103.0,0.4679999999999999,0.418,1,2017-10-13,4,1,3,0.25,5,2,3,0.4
11700077,1610612744,1610612758,117.0,106.0,0.469,0.482,1,2017-10-13,4,2,2,0.5,6,1,5,0.1669999999999999
11700078,1610612746,1610612747,104.0,111.0,0.439,0.489,0,2017-10-13,5,2,3,0.4,6,2,4,0.3329999999999999
11700065,1610612737,1610612742,94.0,108.0,0.3879999999999999,0.494,0,2017-10-12,5,2,3,0.4,5,4,1,0.8
11700066,1610612746,1610612758,104.0,87.0,0.52,0.4029999999999999,1,2017-10-12,4,2,2,0.5,5,1,4,0.2
11700060,1610612766,1610612738,100.0,108.0,0.42,0.506,0,2017-10-11,4,1,3,0.25,4,4,0,1.0
11700062,1610612751,1610612755,114.0,133.0,0.4429999999999999,0.511,0,2017-10-11,4,3,1,0.75,4,1,3,0.25
11700063,1610612748,1610612764,117.0,115.0,0.494,0.5,1,2017-10-11,5,3,2,0.6,4,3,1,0.75
11700064,1610612763,1610612745,89.0,101.0,0.38,0.3879999999999999,0,2017-10-11,4,2,2,0.5,4,4,0,1.0
11700061,1610612756,1610612757,104.0,113.0,0.3779999999999999,0.415,0,2017-10-11,4,1,3,0.25,5,4,1,0.8
11700054,1610612761,1610612765,116.0,94.0,0.519,0.44,1,2017-10-10,4,2,2,0.5,4,2,2,0.5
11700059,1610612739,1610612741,94.0,108.0,0.405,0.433,0,2017-10-10,4,0,4,0.0,5,3,2,0.6
11700057,1610612759,1610612753,98.0,103.0,0.473,0.44,0,2017-10-10,4,2,2,0.5,5,3,2,0.6
11700056,1610612743,1610612760,86.0,96.0,0.341,0.429,0,2017-10-10,5,3,2,0.6,4,3,1,0.75
11700058,1610612747,1610612762,99.0,105.0,0.444,0.4629999999999999,0,2017-10-10,5,1,4,0.2,5,5,0,1.0
11700046,1610612765,1610612754,107.0,97.0,0.494,0.547,1,2017-10-09,3,2,1,0.667,3,2,1,0.667
11700048,1610612738,1610612755,113.0,96.0,0.3979999999999999,0.44,1,2017-10-09,3,3,0,1.0,3,0,3,0.0
11700049,1610612752,1610612745,95.0,117.0,0.4479999999999999,0.541,0,2017-10-09,4,0,4,0.0,3,3,0,1.0
11700050,1610612737,1610612763,100.0,88.0,0.455,0.4320000000000001,1,2017-10-09,4,2,2,0.5,3,2,1,0.667
11700051,1610612748,1610612766,109.0,106.0,0.494,0.451,1,2017-10-09,4,2,2,0.5,3,1,2,0.3329999999999999
11700052,1610612742,1610612753,99.0,96.0,0.4379999999999999,0.414,1,2017-10-09,4,3,1,0.75,4,2,2,0.5
11700047,1610612756,1610612762,102.0,120.0,0.456,0.527,0,2017-10-09,3,1,2,0.3329999999999999,4,4,0,1.0
11700053,1610612758,1610612757,83.0,97.0,0.39,0.421,0,2017-10-09,4,1,3,0.25,4,3,1,0.75
11700044,1610612750,1610612744,110.0,142.0,0.493,0.6,0,2017-10-08,3,2,1,0.667,3,1,2,0.3329999999999999
11700040,1610612764,1610612739,102.0,94.0,0.43,0.462,1,2017-10-08,3,3,0,1.0,3,0,3,0.0
11700038,1610612746,1610612757,106.0,134.0,0.402,0.529,0,2017-10-08,3,1,2,0.3329999999999999,3,2,1,0.667
11700041,1610612759,1610612743,122.0,100.0,0.57,0.4039999999999999,1,2017-10-08,3,2,1,0.667,4,3,1,0.75
11700042,1610612741,1610612740,95.0,108.0,0.368,0.42,0,2017-10-08,4,2,2,0.5,3,1,2,0.3329999999999999
11700045,1610612751,1610612752,117.0,83.0,0.5,0.3779999999999999,1,2017-10-08,3,3,0,1.0,3,0,3,0.0
11700043,1610612747,1610612758,75.0,69.0,0.414,0.313,1,2017-10-08,4,1,3,0.25,3,1,2,0.3329999999999999
11700037,1610612753,1610612748,93.0,90.0,0.4629999999999999,0.364,1,2017-10-07,3,2,1,0.667,3,1,2,0.3329999999999999
11700029,1610612755,1610612738,102.0,110.0,0.47,0.402,0,2017-10-06,2,0,2,0.0,2,2,0,1.0
11700030,1610612764,1610612752,104.0,100.0,0.465,0.455,1,2017-10-06,2,2,0,1.0,2,0,2,0.0
11700031,1610612765,1610612737,109.0,87.0,0.489,0.365,1,2017-10-06,2,1,1,0.5,3,1,2,0.3329999999999999
11700035,1610612739,1610612754,102.0,106.0,0.46,0.47,0,2017-10-06,2,0,2,0.0,2,2,0,1.0
11700032,1610612741,1610612749,114.0,101.0,0.518,0.4679999999999999,1,2017-10-06,3,2,1,0.667,3,0,3,0.0
11700033,1610612760,1610612740,102.0,91.0,0.486,0.39,1,2017-10-06,2,1,1,0.5,2,0,2,0.0
11700036,1610612759,1610612758,113.0,93.0,0.5539999999999999,0.452,1,2017-10-06,2,1,1,0.5,2,1,1,0.5
11700034,1610612762,1610612756,112.0,101.0,0.412,0.4320000000000001,1,2017-10-06,3,3,0,1.0,2,1,1,0.5
11700024,1610612744,1610612750,95.0,111.0,0.4629999999999999,0.42,0,2017-10-05,2,0,2,0.0,2,2,0,1.0
11700025,1610612753,1610612742,112.0,89.0,0.477,0.33,1,2017-10-05,2,1,1,0.5,3,2,1,0.667
11700028,1610612751,1610612748,107.0,88.0,0.452,0.3720000000000001,1,2017-10-05,2,2,0,1.0,2,1,1,0.5
11700027,1610612757,1610612761,106.0,101.0,0.4270000000000001,0.4,1,2017-10-05,2,1,1,0.5,3,1,2,0.3329999999999999
11700015,1610612746,1610612761,98.0,84.0,0.479,0.384,1,2017-10-04,2,1,1,0.5,2,1,1,0.5
11700017,1610612755,1610612763,89.0,110.0,0.348,0.462,0,2017-10-04,1,0,1,0.0,2,2,0,1.0
11700018,1610612739,1610612737,93.0,109.0,0.386,0.481,0,2017-10-04,1,0,1,0.0,2,1,1,0.5
11700019,1610612765,1610612766,104.0,109.0,0.47,0.4479999999999999,0,2017-10-04,1,0,1,0.0,2,1,1,0.5
11700020,1610612749,1610612754,86.0,104.0,0.3879999999999999,0.426,0,2017-10-04,2,0,2,0.0,1,1,0,1.0
11700023,1610612742,1610612741,118.0,71.0,0.5,0.346,1,2017-10-04,2,2,0,1.0,2,1,1,0.5
11700022,1610612747,1610612743,104.0,122.0,0.513,0.5329999999999999,0,2017-10-04,3,0,3,0.0,3,3,0,1.0
11700016,1610612752,1610612751,107.0,115.0,0.3829999999999999,0.4370000000000001,0,2017-10-03,1,0,1,0.0,1,1,0,1.0
11700012,1610612740,1610612741,109.0,113.0,0.4679999999999999,0.494,0,2017-10-03,1,0,1,0.0,1,1,0,1.0
11700013,1610612760,1610612745,97.0,104.0,0.408,0.423,0,2017-10-03,1,0,1,0.0,1,1,0,1.0
11700014,1610612757,1610612756,112.0,114.0,0.41,0.451,0,2017-10-03,1,0,1,0.0,1,1,0,1.0
11700008,1610612738,1610612766,94.0,82.0,0.418,0.375,1,2017-10-02,1,1,0,1.0,1,0,1,0.0
11700006,1610612763,1610612753,92.0,84.0,0.4,0.364,1,2017-10-02,1,1,0,1.0,1,0,1,0.0
11700009,1610612742,1610612749,106.0,104.0,0.47,0.494,1,2017-10-02,1,1,0,1.0,1,0,1,0.0
11700010,1610612758,1610612759,106.0,96.0,0.512,0.415,1,2017-10-02,1,1,0,1.0,1,0,1,0.0
11700011,1610612747,1610612743,107.0,113.0,0.452,0.4529999999999999,0,2017-10-02,2,0,2,0.0,2,2,0,1.0
11700004,1610612748,1610612737,96.0,90.0,0.486,0.356,1,2017-10-01,1,1,0,1.0,1,0,1,0.0
11700003,1610612761,1610612746,121.0,113.0,0.5,0.449,1,2017-10-01,1,1,0,1.0,1,0,1,0.0
11700001,1610612744,1610612743,102.0,108.0,0.411,0.444,0,2017-09-30,1,0,1,0.0,1,1,0,1.0
11700002,1610612747,1610612750,99.0,108.0,0.441,0.416,0,2017-09-30,1,0,1,0.0,1,1,0,1.0
41600405,1610612744,1610612739,129.0,120.0,0.511,0.534,1,2017-06-12,82,67,15,0.8170000000000001,82,51,31,0.622
41600404,1610612739,1610612744,137.0,116.0,0.529,0.4479999999999999,1,2017-06-09,82,51,31,0.622,82,67,15,0.8170000000000001
41600403,1610612739,1610612744,113.0,118.0,0.444,0.482,0,2017-06-07,82,51,31,0.622,82,67,15,0.8170000000000001
41600402,1610612744,1610612739,132.0,113.0,0.517,0.45,1,2017-06-04,82,67,15,0.8170000000000001,82,51,31,0.622
41600401,1610612744,1610612739,113.0,91.0,0.425,0.349,1,2017-06-01,82,67,15,0.8170000000000001,82,51,31,0.622
41600305,1610612738,1610612739,102.0,135.0,0.43,0.565,0,2017-05-25,82,53,29,0.6459999999999999,82,51,31,0.622
41600304,1610612739,1610612738,112.0,99.0,0.595,0.4429999999999999,1,2017-05-23,82,51,31,0.622,82,53,29,0.6459999999999999
41600314,1610612759,1610612744,115.0,129.0,0.418,0.5579999999999999,0,2017-05-22,82,61,21,0.7440000000000001,82,67,15,0.8170000000000001
41600303,1610612739,1610612738,108.0,111.0,0.457,0.462,0,2017-05-21,82,51,31,0.622,82,53,29,0.6459999999999999
41600313,1610612759,1610612744,108.0,120.0,0.473,0.5479999999999999,0,2017-05-20,82,61,21,0.7440000000000001,82,67,15,0.8170000000000001
41600302,1610612738,1610612739,86.0,130.0,0.3720000000000001,0.565,0,2017-05-19,82,53,29,0.6459999999999999,82,51,31,0.622
41600301,1610612738,1610612739,104.0,117.0,0.466,0.481,0,2017-05-17,82,53,29,0.6459999999999999,82,51,31,0.622
41600312,1610612744,1610612759,136.0,100.0,0.562,0.37,1,2017-05-16,82,67,15,0.8170000000000001,82,61,21,0.7440000000000001
41600207,1610612738,1610612764,115.0,105.0,0.532,0.45,1,2017-05-15,82,53,29,0.6459999999999999,82,49,33,0.598
41600311,1610612744,1610612759,113.0,111.0,0.481,0.476,1,2017-05-14,82,67,15,0.8170000000000001,82,61,21,0.7440000000000001
41600206,1610612764,1610612738,92.0,91.0,0.43,0.405,1,2017-05-12,82,49,33,0.598,82,53,29,0.6459999999999999
41600236,1610612745,1610612759,75.0,114.0,0.286,0.531,0,2017-05-11,82,55,27,0.6709999999999999,82,61,21,0.7440000000000001
41600205,1610612738,1610612764,123.0,101.0,0.529,0.385,1,2017-05-10,82,53,29,0.6459999999999999,82,49,33,0.598
41600235,1610612759,1610612745,110.0,107.0,0.408,0.442,1,2017-05-09,82,61,21,0.7440000000000001,82,55,27,0.6709999999999999
41600224,1610612762,1610612744,95.0,121.0,0.371,0.512,0,2017-05-08,82,51,31,0.622,82,67,15,0.8170000000000001
41600214,1610612761,1610612739,102.0,109.0,0.471,0.476,0,2017-05-07,82,51,31,0.622,82,51,31,0.622
41600204,1610612764,1610612738,121.0,102.0,0.524,0.4429999999999999,1,2017-05-07,82,49,33,0.598,82,53,29,0.6459999999999999
41600234,1610612745,1610612759,125.0,104.0,0.526,0.494,1,2017-05-07,82,55,27,0.6709999999999999,82,61,21,0.7440000000000001
41600223,1610612762,1610612744,91.0,102.0,0.39,0.44,0,2017-05-06,82,51,31,0.622,82,67,15,0.8170000000000001
41600213,1610612761,1610612739,94.0,115.0,0.4370000000000001,0.513,0,2017-05-05,82,51,31,0.622,82,51,31,0.622
41600233,1610612745,1610612759,92.0,103.0,0.364,0.4529999999999999,0,2017-05-05,82,55,27,0.6709999999999999,82,61,21,0.7440000000000001
41600203,1610612764,1610612738,116.0,89.0,0.467,0.351,1,2017-05-04,82,49,33,0.598,82,53,29,0.6459999999999999
41600222,1610612744,1610612762,115.0,104.0,0.494,0.452,1,2017-05-04,82,67,15,0.8170000000000001,82,51,31,0.622
41600212,1610612739,1610612761,125.0,103.0,0.547,0.467,1,2017-05-03,82,51,31,0.622,82,51,31,0.622
41600232,1610612759,1610612745,121.0,96.0,0.539,0.446,1,2017-05-03,82,61,21,0.7440000000000001,82,55,27,0.6709999999999999
41600202,1610612738,1610612764,129.0,119.0,0.511,0.465,1,2017-05-02,82,53,29,0.6459999999999999,82,49,33,0.598
41600221,1610612744,1610612762,106.0,94.0,0.488,0.4629999999999999,1,2017-05-02,82,67,15,0.8170000000000001,82,51,31,0.622
41600211,1610612739,1610612761,116.0,105.0,0.4589999999999999,0.4379999999999999,1,2017-05-01,82,51,31,0.622,82,51,31,0.622
41600231,1610612759,1610612745,99.0,126.0,0.369,0.46,0,2017-05-01,82,61,21,0.7440000000000001,82,55,27,0.6709999999999999
41600201,1610612738,1610612764,123.0,111.0,0.511,0.506,1,2017-04-30,82,53,29,0.6459999999999999,82,49,33,0.598
41600177,1610612746,1610612762,91.0,104.0,0.4379999999999999,0.506,0,2017-04-30,82,51,31,0.622,82,51,31,0.622
41600136,1610612737,1610612764,99.0,115.0,0.474,0.5379999999999999,0,2017-04-28,82,43,39,0.524,82,49,33,0.598
41600106,1610612741,1610612738,83.0,105.0,0.395,0.488,0,2017-04-28,82,41,41,0.5,82,53,29,0.6459999999999999
41600176,1610612762,1610612746,93.0,98.0,0.41,0.493,0,2017-04-28,82,51,31,0.622,82,51,31,0.622
41600126,1610612749,1610612761,89.0,92.0,0.4270000000000001,0.457,0,2017-04-27,82,42,40,0.512,82,51,31,0.622
41600156,1610612763,1610612759,96.0,103.0,0.451,0.481,0,2017-04-27,82,43,39,0.524,82,61,21,0.7440000000000001
41600135,1610612764,1610612737,103.0,99.0,0.451,0.409,1,2017-04-26,82,49,33,0.598,82,43,39,0.524
41600105,1610612738,1610612741,108.0,97.0,0.4320000000000001,0.5,1,2017-04-26,82,53,29,0.6459999999999999,82,41,41,0.5
41600165,1610612745,1610612760,105.0,99.0,0.402,0.385,1,2017-04-25,82,55,27,0.6709999999999999,82,47,35,0.573
41600155,1610612759,1610612763,116.0,103.0,0.525,0.514,1,2017-04-25,82,61,21,0.7440000000000001,82,43,39,0.524
41600175,1610612746,1610612762,92.0,96.0,0.42,0.4320000000000001,0,2017-04-25,82,51,31,0.622,82,51,31,0.622
41600125,1610612761,1610612749,118.0,93.0,0.5770000000000001,0.507,1,2017-04-24,82,51,31,0.622,82,42,40,0.512
41600134,1610612737,1610612764,111.0,101.0,0.444,0.424,1,2017-04-24,82,43,39,0.524,82,49,33,0.598
41600144,1610612757,1610612744,103.0,128.0,0.3879999999999999,0.535,0,2017-04-24,82,41,41,0.5,82,67,15,0.8170000000000001
41600114,1610612754,1610612739,102.0,106.0,0.466,0.411,0,2017-04-23,82,42,40,0.512,82,51,31,0.622
41600164,1610612760,1610612745,109.0,113.0,0.494,0.435,0,2017-04-23,82,47,35,0.573,82,55,27,0.6709999999999999
41600104,1610612741,1610612738,95.0,104.0,0.421,0.4629999999999999,0,2017-04-23,82,41,41,0.5,82,53,29,0.6459999999999999
41600174,1610612762,1610612746,105.0,98.0,0.541,0.44,1,2017-04-23,82,51,31,0.622,82,51,31,0.622
41600124,1610612749,1610612761,76.0,87.0,0.37,0.413,0,2017-04-22,82,42,40,0.512,82,51,31,0.622
41600133,1610612737,1610612764,116.0,98.0,0.494,0.416,1,2017-04-22,82,43,39,0.524,82,49,33,0.598
41600154,1610612763,1610612759,110.0,108.0,0.4629999999999999,0.423,1,2017-04-22,82,43,39,0.524,82,61,21,0.7440000000000001
41600143,1610612757,1610612744,113.0,119.0,0.433,0.44,0,2017-04-22,82,41,41,0.5,82,67,15,0.8170000000000001
41600103,1610612741,1610612738,87.0,104.0,0.3929999999999999,0.477,0,2017-04-21,82,41,41,0.5,82,53,29,0.6459999999999999
41600163,1610612760,1610612745,115.0,113.0,0.5539999999999999,0.4579999999999999,1,2017-04-21,82,47,35,0.573,82,55,27,0.6709999999999999
41600173,1610612762,1610612746,106.0,111.0,0.522,0.547,0,2017-04-21,82,51,31,0.622,82,51,31,0.622
41600113,1610612754,1610612739,114.0,119.0,0.4,0.4479999999999999,0,2017-04-20,82,42,40,0.512,82,51,31,0.622
41600123,1610612749,1610612761,104.0,77.0,0.527,0.3379999999999999,1,2017-04-20,82,42,40,0.512,82,51,31,0.622
41600153,1610612763,1610612759,105.0,94.0,0.506,0.472,1,2017-04-20,82,43,39,0.524,82,61,21,0.7440000000000001
41600132,1610612764,1610612737,109.0,101.0,0.4529999999999999,0.405,1,2017-04-19,82,49,33,0.598,82,43,39,0.524
41600162,1610612745,1610612760,115.0,111.0,0.487,0.412,1,2017-04-19,82,55,27,0.6709999999999999,82,47,35,0.573
41600142,1610612744,1610612757,110.0,81.0,0.44,0.3329999999999999,1,2017-04-19,82,67,15,0.8170000000000001,82,41,41,0.5
41600122,1610612761,1610612749,106.0,100.0,0.481,0.414,1,2017-04-18,82,51,31,0.622,82,42,40,0.512
41600102,1610612738,1610612741,97.0,111.0,0.4629999999999999,0.506,0,2017-04-18,82,53,29,0.6459999999999999,82,41,41,0.5
41600172,1610612746,1610612762,99.0,91.0,0.524,0.457,1,2017-04-18,82,51,31,0.622,82,51,31,0.622
41600112,1610612739,1610612754,117.0,111.0,0.5529999999999999,0.512,1,2017-04-17,82,51,31,0.622,82,42,40,0.512
41600152,1610612759,1610612763,96.0,82.0,0.4589999999999999,0.3779999999999999,1,2017-04-17,82,61,21,0.7440000000000001,82,43,39,0.524
41600131,1610612764,1610612737,114.0,107.0,0.45,0.436,1,2017-04-16,82,49,33,0.598,82,43,39,0.524
41600141,1610612744,1610612757,121.0,109.0,0.531,0.43,1,2017-04-16,82,67,15,0.8170000000000001,82,41,41,0.5
41600101,1610612738,1610612741,102.0,106.0,0.43,0.429,0,2017-04-16,82,53,29,0.6459999999999999,82,41,41,0.5
41600161,1610612745,1610612760,118.0,87.0,0.495,0.37,1,2017-04-16,82,55,27,0.6709999999999999,82,47,35,0.573
41600111,1610612739,1610612754,109.0,108.0,0.5379999999999999,0.494,1,2017-04-15,82,51,31,0.622,82,42,40,0.512
41600121,1610612761,1610612749,83.0,97.0,0.36,0.447,0,2017-04-15,82,51,31,0.622,82,42,40,0.512
41600151,1610612759,1610612763,111.0,82.0,0.539,0.392,1,2017-04-15,82,61,21,0.7440000000000001,82,43,39,0.524
41600171,1610612746,1610612762,95.0,97.0,0.444,0.481,0,2017-04-15,82,51,31,0.622,82,51,31,0.622
21601217,1610612753,1610612765,113.0,109.0,0.483,0.387,1,2017-04-12,82,29,53,0.354,82,37,45,0.451
21601218,1610612739,1610612761,83.0,98.0,0.368,0.465,0,2017-04-12,82,51,31,0.622,82,51,31,0.622
21601219,1610612738,1610612749,112.0,94.0,0.456,0.44,1,2017-04-12,82,53,29,0.6459999999999999,82,42,40,0.512
21601220,1610612752,1610612755,114.0,113.0,0.494,0.495,1,2017-04-12,82,31,51,0.3779999999999999,82,28,54,0.341
21601221,1610612748,1610612764,110.0,102.0,0.523,0.483,1,2017-04-12,82,41,41,0.5,82,49,33,0.598
21601222,1610612741,1610612751,112.0,73.0,0.4320000000000001,0.326,1,2017-04-12,82,41,41,0.5,82,20,62,0.244
21601223,1610612763,1610612742,93.0,100.0,0.3929999999999999,0.44,0,2017-04-12,82,43,39,0.524,82,33,49,0.402
21601224,1610612745,1610612750,123.0,118.0,0.4639999999999999,0.527,1,2017-04-12,82,55,27,0.6709999999999999,82,31,51,0.3779999999999999
21601225,1610612760,1610612743,105.0,111.0,0.426,0.4589999999999999,0,2017-04-12,82,47,35,0.573,82,40,42,0.488
21601226,1610612754,1610612737,104.0,86.0,0.476,0.417,1,2017-04-12,82,42,40,0.512,82,43,39,0.524
21601227,1610612762,1610612759,101.0,97.0,0.506,0.4529999999999999,1,2017-04-12,82,51,31,0.622,82,61,21,0.7440000000000001
21601228,1610612746,1610612758,115.0,95.0,0.518,0.494,1,2017-04-12,82,51,31,0.622,82,32,50,0.39
21601229,1610612744,1610612747,109.0,94.0,0.456,0.441,1,2017-04-12,82,67,15,0.8170000000000001,82,26,56,0.317
21601230,1610612757,1610612740,100.0,103.0,0.482,0.444,0,2017-04-12,82,41,41,0.5,82,34,48,0.415
21601212,1610612737,1610612766,103.0,76.0,0.519,0.33,1,2017-04-11,81,43,38,0.531,82,36,46,0.439
21601213,1610612750,1610612760,98.0,100.0,0.442,0.43,0,2017-04-11,81,31,50,0.3829999999999999,81,47,34,0.58
21601214,1610612742,1610612743,91.0,109.0,0.3979999999999999,0.488,0,2017-04-11,81,32,49,0.395,81,39,42,0.481
21601215,1610612747,1610612740,108.0,96.0,0.477,0.4679999999999999,1,2017-04-11,81,26,55,0.321,81,33,48,0.407
21601216,1610612758,1610612756,129.0,104.0,0.518,0.376,1,2017-04-11,81,32,49,0.395,82,24,58,0.293
21601203,1610612755,1610612754,111.0,120.0,0.467,0.5760000000000001,0,2017-04-10,81,28,53,0.346,81,41,40,0.506
21601204,1610612738,1610612751,114.0,105.0,0.451,0.36,1,2017-04-10,81,52,29,0.642,81,20,61,0.247
21601205,1610612748,1610612739,124.0,121.0,0.4629999999999999,0.494,1,2017-04-10,81,40,41,0.494,81,51,30,0.63
21601206,1610612741,1610612753,122.0,75.0,0.539,0.345,1,2017-04-10,81,40,41,0.494,81,28,53,0.346
21601207,1610612749,1610612766,89.0,79.0,0.449,0.407,1,2017-04-10,81,42,39,0.519,81,36,45,0.444
21601208,1610612765,1610612764,101.0,105.0,0.457,0.506,0,2017-04-10,81,37,44,0.457,81,49,32,0.605
21601209,1610612757,1610612759,99.0,98.0,0.416,0.4579999999999999,1,2017-04-10,81,41,40,0.506,81,61,20,0.753
21601210,1610612746,1610612745,125.0,96.0,0.505,0.3929999999999999,1,2017-04-10,81,50,31,0.617,81,54,27,0.667
21601211,1610612744,1610612762,99.0,105.0,0.488,0.446,0,2017-04-10,81,66,15,0.815,81,50,31,0.617
21601196,1610612752,1610612761,97.0,110.0,0.451,0.519,0,2017-04-09,81,30,51,0.37,81,50,31,0.617
21601197,1610612737,1610612739,126.0,125.0,0.4679999999999999,0.4589999999999999,1,2017-04-09,80,42,38,0.525,80,51,29,0.638
21601198,1610612743,1610612760,105.0,106.0,0.476,0.417,0,2017-04-09,80,38,42,0.475,80,46,34,0.575
21601199,1610612756,1610612742,124.0,111.0,0.55,0.423,1,2017-04-09,81,24,57,0.296,80,32,48,0.4
21601200,1610612758,1610612745,128.0,135.0,0.5,0.563,0,2017-04-09,80,31,49,0.3879999999999999,80,54,26,0.675
21601201,1610612763,1610612765,90.0,103.0,0.48,0.476,0,2017-04-09,81,43,38,0.531,80,37,43,0.4629999999999999
21601202,1610612747,1610612750,110.0,109.0,0.488,0.5,1,2017-04-09,80,25,55,0.313,80,31,49,0.3879999999999999
21601188,1610612751,1610612741,107.0,106.0,0.424,0.444,1,2017-04-08,80,20,60,0.25,80,39,41,0.488
21601189,1610612766,1610612738,114.0,121.0,0.452,0.517,0,2017-04-08,80,36,44,0.45,80,51,29,0.638
21601190,1610612753,1610612754,112.0,127.0,0.488,0.593,0,2017-04-08,80,28,52,0.35,80,40,40,0.5
21601191,1610612755,1610612749,82.0,90.0,0.351,0.4429999999999999,0,2017-04-08,80,28,52,0.35,80,41,39,0.513
21601192,1610612764,1610612748,103.0,106.0,0.481,0.4629999999999999,0,2017-04-08,80,48,32,0.6,80,39,41,0.488
21601193,1610612759,1610612746,87.0,98.0,0.425,0.5,0,2017-04-08,80,61,19,0.763,80,49,31,0.613
21601194,1610612757,1610612762,101.0,86.0,0.407,0.397,1,2017-04-08,80,40,40,0.5,80,49,31,0.613
21601195,1610612744,1610612740,123.0,101.0,0.51,0.488,1,2017-04-08,80,66,14,0.825,80,33,47,0.413
21601179,1610612739,1610612737,100.0,114.0,0.481,0.506,0,2017-04-07,79,51,28,0.6459999999999999,79,41,38,0.519
21601180,1610612761,1610612748,96.0,94.0,0.412,0.3979999999999999,1,2017-04-07,80,49,31,0.613,79,38,41,0.481
21601181,1610612763,1610612752,101.0,88.0,0.507,0.4320000000000001,1,2017-04-07,80,43,37,0.5379999999999999,80,30,50,0.375
21601182,1610612745,1610612765,109.0,114.0,0.414,0.426,0,2017-04-07,79,53,26,0.6709999999999999,79,36,43,0.456
21601183,1610612742,1610612759,89.0,102.0,0.4320000000000001,0.417,0,2017-04-07,79,32,47,0.405,79,61,18,0.772
21601184,1610612743,1610612740,122.0,106.0,0.551,0.475,1,2017-04-07,79,38,41,0.481,79,33,46,0.418
21601185,1610612762,1610612750,120.0,113.0,0.6,0.494,1,2017-04-07,79,49,30,0.62,79,31,48,0.392
21601186,1610612756,1610612760,120.0,99.0,0.518,0.37,1,2017-04-07,80,23,57,0.288,79,45,34,0.57
21601187,1610612747,1610612758,98.0,94.0,0.442,0.507,1,2017-04-07,79,24,55,0.304,79,31,48,0.392
21601173,1610612755,1610612741,90.0,102.0,0.363,0.429,0,2017-04-06,79,28,51,0.354,79,39,40,0.494
21601174,1610612753,1610612751,115.0,107.0,0.467,0.46,1,2017-04-06,79,28,51,0.354,79,19,60,0.241
21601175,1610612754,1610612749,104.0,89.0,0.475,0.465,1,2017-04-06,79,39,40,0.494,79,40,39,0.506
21601176,1610612752,1610612764,103.0,106.0,0.421,0.486,0,2017-04-06,79,30,49,0.38,79,48,31,0.608
21601177,1610612737,1610612738,123.0,116.0,0.494,0.411,1,2017-04-06,78,40,38,0.513,79,50,29,0.633
21601178,1610612757,1610612750,105.0,98.0,0.4320000000000001,0.4370000000000001,1,2017-04-06,79,39,40,0.494,78,31,47,0.397
21601165,1610612766,1610612748,99.0,112.0,0.449,0.476,0,2017-04-05,79,36,43,0.456,78,38,40,0.487
21601166,1610612765,1610612761,102.0,105.0,0.519,0.471,0,2017-04-05,78,35,43,0.449,79,48,31,0.608
21601167,1610612763,1610612760,100.0,103.0,0.474,0.435,0,2017-04-05,79,42,37,0.532,78,45,33,0.5770000000000001
21601168,1610612745,1610612743,110.0,104.0,0.425,0.3939999999999999,1,2017-04-05,78,53,25,0.679,78,37,41,0.474
21601169,1610612738,1610612739,91.0,114.0,0.407,0.467,0,2017-04-05,78,50,28,0.6409999999999999,78,51,27,0.654
21601170,1610612759,1610612747,95.0,102.0,0.4379999999999999,0.488,0,2017-04-05,78,60,18,0.769,78,23,55,0.295
21601171,1610612756,1610612744,111.0,120.0,0.417,0.506,0,2017-04-05,79,22,57,0.278,79,65,14,0.823
21601172,1610612746,1610612742,112.0,101.0,0.507,0.442,1,2017-04-05,79,48,31,0.608,78,32,46,0.41
21601154,1610612755,1610612751,118.0,141.0,0.4429999999999999,0.64,0,2017-04-04,78,28,50,0.359,78,19,59,0.244
21601155,1610612764,1610612766,118.0,111.0,0.506,0.506,1,2017-04-04,78,47,31,0.603,78,36,42,0.462
21601156,1610612739,1610612753,122.0,102.0,0.537,0.384,1,2017-04-04,77,50,27,0.649,78,27,51,0.346
21601157,1610612754,1610612761,108.0,90.0,0.4379999999999999,0.447,1,2017-04-04,78,38,40,0.487,78,47,31,0.603
21601158,1610612740,1610612743,131.0,134.0,0.51,0.535,0,2017-04-04,78,33,45,0.423,77,37,40,0.481
21601159,1610612760,1610612749,110.0,79.0,0.476,0.358,1,2017-04-04,77,44,33,0.5710000000000001,78,40,38,0.513
21601160,1610612752,1610612741,100.0,91.0,0.472,0.376,1,2017-04-04,78,30,48,0.385,78,38,40,0.487
21601161,1610612759,1610612763,95.0,89.0,0.4379999999999999,0.3929999999999999,1,2017-04-04,77,60,17,0.779,78,42,36,0.5379999999999999
21601164,1610612762,1610612757,106.0,87.0,0.527,0.3979999999999999,1,2017-04-04,78,48,30,0.615,78,38,40,0.487
21601162,1610612744,1610612750,121.0,107.0,0.524,0.4270000000000001,1,2017-04-04,78,64,14,0.821,77,31,46,0.4029999999999999
21601163,1610612758,1610612742,98.0,87.0,0.444,0.4,1,2017-04-04,78,31,47,0.397,77,32,45,0.416
21600940,1610612750,1610612757,110.0,109.0,0.488,0.442,1,2017-04-03,76,31,45,0.408,77,38,39,0.494
21601145,1610612752,1610612738,94.0,110.0,0.3879999999999999,0.556,0,2017-04-02,77,29,48,0.377,77,50,27,0.649
21601142,1610612760,1610612766,101.0,113.0,0.4639999999999999,0.481,0,2017-04-02,76,43,33,0.5660000000000001,77,36,41,0.4679999999999999
21601143,1610612747,1610612763,108.0,103.0,0.471,0.5,1,2017-04-02,77,22,55,0.286,77,42,35,0.545
21601144,1610612749,1610612742,105.0,109.0,0.506,0.521,0,2017-04-02,77,40,37,0.519,76,32,44,0.421
21601151,1610612759,1610612762,109.0,103.0,0.519,0.483,1,2017-04-02,76,59,17,0.7759999999999999,77,47,30,0.61
21601146,1610612740,1610612741,110.0,117.0,0.407,0.489,0,2017-04-02,77,33,44,0.429,77,38,39,0.494
21601147,1610612761,1610612755,113.0,105.0,0.541,0.45,1,2017-04-02,77,47,30,0.61,77,28,49,0.364
21601148,1610612751,1610612737,91.0,82.0,0.39,0.375,1,2017-04-02,77,18,59,0.2339999999999999,77,39,38,0.506
21601149,1610612748,1610612743,113.0,116.0,0.483,0.506,0,2017-04-02,77,37,40,0.481,76,36,40,0.474
21601150,1610612739,1610612754,135.0,130.0,0.495,0.457,1,2017-04-02,76,49,27,0.645,77,37,40,0.481
21601152,1610612744,1610612764,139.0,115.0,0.568,0.467,1,2017-04-02,77,63,14,0.818,77,46,31,0.597
21601153,1610612756,1610612745,116.0,123.0,0.42,0.47,0,2017-04-02,78,22,56,0.282,77,52,25,0.675
21601137,1610612746,1610612747,115.0,104.0,0.551,0.433,1,2017-04-01,78,47,31,0.603,76,21,55,0.276
21601138,1610612741,1610612737,106.0,104.0,0.471,0.444,1,2017-04-01,76,37,39,0.487,76,39,37,0.513
21601139,1610612751,1610612753,121.0,111.0,0.532,0.495,1,2017-04-01,76,17,59,0.2239999999999999,77,27,50,0.351
21601140,1610612750,1610612758,117.0,123.0,0.4479999999999999,0.564,0,2017-04-01,75,30,45,0.4,77,30,47,0.39
21601141,1610612757,1610612756,130.0,117.0,0.467,0.524,1,2017-04-01,76,38,38,0.5,77,22,55,0.286
21601126,1610612761,1610612754,111.0,100.0,0.451,0.414,1,2017-03-31,76,46,30,0.605,76,37,39,0.487
21601127,1610612766,1610612743,122.0,114.0,0.465,0.5,1,2017-03-31,76,35,41,0.461,75,35,40,0.467
21601128,1610612739,1610612755,122.0,105.0,0.526,0.488,1,2017-03-31,75,48,27,0.64,76,28,48,0.368
21601129,1610612738,1610612753,117.0,116.0,0.452,0.408,1,2017-03-31,76,49,27,0.645,76,27,49,0.355
21601130,1610612749,1610612765,108.0,105.0,0.417,0.4539999999999999,1,2017-03-31,76,40,36,0.526,77,35,42,0.455
21601131,1610612763,1610612742,99.0,90.0,0.467,0.382,1,2017-03-31,76,42,34,0.5529999999999999,75,31,44,0.413
21601132,1610612740,1610612758,117.0,89.0,0.484,0.389,1,2017-03-31,76,33,43,0.434,76,29,47,0.382
21601133,1610612748,1610612752,94.0,98.0,0.41,0.475,0,2017-03-31,76,37,39,0.487,76,29,47,0.382
21601135,1610612760,1610612759,95.0,100.0,0.407,0.435,0,2017-03-31,75,43,32,0.573,75,58,17,0.773
21601134,1610612762,1610612764,95.0,88.0,0.4579999999999999,0.402,1,2017-03-31,76,47,29,0.618,76,46,30,0.605
21601136,1610612744,1610612745,107.0,98.0,0.4529999999999999,0.374,1,2017-03-31,76,62,14,0.816,76,51,25,0.6709999999999999
21601121,1610612765,1610612751,90.0,89.0,0.419,0.38,1,2017-03-30,76,35,41,0.461,75,16,59,0.213
21601122,1610612741,1610612739,99.0,93.0,0.422,0.446,1,2017-03-30,75,36,39,0.48,74,47,27,0.635
21601123,1610612750,1610612747,119.0,104.0,0.483,0.476,1,2017-03-30,74,30,44,0.405,75,21,54,0.28
21601124,1610612756,1610612746,118.0,124.0,0.5329999999999999,0.55,0,2017-03-30,76,22,54,0.289,77,46,31,0.597
21601125,1610612757,1610612745,117.0,107.0,0.478,0.44,1,2017-03-30,75,37,38,0.493,75,51,24,0.68
21601111,1610612755,1610612737,92.0,99.0,0.414,0.425,0,2017-03-29,75,28,47,0.373,75,39,36,0.52
21601112,1610612753,1610612760,106.0,114.0,0.402,0.422,0,2017-03-29,75,27,48,0.36,74,43,31,0.581
21601113,1610612738,1610612749,100.0,103.0,0.3979999999999999,0.526,0,2017-03-29,75,48,27,0.64,75,39,36,0.52
21601114,1610612761,1610612766,106.0,110.0,0.4579999999999999,0.4529999999999999,0,2017-03-29,75,45,30,0.6,75,34,41,0.4529999999999999
21601115,1610612752,1610612748,88.0,105.0,0.371,0.476,0,2017-03-29,75,28,47,0.373,75,37,38,0.493
21601116,1610612763,1610612754,110.0,97.0,0.466,0.435,1,2017-03-29,75,41,34,0.547,75,37,38,0.493
21601117,1610612740,1610612742,121.0,118.0,0.5,0.484,1,2017-03-29,75,32,43,0.4270000000000001,74,31,43,0.419
21601118,1610612759,1610612744,98.0,110.0,0.41,0.506,0,2017-03-29,74,57,17,0.77,75,61,14,0.813
21601119,1610612746,1610612764,133.0,124.0,0.5660000000000001,0.495,1,2017-03-29,76,45,31,0.5920000000000001,75,46,29,0.613
21601120,1610612758,1610612762,82.0,112.0,0.4529999999999999,0.532,0,2017-03-29,75,29,46,0.387,75,46,29,0.613
21601103,1610612766,1610612749,108.0,118.0,0.488,0.622,0,2017-03-28,74,33,41,0.446,74,38,36,0.514
21601104,1610612754,1610612750,114.0,115.0,0.494,0.474,0,2017-03-28,74,37,37,0.5,73,29,44,0.397
21601105,1610612751,1610612755,101.0,106.0,0.4039999999999999,0.429,0,2017-03-28,74,16,58,0.216,74,28,46,0.3779999999999999
21601106,1610612737,1610612756,95.0,91.0,0.4,0.365,1,2017-03-28,74,38,36,0.514,75,22,53,0.293
21601107,1610612765,1610612748,96.0,97.0,0.424,0.456,0,2017-03-28,75,34,41,0.4529999999999999,74,36,38,0.486
21601108,1610612745,1610612744,106.0,113.0,0.3879999999999999,0.511,0,2017-03-28,74,51,23,0.6890000000000001,74,60,14,0.8109999999999999
21601109,1610612757,1610612743,122.0,113.0,0.495,0.4679999999999999,1,2017-03-28,74,36,38,0.486,74,35,39,0.473
21601110,1610612747,1610612764,108.0,119.0,0.506,0.511,0,2017-03-28,74,21,53,0.284,74,46,28,0.622
21601097,1610612761,1610612753,131.0,112.0,0.59,0.489,1,2017-03-27,74,45,29,0.608,74,27,47,0.365
21601098,1610612752,1610612765,109.0,95.0,0.536,0.429,1,2017-03-27,74,28,46,0.3779999999999999,74,34,40,0.4589999999999999
21601099,1610612759,1610612739,103.0,74.0,0.477,0.373,1,2017-03-27,73,57,16,0.7809999999999999,73,47,26,0.644
21601100,1610612742,1610612760,91.0,92.0,0.413,0.435,0,2017-03-27,73,31,42,0.425,73,42,31,0.575
21601101,1610612758,1610612763,91.0,90.0,0.4629999999999999,0.344,1,2017-03-27,74,29,45,0.392,74,40,34,0.541
21601102,1610612762,1610612740,108.0,100.0,0.482,0.4629999999999999,1,2017-03-27,74,45,29,0.608,74,31,43,0.419
21601087,1610612766,1610612756,120.0,106.0,0.483,0.506,1,2017-03-26,73,33,40,0.452,74,22,52,0.297
21601088,1610612737,1610612751,92.0,107.0,0.347,0.442,0,2017-03-26,73,37,36,0.507,73,16,57,0.2189999999999999
21601089,1610612746,1610612758,97.0,98.0,0.41,0.452,0,2017-03-26,75,44,31,0.5870000000000001,73,28,45,0.384
21601090,1610612749,1610612741,94.0,109.0,0.44,0.541,0,2017-03-26,73,37,36,0.507,74,35,39,0.473
21601091,1610612745,1610612760,137.0,125.0,0.633,0.5,1,2017-03-26,73,51,22,0.6990000000000001,72,41,31,0.569
21601092,1610612754,1610612755,107.0,94.0,0.4270000000000001,0.3979999999999999,1,2017-03-26,73,37,36,0.507,73,27,46,0.37
21601093,1610612738,1610612748,112.0,108.0,0.532,0.451,1,2017-03-26,74,48,26,0.649,73,35,38,0.479
21601094,1610612744,1610612763,106.0,94.0,0.5489999999999999,0.447,1,2017-03-26,73,59,14,0.8079999999999999,73,40,33,0.5479999999999999
21601095,1610612743,1610612740,90.0,115.0,0.379,0.495,0,2017-03-26,73,35,38,0.479,73,31,42,0.425
21601096,1610612747,1610612757,81.0,97.0,0.3929999999999999,0.4039999999999999,0,2017-03-26,73,21,52,0.288,73,35,38,0.479
21601082,1610612746,1610612762,108.0,95.0,0.452,0.43,1,2017-03-25,74,44,30,0.595,73,44,29,0.603
21601083,1610612739,1610612764,115.0,127.0,0.494,0.598,0,2017-03-25,72,47,25,0.653,73,45,28,0.616
21601084,1610612742,1610612761,86.0,94.0,0.3779999999999999,0.481,0,2017-03-25,72,31,41,0.431,73,44,29,0.603
21601085,1610612759,1610612752,106.0,98.0,0.455,0.471,1,2017-03-25,72,56,16,0.778,73,27,46,0.37
21601086,1610612757,1610612750,112.0,100.0,0.634,0.487,1,2017-03-25,72,34,38,0.472,72,28,44,0.389
21601072,1610612764,1610612751,129.0,108.0,0.505,0.524,1,2017-03-24,72,44,28,0.611,72,15,57,0.208
21601073,1610612766,1610612739,105.0,112.0,0.422,0.5539999999999999,0,2017-03-24,72,32,40,0.444,71,47,24,0.662
21601074,1610612753,1610612765,115.0,87.0,0.516,0.354,1,2017-03-24,73,27,46,0.37,73,34,39,0.466
21601075,1610612754,1610612743,117.0,125.0,0.505,0.476,0,2017-03-24,72,36,36,0.5,72,35,37,0.486
21601076,1610612738,1610612756,130.0,120.0,0.4679999999999999,0.4529999999999999,1,2017-03-24,73,47,26,0.644,73,22,51,0.301
21601077,1610612741,1610612755,107.0,117.0,0.407,0.5539999999999999,0,2017-03-24,73,34,39,0.466,72,27,45,0.375
21601078,1610612749,1610612737,100.0,97.0,0.4429999999999999,0.41,1,2017-03-24,72,37,35,0.514,72,37,35,0.514
21601079,1610612745,1610612740,117.0,107.0,0.473,0.451,1,2017-03-24,72,50,22,0.6940000000000001,72,30,42,0.417
21601080,1610612747,1610612750,130.0,119.0,0.523,0.484,1,2017-03-24,72,21,51,0.292,71,28,43,0.3939999999999999
21601081,1610612744,1610612758,114.0,100.0,0.494,0.482,1,2017-03-24,72,58,14,0.8059999999999999,72,27,45,0.375
21601067,1610612751,1610612756,126.0,98.0,0.4529999999999999,0.366,1,2017-03-23,71,15,56,0.211,72,22,50,0.306
21601068,1610612748,1610612761,84.0,101.0,0.39,0.4429999999999999,0,2017-03-23,72,35,37,0.486,72,43,29,0.597
21601069,1610612742,1610612746,97.0,95.0,0.4629999999999999,0.45,1,2017-03-23,71,31,40,0.4370000000000001,73,43,30,0.589
21601070,1610612759,1610612763,97.0,90.0,0.481,0.436,1,2017-03-23,71,55,16,0.775,72,40,32,0.556
21601071,1610612757,1610612752,110.0,95.0,0.488,0.409,1,2017-03-23,71,33,38,0.465,72,27,45,0.375
21601059,1610612753,1610612766,102.0,109.0,0.455,0.467,0,2017-03-22,72,26,46,0.361,71,32,39,0.451
21601060,1610612738,1610612754,109.0,100.0,0.512,0.4370000000000001,1,2017-03-22,72,46,26,0.639,71,36,35,0.507
21601061,1610612741,1610612765,117.0,95.0,0.588,0.4429999999999999,1,2017-03-22,72,34,38,0.472,72,34,38,0.472
21601062,1610612760,1610612755,122.0,97.0,0.545,0.425,1,2017-03-22,71,41,30,0.5770000000000001,71,26,45,0.366
21601063,1610612764,1610612737,104.0,100.0,0.4,0.395,1,2017-03-22,71,43,28,0.606,71,37,34,0.521
21601064,1610612743,1610612739,126.0,113.0,0.531,0.506,1,2017-03-22,71,34,37,0.479,70,46,24,0.657
21601065,1610612758,1610612749,98.0,116.0,0.488,0.531,0,2017-03-22,71,27,44,0.38,71,36,35,0.507
21601066,1610612762,1610612752,108.0,101.0,0.456,0.475,1,2017-03-22,72,44,28,0.611,71,27,44,0.38
21601051,1610612761,1610612741,122.0,120.0,0.495,0.467,1,2017-03-21,71,42,29,0.5920000000000001,71,33,38,0.465
21601052,1610612751,1610612765,98.0,96.0,0.4320000000000001,0.435,1,2017-03-21,70,14,56,0.2,71,34,37,0.479
21601053,1610612748,1610612756,112.0,97.0,0.4379999999999999,0.439,1,2017-03-21,71,35,36,0.493,71,22,49,0.31
21601054,1610612740,1610612763,95.0,82.0,0.3979999999999999,0.405,1,2017-03-21,71,30,41,0.423,71,40,31,0.563
21601055,1610612742,1610612744,87.0,112.0,0.359,0.551,0,2017-03-21,70,30,40,0.429,71,57,14,0.8029999999999999
21601056,1610612750,1610612759,93.0,100.0,0.444,0.481,0,2017-03-21,70,28,42,0.4,70,54,16,0.7709999999999999
21601057,1610612757,1610612749,90.0,93.0,0.422,0.422,0,2017-03-21,70,32,38,0.457,70,35,35,0.5
21601058,1610612747,1610612746,109.0,133.0,0.467,0.536,0,2017-03-21,71,20,51,0.282,72,43,29,0.597
21601044,1610612766,1610612737,105.0,90.0,0.5,0.44,1,2017-03-20,70,31,39,0.4429999999999999,70,37,33,0.529
21601045,1610612753,1610612755,112.0,109.0,0.3720000000000001,0.382,1,2017-03-20,71,26,45,0.366,70,26,44,0.371
21601046,1610612754,1610612762,107.0,100.0,0.4370000000000001,0.455,1,2017-03-20,70,36,34,0.514,71,43,28,0.606
21601047,1610612738,1610612764,110.0,102.0,0.43,0.43,1,2017-03-20,71,45,26,0.634,70,42,28,0.6
21601048,1610612745,1610612743,125.0,124.0,0.506,0.512,1,2017-03-20,71,49,22,0.69,70,33,37,0.471
21601049,1610612760,1610612744,95.0,111.0,0.425,0.482,0,2017-03-20,70,40,30,0.5710000000000001,70,56,14,0.8
21601050,1610612746,1610612752,114.0,105.0,0.494,0.449,1,2017-03-20,71,42,29,0.5920000000000001,70,27,43,0.386
21601036,1610612751,1610612742,104.0,111.0,0.431,0.539,0,2017-03-19,69,13,56,0.188,69,30,39,0.435
21601037,1610612755,1610612738,105.0,99.0,0.466,0.405,1,2017-03-19,69,26,43,0.377,70,44,26,0.629
21601038,1610612765,1610612756,112.0,95.0,0.435,0.354,1,2017-03-19,70,34,36,0.486,70,22,48,0.314
21601039,1610612740,1610612750,123.0,109.0,0.544,0.512,1,2017-03-19,70,29,41,0.414,69,28,41,0.406
21601040,1610612761,1610612754,116.0,91.0,0.495,0.413,1,2017-03-19,70,41,29,0.586,69,35,34,0.507
21601041,1610612748,1610612757,104.0,115.0,0.466,0.506,0,2017-03-19,70,34,36,0.486,69,32,37,0.4639999999999999
21601042,1610612759,1610612758,118.0,102.0,0.494,0.494,1,2017-03-19,69,53,16,0.768,70,27,43,0.386
21601043,1610612747,1610612739,120.0,125.0,0.516,0.529,0,2017-03-19,70,20,50,0.286,69,46,23,0.667
21601028,1610612760,1610612758,110.0,94.0,0.5,0.412,1,2017-03-18,69,40,29,0.58,69,27,42,0.391
21601029,1610612737,1610612757,97.0,113.0,0.364,0.506,0,2017-03-18,69,37,32,0.536,68,31,37,0.456
21601030,1610612766,1610612764,98.0,93.0,0.4270000000000001,0.3670000000000001,1,2017-03-18,69,30,39,0.435,69,42,27,0.609
21601031,1610612746,1610612739,108.0,78.0,0.513,0.386,1,2017-03-18,70,41,29,0.586,68,45,23,0.662
21601032,1610612741,1610612762,95.0,86.0,0.475,0.3829999999999999,1,2017-03-18,70,33,37,0.471,70,43,27,0.614
21601033,1610612763,1610612759,104.0,96.0,0.421,0.44,1,2017-03-18,70,40,30,0.5710000000000001,68,52,16,0.765
21601034,1610612743,1610612745,105.0,109.0,0.4270000000000001,0.4579999999999999,0,2017-03-18,69,33,36,0.478,70,48,22,0.6859999999999999
21601035,1610612744,1610612749,117.0,92.0,0.6,0.4039999999999999,1,2017-03-18,69,55,14,0.797,69,34,35,0.493
21601020,1610612755,1610612742,116.0,74.0,0.525,0.345,1,2017-03-17,68,25,43,0.368,68,29,39,0.426
21601021,1610612764,1610612741,112.0,107.0,0.455,0.5,1,2017-03-17,68,42,26,0.618,69,32,37,0.4639999999999999
21601022,1610612751,1610612738,95.0,98.0,0.361,0.4,0,2017-03-17,68,13,55,0.191,69,44,25,0.638
21601023,1610612765,1610612761,75.0,87.0,0.349,0.385,0,2017-03-17,69,33,36,0.478,69,40,29,0.58
21601024,1610612740,1610612745,128.0,112.0,0.5329999999999999,0.407,1,2017-03-17,69,28,41,0.406,69,47,22,0.6809999999999999
21601025,1610612748,1610612750,123.0,105.0,0.588,0.5,1,2017-03-17,69,34,35,0.493,68,28,40,0.412
21601026,1610612756,1610612753,103.0,109.0,0.4370000000000001,0.4379999999999999,0,2017-03-17,69,22,47,0.319,70,25,45,0.357
21601027,1610612747,1610612749,103.0,107.0,0.452,0.488,0,2017-03-17,69,20,49,0.29,68,34,34,0.5
21601014,1610612739,1610612762,91.0,83.0,0.419,0.415,1,2017-03-16,67,45,22,0.672,69,43,26,0.623
21601015,1610612761,1610612760,102.0,123.0,0.457,0.534,0,2017-03-16,68,39,29,0.574,68,39,29,0.574
21601016,1610612752,1610612751,110.0,121.0,0.466,0.477,0,2017-03-16,69,27,42,0.391,67,13,54,0.1939999999999999
21601017,1610612737,1610612763,91.0,103.0,0.408,0.424,0,2017-03-16,68,37,31,0.544,69,39,30,0.565
21601018,1610612743,1610612746,129.0,114.0,0.535,0.524,1,2017-03-16,68,33,35,0.485,69,40,29,0.58
21601019,1610612744,1610612753,122.0,92.0,0.575,0.3720000000000001,1,2017-03-16,68,54,14,0.794,69,24,45,0.348
21601004,1610612764,1610612742,107.0,112.0,0.488,0.506,0,2017-03-15,67,41,26,0.612,67,29,38,0.433
21601005,1610612754,1610612766,98.0,77.0,0.534,0.4,1,2017-03-15,68,35,33,0.515,68,29,39,0.426
21601006,1610612738,1610612750,117.0,104.0,0.544,0.44,1,2017-03-15,68,43,25,0.632,67,28,39,0.418
21601007,1610612748,1610612740,120.0,112.0,0.506,0.477,1,2017-03-15,68,33,35,0.485,68,27,41,0.397
21601008,1610612765,1610612762,83.0,97.0,0.419,0.4679999999999999,0,2017-03-15,68,33,35,0.485,68,43,25,0.632
21601009,1610612741,1610612763,91.0,98.0,0.374,0.424,0,2017-03-15,68,32,36,0.471,68,38,30,0.5589999999999999
21601010,1610612745,1610612747,139.0,100.0,0.5489999999999999,0.462,1,2017-03-15,68,47,21,0.691,68,20,48,0.294
21601011,1610612759,1610612757,106.0,110.0,0.477,0.475,0,2017-03-15,67,52,15,0.7759999999999999,67,30,37,0.4479999999999999
21601012,1610612756,1610612758,101.0,107.0,0.402,0.481,0,2017-03-15,68,22,46,0.324,68,27,41,0.397
21601013,1610612746,1610612749,96.0,97.0,0.467,0.447,0,2017-03-15,68,40,28,0.588,67,33,34,0.493
21600999,1610612739,1610612765,128.0,96.0,0.597,0.374,1,2017-03-14,66,44,22,0.667,67,33,34,0.493
21601000,1610612751,1610612760,104.0,122.0,0.465,0.494,0,2017-03-14,66,12,54,0.182,67,38,29,0.5670000000000001
21601001,1610612752,1610612754,87.0,81.0,0.422,0.368,1,2017-03-14,68,27,41,0.397,67,34,33,0.507
21601002,1610612740,1610612757,100.0,77.0,0.475,0.303,1,2017-03-14,67,27,40,0.4029999999999999,66,29,37,0.439
21601003,1610612744,1610612755,106.0,104.0,0.364,0.4379999999999999,1,2017-03-14,67,53,14,0.7909999999999999,67,24,43,0.358
21600991,1610612766,1610612741,109.0,115.0,0.462,0.446,0,2017-03-13,67,29,38,0.433,67,32,35,0.478
21600992,1610612761,1610612742,100.0,78.0,0.474,0.365,1,2017-03-13,67,39,28,0.5820000000000001,66,28,38,0.424
21600993,1610612763,1610612749,113.0,93.0,0.519,0.4629999999999999,1,2017-03-13,67,37,30,0.552,66,32,34,0.485
21600994,1610612759,1610612737,107.0,99.0,0.481,0.457,1,2017-03-13,66,52,14,0.7879999999999999,67,37,30,0.552
21600995,1610612750,1610612764,119.0,104.0,0.523,0.429,1,2017-03-13,66,28,38,0.424,66,41,25,0.621
21600996,1610612762,1610612746,114.0,108.0,0.526,0.5,1,2017-03-13,67,42,25,0.627,67,40,27,0.597
21600997,1610612758,1610612753,120.0,115.0,0.537,0.4589999999999999,1,2017-03-13,67,26,41,0.3879999999999999,68,24,44,0.353
21600998,1610612743,1610612747,129.0,101.0,0.536,0.433,1,2017-03-13,67,32,35,0.478,67,20,47,0.299
21600985,1610612738,1610612741,100.0,80.0,0.465,0.379,1,2017-03-12,67,42,25,0.627,66,31,35,0.47
21600986,1610612751,1610612752,120.0,112.0,0.46,0.415,1,2017-03-12,65,12,53,0.185,67,26,41,0.3879999999999999
21600987,1610612754,1610612748,102.0,98.0,0.4270000000000001,0.415,1,2017-03-12,66,34,32,0.515,67,32,35,0.478
21600988,1610612756,1610612757,101.0,110.0,0.441,0.5,0,2017-03-12,67,22,45,0.3279999999999999,65,29,36,0.446
21600989,1610612745,1610612739,117.0,112.0,0.4270000000000001,0.525,1,2017-03-12,67,46,21,0.687,65,43,22,0.662
21600990,1610612747,1610612755,116.0,118.0,0.5,0.519,0,2017-03-12,66,20,46,0.303,66,24,42,0.364
21600973,1610612760,1610612762,112.0,104.0,0.5,0.48,1,2017-03-11,66,37,29,0.561,66,41,25,0.621
21600974,1610612746,1610612755,112.0,100.0,0.494,0.476,1,2017-03-11,66,40,26,0.606,65,23,42,0.354
21600975,1610612765,1610612752,112.0,92.0,0.479,0.439,1,2017-03-11,66,33,33,0.5,66,26,40,0.3939999999999999
21600976,1610612766,1610612740,122.0,125.0,0.451,0.505,0,2017-03-11,66,29,37,0.439,66,26,40,0.3939999999999999
21600977,1610612753,1610612739,104.0,116.0,0.396,0.5,0,2017-03-11,67,24,43,0.358,64,43,21,0.672
21600978,1610612749,1610612750,102.0,95.0,0.4629999999999999,0.457,1,2017-03-11,65,32,33,0.4920000000000001,65,27,38,0.415
21600979,1610612748,1610612761,104.0,89.0,0.486,0.375,1,2017-03-11,66,32,34,0.485,66,38,28,0.5760000000000001
21600980,1610612759,1610612744,107.0,85.0,0.519,0.359,1,2017-03-11,65,51,14,0.785,66,52,14,0.7879999999999999
21600981,1610612763,1610612737,90.0,107.0,0.3779999999999999,0.5,0,2017-03-11,66,36,30,0.545,66,37,29,0.561
21600982,1610612742,1610612756,98.0,100.0,0.3779999999999999,0.4579999999999999,0,2017-03-11,65,28,37,0.431,66,22,44,0.3329999999999999
21600983,1610612757,1610612764,124.0,125.0,0.511,0.522,0,2017-03-11,64,28,36,0.4379999999999999,65,41,24,0.631
21600984,1610612758,1610612743,92.0,105.0,0.439,0.471,0,2017-03-11,66,25,41,0.379,66,31,35,0.47
21600965,1610612766,1610612753,121.0,81.0,0.595,0.408,1,2017-03-10,65,29,36,0.446,66,24,42,0.364
21600966,1610612741,1610612745,94.0,115.0,0.3879999999999999,0.416,0,2017-03-10,65,31,34,0.477,66,45,21,0.682
21600967,1610612749,1610612754,99.0,85.0,0.516,0.44,1,2017-03-10,64,31,33,0.484,65,33,32,0.508
21600968,1610612750,1610612744,103.0,102.0,0.4429999999999999,0.466,1,2017-03-10,64,27,37,0.422,65,52,13,0.8
21600969,1610612737,1610612761,105.0,99.0,0.52,0.402,1,2017-03-10,65,36,29,0.5539999999999999,65,38,27,0.585
21600970,1610612743,1610612738,119.0,99.0,0.529,0.42,1,2017-03-10,65,30,35,0.462,66,41,25,0.621
21600971,1610612742,1610612751,105.0,96.0,0.423,0.436,1,2017-03-10,64,28,36,0.4379999999999999,64,11,53,0.172
21600972,1610612758,1610612764,122.0,130.0,0.478,0.5,0,2017-03-10,65,25,40,0.385,64,40,24,0.625
21600960,1610612765,1610612739,106.0,101.0,0.466,0.4639999999999999,1,2017-03-09,65,32,33,0.4920000000000001,63,42,21,0.667
21600961,1610612763,1610612746,98.0,114.0,0.446,0.513,0,2017-03-09,65,36,29,0.5539999999999999,65,39,26,0.6
21600962,1610612760,1610612759,102.0,92.0,0.461,0.417,1,2017-03-09,65,36,29,0.5539999999999999,64,50,14,0.7809999999999999
21600963,1610612757,1610612755,114.0,108.0,0.455,0.436,1,2017-03-09,63,28,35,0.444,64,23,41,0.359
21600964,1610612756,1610612747,110.0,122.0,0.462,0.48,0,2017-03-09,65,21,44,0.3229999999999999,65,20,45,0.308
21600949,1610612753,1610612741,98.0,91.0,0.416,0.444,1,2017-03-08,65,24,41,0.369,64,31,33,0.484
21600950,1610612737,1610612751,110.0,105.0,0.4320000000000001,0.4629999999999999,1,2017-03-08,64,35,29,0.547,63,11,52,0.175
21600951,1610612748,1610612766,108.0,101.0,0.435,0.4629999999999999,1,2017-03-08,65,31,34,0.477,64,28,36,0.4379999999999999
21600952,1610612749,1610612752,104.0,93.0,0.43,0.4639999999999999,1,2017-03-08,63,30,33,0.476,65,26,39,0.4
21600953,1610612740,1610612761,87.0,94.0,0.425,0.474,0,2017-03-08,65,25,40,0.385,64,38,26,0.594
21600954,1610612745,1610612762,108.0,115.0,0.4429999999999999,0.539,0,2017-03-08,65,44,21,0.677,65,41,24,0.631
21600955,1610612750,1610612746,107.0,91.0,0.488,0.422,1,2017-03-08,63,26,37,0.413,64,38,26,0.594
21600956,1610612754,1610612765,115.0,98.0,0.5,0.4379999999999999,1,2017-03-08,64,33,31,0.516,64,31,33,0.484
21600957,1610612759,1610612758,114.0,104.0,0.5,0.488,1,2017-03-08,63,50,13,0.794,64,25,39,0.391
21600958,1610612743,1610612764,113.0,123.0,0.529,0.568,0,2017-03-08,64,29,35,0.4529999999999999,63,39,24,0.619
21600959,1610612744,1610612738,86.0,99.0,0.44,0.44,0,2017-03-08,64,52,12,0.813,65,41,24,0.631
21600946,1610612760,1610612757,121.0,126.0,0.518,0.5529999999999999,0,2017-03-07,64,35,29,0.547,62,27,35,0.435
21600947,1610612742,1610612747,122.0,111.0,0.542,0.467,1,2017-03-07,63,27,36,0.429,64,19,45,0.297
21600948,1610612756,1610612764,127.0,131.0,0.5,0.456,0,2017-03-07,64,21,43,0.3279999999999999,62,38,24,0.613
21600934,1610612755,1610612749,98.0,112.0,0.4379999999999999,0.494,0,2017-03-06,63,23,40,0.365,62,29,33,0.4679999999999999
21600935,1610612753,1610612752,105.0,113.0,0.471,0.465,0,2017-03-06,64,23,41,0.359,64,26,38,0.406
21600936,1610612739,1610612748,98.0,106.0,0.449,0.429,0,2017-03-06,62,42,20,0.677,64,30,34,0.469
21600937,1610612737,1610612744,111.0,119.0,0.4629999999999999,0.471,0,2017-03-06,63,34,29,0.54,63,52,11,0.825
21600938,1610612765,1610612741,109.0,95.0,0.489,0.41,1,2017-03-06,63,31,32,0.4920000000000001,63,31,32,0.4920000000000001
21600939,1610612763,1610612751,109.0,122.0,0.442,0.534,0,2017-03-06,64,36,28,0.563,62,11,51,0.177
21600941,1610612766,1610612754,100.0,88.0,0.407,0.457,1,2017-03-06,63,28,35,0.444,63,32,31,0.508
21600942,1610612759,1610612745,112.0,110.0,0.455,0.466,1,2017-03-06,62,49,13,0.79,64,44,20,0.688
21600943,1610612743,1610612758,108.0,96.0,0.5,0.434,1,2017-03-06,63,29,34,0.46,63,25,38,0.397
21600944,1610612762,1610612740,88.0,83.0,0.407,0.357,1,2017-03-06,64,40,24,0.625,64,25,39,0.391
21600945,1610612746,1610612738,116.0,102.0,0.534,0.41,1,2017-03-06,63,38,25,0.603,64,40,24,0.625
21600927,1610612737,1610612754,96.0,97.0,0.442,0.449,0,2017-03-05,62,34,28,0.5479999999999999,62,32,30,0.516
21600928,1610612752,1610612744,105.0,112.0,0.47,0.455,0,2017-03-05,63,25,38,0.397,62,51,11,0.823
21600929,1610612756,1610612738,109.0,106.0,0.447,0.376,1,2017-03-05,63,21,42,0.3329999999999999,63,40,23,0.635
21600930,1610612764,1610612753,115.0,114.0,0.481,0.494,1,2017-03-05,61,37,24,0.607,63,23,40,0.365
21600931,1610612758,1610612762,109.0,110.0,0.518,0.456,0,2017-03-05,62,25,37,0.4029999999999999,63,39,24,0.619
21600932,1610612742,1610612760,104.0,89.0,0.488,0.402,1,2017-03-05,62,26,36,0.419,63,35,28,0.556
21600933,1610612747,1610612740,97.0,105.0,0.4579999999999999,0.4039999999999999,0,2017-03-05,63,19,44,0.302,63,25,38,0.397
21600919,1610612755,1610612765,106.0,136.0,0.489,0.568,0,2017-03-04,62,23,39,0.371,62,30,32,0.484
21600920,1610612749,1610612761,101.0,94.0,0.4370000000000001,0.467,1,2017-03-04,61,28,33,0.4589999999999999,63,37,26,0.5870000000000001
21600921,1610612748,1610612739,120.0,92.0,0.523,0.479,1,2017-03-04,63,29,34,0.46,61,42,19,0.6890000000000001
21600922,1610612741,1610612746,91.0,101.0,0.422,0.482,0,2017-03-04,62,31,31,0.5,62,37,25,0.597
21600923,1610612743,1610612766,102.0,112.0,0.45,0.456,0,2017-03-04,62,28,34,0.452,62,27,35,0.435
21600924,1610612745,1610612763,123.0,108.0,0.5,0.4429999999999999,1,2017-03-04,63,44,19,0.698,63,36,27,0.5710000000000001
21600925,1610612759,1610612750,97.0,90.0,0.4039999999999999,0.3929999999999999,1,2017-03-04,61,48,13,0.787,62,25,37,0.4029999999999999
21600926,1610612757,1610612751,130.0,116.0,0.57,0.523,1,2017-03-04,61,26,35,0.426,61,10,51,0.1639999999999999
21600909,1610612755,1610612752,105.0,102.0,0.434,0.3929999999999999,1,2017-03-03,61,23,38,0.377,62,25,37,0.4029999999999999
21600910,1610612764,1610612761,106.0,114.0,0.37,0.506,0,2017-03-03,60,36,24,0.6,62,37,25,0.597
21600911,1610612753,1610612748,110.0,99.0,0.5,0.385,1,2017-03-03,62,23,39,0.371,62,28,34,0.452
21600913,1610612737,1610612739,130.0,135.0,0.5379999999999999,0.547,0,2017-03-03,61,34,27,0.557,60,42,18,0.7
21600912,1610612749,1610612746,112.0,101.0,0.55,0.563,1,2017-03-03,60,27,33,0.45,61,36,25,0.59
21600914,1610612742,1610612763,104.0,100.0,0.476,0.4629999999999999,1,2017-03-03,61,25,36,0.41,62,36,26,0.581
21600915,1610612762,1610612751,112.0,97.0,0.514,0.4039999999999999,1,2017-03-03,62,38,24,0.613,60,10,50,0.1669999999999999
21600916,1610612756,1610612760,118.0,111.0,0.494,0.425,1,2017-03-03,62,20,42,0.3229999999999999,62,35,27,0.565
21600917,1610612740,1610612759,98.0,101.0,0.385,0.421,0,2017-03-03,62,24,38,0.387,60,47,13,0.7829999999999999
21600918,1610612747,1610612738,95.0,115.0,0.425,0.512,0,2017-03-03,62,19,43,0.306,62,40,22,0.645
21600906,1610612741,1610612744,94.0,87.0,0.439,0.386,1,2017-03-02,61,31,30,0.508,61,50,11,0.82
21600907,1610612756,1610612766,120.0,103.0,0.597,0.3929999999999999,1,2017-03-02,61,19,42,0.311,61,26,35,0.426
21600908,1610612757,1610612760,114.0,109.0,0.494,0.395,1,2017-03-02,60,25,35,0.417,61,35,26,0.574
21600895,1610612753,1610612752,90.0,101.0,0.41,0.42,0,2017-03-01,61,22,39,0.361,61,25,36,0.41
21600896,1610612761,1610612764,96.0,105.0,0.3670000000000001,0.476,0,2017-03-01,61,36,25,0.59,59,36,23,0.61
21600897,1610612737,1610612742,100.0,95.0,0.563,0.455,1,2017-03-01,60,34,26,0.5670000000000001,60,24,36,0.4
21600898,1610612748,1610612755,125.0,98.0,0.544,0.435,1,2017-03-01,61,28,33,0.4589999999999999,60,22,38,0.3670000000000001
21600899,1610612749,1610612743,98.0,110.0,0.4579999999999999,0.488,0,2017-03-01,59,26,33,0.441,61,28,33,0.4589999999999999
21600900,1610612740,1610612765,109.0,86.0,0.5,0.3879999999999999,1,2017-03-01,61,24,37,0.3929999999999999,61,29,32,0.475
21600901,1610612738,1610612739,103.0,99.0,0.462,0.407,1,2017-03-01,61,39,22,0.639,59,41,18,0.695
21600902,1610612759,1610612754,100.0,99.0,0.473,0.457,1,2017-03-01,59,46,13,0.78,61,31,30,0.508
21600903,1610612762,1610612750,80.0,107.0,0.389,0.5,0,2017-03-01,61,37,24,0.607,61,25,36,0.41
21600904,1610612746,1610612745,103.0,122.0,0.447,0.425,0,2017-03-01,60,36,24,0.6,62,43,19,0.6940000000000001
21600905,1610612758,1610612751,100.0,109.0,0.4320000000000001,0.4589999999999999,0,2017-03-01,61,25,36,0.41,59,10,49,0.1689999999999999
21600889,1610612764,1610612744,112.0,108.0,0.451,0.4639999999999999,1,2017-02-28,58,35,23,0.603,60,50,10,0.833
21600890,1610612765,1610612757,120.0,113.0,0.433,0.524,1,2017-02-28,60,29,31,0.483,59,24,35,0.407
21600891,1610612741,1610612743,107.0,125.0,0.4579999999999999,0.563,0,2017-02-28,60,30,30,0.5,60,27,33,0.45
21600892,1610612763,1610612756,130.0,112.0,0.5579999999999999,0.518,1,2017-02-28,61,36,25,0.59,60,18,42,0.3
21600893,1610612760,1610612762,109.0,106.0,0.513,0.462,1,2017-02-28,60,35,25,0.583,60,37,23,0.617
21600894,1610612747,1610612766,104.0,109.0,0.488,0.447,0,2017-02-28,61,19,42,0.311,60,26,34,0.433
21600882,1610612752,1610612761,91.0,92.0,0.452,0.423,0,2017-02-27,60,24,36,0.4,60,36,24,0.6
21600883,1610612755,1610612744,108.0,119.0,0.451,0.449,0,2017-02-27,59,22,37,0.373,59,50,9,0.847
21600884,1610612739,1610612749,102.0,95.0,0.5,0.446,1,2017-02-27,58,41,17,0.7070000000000001,58,26,32,0.4479999999999999
21600885,1610612738,1610612737,98.0,114.0,0.391,0.484,0,2017-02-27,60,38,22,0.633,59,33,26,0.5589999999999999
21600887,1610612742,1610612748,96.0,89.0,0.434,0.446,1,2017-02-27,59,24,35,0.407,60,27,33,0.45
21600886,1610612745,1610612754,108.0,117.0,0.364,0.451,0,2017-02-27,61,42,19,0.6890000000000001,60,31,29,0.517
21600888,1610612758,1610612750,88.0,102.0,0.439,0.421,0,2017-02-27,60,25,35,0.417,60,24,36,0.4
21600874,1610612747,1610612759,98.0,119.0,0.46,0.521,0,2017-02-26,60,19,41,0.317,58,45,13,0.7759999999999999
21600875,1610612749,1610612756,100.0,96.0,0.513,0.482,1,2017-02-26,57,26,31,0.456,59,18,41,0.305
21600876,1610612743,1610612763,98.0,105.0,0.44,0.45,0,2017-02-26,59,26,33,0.441,60,35,25,0.583
21600877,1610612764,1610612762,92.0,102.0,0.425,0.472,0,2017-02-26,57,34,23,0.596,59,37,22,0.627
21600878,1610612761,1610612757,112.0,106.0,0.5379999999999999,0.4429999999999999,1,2017-02-26,59,35,24,0.593,58,24,34,0.414
21600879,1610612765,1610612738,98.0,104.0,0.4320000000000001,0.4,0,2017-02-26,59,28,31,0.475,59,38,21,0.644
21600880,1610612760,1610612740,118.0,110.0,0.477,0.45,1,2017-02-26,59,34,25,0.5760000000000001,60,23,37,0.3829999999999999
21600881,1610612746,1610612766,124.0,121.0,0.4639999999999999,0.475,1,2017-02-26,59,36,23,0.61,59,25,34,0.424
21600866,1610612758,1610612766,85.0,99.0,0.392,0.4,0,2017-02-25,59,25,34,0.424,58,25,33,0.431
21600867,1610612753,1610612737,105.0,86.0,0.457,0.376,1,2017-02-25,60,22,38,0.3670000000000001,58,32,26,0.552
21600868,1610612752,1610612755,110.0,109.0,0.473,0.421,1,2017-02-25,59,24,35,0.407,58,22,36,0.379
21600869,1610612748,1610612754,113.0,95.0,0.487,0.4,1,2017-02-25,59,27,32,0.4579999999999999,59,30,29,0.508
21600870,1610612742,1610612740,96.0,83.0,0.462,0.397,1,2017-02-25,58,23,35,0.397,59,23,36,0.39
21600871,1610612739,1610612741,99.0,117.0,0.4629999999999999,0.495,0,2017-02-25,57,40,17,0.7020000000000001,59,30,29,0.508
21600872,1610612745,1610612750,142.0,130.0,0.4679999999999999,0.521,1,2017-02-25,60,42,18,0.7,59,23,36,0.39
21600873,1610612744,1610612751,112.0,95.0,0.42,0.4039999999999999,1,2017-02-25,58,49,9,0.845,58,9,49,0.155
21600856,1610612755,1610612764,120.0,112.0,0.494,0.422,1,2017-02-24,57,22,35,0.386,56,34,22,0.607
21600857,1610612754,1610612763,102.0,92.0,0.513,0.417,1,2017-02-24,58,30,28,0.517,59,34,25,0.5760000000000001
21600858,1610612761,1610612738,107.0,97.0,0.494,0.423,1,2017-02-24,58,34,24,0.586,58,37,21,0.638
21600859,1610612741,1610612756,128.0,121.0,0.469,0.527,1,2017-02-24,58,29,29,0.5,58,18,40,0.31
21600860,1610612749,1610612762,95.0,109.0,0.4320000000000001,0.5,0,2017-02-24,56,25,31,0.446,58,36,22,0.621
21600861,1610612760,1610612747,110.0,93.0,0.4539999999999999,0.396,1,2017-02-24,58,33,25,0.569,59,19,40,0.322
21600862,1610612750,1610612742,97.0,84.0,0.526,0.422,1,2017-02-24,58,23,35,0.397,57,22,35,0.386
21600863,1610612737,1610612748,90.0,108.0,0.38,0.4039999999999999,0,2017-02-24,57,32,25,0.561,58,26,32,0.4479999999999999
21600864,1610612743,1610612751,129.0,109.0,0.505,0.494,1,2017-02-24,58,26,32,0.4479999999999999,57,9,48,0.158
21600865,1610612746,1610612759,97.0,105.0,0.4429999999999999,0.4270000000000001,0,2017-02-24,58,35,23,0.603,57,44,13,0.772
21600850,1610612753,1610612757,103.0,112.0,0.395,0.506,0,2017-02-23,59,21,38,0.356,57,24,33,0.421
21600851,1610612765,1610612766,114.0,108.0,0.411,0.413,1,2017-02-23,58,28,30,0.483,57,24,33,0.421
21600852,1610612740,1610612745,99.0,129.0,0.419,0.495,0,2017-02-23,58,23,35,0.397,59,41,18,0.695
21600853,1610612739,1610612752,119.0,104.0,0.529,0.416,1,2017-02-23,56,40,16,0.7140000000000001,58,23,35,0.397
21600854,1610612744,1610612746,123.0,113.0,0.531,0.409,1,2017-02-23,57,48,9,0.8420000000000001,57,35,22,0.614
21600855,1610612758,1610612743,116.0,100.0,0.523,0.4429999999999999,1,2017-02-23,58,25,33,0.431,57,25,32,0.439
21600848,1610612754,1610612764,98.0,111.0,0.5,0.518,0,2017-02-16,57,29,28,0.509,55,34,21,0.618
21600849,1610612741,1610612738,104.0,103.0,0.422,0.4679999999999999,1,2017-02-16,57,28,29,0.491,57,37,20,0.649
21600834,1610612753,1610612759,79.0,107.0,0.395,0.472,0,2017-02-15,58,21,37,0.362,56,43,13,0.768
21600835,1610612739,1610612754,113.0,104.0,0.476,0.465,1,2017-02-15,55,39,16,0.7090000000000001,56,29,27,0.518
21600836,1610612738,1610612755,116.0,108.0,0.475,0.473,1,2017-02-15,56,37,19,0.6609999999999999,56,21,35,0.375
21600837,1610612761,1610612766,90.0,85.0,0.381,0.421,1,2017-02-15,57,33,24,0.579,56,24,32,0.429
21600838,1610612751,1610612749,125.0,129.0,0.523,0.568,0,2017-02-15,56,9,47,0.161,55,25,30,0.455
21600839,1610612765,1610612742,98.0,91.0,0.439,0.38,1,2017-02-15,57,27,30,0.474,56,22,34,0.3929999999999999
21600840,1610612763,1610612740,91.0,95.0,0.371,0.493,0,2017-02-15,58,34,24,0.586,57,23,34,0.4039999999999999
21600841,1610612745,1610612748,109.0,117.0,0.414,0.524,0,2017-02-15,58,40,18,0.69,57,25,32,0.439
21600842,1610612743,1610612750,99.0,112.0,0.4039999999999999,0.477,0,2017-02-15,56,25,31,0.446,57,22,35,0.386
21600843,1610612762,1610612757,111.0,88.0,0.519,0.405,1,2017-02-15,57,35,22,0.614,56,23,33,0.411
21600844,1610612756,1610612747,137.0,101.0,0.557,0.376,1,2017-02-15,57,18,39,0.316,58,19,39,0.3279999999999999
21600845,1610612760,1610612752,116.0,105.0,0.466,0.477,1,2017-02-15,57,32,25,0.561,57,23,34,0.4039999999999999
21600846,1610612746,1610612737,99.0,84.0,0.4679999999999999,0.405,1,2017-02-15,56,35,21,0.625,56,32,24,0.5710000000000001
21600847,1610612744,1610612758,109.0,86.0,0.488,0.371,1,2017-02-15,56,47,9,0.8390000000000001,57,24,33,0.421
21600831,1610612741,1610612761,105.0,94.0,0.479,0.455,1,2017-02-14,56,27,29,0.482,56,32,24,0.5710000000000001
21600832,1610612750,1610612739,108.0,116.0,0.488,0.512,0,2017-02-14,56,21,35,0.375,54,38,16,0.7040000000000001
21600833,1610612747,1610612758,96.0,97.0,0.4579999999999999,0.493,0,2017-02-14,57,19,38,0.3329999999999999,56,24,32,0.429
21600821,1610612766,1610612755,99.0,105.0,0.436,0.477,0,2017-02-13,55,24,31,0.436,55,21,34,0.382
21600825,1610612754,1610612759,106.0,110.0,0.487,0.46,0,2017-02-13,55,29,26,0.527,55,42,13,0.764
21600822,1610612751,1610612763,103.0,112.0,0.4629999999999999,0.506,0,2017-02-13,55,9,46,0.1639999999999999,57,34,23,0.596
21600823,1610612748,1610612753,107.0,116.0,0.47,0.489,0,2017-02-13,56,24,32,0.429,57,21,36,0.368
21600820,1610612764,1610612760,120.0,98.0,0.575,0.354,1,2017-02-13,54,33,21,0.611,56,31,25,0.5539999999999999
21600824,1610612749,1610612765,102.0,89.0,0.506,0.436,1,2017-02-13,54,24,30,0.444,56,26,30,0.4639999999999999
21600826,1610612742,1610612738,98.0,111.0,0.455,0.494,0,2017-02-13,55,22,33,0.4,55,36,19,0.655
21600827,1610612743,1610612744,132.0,110.0,0.545,0.489,1,2017-02-13,55,25,30,0.455,55,46,9,0.836
21600828,1610612762,1610612746,72.0,88.0,0.322,0.444,0,2017-02-13,56,34,22,0.607,55,34,21,0.618
21600829,1610612756,1610612740,108.0,110.0,0.43,0.474,0,2017-02-13,56,17,39,0.304,56,22,34,0.3929999999999999
21600830,1610612757,1610612737,104.0,109.0,0.359,0.386,0,2017-02-13,55,23,32,0.418,55,32,23,0.5820000000000001
21600816,1610612750,1610612741,117.0,89.0,0.5429999999999999,0.417,1,2017-02-12,55,21,34,0.382,55,26,29,0.473
21600817,1610612752,1610612759,94.0,90.0,0.5,0.363,1,2017-02-12,56,23,33,0.411,54,41,13,0.759
21600818,1610612761,1610612765,101.0,102.0,0.507,0.429,0,2017-02-12,55,32,23,0.5820000000000001,55,26,29,0.473
21600819,1610612758,1610612740,105.0,99.0,0.449,0.415,1,2017-02-12,55,23,32,0.418,55,21,34,0.382
21600808,1610612766,1610612746,102.0,107.0,0.435,0.471,0,2017-02-11,54,24,30,0.444,54,33,21,0.611
21600809,1610612754,1610612749,100.0,116.0,0.479,0.479,0,2017-02-11,54,29,25,0.537,53,23,30,0.434
21600810,1610612755,1610612748,117.0,109.0,0.4529999999999999,0.4589999999999999,1,2017-02-11,54,20,34,0.37,55,24,31,0.436
21600811,1610612739,1610612743,125.0,109.0,0.5479999999999999,0.402,1,2017-02-11,53,37,16,0.698,54,24,30,0.444
21600813,1610612760,1610612744,114.0,130.0,0.482,0.529,0,2017-02-11,55,31,24,0.564,54,46,8,0.852
21600812,1610612745,1610612756,133.0,102.0,0.494,0.3939999999999999,1,2017-02-11,57,40,17,0.7020000000000001,55,17,38,0.309
21600814,1610612742,1610612753,112.0,80.0,0.495,0.39,1,2017-02-11,54,22,32,0.407,56,20,36,0.357
21600815,1610612762,1610612738,104.0,112.0,0.407,0.5920000000000001,0,2017-02-11,55,34,21,0.618,54,35,19,0.648
21600799,1610612751,1610612748,99.0,108.0,0.4320000000000001,0.446,0,2017-02-10,54,9,45,0.1669999999999999,54,24,30,0.444
21600800,1610612752,1610612743,123.0,131.0,0.5589999999999999,0.568,0,2017-02-10,55,22,33,0.4,53,24,29,0.4529999999999999
21600801,1610612765,1610612759,92.0,103.0,0.424,0.5,0,2017-02-10,54,25,29,0.4629999999999999,53,41,12,0.774
21600802,1610612749,1610612747,114.0,122.0,0.526,0.52,0,2017-02-10,52,22,30,0.423,56,19,37,0.3389999999999999
21600803,1610612763,1610612744,107.0,122.0,0.391,0.506,0,2017-02-10,56,33,23,0.589,53,45,8,0.8490000000000001
21600804,1610612750,1610612740,106.0,122.0,0.4629999999999999,0.6,0,2017-02-10,54,20,34,0.37,54,21,33,0.389
21600805,1610612764,1610612754,112.0,107.0,0.466,0.489,1,2017-02-10,53,32,21,0.604,53,29,24,0.547
21600806,1610612758,1610612737,108.0,107.0,0.475,0.507,1,2017-02-10,54,22,32,0.407,54,31,23,0.574
21600807,1610612756,1610612741,115.0,97.0,0.505,0.43,1,2017-02-10,54,17,37,0.315,54,26,28,0.481
21600794,1610612766,1610612745,95.0,107.0,0.435,0.4479999999999999,0,2017-02-09,53,24,29,0.4529999999999999,56,39,17,0.696
21600795,1610612753,1610612755,111.0,112.0,0.488,0.421,0,2017-02-09,55,20,35,0.364,53,19,34,0.358
21600796,1610612760,1610612739,118.0,109.0,0.472,0.481,1,2017-02-09,54,31,23,0.574,52,36,16,0.6920000000000001
21600797,1610612742,1610612762,112.0,105.0,0.506,0.4589999999999999,1,2017-02-09,53,21,32,0.396,54,34,20,0.63
21600798,1610612757,1610612738,111.0,120.0,0.506,0.484,0,2017-02-09,54,23,31,0.426,53,34,19,0.642
21600782,1610612755,1610612759,103.0,111.0,0.405,0.527,0,2017-02-08,52,18,34,0.346,52,40,12,0.769
21600783,1610612754,1610612739,117.0,132.0,0.5,0.5479999999999999,0,2017-02-08,52,29,23,0.5579999999999999,51,36,15,0.706
21600784,1610612751,1610612764,110.0,114.0,0.418,0.412,0,2017-02-08,53,9,44,0.17,52,31,21,0.596
21600785,1610612737,1610612743,117.0,106.0,0.505,0.4,1,2017-02-08,53,31,22,0.585,52,23,29,0.442
21600786,1610612765,1610612747,121.0,102.0,0.526,0.43,1,2017-02-08,53,25,28,0.472,55,18,37,0.327
21600787,1610612749,1610612748,88.0,106.0,0.465,0.477,0,2017-02-08,51,22,29,0.431,53,23,30,0.434
21600788,1610612763,1610612756,110.0,91.0,0.486,0.3329999999999999,1,2017-02-08,55,33,22,0.6,53,16,37,0.302
21600789,1610612740,1610612762,94.0,127.0,0.455,0.545,0,2017-02-08,53,20,33,0.377,53,34,19,0.642
21600790,1610612750,1610612761,112.0,109.0,0.488,0.532,1,2017-02-08,53,20,33,0.377,54,32,22,0.593
21600791,1610612752,1610612746,115.0,119.0,0.5,0.489,0,2017-02-08,54,22,32,0.407,53,32,21,0.604
21600792,1610612744,1610612741,123.0,92.0,0.565,0.402,1,2017-02-08,52,44,8,0.846,53,26,27,0.491
21600793,1610612758,1610612738,108.0,92.0,0.5,0.397,1,2017-02-08,53,21,32,0.396,52,33,19,0.635
21600779,1610612766,1610612751,111.0,107.0,0.392,0.4529999999999999,1,2017-02-07,52,24,28,0.462,52,9,43,0.173
21600780,1610612745,1610612753,128.0,104.0,0.494,0.477,1,2017-02-07,55,38,17,0.691,54,20,34,0.37
21600781,1610612742,1610612757,113.0,114.0,0.493,0.488,0,2017-02-07,52,20,32,0.385,53,23,30,0.434
21600768,1610612752,1610612747,107.0,121.0,0.451,0.431,0,2017-02-06,53,22,31,0.415,54,18,36,0.3329999999999999
21600769,1610612764,1610612739,135.0,140.0,0.505,0.5329999999999999,0,2017-02-06,51,30,21,0.588,50,35,15,0.7
21600770,1610612754,1610612760,93.0,90.0,0.379,0.386,1,2017-02-06,51,29,22,0.569,53,30,23,0.5660000000000001
21600771,1610612761,1610612746,118.0,109.0,0.488,0.467,1,2017-02-06,53,32,21,0.604,52,31,21,0.596
21600772,1610612737,1610612762,95.0,120.0,0.446,0.613,0,2017-02-06,52,30,22,0.5770000000000001,52,33,19,0.635
21600773,1610612765,1610612755,113.0,96.0,0.465,0.424,1,2017-02-06,52,24,28,0.462,51,18,33,0.353
21600774,1610612740,1610612756,111.0,106.0,0.457,0.43,1,2017-02-06,52,20,32,0.385,52,16,36,0.308
21600775,1610612750,1610612748,113.0,115.0,0.5379999999999999,0.523,0,2017-02-06,52,19,33,0.365,52,22,30,0.423
21600776,1610612743,1610612742,110.0,87.0,0.5,0.43,1,2017-02-06,51,23,28,0.451,51,20,31,0.392
21600777,1610612763,1610612759,89.0,74.0,0.395,0.366,1,2017-02-06,54,32,22,0.593,51,39,12,0.765
21600778,1610612758,1610612741,107.0,112.0,0.519,0.531,0,2017-02-06,52,20,32,0.385,52,26,26,0.5
21600765,1610612751,1610612761,95.0,103.0,0.421,0.46,0,2017-02-05,51,9,42,0.176,52,31,21,0.596
21600766,1610612738,1610612746,107.0,102.0,0.42,0.417,1,2017-02-05,51,33,18,0.647,51,31,20,0.608
21600767,1610612760,1610612757,105.0,99.0,0.408,0.402,1,2017-02-05,52,30,22,0.5770000000000001,52,22,30,0.423
21600755,1610612764,1610612740,105.0,91.0,0.4579999999999999,0.44,1,2017-02-04,50,30,20,0.6,51,19,32,0.373
21600756,1610612737,1610612753,113.0,86.0,0.526,0.346,1,2017-02-04,51,30,21,0.588,53,20,33,0.377
21600757,1610612754,1610612765,105.0,84.0,0.484,0.413,1,2017-02-04,50,28,22,0.56,51,23,28,0.451
21600758,1610612748,1610612755,125.0,102.0,0.585,0.417,1,2017-02-04,51,21,30,0.412,50,18,32,0.36
21600759,1610612752,1610612739,104.0,111.0,0.4529999999999999,0.488,0,2017-02-04,52,22,30,0.423,49,34,15,0.6940000000000001
21600760,1610612762,1610612766,105.0,98.0,0.469,0.4270000000000001,1,2017-02-04,51,32,19,0.627,51,23,28,0.451
21600761,1610612756,1610612749,112.0,137.0,0.418,0.634,0,2017-02-04,51,16,35,0.314,50,22,28,0.44
21600762,1610612759,1610612743,121.0,97.0,0.57,0.446,1,2017-02-04,50,39,11,0.78,50,22,28,0.44
21600763,1610612750,1610612763,99.0,107.0,0.417,0.416,0,2017-02-04,51,19,32,0.373,53,31,22,0.585
21600764,1610612758,1610612744,109.0,106.0,0.489,0.414,1,2017-02-04,51,20,31,0.392,51,43,8,0.843
21600746,1610612753,1610612761,102.0,94.0,0.4629999999999999,0.391,1,2017-02-03,52,20,32,0.385,51,30,21,0.588
21600747,1610612751,1610612754,97.0,106.0,0.3720000000000001,0.43,0,2017-02-03,50,9,41,0.18,49,27,22,0.551
21600748,1610612765,1610612750,116.0,108.0,0.449,0.494,1,2017-02-03,50,23,27,0.46,50,19,31,0.38
21600749,1610612745,1610612741,121.0,117.0,0.449,0.48,1,2017-02-03,54,37,17,0.685,51,25,26,0.49
21600750,1610612760,1610612763,114.0,102.0,0.475,0.482,1,2017-02-03,51,29,22,0.569,52,30,22,0.5770000000000001
21600751,1610612738,1610612747,113.0,107.0,0.476,0.3939999999999999,1,2017-02-03,50,32,18,0.64,53,17,36,0.321
21600752,1610612743,1610612749,121.0,117.0,0.449,0.542,1,2017-02-03,49,22,27,0.449,49,21,28,0.429
21600753,1610612758,1610612756,103.0,105.0,0.447,0.416,0,2017-02-03,50,19,31,0.38,50,16,34,0.32
21600754,1610612757,1610612742,104.0,108.0,0.455,0.474,0,2017-02-03,51,22,29,0.431,50,20,30,0.4
21600742,1610612764,1610612747,116.0,108.0,0.4579999999999999,0.46,1,2017-02-02,49,29,20,0.5920000000000001,52,17,35,0.327
21600743,1610612745,1610612737,108.0,113.0,0.376,0.518,0,2017-02-02,53,36,17,0.679,50,29,21,0.58
21600744,1610612759,1610612755,102.0,86.0,0.4270000000000001,0.341,1,2017-02-02,49,38,11,0.7759999999999999,49,18,31,0.3670000000000001
21600745,1610612746,1610612744,120.0,133.0,0.5,0.525,0,2017-02-02,50,31,19,0.62,50,43,7,0.86
21600730,1610612753,1610612754,88.0,98.0,0.4029999999999999,0.478,0,2017-02-01,51,19,32,0.373,48,26,22,0.542
21600731,1610612739,1610612750,125.0,97.0,0.539,0.436,1,2017-02-01,48,33,15,0.688,49,19,30,0.3879999999999999
21600732,1610612738,1610612761,109.0,104.0,0.414,0.526,1,2017-02-01,49,31,18,0.633,50,30,20,0.6
21600733,1610612751,1610612752,90.0,95.0,0.42,0.354,0,2017-02-01,49,9,40,0.184,51,22,29,0.431
21600734,1610612748,1610612737,116.0,93.0,0.484,0.395,1,2017-02-01,50,20,30,0.4,49,28,21,0.5710000000000001
21600735,1610612765,1610612740,118.0,98.0,0.545,0.5,1,2017-02-01,49,22,27,0.449,50,19,31,0.38
21600736,1610612742,1610612755,113.0,95.0,0.465,0.455,1,2017-02-01,49,19,30,0.3879999999999999,48,18,30,0.375
21600737,1610612743,1610612763,99.0,119.0,0.4,0.489,0,2017-02-01,48,21,27,0.4379999999999999,51,30,21,0.588
21600738,1610612762,1610612749,104.0,88.0,0.462,0.4379999999999999,1,2017-02-01,50,31,19,0.62,48,21,27,0.4379999999999999
21600739,1610612756,1610612746,114.0,124.0,0.406,0.518,0,2017-02-01,49,15,34,0.306,49,31,18,0.633
21600740,1610612760,1610612741,100.0,128.0,0.38,0.605,0,2017-02-01,50,28,22,0.56,50,25,25,0.5
21600741,1610612744,1610612766,126.0,111.0,0.49,0.4429999999999999,1,2017-02-01,49,42,7,0.857,50,23,27,0.46
21600724,1610612764,1610612752,117.0,101.0,0.557,0.366,1,2017-01-31,48,28,20,0.583,50,21,29,0.42
21600725,1610612761,1610612740,108.0,106.0,0.457,0.426,1,2017-01-31,49,30,19,0.612,49,19,30,0.3879999999999999
21600726,1610612745,1610612758,105.0,83.0,0.447,0.349,1,2017-01-31,52,36,16,0.6920000000000001,49,19,30,0.3879999999999999
21600727,1610612759,1610612760,108.0,94.0,0.43,0.353,1,2017-01-31,48,37,11,0.7709999999999999,49,28,21,0.5710000000000001
21600728,1610612757,1610612766,115.0,98.0,0.452,0.3979999999999999,1,2017-01-31,50,22,28,0.44,49,23,26,0.469
21600729,1610612747,1610612743,120.0,116.0,0.528,0.414,1,2017-01-31,51,17,34,0.3329999999999999,47,21,26,0.447
21600266,1610612755,1610612758,122.0,119.0,0.542,0.5539999999999999,1,2017-01-30,47,18,29,0.3829999999999999,48,19,29,0.396
21600719,1610612748,1610612751,104.0,96.0,0.476,0.425,1,2017-01-30,49,19,30,0.3879999999999999,48,9,39,0.188
21600720,1610612750,1610612753,111.0,105.0,0.44,0.4270000000000001,1,2017-01-30,48,19,29,0.396,50,19,31,0.38
21600721,1610612738,1610612765,113.0,109.0,0.439,0.4429999999999999,1,2017-01-30,48,30,18,0.625,48,21,27,0.4379999999999999
21600722,1610612742,1610612739,104.0,97.0,0.4529999999999999,0.467,1,2017-01-30,48,18,30,0.375,47,32,15,0.6809999999999999
21600723,1610612756,1610612763,96.0,115.0,0.419,0.488,0,2017-01-30,48,15,33,0.313,50,29,21,0.58
21600711,1610612737,1610612752,142.0,139.0,0.4370000000000001,0.3979999999999999,1,2017-01-29,48,28,20,0.583,49,21,28,0.429
21600712,1610612739,1610612760,107.0,91.0,0.446,0.37,1,2017-01-29,46,32,14,0.696,48,28,20,0.583
21600713,1610612754,1610612745,120.0,101.0,0.54,0.41,1,2017-01-29,47,25,22,0.532,51,35,16,0.6859999999999999
21600714,1610612740,1610612764,94.0,107.0,0.452,0.506,0,2017-01-29,48,19,29,0.396,47,27,20,0.574
21600715,1610612761,1610612753,113.0,114.0,0.456,0.532,0,2017-01-29,48,29,19,0.604,49,19,30,0.3879999999999999
21600716,1610612741,1610612755,121.0,108.0,0.506,0.444,1,2017-01-29,49,24,25,0.49,46,17,29,0.37
21600717,1610612759,1610612742,101.0,105.0,0.47,0.4479999999999999,0,2017-01-29,47,36,11,0.7659999999999999,47,17,30,0.362
21600718,1610612757,1610612744,111.0,113.0,0.495,0.456,0,2017-01-29,49,21,28,0.429,48,41,7,0.8540000000000001
21600704,1610612766,1610612758,106.0,109.0,0.48,0.519,0,2017-01-28,48,23,25,0.479,47,19,28,0.4039999999999999
21600705,1610612748,1610612765,116.0,103.0,0.525,0.517,1,2017-01-28,48,18,30,0.375,47,21,26,0.447
21600706,1610612749,1610612738,108.0,112.0,0.425,0.416,0,2017-01-28,47,21,26,0.447,47,29,18,0.617
21600707,1610612744,1610612746,144.0,98.0,0.62,0.439,1,2017-01-28,47,40,7,0.851,48,30,18,0.625
21600708,1610612762,1610612763,95.0,102.0,0.4679999999999999,0.513,0,2017-01-28,49,30,19,0.612,49,28,21,0.5710000000000001
21600709,1610612756,1610612743,112.0,123.0,0.451,0.488,0,2017-01-28,47,15,32,0.319,46,21,25,0.457
21600710,1610612750,1610612751,129.0,109.0,0.505,0.482,1,2017-01-28,47,18,29,0.3829999999999999,47,9,38,0.191
21600696,1610612754,1610612758,115.0,111.0,0.487,0.5,1,2017-01-27,46,24,22,0.522,46,18,28,0.391
21600695,1610612739,1610612751,124.0,116.0,0.5329999999999999,0.494,1,2017-01-27,45,31,14,0.6890000000000001,46,9,37,0.196
21600697,1610612738,1610612753,128.0,98.0,0.562,0.4370000000000001,1,2017-01-27,46,28,18,0.609,48,18,30,0.375
21600698,1610612761,1610612749,102.0,86.0,0.44,0.3879999999999999,1,2017-01-27,47,29,18,0.617,46,21,25,0.457
21600699,1610612752,1610612766,110.0,107.0,0.479,0.444,1,2017-01-27,48,21,27,0.4379999999999999,47,23,24,0.489
21600694,1610612755,1610612745,118.0,123.0,0.5379999999999999,0.519,0,2017-01-27,45,17,28,0.3779999999999999,50,35,15,0.7
21600700,1610612741,1610612748,88.0,100.0,0.423,0.461,0,2017-01-27,48,23,25,0.479,47,17,30,0.362
21600701,1610612740,1610612759,119.0,103.0,0.516,0.3879999999999999,1,2017-01-27,47,19,28,0.4039999999999999,46,36,10,0.7829999999999999
21600702,1610612737,1610612764,86.0,112.0,0.361,0.483,0,2017-01-27,47,27,20,0.574,46,26,20,0.565
21600703,1610612757,1610612763,112.0,109.0,0.469,0.481,1,2017-01-27,48,21,27,0.4379999999999999,48,27,21,0.563
21600690,1610612760,1610612742,109.0,98.0,0.514,0.452,1,2017-01-26,47,28,19,0.596,46,16,30,0.348
21600691,1610612750,1610612754,103.0,109.0,0.444,0.519,0,2017-01-26,46,17,29,0.37,45,23,22,0.511
21600692,1610612743,1610612756,127.0,120.0,0.512,0.539,1,2017-01-26,45,20,25,0.444,46,15,31,0.326
21600693,1610612762,1610612747,96.0,88.0,0.407,0.429,1,2017-01-26,48,30,18,0.625,50,16,34,0.32
21600680,1610612739,1610612758,112.0,116.0,0.488,0.4529999999999999,0,2017-01-25,44,30,14,0.682,45,18,27,0.4
21600681,1610612738,1610612745,120.0,109.0,0.516,0.4679999999999999,1,2017-01-25,45,27,18,0.6,49,34,15,0.6940000000000001
21600682,1610612751,1610612748,106.0,109.0,0.4379999999999999,0.482,0,2017-01-25,45,9,36,0.2,46,16,30,0.348
21600683,1610612741,1610612737,114.0,119.0,0.457,0.518,0,2017-01-25,47,23,24,0.489,46,27,19,0.5870000000000001
21600684,1610612749,1610612755,109.0,114.0,0.462,0.5329999999999999,0,2017-01-25,45,21,24,0.467,44,17,27,0.386
21600685,1610612763,1610612761,101.0,99.0,0.462,0.424,1,2017-01-25,47,27,20,0.574,46,28,18,0.609
21600686,1610612740,1610612760,105.0,114.0,0.4270000000000001,0.462,0,2017-01-25,46,18,28,0.391,46,27,19,0.5870000000000001
21600687,1610612766,1610612744,103.0,113.0,0.413,0.476,0,2017-01-25,46,23,23,0.5,46,39,7,0.848
21600688,1610612742,1610612752,103.0,95.0,0.47,0.424,1,2017-01-25,45,16,29,0.356,47,20,27,0.426
21600689,1610612757,1610612747,105.0,98.0,0.478,0.3939999999999999,1,2017-01-25,47,20,27,0.426,49,16,33,0.327
21600674,1610612761,1610612759,106.0,108.0,0.452,0.447,0,2017-01-24,45,28,17,0.622,45,36,9,0.8
21600675,1610612755,1610612746,121.0,110.0,0.5,0.465,1,2017-01-24,43,16,27,0.3720000000000001,47,30,17,0.638
21600676,1610612764,1610612738,123.0,108.0,0.5710000000000001,0.452,1,2017-01-24,45,25,20,0.556,44,26,18,0.591
21600677,1610612753,1610612741,92.0,100.0,0.412,0.455,0,2017-01-24,47,18,29,0.3829999999999999,46,23,23,0.5
21600678,1610612743,1610612762,103.0,93.0,0.461,0.412,1,2017-01-24,44,19,25,0.4320000000000001,47,29,18,0.617
21600679,1610612756,1610612750,111.0,112.0,0.442,0.524,0,2017-01-24,45,15,30,0.3329999999999999,45,17,28,0.3779999999999999
21600665,1610612766,1610612764,99.0,109.0,0.389,0.5379999999999999,0,2017-01-23,45,23,22,0.511,44,24,20,0.545
21600666,1610612751,1610612759,86.0,112.0,0.395,0.474,0,2017-01-23,44,9,35,0.205,44,35,9,0.795
21600667,1610612737,1610612746,105.0,115.0,0.42,0.5,0,2017-01-23,45,26,19,0.578,46,30,16,0.652
21600668,1610612748,1610612744,105.0,102.0,0.442,0.466,1,2017-01-23,45,15,30,0.3329999999999999,45,38,7,0.8440000000000001
21600669,1610612765,1610612758,104.0,109.0,0.5,0.488,0,2017-01-23,46,21,25,0.457,44,17,27,0.386
21600670,1610612749,1610612745,127.0,114.0,0.588,0.506,1,2017-01-23,44,21,23,0.477,48,34,14,0.708
21600671,1610612740,1610612739,124.0,122.0,0.494,0.462,1,2017-01-23,45,18,27,0.4,43,30,13,0.698
21600672,1610612754,1610612752,103.0,109.0,0.442,0.461,0,2017-01-23,44,22,22,0.5,46,20,26,0.435
21600673,1610612762,1610612760,95.0,97.0,0.429,0.434,0,2017-01-23,46,29,17,0.63,45,26,19,0.578
21600661,1610612753,1610612744,98.0,118.0,0.4379999999999999,0.472,0,2017-01-22,46,18,28,0.391,44,38,6,0.8640000000000001
21600662,1610612742,1610612747,122.0,73.0,0.494,0.384,1,2017-01-22,44,15,29,0.341,48,16,32,0.3329999999999999
21600663,1610612761,1610612756,103.0,115.0,0.3979999999999999,0.506,0,2017-01-22,44,28,16,0.636,44,15,29,0.341
21600664,1610612750,1610612743,111.0,108.0,0.529,0.512,1,2017-01-22,44,16,28,0.364,43,18,25,0.419
21600650,1610612738,1610612757,123.0,127.0,0.457,0.467,0,2017-01-21,43,26,17,0.605,46,19,27,0.413
21600651,1610612765,1610612764,113.0,112.0,0.494,0.429,1,2017-01-21,45,21,24,0.467,43,23,20,0.535
21600652,1610612766,1610612751,112.0,105.0,0.476,0.4320000000000001,1,2017-01-21,44,23,21,0.523,43,9,34,0.209
21600653,1610612737,1610612755,110.0,93.0,0.495,0.423,1,2017-01-21,44,26,18,0.591,42,15,27,0.357
21600654,1610612752,1610612756,105.0,107.0,0.449,0.435,0,2017-01-21,45,19,26,0.422,43,14,29,0.326
21600655,1610612748,1610612749,109.0,97.0,0.532,0.418,1,2017-01-21,44,14,30,0.318,43,20,23,0.465
21600656,1610612763,1610612745,95.0,119.0,0.371,0.513,0,2017-01-21,46,26,20,0.565,47,34,13,0.723
21600657,1610612739,1610612759,115.0,118.0,0.495,0.5,0,2017-01-21,42,30,12,0.7140000000000001,43,34,9,0.7909999999999999
21600658,1610612743,1610612746,123.0,98.0,0.529,0.417,1,2017-01-21,42,18,24,0.429,45,29,16,0.644
21600659,1610612762,1610612754,109.0,100.0,0.4639999999999999,0.506,1,2017-01-21,45,29,16,0.644,43,22,21,0.512
21600660,1610612741,1610612758,102.0,99.0,0.41,0.44,1,2017-01-21,45,22,23,0.489,43,16,27,0.3720000000000001
21600641,1610612755,1610612757,93.0,92.0,0.391,0.371,1,2017-01-20,41,15,26,0.366,45,18,27,0.4
21600642,1610612766,1610612761,113.0,78.0,0.5,0.337,1,2017-01-20,43,22,21,0.512,43,28,15,0.6509999999999999
21600643,1610612753,1610612749,112.0,96.0,0.46,0.41,1,2017-01-20,45,18,27,0.4,42,20,22,0.476
21600644,1610612763,1610612758,107.0,91.0,0.4579999999999999,0.408,1,2017-01-20,45,26,19,0.578,42,16,26,0.381
21600645,1610612740,1610612751,114.0,143.0,0.41,0.578,0,2017-01-20,44,17,27,0.386,42,9,33,0.214
21600646,1610612745,1610612744,108.0,125.0,0.4479999999999999,0.528,0,2017-01-20,46,33,13,0.7170000000000001,43,37,6,0.86
21600647,1610612737,1610612741,102.0,93.0,0.476,0.42,1,2017-01-20,43,25,18,0.581,44,21,23,0.477
21600648,1610612742,1610612762,107.0,112.0,0.4479999999999999,0.4579999999999999,0,2017-01-20,43,14,29,0.326,44,28,16,0.636
21600649,1610612747,1610612754,108.0,95.0,0.471,0.425,1,2017-01-20,47,16,31,0.34,42,22,20,0.524
21600636,1610612739,1610612756,118.0,103.0,0.506,0.435,1,2017-01-19,41,30,11,0.732,42,13,29,0.31
21600637,1610612748,1610612742,99.0,95.0,0.479,0.451,1,2017-01-19,43,13,30,0.302,42,14,28,0.3329999999999999
21600638,1610612752,1610612764,110.0,113.0,0.467,0.5,0,2017-01-19,44,19,25,0.4320000000000001,42,23,19,0.5479999999999999
21600639,1610612759,1610612743,118.0,104.0,0.512,0.407,1,2017-01-19,42,33,9,0.7859999999999999,41,17,24,0.415
21600640,1610612746,1610612750,101.0,104.0,0.483,0.476,0,2017-01-19,44,29,15,0.659,43,15,28,0.349
21600627,1610612755,1610612761,94.0,89.0,0.449,0.395,1,2017-01-18,40,14,26,0.35,42,28,14,0.667
21600628,1610612764,1610612763,104.0,101.0,0.45,0.3979999999999999,1,2017-01-18,41,22,19,0.537,44,25,19,0.568
21600629,1610612766,1610612757,107.0,85.0,0.471,0.351,1,2017-01-18,42,21,21,0.5,44,18,26,0.409
21600630,1610612738,1610612752,106.0,117.0,0.385,0.505,0,2017-01-18,42,26,16,0.619,43,19,24,0.442
21600631,1610612740,1610612753,118.0,98.0,0.495,0.4429999999999999,1,2017-01-18,43,17,26,0.395,44,17,27,0.386
21600632,1610612745,1610612749,111.0,92.0,0.4529999999999999,0.3979999999999999,1,2017-01-18,45,33,12,0.733,41,20,21,0.488
21600633,1610612765,1610612737,118.0,95.0,0.495,0.385,1,2017-01-18,44,20,24,0.455,42,24,18,0.5710000000000001
21600634,1610612744,1610612760,121.0,100.0,0.541,0.422,1,2017-01-18,42,36,6,0.857,44,25,19,0.568
21600635,1610612758,1610612754,100.0,106.0,0.486,0.52,0,2017-01-18,41,16,25,0.39,41,22,19,0.537
21600622,1610612751,1610612761,109.0,119.0,0.449,0.522,0,2017-01-17,41,8,33,0.195,41,28,13,0.6829999999999999
21600623,1610612748,1610612745,109.0,103.0,0.467,0.4,1,2017-01-17,42,12,30,0.286,44,32,12,0.727
21600624,1610612741,1610612742,98.0,99.0,0.451,0.474,0,2017-01-17,43,21,22,0.488,41,14,27,0.341
21600625,1610612759,1610612750,122.0,114.0,0.512,0.493,1,2017-01-17,41,32,9,0.78,42,14,28,0.3329999999999999
21600626,1610612747,1610612743,121.0,127.0,0.435,0.568,0,2017-01-17,46,15,31,0.326,40,17,23,0.425
21600613,1610612752,1610612737,107.0,108.0,0.494,0.46,0,2017-01-16,42,18,24,0.429,41,24,17,0.585
21600614,1610612764,1610612757,120.0,101.0,0.488,0.42,1,2017-01-16,40,21,19,0.525,43,18,25,0.419
21600615,1610612749,1610612755,104.0,113.0,0.472,0.449,0,2017-01-16,40,20,20,0.5,39,13,26,0.3329999999999999
21600616,1610612754,1610612740,98.0,95.0,0.506,0.434,1,2017-01-16,40,21,19,0.525,42,16,26,0.381
21600617,1610612743,1610612753,125.0,112.0,0.584,0.511,1,2017-01-16,39,16,23,0.41,43,17,26,0.395
21600618,1610612738,1610612766,108.0,98.0,0.5,0.442,1,2017-01-16,41,26,15,0.634,41,20,21,0.488
21600619,1610612744,1610612739,126.0,91.0,0.505,0.352,1,2017-01-16,41,35,6,0.8540000000000001,40,29,11,0.725
21600620,1610612756,1610612762,101.0,106.0,0.494,0.461,0,2017-01-16,41,13,28,0.317,43,27,16,0.628
21600621,1610612746,1610612760,120.0,98.0,0.5489999999999999,0.424,1,2017-01-16,43,29,14,0.674,43,25,18,0.581
21600608,1610612742,1610612750,98.0,87.0,0.4679999999999999,0.4379999999999999,1,2017-01-15,40,13,27,0.325,41,14,27,0.341
21600606,1610612761,1610612752,116.0,101.0,0.494,0.417,1,2017-01-15,40,27,13,0.675,41,18,23,0.439
21600607,1610612737,1610612749,111.0,98.0,0.525,0.494,1,2017-01-15,40,23,17,0.575,39,20,19,0.513
21600609,1610612751,1610612745,112.0,137.0,0.441,0.5,0,2017-01-15,40,8,32,0.2,43,32,11,0.7440000000000001
21600610,1610612758,1610612760,118.0,122.0,0.457,0.444,0,2017-01-15,40,16,24,0.4,42,25,17,0.595
21600611,1610612763,1610612741,104.0,108.0,0.421,0.513,0,2017-01-15,43,25,18,0.581,42,21,21,0.5
21600612,1610612747,1610612765,97.0,102.0,0.434,0.4320000000000001,0,2017-01-15,45,15,30,0.3329999999999999,43,19,24,0.442
21600601,1610612746,1610612747,113.0,97.0,0.522,0.45,1,2017-01-14,42,28,14,0.667,44,15,29,0.341
21600602,1610612741,1610612740,107.0,99.0,0.426,0.4639999999999999,1,2017-01-14,41,20,21,0.488,41,16,25,0.39
21600605,1610612756,1610612759,108.0,105.0,0.4589999999999999,0.507,1,2017-01-14,40,13,27,0.325,40,31,9,0.775
21600603,1610612764,1610612755,109.0,93.0,0.484,0.414,1,2017-01-14,39,20,19,0.513,38,12,26,0.316
21600604,1610612762,1610612753,114.0,107.0,0.494,0.4629999999999999,1,2017-01-14,42,26,16,0.619,42,17,25,0.405
21600593,1610612755,1610612766,102.0,93.0,0.474,0.3289999999999999,1,2017-01-13,37,12,25,0.324,40,20,20,0.5
21600592,1610612761,1610612751,132.0,113.0,0.536,0.465,1,2017-01-13,39,26,13,0.667,39,8,31,0.205
21600594,1610612749,1610612748,116.0,108.0,0.5,0.494,1,2017-01-13,38,20,18,0.526,41,11,30,0.268
21600595,1610612745,1610612763,105.0,110.0,0.402,0.539,0,2017-01-13,42,31,11,0.738,42,25,17,0.595
21600596,1610612750,1610612760,96.0,86.0,0.4529999999999999,0.3879999999999999,1,2017-01-13,40,14,26,0.35,41,24,17,0.585
21600597,1610612737,1610612738,101.0,103.0,0.429,0.434,0,2017-01-13,39,22,17,0.564,40,25,15,0.625
21600598,1610612757,1610612753,109.0,115.0,0.402,0.494,0,2017-01-13,42,18,24,0.429,41,17,24,0.415
21600599,1610612758,1610612739,108.0,120.0,0.525,0.506,0,2017-01-13,39,16,23,0.41,39,29,10,0.7440000000000001
21600600,1610612762,1610612765,110.0,77.0,0.5379999999999999,0.395,1,2017-01-13,41,25,16,0.61,42,18,24,0.429
21600589,1610612743,1610612754,140.0,112.0,0.578,0.4679999999999999,1,2017-01-12,38,15,23,0.395,39,20,19,0.513
21600586,1610612751,1610612740,95.0,104.0,0.412,0.422,0,2017-01-12,38,8,30,0.211,40,16,24,0.4
21600587,1610612752,1610612741,104.0,89.0,0.478,0.3929999999999999,1,2017-01-12,40,18,22,0.45,40,19,21,0.475
21600588,1610612759,1610612747,134.0,94.0,0.605,0.412,1,2017-01-12,39,31,8,0.795,43,15,28,0.349
21600591,1610612756,1610612742,108.0,113.0,0.487,0.483,0,2017-01-12,39,12,27,0.308,39,12,27,0.308
21600590,1610612744,1610612765,127.0,107.0,0.562,0.489,1,2017-01-12,40,34,6,0.85,41,18,23,0.439
21600580,1610612755,1610612752,98.0,97.0,0.389,0.488,1,2017-01-11,36,11,25,0.306,39,17,22,0.436
21600581,1610612760,1610612763,103.0,95.0,0.444,0.413,1,2017-01-11,40,24,16,0.6,41,24,17,0.585
21600582,1610612750,1610612745,119.0,105.0,0.5429999999999999,0.414,1,2017-01-11,39,13,26,0.3329999999999999,41,31,10,0.7559999999999999
21600583,1610612738,1610612764,117.0,108.0,0.506,0.429,1,2017-01-11,39,24,15,0.615,38,19,19,0.5
21600584,1610612746,1610612753,105.0,96.0,0.513,0.424,1,2017-01-11,41,27,14,0.659,40,16,24,0.4
21600585,1610612757,1610612739,102.0,86.0,0.43,0.341,1,2017-01-11,41,18,23,0.439,38,28,10,0.737
21600571,1610612764,1610612741,101.0,99.0,0.506,0.3979999999999999,1,2017-01-10,37,19,18,0.514,39,19,20,0.487
21600572,1610612761,1610612738,114.0,106.0,0.471,0.471,1,2017-01-10,38,25,13,0.6579999999999999,38,23,15,0.605
21600573,1610612751,1610612737,97.0,117.0,0.402,0.478,0,2017-01-10,37,8,29,0.216,38,22,16,0.579
21600574,1610612745,1610612766,121.0,114.0,0.488,0.478,1,2017-01-10,40,31,9,0.775,39,20,19,0.513
21600575,1610612759,1610612749,107.0,109.0,0.477,0.524,0,2017-01-10,38,30,8,0.789,37,19,18,0.514
21600576,1610612762,1610612739,100.0,92.0,0.481,0.365,1,2017-01-10,40,24,16,0.6,37,28,9,0.757
21600577,1610612747,1610612757,87.0,108.0,0.386,0.506,0,2017-01-10,42,15,27,0.357,40,17,23,0.425
21600578,1610612744,1610612748,107.0,95.0,0.4529999999999999,0.422,1,2017-01-10,39,33,6,0.846,40,11,29,0.275
21600579,1610612758,1610612765,100.0,94.0,0.4379999999999999,0.439,1,2017-01-10,38,16,22,0.421,40,18,22,0.45
21600568,1610612752,1610612740,96.0,110.0,0.424,0.488,0,2017-01-09,38,17,21,0.447,39,15,24,0.385
21600569,1610612741,1610612760,94.0,109.0,0.41,0.5660000000000001,0,2017-01-09,38,19,19,0.5,39,23,16,0.59
21600570,1610612750,1610612742,101.0,92.0,0.563,0.462,1,2017-01-09,38,12,26,0.316,38,11,27,0.289
21600560,1610612751,1610612755,95.0,105.0,0.462,0.3939999999999999,0,2017-01-08,36,8,28,0.222,35,10,25,0.286
21600562,1610612749,1610612764,101.0,107.0,0.4629999999999999,0.488,0,2017-01-08,36,18,18,0.5,36,18,18,0.5
21600561,1610612746,1610612748,98.0,86.0,0.419,0.369,1,2017-01-08,40,26,14,0.65,39,11,28,0.282
21600563,1610612761,1610612745,122.0,129.0,0.5379999999999999,0.517,0,2017-01-08,37,24,13,0.649,39,30,9,0.769
21600564,1610612763,1610612762,88.0,79.0,0.436,0.389,1,2017-01-08,40,24,16,0.6,39,23,16,0.59
21600565,1610612756,1610612739,116.0,120.0,0.529,0.537,0,2017-01-08,38,12,26,0.316,36,28,8,0.778
21600559,1610612757,1610612765,124.0,125.0,0.52,0.514,0,2017-01-08,39,16,23,0.41,39,18,21,0.462
21600566,1610612758,1610612744,106.0,117.0,0.486,0.506,0,2017-01-08,37,15,22,0.405,38,32,6,0.8420000000000001
21600567,1610612747,1610612753,111.0,95.0,0.483,0.3779999999999999,1,2017-01-08,41,15,26,0.366,39,16,23,0.41
21600552,1610612754,1610612752,123.0,109.0,0.5,0.46,1,2017-01-07,38,20,18,0.526,37,17,20,0.4589999999999999
21600553,1610612738,1610612740,117.0,108.0,0.43,0.471,1,2017-01-07,37,23,14,0.622,38,14,24,0.368
21600554,1610612741,1610612761,123.0,118.0,0.392,0.435,1,2017-01-07,37,19,18,0.514,36,24,12,0.667
21600555,1610612760,1610612743,121.0,106.0,0.483,0.4039999999999999,1,2017-01-07,38,22,16,0.579,37,14,23,0.3779999999999999
21600556,1610612750,1610612762,92.0,94.0,0.4379999999999999,0.416,0,2017-01-07,37,11,26,0.297,38,23,15,0.605
21600557,1610612742,1610612737,82.0,97.0,0.39,0.405,0,2017-01-07,37,11,26,0.297,37,21,16,0.568
21600558,1610612759,1610612766,102.0,85.0,0.4039999999999999,0.4,1,2017-01-07,37,30,7,0.8109999999999999,38,20,18,0.526
21600544,1610612764,1610612750,112.0,105.0,0.5820000000000001,0.477,1,2017-01-06,35,17,18,0.486,36,11,25,0.306
21600545,1610612753,1610612745,93.0,100.0,0.418,0.4529999999999999,0,2017-01-06,38,16,22,0.421,38,29,9,0.763
21600546,1610612738,1610612755,110.0,106.0,0.402,0.4679999999999999,1,2017-01-06,36,22,14,0.611,34,9,25,0.265
21600547,1610612751,1610612739,108.0,116.0,0.451,0.4320000000000001,0,2017-01-06,35,8,27,0.2289999999999999,35,27,8,0.7709999999999999
21600548,1610612749,1610612752,111.0,116.0,0.5,0.494,0,2017-01-06,35,18,17,0.514,36,17,19,0.472
21600549,1610612747,1610612748,127.0,100.0,0.5,0.413,1,2017-01-06,40,14,26,0.35,38,11,27,0.289
21600550,1610612744,1610612763,119.0,128.0,0.494,0.485,0,2017-01-06,37,31,6,0.838,39,23,16,0.59
21600551,1610612758,1610612746,98.0,106.0,0.414,0.4639999999999999,0,2017-01-06,36,15,21,0.417,39,25,14,0.6409999999999999
21600536,1610612754,1610612751,121.0,109.0,0.516,0.456,1,2017-01-05,37,19,18,0.514,34,8,26,0.235
21600537,1610612761,1610612762,101.0,93.0,0.396,0.466,1,2017-01-05,35,24,11,0.6859999999999999,37,22,15,0.595
21600538,1610612765,1610612766,115.0,114.0,0.402,0.407,1,2017-01-05,38,17,21,0.447,37,20,17,0.541
21600539,1610612740,1610612737,94.0,99.0,0.366,0.422,0,2017-01-05,37,14,23,0.3779999999999999,36,20,16,0.556
21600540,1610612745,1610612760,118.0,116.0,0.477,0.451,1,2017-01-05,37,28,9,0.757,37,21,16,0.568
21600541,1610612742,1610612756,95.0,102.0,0.456,0.447,0,2017-01-05,36,11,25,0.306,37,12,25,0.324
21600543,1610612743,1610612759,99.0,127.0,0.4529999999999999,0.5670000000000001,0,2017-01-05,36,14,22,0.389,36,29,7,0.8059999999999999
21600542,1610612757,1610612747,118.0,109.0,0.531,0.419,1,2017-01-05,38,16,22,0.421,39,13,26,0.3329999999999999
21600529,1610612766,1610612760,123.0,112.0,0.4629999999999999,0.4379999999999999,1,2017-01-04,36,20,16,0.556,36,21,15,0.583
21600530,1610612753,1610612737,92.0,111.0,0.43,0.5429999999999999,0,2017-01-04,37,16,21,0.4320000000000001,35,19,16,0.5429999999999999
21600531,1610612752,1610612749,104.0,105.0,0.447,0.474,0,2017-01-04,35,16,19,0.457,34,18,16,0.529
21600532,1610612739,1610612741,94.0,106.0,0.41,0.482,0,2017-01-04,34,26,8,0.765,36,18,18,0.5
21600533,1610612746,1610612763,115.0,106.0,0.507,0.4320000000000001,1,2017-01-04,38,24,14,0.632,38,22,16,0.579
21600534,1610612744,1610612757,125.0,117.0,0.506,0.449,1,2017-01-04,36,31,5,0.861,37,15,22,0.405
21600535,1610612758,1610612748,102.0,107.0,0.513,0.486,0,2017-01-04,35,15,20,0.429,37,11,26,0.297
21600521,1610612755,1610612750,93.0,91.0,0.3879999999999999,0.402,1,2017-01-03,33,9,24,0.273,35,11,24,0.314
21600522,1610612738,1610612762,115.0,104.0,0.5539999999999999,0.4629999999999999,1,2017-01-03,35,21,14,0.6,36,22,14,0.611
21600523,1610612765,1610612754,116.0,121.0,0.495,0.581,0,2017-01-03,37,16,21,0.4320000000000001,36,18,18,0.5
21600524,1610612742,1610612764,113.0,105.0,0.474,0.446,1,2017-01-03,35,11,24,0.314,34,16,18,0.471
21600525,1610612759,1610612761,110.0,82.0,0.551,0.373,1,2017-01-03,35,28,7,0.8,34,23,11,0.6759999999999999
21600526,1610612743,1610612758,113.0,120.0,0.5,0.523,0,2017-01-03,35,14,21,0.4,34,15,19,0.441
21600527,1610612756,1610612748,99.0,90.0,0.4679999999999999,0.396,1,2017-01-03,36,11,25,0.306,36,10,26,0.278
21600528,1610612747,1610612763,116.0,102.0,0.512,0.39,1,2017-01-03,38,13,25,0.342,37,22,15,0.595
21600513,1610612749,1610612760,98.0,94.0,0.481,0.462,1,2017-01-02,33,17,16,0.515,35,21,14,0.6
21600514,1610612739,1610612740,90.0,82.0,0.3779999999999999,0.364,1,2017-01-02,33,26,7,0.7879999999999999,36,14,22,0.389
21600515,1610612751,1610612762,89.0,101.0,0.423,0.419,0,2017-01-02,33,8,25,0.242,35,22,13,0.629
21600516,1610612752,1610612753,103.0,115.0,0.47,0.495,0,2017-01-02,34,16,18,0.471,36,16,20,0.444
21600517,1610612741,1610612766,118.0,111.0,0.467,0.494,1,2017-01-02,35,17,18,0.486,35,19,16,0.5429999999999999
21600518,1610612745,1610612764,101.0,91.0,0.43,0.4370000000000001,1,2017-01-02,36,27,9,0.75,33,16,17,0.485
21600519,1610612746,1610612756,109.0,98.0,0.4629999999999999,0.382,1,2017-01-02,37,23,14,0.622,35,10,25,0.286
21600520,1610612744,1610612743,127.0,119.0,0.526,0.475,1,2017-01-02,35,30,5,0.857,34,14,20,0.412
21600508,1610612737,1610612759,114.0,112.0,0.457,0.467,1,2017-01-01,34,18,16,0.529,34,27,7,0.794
21600509,1610612748,1610612765,98.0,107.0,0.455,0.488,0,2017-01-01,35,10,25,0.286,36,16,20,0.444
21600510,1610612754,1610612753,117.0,104.0,0.5,0.433,1,2017-01-01,35,17,18,0.486,35,15,20,0.429
21600511,1610612750,1610612757,89.0,95.0,0.402,0.493,0,2017-01-01,34,11,23,0.324,36,15,21,0.417
21600512,1610612747,1610612761,114.0,123.0,0.402,0.56,0,2017-01-01,37,12,25,0.324,33,23,10,0.6970000000000001
21600502,1610612758,1610612763,98.0,112.0,0.431,0.506,0,2016-12-31,33,14,19,0.424,36,22,14,0.611
21600503,1610612741,1610612749,96.0,116.0,0.3979999999999999,0.5660000000000001,0,2016-12-31,34,16,18,0.471,32,16,16,0.5
21600505,1610612766,1610612739,109.0,121.0,0.513,0.506,0,2016-12-31,34,19,15,0.5589999999999999,32,25,7,0.7809999999999999
21600504,1610612745,1610612752,129.0,122.0,0.457,0.4479999999999999,1,2016-12-31,35,26,9,0.743,33,16,17,0.485
21600506,1610612762,1610612756,91.0,86.0,0.479,0.414,1,2016-12-31,34,21,13,0.618,34,10,24,0.294
21600507,1610612760,1610612746,114.0,88.0,0.474,0.413,1,2016-12-31,34,21,13,0.618,36,22,14,0.611
21600492,1610612754,1610612741,111.0,101.0,0.481,0.417,1,2016-12-30,34,16,18,0.471,33,16,17,0.485
21600493,1610612764,1610612751,118.0,95.0,0.5660000000000001,0.4320000000000001,1,2016-12-30,32,16,16,0.5,32,8,24,0.25
21600494,1610612738,1610612748,117.0,114.0,0.514,0.5329999999999999,1,2016-12-30,34,20,14,0.588,34,10,24,0.294
21600495,1610612740,1610612752,104.0,92.0,0.447,0.376,1,2016-12-30,35,14,21,0.4,32,16,16,0.5
21600496,1610612745,1610612746,140.0,116.0,0.556,0.469,1,2016-12-30,34,25,9,0.735,35,22,13,0.629
21600497,1610612750,1610612749,116.0,99.0,0.5579999999999999,0.541,1,2016-12-30,33,11,22,0.3329999999999999,31,15,16,0.484
21600498,1610612737,1610612765,105.0,98.0,0.4429999999999999,0.417,1,2016-12-30,33,17,16,0.515,35,15,20,0.429
21600499,1610612759,1610612757,110.0,94.0,0.5,0.455,1,2016-12-30,33,27,6,0.818,35,14,21,0.4
21600500,1610612743,1610612755,122.0,124.0,0.4639999999999999,0.4370000000000001,0,2016-12-30,33,14,19,0.424,32,8,24,0.25
21600501,1610612744,1610612742,108.0,99.0,0.5,0.419,1,2016-12-30,34,29,5,0.853,34,10,24,0.294
21600486,1610612766,1610612748,91.0,82.0,0.387,0.402,1,2016-12-29,33,19,14,0.5760000000000001,33,10,23,0.303
21600487,1610612763,1610612760,114.0,80.0,0.524,0.3379999999999999,1,2016-12-29,35,21,14,0.6,33,20,13,0.606
21600488,1610612739,1610612738,124.0,118.0,0.518,0.506,1,2016-12-29,31,24,7,0.774,33,19,14,0.5760000000000001
21600489,1610612762,1610612755,100.0,83.0,0.479,0.402,1,2016-12-29,33,20,13,0.606,31,7,24,0.226
21600490,1610612756,1610612761,99.0,91.0,0.446,0.4,1,2016-12-29,33,10,23,0.303,32,22,10,0.688
21600491,1610612747,1610612742,89.0,101.0,0.471,0.494,0,2016-12-29,36,12,24,0.3329999999999999,33,10,23,0.303
21600476,1610612764,1610612754,111.0,105.0,0.487,0.4429999999999999,1,2016-12-28,31,15,16,0.484,33,15,18,0.455
21600477,1610612753,1610612766,101.0,120.0,0.488,0.5479999999999999,0,2016-12-28,34,15,19,0.441,32,18,14,0.563
21600478,1610612737,1610612752,102.0,98.0,0.366,0.376,1,2016-12-28,32,16,16,0.5,31,16,15,0.516
21600479,1610612765,1610612749,94.0,119.0,0.4429999999999999,0.5710000000000001,0,2016-12-28,34,15,19,0.441,30,15,15,0.5
21600480,1610612741,1610612751,101.0,99.0,0.3979999999999999,0.43,1,2016-12-28,32,16,16,0.5,31,8,23,0.258
21600481,1610612740,1610612746,102.0,98.0,0.46,0.3939999999999999,1,2016-12-28,34,13,21,0.382,34,22,12,0.647
21600482,1610612759,1610612756,119.0,98.0,0.54,0.486,1,2016-12-28,32,26,6,0.813,32,9,23,0.281
21600483,1610612743,1610612750,105.0,103.0,0.519,0.447,1,2016-12-28,32,14,18,0.4379999999999999,32,10,22,0.313
21600484,1610612757,1610612758,102.0,89.0,0.473,0.392,1,2016-12-28,34,14,20,0.412,32,14,18,0.4379999999999999
21600485,1610612744,1610612761,121.0,111.0,0.568,0.3879999999999999,1,2016-12-28,33,28,5,0.848,31,22,9,0.71
21600472,1610612738,1610612763,113.0,103.0,0.482,0.42,1,2016-12-27,32,19,13,0.594,34,20,14,0.588
21600473,1610612748,1610612760,94.0,106.0,0.439,0.512,0,2016-12-27,32,10,22,0.313,32,20,12,0.625
21600474,1610612742,1610612745,107.0,123.0,0.414,0.526,0,2016-12-27,32,9,23,0.281,33,24,9,0.727
21600475,1610612747,1610612762,100.0,102.0,0.47,0.507,0,2016-12-27,35,12,23,0.3429999999999999,32,19,13,0.594
21600461,1610612764,1610612749,107.0,102.0,0.506,0.46,1,2016-12-26,30,14,16,0.467,29,14,15,0.483
21600462,1610612753,1610612763,112.0,102.0,0.512,0.461,1,2016-12-26,33,15,18,0.455,33,20,13,0.606
21600463,1610612751,1610612766,120.0,118.0,0.5329999999999999,0.4679999999999999,1,2016-12-26,30,8,22,0.267,31,17,14,0.5479999999999999
21600464,1610612765,1610612739,106.0,90.0,0.446,0.38,1,2016-12-26,33,15,18,0.455,30,23,7,0.767
21600465,1610612741,1610612754,90.0,85.0,0.386,0.42,1,2016-12-26,31,15,16,0.484,32,15,17,0.469
21600466,1610612740,1610612742,111.0,104.0,0.529,0.493,1,2016-12-26,33,12,21,0.364,31,9,22,0.29
21600467,1610612745,1610612756,131.0,115.0,0.5,0.426,1,2016-12-26,32,23,9,0.7190000000000001,31,9,22,0.29
21600468,1610612750,1610612737,104.0,90.0,0.451,0.422,1,2016-12-26,31,10,21,0.3229999999999999,31,15,16,0.484
21600469,1610612757,1610612761,91.0,95.0,0.422,0.337,0,2016-12-26,33,13,20,0.3939999999999999,30,22,8,0.733
21600470,1610612746,1610612743,102.0,106.0,0.4639999999999999,0.439,0,2016-12-26,33,22,11,0.667,31,13,18,0.419
21600471,1610612758,1610612755,102.0,100.0,0.4479999999999999,0.494,1,2016-12-26,31,14,17,0.452,30,7,23,0.233
21600456,1610612752,1610612738,114.0,119.0,0.471,0.484,0,2016-12-25,30,16,14,0.5329999999999999,31,18,13,0.581
21600457,1610612739,1610612744,109.0,108.0,0.389,0.481,1,2016-12-25,29,23,6,0.7929999999999999,32,27,5,0.8440000000000001
21600458,1610612759,1610612741,119.0,100.0,0.565,0.4529999999999999,1,2016-12-25,31,25,6,0.8059999999999999,30,14,16,0.467
21600459,1610612760,1610612750,112.0,100.0,0.512,0.47,1,2016-12-25,31,19,12,0.613,30,9,21,0.3
21600460,1610612747,1610612746,111.0,102.0,0.476,0.435,1,2016-12-25,34,12,22,0.353,32,22,10,0.688
21600442,1610612766,1610612741,103.0,91.0,0.44,0.396,1,2016-12-23,30,17,13,0.5670000000000001,29,14,15,0.483
21600443,1610612753,1610612747,109.0,90.0,0.506,0.356,1,2016-12-23,32,14,18,0.4379999999999999,33,11,22,0.3329999999999999
21600444,1610612739,1610612751,119.0,99.0,0.455,0.447,1,2016-12-23,28,22,6,0.7859999999999999,29,7,22,0.241
21600445,1610612738,1610612760,112.0,117.0,0.441,0.513,0,2016-12-23,30,17,13,0.5670000000000001,30,18,12,0.6
21600446,1610612765,1610612744,113.0,119.0,0.506,0.5579999999999999,0,2016-12-23,32,14,18,0.4379999999999999,31,27,4,0.871
21600447,1610612749,1610612764,123.0,96.0,0.563,0.4679999999999999,1,2016-12-23,28,14,14,0.5,29,13,16,0.4479999999999999
21600448,1610612763,1610612745,115.0,109.0,0.506,0.4270000000000001,1,2016-12-23,32,20,12,0.625,31,22,9,0.71
21600449,1610612740,1610612748,91.0,87.0,0.371,0.414,1,2016-12-23,32,11,21,0.344,31,10,21,0.3229999999999999
21600450,1610612750,1610612758,105.0,109.0,0.456,0.525,0,2016-12-23,29,9,20,0.31,30,13,17,0.433
21600451,1610612743,1610612737,108.0,109.0,0.474,0.43,0,2016-12-23,30,12,18,0.4,30,15,15,0.5
21600452,1610612762,1610612761,98.0,104.0,0.4429999999999999,0.531,0,2016-12-23,31,18,13,0.581,29,21,8,0.7240000000000001
21600453,1610612756,1610612755,123.0,116.0,0.532,0.506,1,2016-12-23,30,9,21,0.3,29,7,22,0.241
21600454,1610612757,1610612759,90.0,110.0,0.4429999999999999,0.5,0,2016-12-23,32,13,19,0.406,30,24,6,0.8
21600455,1610612746,1610612742,88.0,90.0,0.4589999999999999,0.425,0,2016-12-23,31,22,9,0.71,30,9,21,0.3
21600440,1610612754,1610612738,102.0,109.0,0.4270000000000001,0.413,0,2016-12-22,31,15,16,0.484,29,17,12,0.586
21600437,1610612751,1610612744,101.0,117.0,0.442,0.452,0,2016-12-22,28,7,21,0.25,30,26,4,0.867
21600438,1610612752,1610612753,106.0,95.0,0.4270000000000001,0.433,1,2016-12-22,29,16,13,0.552,31,13,18,0.419
21600439,1610612748,1610612747,115.0,107.0,0.536,0.444,1,2016-12-22,30,10,20,0.3329999999999999,32,11,21,0.344
21600441,1610612746,1610612759,106.0,101.0,0.47,0.402,1,2016-12-22,30,22,8,0.733,29,23,6,0.7929999999999999
21600429,1610612739,1610612749,113.0,102.0,0.494,0.4679999999999999,1,2016-12-21,27,21,6,0.778,27,13,14,0.481
21600430,1610612737,1610612750,84.0,92.0,0.415,0.422,0,2016-12-21,29,14,15,0.483,28,9,19,0.321
21600431,1610612765,1610612763,86.0,98.0,0.361,0.4270000000000001,0,2016-12-21,31,14,17,0.452,31,19,12,0.613
21600432,1610612741,1610612764,97.0,107.0,0.4,0.524,0,2016-12-21,28,14,14,0.5,28,13,15,0.4639999999999999
21600433,1610612740,1610612760,110.0,121.0,0.477,0.511,0,2016-12-21,31,10,21,0.3229999999999999,29,17,12,0.586
21600434,1610612762,1610612758,93.0,94.0,0.446,0.4589999999999999,0,2016-12-21,30,18,12,0.6,29,12,17,0.414
21600435,1610612756,1610612745,111.0,125.0,0.473,0.535,0,2016-12-21,29,8,21,0.276,30,22,8,0.733
21600436,1610612757,1610612742,95.0,96.0,0.444,0.422,0,2016-12-21,31,13,18,0.419,29,8,21,0.276
21600418,1610612755,1610612740,93.0,108.0,0.402,0.43,0,2016-12-20,28,7,21,0.25,30,10,20,0.3329999999999999
21600419,1610612766,1610612747,117.0,113.0,0.457,0.489,1,2016-12-20,29,16,13,0.552,31,11,20,0.355
21600420,1610612761,1610612751,116.0,104.0,0.462,0.396,1,2016-12-20,28,20,8,0.7140000000000001,27,7,20,0.259
21600421,1610612752,1610612754,118.0,111.0,0.5,0.429,1,2016-12-20,28,15,13,0.536,30,15,15,0.5
21600422,1610612748,1610612753,130.0,136.0,0.4629999999999999,0.495,0,2016-12-20,29,9,20,0.31,30,13,17,0.433
21600423,1610612749,1610612739,108.0,114.0,0.46,0.407,0,2016-12-20,26,13,13,0.5,26,20,6,0.769
21600424,1610612763,1610612738,109.0,112.0,0.4039999999999999,0.407,0,2016-12-20,30,18,12,0.6,28,16,12,0.5710000000000001
21600425,1610612745,1610612759,100.0,102.0,0.38,0.4679999999999999,0,2016-12-20,29,21,8,0.7240000000000001,28,23,5,0.821
21600426,1610612746,1610612743,119.0,102.0,0.547,0.433,1,2016-12-20,29,21,8,0.7240000000000001,29,12,17,0.414
21600427,1610612744,1610612762,104.0,74.0,0.444,0.355,1,2016-12-20,29,25,4,0.862,29,18,11,0.621
21600428,1610612758,1610612757,126.0,121.0,0.556,0.512,1,2016-12-20,28,11,17,0.3929999999999999,30,13,17,0.433
21600413,1610612754,1610612764,107.0,105.0,0.471,0.4320000000000001,1,2016-12-19,29,15,14,0.517,27,12,15,0.444
21600414,1610612741,1610612765,113.0,82.0,0.598,0.41,1,2016-12-19,27,14,13,0.519,30,14,16,0.467
21600415,1610612760,1610612737,108.0,110.0,0.4479999999999999,0.547,0,2016-12-19,28,16,12,0.5710000000000001,28,14,14,0.5
21600416,1610612750,1610612756,115.0,108.0,0.488,0.451,1,2016-12-19,27,8,19,0.296,28,8,20,0.286
21600417,1610612743,1610612742,117.0,107.0,0.563,0.5379999999999999,1,2016-12-19,28,12,16,0.429,28,7,21,0.25
21600406,1610612764,1610612746,117.0,110.0,0.531,0.494,1,2016-12-18,26,12,14,0.462,28,20,8,0.7140000000000001
21600411,1610612742,1610612758,99.0,79.0,0.442,0.395,1,2016-12-18,27,7,20,0.259,27,10,17,0.37
21600407,1610612763,1610612762,73.0,82.0,0.301,0.455,0,2016-12-18,29,18,11,0.621,28,18,10,0.643
21600408,1610612755,1610612751,108.0,107.0,0.4320000000000001,0.444,1,2016-12-18,27,7,20,0.259,26,7,19,0.2689999999999999
21600409,1610612753,1610612761,79.0,109.0,0.41,0.494,0,2016-12-18,29,12,17,0.414,27,19,8,0.7040000000000001
21600410,1610612748,1610612738,95.0,105.0,0.522,0.456,0,2016-12-18,28,9,19,0.321,27,15,12,0.556
21600412,1610612759,1610612740,113.0,100.0,0.488,0.461,1,2016-12-18,27,22,5,0.815,29,9,20,0.31
21600399,1610612760,1610612756,114.0,101.0,0.506,0.433,1,2016-12-17,27,16,11,0.593,27,8,19,0.296
21600400,1610612765,1610612754,90.0,105.0,0.381,0.482,0,2016-12-17,29,14,15,0.483,28,14,14,0.5
21600401,1610612737,1610612766,99.0,107.0,0.465,0.489,0,2016-12-17,27,13,14,0.481,28,15,13,0.536
21600402,1610612739,1610612747,119.0,108.0,0.517,0.477,1,2016-12-17,25,19,6,0.76,30,11,19,0.3670000000000001
21600403,1610612750,1610612745,109.0,111.0,0.446,0.406,0,2016-12-17,26,7,19,0.2689999999999999,28,21,7,0.75
21600404,1610612743,1610612752,127.0,114.0,0.556,0.4379999999999999,1,2016-12-17,27,11,16,0.407,27,14,13,0.519
21600405,1610612744,1610612757,135.0,90.0,0.586,0.395,1,2016-12-17,28,24,4,0.857,29,13,16,0.4479999999999999
21600389,1610612764,1610612765,122.0,108.0,0.5710000000000001,0.488,1,2016-12-16,25,11,14,0.44,28,14,14,0.5
21600390,1610612753,1610612751,118.0,111.0,0.402,0.47,1,2016-12-16,28,12,16,0.429,25,7,18,0.28
21600391,1610612738,1610612766,96.0,88.0,0.436,0.33,1,2016-12-16,26,14,12,0.5379999999999999,27,14,13,0.519
21600392,1610612761,1610612737,121.0,125.0,0.547,0.535,0,2016-12-16,26,18,8,0.6920000000000001,26,13,13,0.5
21600393,1610612741,1610612749,69.0,95.0,0.304,0.4629999999999999,0,2016-12-16,26,13,13,0.5,25,13,12,0.52
21600394,1610612763,1610612758,92.0,96.0,0.377,0.3879999999999999,0,2016-12-16,28,18,10,0.643,26,10,16,0.385
21600395,1610612745,1610612740,122.0,100.0,0.447,0.408,1,2016-12-16,27,20,7,0.741,28,9,19,0.321
21600396,1610612755,1610612747,89.0,100.0,0.364,0.456,0,2016-12-16,26,6,20,0.231,29,11,18,0.379
21600397,1610612748,1610612746,98.0,102.0,0.409,0.434,0,2016-12-16,27,9,18,0.3329999999999999,27,20,7,0.741
21600398,1610612762,1610612742,103.0,100.0,0.569,0.455,1,2016-12-16,27,17,10,0.63,26,6,20,0.231
21600384,1610612749,1610612741,108.0,97.0,0.474,0.473,1,2016-12-15,24,12,12,0.5,25,13,12,0.52
21600385,1610612740,1610612754,102.0,95.0,0.424,0.414,1,2016-12-15,27,9,18,0.3329999999999999,27,13,14,0.481
21600386,1610612743,1610612757,132.0,120.0,0.512,0.466,1,2016-12-15,26,10,16,0.385,28,13,15,0.4639999999999999
21600387,1610612756,1610612759,92.0,107.0,0.4,0.527,0,2016-12-15,26,8,18,0.308,26,21,5,0.8079999999999999
21600388,1610612744,1610612752,103.0,90.0,0.469,0.409,1,2016-12-15,27,23,4,0.852,26,14,12,0.5379999999999999
21600374,1610612755,1610612761,114.0,123.0,0.5,0.471,0,2016-12-14,25,6,19,0.24,25,18,7,0.72
21600375,1610612764,1610612766,109.0,106.0,0.517,0.514,1,2016-12-14,24,10,14,0.417,26,14,12,0.5379999999999999
21600376,1610612753,1610612746,108.0,113.0,0.472,0.5,0,2016-12-14,27,11,16,0.407,26,19,7,0.731
21600377,1610612748,1610612754,95.0,89.0,0.451,0.371,1,2016-12-14,26,9,17,0.346,26,13,13,0.5
21600378,1610612751,1610612747,107.0,97.0,0.384,0.385,1,2016-12-14,24,7,17,0.292,28,10,18,0.357
21600379,1610612763,1610612739,93.0,85.0,0.4320000000000001,0.373,1,2016-12-14,27,18,9,0.667,24,18,6,0.75
21600380,1610612745,1610612758,132.0,98.0,0.588,0.424,1,2016-12-14,26,19,7,0.731,25,9,16,0.36
21600381,1610612742,1610612765,85.0,95.0,0.41,0.507,0,2016-12-14,25,6,19,0.24,27,14,13,0.519
21600382,1610612762,1610612760,109.0,89.0,0.583,0.366,1,2016-12-14,26,16,10,0.615,26,15,11,0.5770000000000001
21600383,1610612759,1610612738,108.0,101.0,0.55,0.44,1,2016-12-14,25,20,5,0.8,25,13,12,0.52
21600368,1610612739,1610612763,103.0,86.0,0.457,0.407,1,2016-12-13,23,18,5,0.7829999999999999,26,17,9,0.654
21600369,1610612737,1610612753,120.0,131.0,0.506,0.586,0,2016-12-13,25,12,13,0.48,26,11,15,0.423
21600370,1610612741,1610612750,94.0,99.0,0.4370000000000001,0.442,0,2016-12-13,24,13,11,0.542,25,7,18,0.28
21600371,1610612740,1610612744,109.0,113.0,0.476,0.442,0,2016-12-13,26,8,18,0.308,26,22,4,0.846
21600372,1610612756,1610612752,113.0,111.0,0.409,0.392,1,2016-12-13,25,8,17,0.32,25,14,11,0.56
21600373,1610612757,1610612760,114.0,95.0,0.5379999999999999,0.379,1,2016-12-13,27,13,14,0.481,25,15,10,0.6
21600361,1610612754,1610612766,110.0,94.0,0.489,0.3329999999999999,1,2016-12-12,25,13,12,0.52,25,14,11,0.56
21600362,1610612761,1610612749,122.0,100.0,0.519,0.472,1,2016-12-12,24,17,7,0.708,23,11,12,0.478
21600363,1610612748,1610612764,112.0,101.0,0.511,0.4639999999999999,1,2016-12-12,25,8,17,0.32,23,9,14,0.391
21600364,1610612745,1610612751,122.0,118.0,0.462,0.525,1,2016-12-12,25,18,7,0.72,23,6,17,0.261
21600365,1610612742,1610612743,112.0,92.0,0.584,0.422,1,2016-12-12,24,6,18,0.25,25,9,16,0.36
21600366,1610612746,1610612757,121.0,120.0,0.472,0.506,1,2016-12-12,25,18,7,0.72,26,12,14,0.462
21600367,1610612758,1610612747,116.0,92.0,0.56,0.3929999999999999,1,2016-12-12,24,9,15,0.375,27,10,17,0.37
21600356,1610612765,1610612755,79.0,97.0,0.39,0.5589999999999999,0,2016-12-11,26,13,13,0.5,24,6,18,0.25
21600357,1610612760,1610612738,99.0,96.0,0.494,0.444,1,2016-12-11,24,15,9,0.625,24,13,11,0.542
21600358,1610612750,1610612744,108.0,116.0,0.444,0.4579999999999999,0,2016-12-11,24,6,18,0.25,25,21,4,0.84
21600359,1610612756,1610612740,119.0,120.0,0.4579999999999999,0.392,0,2016-12-11,24,7,17,0.292,25,8,17,0.32
21600360,1610612747,1610612752,112.0,118.0,0.477,0.488,0,2016-12-11,26,10,16,0.385,24,14,10,0.583
21600346,1610612764,1610612749,110.0,105.0,0.455,0.506,1,2016-12-10,22,9,13,0.409,22,11,11,0.5
21600347,1610612753,1610612743,113.0,121.0,0.489,0.5660000000000001,0,2016-12-10,25,10,15,0.4,24,9,15,0.375
21600348,1610612754,1610612757,118.0,111.0,0.482,0.488,1,2016-12-10,24,12,12,0.5,25,12,13,0.48
21600349,1610612739,1610612766,116.0,105.0,0.575,0.4529999999999999,1,2016-12-10,22,17,5,0.773,24,14,10,0.583
21600350,1610612741,1610612748,105.0,100.0,0.452,0.462,1,2016-12-10,23,13,10,0.565,24,7,17,0.292
21600351,1610612763,1610612744,110.0,89.0,0.4370000000000001,0.442,1,2016-12-10,25,17,8,0.68,24,20,4,0.833
21600352,1610612745,1610612742,109.0,87.0,0.5,0.405,1,2016-12-10,24,17,7,0.708,23,5,18,0.217
21600353,1610612759,1610612751,130.0,101.0,0.532,0.414,1,2016-12-10,24,19,5,0.792,22,6,16,0.273
21600354,1610612762,1610612758,104.0,84.0,0.481,0.3779999999999999,1,2016-12-10,25,15,10,0.6,23,8,15,0.348
21600355,1610612746,1610612740,133.0,105.0,0.574,0.482,1,2016-12-10,24,17,7,0.708,24,7,17,0.292
21600337,1610612766,1610612753,109.0,88.0,0.482,0.374,1,2016-12-09,23,14,9,0.609,24,10,14,0.417
21600338,1610612739,1610612748,114.0,84.0,0.5539999999999999,0.344,1,2016-12-09,21,16,5,0.762,23,7,16,0.304
21600339,1610612738,1610612761,94.0,101.0,0.373,0.415,0,2016-12-09,23,13,10,0.565,23,16,7,0.696
21600340,1610612749,1610612737,110.0,114.0,0.4679999999999999,0.476,0,2016-12-09,21,11,10,0.524,24,12,12,0.5
21600341,1610612760,1610612745,99.0,102.0,0.42,0.391,0,2016-12-09,23,14,9,0.609,23,16,7,0.696
21600342,1610612750,1610612765,90.0,117.0,0.474,0.5,0,2016-12-09,23,6,17,0.261,25,13,12,0.52
21600343,1610612742,1610612754,111.0,103.0,0.488,0.4639999999999999,1,2016-12-09,22,5,17,0.2269999999999999,23,11,12,0.478
21600344,1610612747,1610612756,115.0,119.0,0.46,0.474,0,2016-12-09,25,10,15,0.4,23,7,16,0.304
21600345,1610612758,1610612752,100.0,103.0,0.402,0.429,0,2016-12-09,22,8,14,0.364,23,13,10,0.565
21600331,1610612761,1610612750,124.0,110.0,0.494,0.511,1,2016-12-08,22,15,7,0.682,22,6,16,0.273
21600332,1610612764,1610612743,92.0,85.0,0.449,0.408,1,2016-12-08,21,8,13,0.381,23,8,15,0.348
21600333,1610612763,1610612757,88.0,86.0,0.356,0.305,1,2016-12-08,24,16,8,0.667,24,12,12,0.5
21600334,1610612740,1610612755,88.0,99.0,0.3929999999999999,0.429,0,2016-12-08,23,7,16,0.304,23,5,18,0.217
21600335,1610612762,1610612744,99.0,106.0,0.416,0.488,0,2016-12-08,24,14,10,0.583,23,20,3,0.87
21600336,1610612741,1610612759,95.0,91.0,0.4379999999999999,0.402,1,2016-12-08,22,12,10,0.545,23,18,5,0.7829999999999999
21600321,1610612766,1610612765,87.0,77.0,0.341,0.382,1,2016-12-07,22,13,9,0.591,24,12,12,0.5
21600322,1610612753,1610612738,87.0,117.0,0.37,0.512,0,2016-12-07,23,10,13,0.435,22,13,9,0.591
21600323,1610612751,1610612743,116.0,111.0,0.482,0.4,1,2016-12-07,21,6,15,0.286,22,8,14,0.364
21600324,1610612737,1610612748,103.0,95.0,0.489,0.425,1,2016-12-07,23,11,12,0.478,22,7,15,0.318
21600325,1610612749,1610612757,115.0,107.0,0.519,0.435,1,2016-12-07,20,11,9,0.55,23,12,11,0.522
21600326,1610612745,1610612747,134.0,95.0,0.5429999999999999,0.391,1,2016-12-07,22,15,7,0.682,24,10,14,0.417
21600327,1610612752,1610612739,94.0,126.0,0.402,0.488,0,2016-12-07,22,12,10,0.545,20,15,5,0.75
21600328,1610612742,1610612758,89.0,120.0,0.41,0.56,0,2016-12-07,21,4,17,0.19,21,8,13,0.381
21600329,1610612756,1610612754,94.0,109.0,0.4,0.449,0,2016-12-07,22,6,16,0.273,22,11,11,0.5
21600330,1610612746,1610612744,98.0,115.0,0.391,0.472,0,2016-12-07,23,16,7,0.696,22,19,3,0.8640000000000001
21600315,1610612764,1610612753,116.0,124.0,0.473,0.518,0,2016-12-06,20,7,13,0.35,22,10,12,0.455
21600316,1610612748,1610612752,103.0,114.0,0.4270000000000001,0.49,0,2016-12-06,21,7,14,0.3329999999999999,21,12,9,0.5710000000000001
21600317,1610612765,1610612741,102.0,91.0,0.455,0.44,1,2016-12-06,23,12,11,0.522,21,11,10,0.524
21600318,1610612763,1610612755,96.0,91.0,0.384,0.39,1,2016-12-06,23,15,8,0.652,22,4,18,0.182
21600319,1610612750,1610612759,91.0,105.0,0.439,0.527,0,2016-12-06,21,6,15,0.286,22,18,4,0.818
21600320,1610612762,1610612756,112.0,105.0,0.493,0.4639999999999999,1,2016-12-06,23,14,9,0.609,21,6,15,0.286
21600304,1610612755,1610612743,98.0,106.0,0.407,0.461,0,2016-12-05,21,4,17,0.19,21,8,13,0.381
21600305,1610612761,1610612739,112.0,116.0,0.4320000000000001,0.476,0,2016-12-05,21,14,7,0.667,19,14,5,0.737
21600306,1610612751,1610612764,113.0,118.0,0.494,0.489,0,2016-12-05,20,5,15,0.25,19,7,12,0.368
21600307,1610612737,1610612760,99.0,102.0,0.442,0.4629999999999999,0,2016-12-05,22,10,12,0.455,22,14,8,0.636
21600308,1610612741,1610612757,110.0,112.0,0.422,0.484,0,2016-12-05,20,11,9,0.55,22,12,10,0.545
21600309,1610612749,1610612759,96.0,97.0,0.411,0.43,0,2016-12-05,19,10,9,0.526,21,17,4,0.81
21600310,1610612740,1610612763,108.0,110.0,0.3939999999999999,0.4039999999999999,0,2016-12-05,22,7,15,0.318,22,14,8,0.636
21600311,1610612745,1610612738,107.0,106.0,0.447,0.424,1,2016-12-05,21,14,7,0.667,21,12,9,0.5710000000000001
21600312,1610612742,1610612766,101.0,109.0,0.416,0.506,0,2016-12-05,20,4,16,0.2,21,12,9,0.5710000000000001
21600313,1610612747,1610612762,101.0,107.0,0.4479999999999999,0.475,0,2016-12-05,23,10,13,0.435,22,13,9,0.591
21600314,1610612744,1610612754,142.0,106.0,0.519,0.412,1,2016-12-05,21,18,3,0.857,21,10,11,0.476
21600300,1610612765,1610612753,92.0,98.0,0.442,0.532,0,2016-12-04,22,11,11,0.5,21,9,12,0.429
21600301,1610612760,1610612740,101.0,92.0,0.461,0.3670000000000001,1,2016-12-04,21,13,8,0.619,21,7,14,0.3329999999999999
21600302,1610612752,1610612758,106.0,98.0,0.4429999999999999,0.32,1,2016-12-04,20,11,9,0.55,20,7,13,0.35
21600303,1610612746,1610612754,102.0,111.0,0.444,0.494,0,2016-12-04,22,16,6,0.727,20,10,10,0.5
21600291,1610612749,1610612751,112.0,103.0,0.471,0.374,1,2016-12-03,18,10,8,0.556,19,5,14,0.263
21600292,1610612766,1610612750,120.0,125.0,0.436,0.4529999999999999,0,2016-12-03,20,11,9,0.55,20,6,14,0.3
21600293,1610612761,1610612737,128.0,84.0,0.5760000000000001,0.3979999999999999,1,2016-12-03,20,14,6,0.7,21,10,11,0.476
21600294,1610612755,1610612738,106.0,107.0,0.461,0.5,0,2016-12-03,20,4,16,0.2,20,12,8,0.6
21600295,1610612763,1610612747,103.0,100.0,0.466,0.4320000000000001,1,2016-12-03,21,13,8,0.619,22,10,12,0.455
21600296,1610612742,1610612741,107.0,82.0,0.46,0.451,1,2016-12-03,19,4,15,0.211,19,11,8,0.579
21600297,1610612762,1610612743,105.0,98.0,0.449,0.446,1,2016-12-03,21,12,9,0.5710000000000001,20,7,13,0.35
21600298,1610612757,1610612748,99.0,92.0,0.4039999999999999,0.442,1,2016-12-03,21,11,10,0.524,20,7,13,0.35
21600299,1610612744,1610612756,138.0,109.0,0.628,0.451,1,2016-12-03,20,17,3,0.85,20,6,14,0.3
21600282,1610612755,1610612753,88.0,105.0,0.379,0.474,0,2016-12-02,19,4,15,0.211,20,8,12,0.4
21600283,1610612738,1610612758,97.0,92.0,0.409,0.375,1,2016-12-02,19,11,8,0.579,19,7,12,0.368
21600284,1610612761,1610612747,113.0,80.0,0.542,0.344,1,2016-12-02,19,13,6,0.684,21,10,11,0.476
21600285,1610612752,1610612750,118.0,114.0,0.477,0.466,1,2016-12-02,19,10,9,0.526,19,5,14,0.263
21600286,1610612741,1610612739,111.0,105.0,0.49,0.542,1,2016-12-02,18,11,7,0.611,18,13,5,0.722
21600287,1610612740,1610612746,96.0,114.0,0.4589999999999999,0.511,0,2016-12-02,20,7,13,0.35,21,16,5,0.762
21600288,1610612737,1610612765,85.0,121.0,0.364,0.539,0,2016-12-02,20,10,10,0.5,21,11,10,0.524
21600289,1610612759,1610612764,107.0,105.0,0.488,0.506,1,2016-12-02,20,16,4,0.8,18,6,12,0.3329999999999999
21600290,1610612743,1610612745,110.0,128.0,0.442,0.511,0,2016-12-02,19,7,12,0.368,20,13,7,0.65
21600276,1610612766,1610612742,97.0,87.0,0.473,0.3720000000000001,1,2016-12-01,19,11,8,0.579,18,3,15,0.1669999999999999
21600277,1610612751,1610612749,93.0,111.0,0.382,0.45,0,2016-12-01,18,5,13,0.278,17,9,8,0.529
21600278,1610612763,1610612753,95.0,94.0,0.418,0.446,1,2016-12-01,20,12,8,0.6,19,7,12,0.368
21600279,1610612739,1610612746,94.0,113.0,0.406,0.472,0,2016-12-01,17,13,4,0.765,20,15,5,0.75
21600280,1610612762,1610612748,110.0,111.0,0.5479999999999999,0.512,0,2016-12-01,20,11,9,0.55,19,7,12,0.368
21600281,1610612744,1610612745,127.0,132.0,0.413,0.444,0,2016-12-01,19,16,3,0.8420000000000001,19,12,7,0.632
21600267,1610612738,1610612765,114.0,121.0,0.44,0.552,0,2016-11-30,18,10,8,0.556,20,10,10,0.5
21600268,1610612761,1610612763,120.0,105.0,0.551,0.439,1,2016-11-30,18,12,6,0.667,19,11,8,0.579
21600269,1610612741,1610612747,90.0,96.0,0.352,0.407,0,2016-11-30,17,10,7,0.588,20,10,10,0.5
21600270,1610612760,1610612764,126.0,115.0,0.484,0.449,1,2016-11-30,20,12,8,0.6,17,6,11,0.353
21600271,1610612750,1610612752,104.0,106.0,0.442,0.451,0,2016-11-30,18,5,13,0.278,18,9,9,0.5
21600272,1610612742,1610612759,87.0,94.0,0.429,0.465,0,2016-11-30,17,3,14,0.176,19,15,4,0.789
21600273,1610612743,1610612748,98.0,106.0,0.418,0.441,0,2016-11-30,18,7,11,0.389,18,6,12,0.3329999999999999
21600274,1610612756,1610612737,109.0,107.0,0.449,0.506,1,2016-11-30,19,6,13,0.316,19,10,9,0.526
21600275,1610612757,1610612754,131.0,109.0,0.5429999999999999,0.5,1,2016-11-30,20,10,10,0.5,19,9,10,0.474
21600260,1610612766,1610612765,89.0,112.0,0.397,0.489,0,2016-11-29,18,10,8,0.556,19,9,10,0.474
21600261,1610612751,1610612746,127.0,122.0,0.433,0.422,1,2016-11-29,17,5,12,0.294,19,14,5,0.737
21600262,1610612749,1610612739,118.0,101.0,0.535,0.4270000000000001,1,2016-11-29,16,8,8,0.5,16,13,3,0.813
21600263,1610612740,1610612747,105.0,88.0,0.4320000000000001,0.425,1,2016-11-29,19,7,12,0.368,19,9,10,0.474
21600264,1610612759,1610612753,83.0,95.0,0.368,0.4529999999999999,0,2016-11-29,18,14,4,0.778,18,7,11,0.389
21600265,1610612762,1610612745,120.0,101.0,0.5539999999999999,0.407,1,2016-11-29,19,11,8,0.579,18,11,7,0.611
21600253,1610612764,1610612758,101.0,95.0,0.412,0.409,1,2016-11-28,16,6,10,0.375,18,7,11,0.389
21600254,1610612761,1610612755,122.0,95.0,0.545,0.419,1,2016-11-28,17,11,6,0.647,18,4,14,0.222
21600255,1610612752,1610612760,103.0,112.0,0.396,0.5,0,2016-11-28,17,8,9,0.471,19,11,8,0.579
21600256,1610612748,1610612738,104.0,112.0,0.475,0.482,0,2016-11-28,17,5,12,0.294,17,10,7,0.588
21600257,1610612763,1610612766,85.0,104.0,0.4039999999999999,0.439,0,2016-11-28,18,11,7,0.611,17,10,7,0.588
21600258,1610612750,1610612762,103.0,112.0,0.444,0.506,0,2016-11-28,17,5,12,0.294,18,10,8,0.556
21600259,1610612744,1610612737,105.0,100.0,0.435,0.424,1,2016-11-28,18,16,2,0.889,18,10,8,0.556
21600245,1610612755,1610612739,108.0,112.0,0.467,0.413,0,2016-11-27,17,4,13,0.235,15,13,2,0.867
21600246,1610612756,1610612743,114.0,120.0,0.4039999999999999,0.4379999999999999,0,2016-11-27,18,5,13,0.278,17,7,10,0.412
21600247,1610612751,1610612758,105.0,122.0,0.4370000000000001,0.535,0,2016-11-27,16,4,12,0.25,17,7,10,0.412
21600248,1610612753,1610612749,96.0,104.0,0.413,0.477,0,2016-11-27,17,6,11,0.353,15,7,8,0.467
21600249,1610612754,1610612746,91.0,70.0,0.435,0.314,1,2016-11-27,18,9,9,0.5,18,14,4,0.778
21600250,1610612742,1610612740,91.0,81.0,0.416,0.39,1,2016-11-27,16,3,13,0.188,18,6,12,0.3329999999999999
21600251,1610612757,1610612745,114.0,130.0,0.482,0.561,0,2016-11-27,19,9,10,0.474,17,11,6,0.647
21600252,1610612747,1610612737,109.0,94.0,0.442,0.4429999999999999,1,2016-11-27,18,9,9,0.5,17,10,7,0.588
21600240,1610612764,1610612759,100.0,112.0,0.477,0.5329999999999999,0,2016-11-26,15,5,10,0.3329999999999999,17,14,3,0.8240000000000001
21600241,1610612766,1610612752,107.0,102.0,0.4379999999999999,0.374,1,2016-11-26,16,9,7,0.563,16,8,8,0.5
21600242,1610612760,1610612765,106.0,88.0,0.506,0.451,1,2016-11-26,18,10,8,0.556,18,8,10,0.444
21600243,1610612748,1610612763,107.0,110.0,0.494,0.507,0,2016-11-26,16,5,11,0.313,17,11,6,0.647
21600244,1610612744,1610612750,115.0,102.0,0.556,0.461,1,2016-11-26,17,15,2,0.882,16,5,11,0.313
21600225,1610612738,1610612759,103.0,109.0,0.462,0.469,0,2016-11-25,16,9,7,0.563,16,13,3,0.813
21600226,1610612753,1610612764,91.0,94.0,0.4379999999999999,0.455,0,2016-11-25,16,6,10,0.375,14,5,9,0.357
21600227,1610612739,1610612742,128.0,90.0,0.506,0.407,1,2016-11-25,14,12,2,0.857,15,2,13,0.133
21600228,1610612752,1610612766,113.0,111.0,0.4639999999999999,0.462,1,2016-11-25,15,8,7,0.5329999999999999,15,8,7,0.5329999999999999
21600229,1610612755,1610612741,89.0,105.0,0.397,0.444,0,2016-11-25,16,4,12,0.25,16,10,6,0.625
21600230,1610612765,1610612746,108.0,97.0,0.522,0.479,1,2016-11-25,17,8,9,0.471,17,14,3,0.8240000000000001
21600231,1610612762,1610612737,95.0,68.0,0.4379999999999999,0.313,1,2016-11-25,17,9,8,0.529,16,10,6,0.625
21600232,1610612749,1610612761,99.0,105.0,0.506,0.4629999999999999,0,2016-11-25,14,6,8,0.429,16,10,6,0.625
21600233,1610612763,1610612748,81.0,90.0,0.354,0.3879999999999999,0,2016-11-25,16,10,6,0.625,15,5,10,0.3329999999999999
21600234,1610612754,1610612751,118.0,97.0,0.552,0.456,1,2016-11-25,17,8,9,0.471,15,4,11,0.267
21600235,1610612743,1610612760,129.0,132.0,0.475,0.5,0,2016-11-25,16,6,10,0.375,17,9,8,0.529
21600236,1610612756,1610612750,85.0,98.0,0.405,0.4,0,2016-11-25,17,5,12,0.294,15,5,10,0.3329999999999999
21600237,1610612757,1610612740,119.0,104.0,0.47,0.474,1,2016-11-25,18,9,9,0.5,17,6,11,0.353
21600238,1610612747,1610612744,85.0,109.0,0.356,0.518,0,2016-11-25,17,8,9,0.471,16,14,2,0.875
21600239,1610612758,1610612745,104.0,117.0,0.488,0.471,0,2016-11-25,16,6,10,0.375,16,10,6,0.625
21600212,1610612755,1610612763,99.0,104.0,0.376,0.384,0,2016-11-23,15,4,11,0.267,15,10,5,0.667
21600213,1610612766,1610612759,114.0,119.0,0.506,0.512,0,2016-11-23,14,8,6,0.5710000000000001,15,12,3,0.8
21600214,1610612753,1610612756,87.0,92.0,0.363,0.452,0,2016-11-23,15,6,9,0.4,16,5,11,0.313
21600215,1610612739,1610612757,137.0,125.0,0.5329999999999999,0.522,1,2016-11-23,13,11,2,0.846,17,8,9,0.471
21600216,1610612754,1610612737,85.0,96.0,0.405,0.424,0,2016-11-23,16,7,9,0.4379999999999999,15,10,5,0.667
21600217,1610612751,1610612738,92.0,111.0,0.395,0.4589999999999999,0,2016-11-23,14,4,10,0.286,15,9,6,0.6
21600218,1610612765,1610612748,107.0,84.0,0.494,0.36,1,2016-11-23,16,7,9,0.4379999999999999,14,4,10,0.286
21600219,1610612745,1610612761,102.0,115.0,0.487,0.489,0,2016-11-23,15,9,6,0.6,15,9,6,0.6
21600220,1610612742,1610612746,104.0,124.0,0.452,0.506,0,2016-11-23,14,2,12,0.143,16,14,2,0.875
21600221,1610612762,1610612743,108.0,83.0,0.494,0.318,1,2016-11-23,16,8,8,0.5,15,6,9,0.4
21600222,1610612740,1610612750,117.0,96.0,0.542,0.384,1,2016-11-23,16,6,10,0.375,14,4,10,0.286
21600223,1610612744,1610612747,149.0,106.0,0.616,0.43,1,2016-11-23,15,13,2,0.867,16,8,8,0.5
21600224,1610612758,1610612760,116.0,101.0,0.4679999999999999,0.421,1,2016-11-23,15,6,9,0.4,16,8,8,0.5
21600208,1610612752,1610612757,107.0,103.0,0.469,0.442,1,2016-11-22,14,7,7,0.5,16,8,8,0.5
21600209,1610612737,1610612740,94.0,112.0,0.4589999999999999,0.523,0,2016-11-22,14,9,5,0.643,15,5,10,0.3329999999999999
21600210,1610612743,1610612741,110.0,107.0,0.43,0.4529999999999999,1,2016-11-22,14,6,8,0.429,15,9,6,0.6
21600211,1610612747,1610612760,111.0,109.0,0.506,0.489,1,2016-11-22,15,8,7,0.5329999999999999,15,8,7,0.5329999999999999
21600199,1610612755,1610612748,101.0,94.0,0.474,0.386,1,2016-11-21,14,4,10,0.286,13,4,9,0.308
21600200,1610612764,1610612756,106.0,101.0,0.407,0.429,1,2016-11-21,13,4,9,0.308,15,4,11,0.267
21600201,1610612766,1610612763,90.0,105.0,0.411,0.476,0,2016-11-21,13,8,5,0.615,14,9,5,0.643
21600202,1610612754,1610612744,83.0,120.0,0.32,0.444,0,2016-11-21,15,7,8,0.467,14,12,2,0.857
21600203,1610612765,1610612745,96.0,99.0,0.414,0.449,0,2016-11-21,15,6,9,0.4,14,9,5,0.643
21600204,1610612749,1610612753,93.0,89.0,0.407,0.416,1,2016-11-21,13,6,7,0.462,14,6,8,0.429
21600205,1610612750,1610612738,93.0,99.0,0.419,0.452,0,2016-11-21,13,4,9,0.308,14,8,6,0.5710000000000001
21600206,1610612759,1610612742,96.0,91.0,0.467,0.473,1,2016-11-21,14,11,3,0.7859999999999999,13,2,11,0.154
21600207,1610612746,1610612761,123.0,115.0,0.527,0.5,1,2016-11-21,15,13,2,0.867,14,8,6,0.5710000000000001
21600193,1610612752,1610612737,104.0,94.0,0.477,0.4,1,2016-11-20,13,6,7,0.462,13,9,4,0.6920000000000001
21600194,1610612751,1610612757,109.0,129.0,0.3979999999999999,0.5760000000000001,0,2016-11-20,13,4,9,0.308,15,8,7,0.5329999999999999
21600195,1610612760,1610612754,111.0,115.0,0.436,0.449,0,2016-11-20,14,8,6,0.5710000000000001,14,7,7,0.5
21600196,1610612758,1610612761,102.0,99.0,0.444,0.4,1,2016-11-20,14,5,9,0.357,13,8,5,0.615
21600197,1610612743,1610612762,105.0,91.0,0.488,0.3879999999999999,1,2016-11-20,13,5,8,0.385,15,7,8,0.467
21600198,1610612747,1610612741,110.0,118.0,0.441,0.517,0,2016-11-20,14,7,7,0.5,14,9,5,0.643
21600184,1610612745,1610612762,111.0,102.0,0.447,0.513,1,2016-11-19,13,8,5,0.615,14,7,7,0.5
21600185,1610612740,1610612766,121.0,116.0,0.439,0.412,1,2016-11-19,14,4,10,0.286,12,8,4,0.667
21600186,1610612764,1610612748,111.0,114.0,0.472,0.506,0,2016-11-19,12,3,9,0.25,12,4,8,0.3329999999999999
21600187,1610612753,1610612742,95.0,87.0,0.436,0.3379999999999999,1,2016-11-19,13,6,7,0.462,12,2,10,0.1669999999999999
21600188,1610612765,1610612738,92.0,94.0,0.43,0.402,0,2016-11-19,14,6,8,0.429,13,7,6,0.5379999999999999
21600189,1610612755,1610612756,120.0,105.0,0.523,0.424,1,2016-11-19,13,3,10,0.231,14,4,10,0.286
21600190,1610612763,1610612750,93.0,71.0,0.382,0.391,1,2016-11-19,13,8,5,0.615,12,4,8,0.3329999999999999
21600191,1610612749,1610612744,121.0,124.0,0.517,0.442,0,2016-11-19,12,5,7,0.417,13,11,2,0.846
21600192,1610612746,1610612741,102.0,95.0,0.4679999999999999,0.429,1,2016-11-19,14,12,2,0.857,13,8,5,0.615
21600174,1610612766,1610612737,100.0,96.0,0.411,0.4639999999999999,1,2016-11-18,11,8,3,0.727,12,9,3,0.75
21600176,1610612754,1610612756,96.0,116.0,0.474,0.474,0,2016-11-18,13,6,7,0.462,13,4,9,0.308
21600175,1610612739,1610612765,104.0,81.0,0.482,0.312,1,2016-11-18,12,10,2,0.833,13,6,7,0.462
21600177,1610612740,1610612757,113.0,101.0,0.5489999999999999,0.375,1,2016-11-18,13,3,10,0.231,14,7,7,0.5
21600178,1610612760,1610612751,124.0,105.0,0.551,0.422,1,2016-11-18,13,8,5,0.615,12,4,8,0.3329999999999999
21600179,1610612738,1610612744,88.0,104.0,0.373,0.489,0,2016-11-18,12,6,6,0.5,12,10,2,0.833
21600180,1610612742,1610612763,64.0,80.0,0.288,0.4029999999999999,0,2016-11-18,11,2,9,0.182,12,7,5,0.583
21600181,1610612743,1610612761,111.0,113.0,0.47,0.457,0,2016-11-18,12,4,8,0.3329999999999999,12,8,4,0.667
21600182,1610612747,1610612759,107.0,116.0,0.4479999999999999,0.564,0,2016-11-18,13,7,6,0.5379999999999999,13,10,3,0.769
21600183,1610612758,1610612746,115.0,121.0,0.442,0.526,0,2016-11-18,13,4,9,0.308,13,11,2,0.846
21600169,1610612764,1610612752,119.0,112.0,0.5429999999999999,0.477,1,2016-11-17,11,3,8,0.273,12,5,7,0.417
21600170,1610612748,1610612749,96.0,73.0,0.402,0.3289999999999999,1,2016-11-17,11,3,8,0.273,11,5,6,0.455
21600171,1610612745,1610612757,126.0,109.0,0.484,0.456,1,2016-11-17,12,7,5,0.583,13,7,6,0.5379999999999999
21600172,1610612750,1610612755,110.0,86.0,0.512,0.373,1,2016-11-17,11,4,7,0.364,12,2,10,0.1669999999999999
21600173,1610612762,1610612741,77.0,85.0,0.385,0.3670000000000001,0,2016-11-17,13,7,6,0.5379999999999999,12,8,4,0.667
21600158,1610612755,1610612764,109.0,102.0,0.545,0.418,1,2016-11-16,11,2,9,0.182,10,2,8,0.2
21600159,1610612753,1610612740,89.0,82.0,0.386,0.366,1,2016-11-16,12,5,7,0.417,12,2,10,0.1669999999999999
21600160,1610612754,1610612739,103.0,93.0,0.5,0.407,1,2016-11-16,12,6,6,0.5,11,9,2,0.818
21600161,1610612738,1610612742,90.0,83.0,0.434,0.41,1,2016-11-16,11,6,5,0.545,10,2,8,0.2
21600162,1610612752,1610612765,105.0,102.0,0.452,0.494,1,2016-11-16,11,5,6,0.455,12,6,6,0.5
21600163,1610612737,1610612749,107.0,100.0,0.486,0.3979999999999999,1,2016-11-16,11,9,2,0.818,10,5,5,0.5
21600164,1610612760,1610612745,105.0,103.0,0.476,0.435,1,2016-11-16,12,7,5,0.583,11,6,5,0.545
21600165,1610612761,1610612744,121.0,127.0,0.451,0.506,0,2016-11-16,11,7,4,0.636,11,9,2,0.818
21600166,1610612743,1610612756,120.0,104.0,0.484,0.494,1,2016-11-16,11,4,7,0.364,12,3,9,0.25
21600167,1610612746,1610612763,107.0,111.0,0.457,0.488,0,2016-11-16,12,10,2,0.833,11,6,5,0.545
21600168,1610612758,1610612759,105.0,110.0,0.474,0.489,0,2016-11-16,12,4,8,0.3329999999999999,12,9,3,0.75
21600153,1610612739,1610612761,121.0,117.0,0.53,0.479,1,2016-11-15,10,9,1,0.9,10,7,3,0.7
21600154,1610612748,1610612737,90.0,93.0,0.4039999999999999,0.4629999999999999,0,2016-11-15,10,2,8,0.2,10,8,2,0.8
21600155,1610612750,1610612766,108.0,115.0,0.4270000000000001,0.5379999999999999,0,2016-11-15,10,3,7,0.3,10,7,3,0.7
21600156,1610612757,1610612741,88.0,113.0,0.358,0.418,0,2016-11-15,12,7,5,0.583,11,7,4,0.636
21600157,1610612747,1610612751,125.0,118.0,0.446,0.455,1,2016-11-15,12,7,5,0.583,11,4,7,0.364
21600145,1610612754,1610612753,88.0,69.0,0.389,0.321,1,2016-11-14,11,5,6,0.455,11,4,7,0.364
21600146,1610612752,1610612742,93.0,77.0,0.436,0.381,1,2016-11-14,10,4,6,0.4,9,2,7,0.222
21600147,1610612765,1610612760,104.0,88.0,0.467,0.375,1,2016-11-14,11,6,5,0.545,11,6,5,0.545
21600148,1610612740,1610612738,106.0,105.0,0.4429999999999999,0.4,1,2016-11-14,11,2,9,0.182,10,5,5,0.5
21600149,1610612745,1610612755,115.0,88.0,0.484,0.3779999999999999,1,2016-11-14,10,6,4,0.6,10,1,9,0.1
21600150,1610612759,1610612748,94.0,90.0,0.402,0.44,1,2016-11-14,11,8,3,0.727,9,2,7,0.222
21600151,1610612762,1610612763,96.0,102.0,0.479,0.474,0,2016-11-14,12,7,5,0.583,10,5,5,0.5
21600152,1610612746,1610612751,127.0,95.0,0.5329999999999999,0.442,1,2016-11-14,11,10,1,0.909,10,4,6,0.4
21600140,1610612739,1610612766,100.0,93.0,0.424,0.379,1,2016-11-13,9,8,1,0.889,9,6,3,0.667
21600141,1610612760,1610612753,117.0,119.0,0.511,0.535,0,2016-11-13,10,6,4,0.6,10,4,6,0.4
21600142,1610612750,1610612747,125.0,99.0,0.525,0.465,1,2016-11-13,9,3,6,0.3329999999999999,11,6,5,0.545
21600143,1610612744,1610612756,133.0,120.0,0.517,0.511,1,2016-11-13,10,8,2,0.8,11,3,8,0.273
21600144,1610612757,1610612743,112.0,105.0,0.3939999999999999,0.396,1,2016-11-13,11,7,4,0.636,10,3,7,0.3
21600129,1610612740,1610612747,99.0,126.0,0.433,0.5529999999999999,0,2016-11-12,10,1,9,0.1,10,6,4,0.6
21600130,1610612754,1610612738,99.0,105.0,0.419,0.4379999999999999,0,2016-11-12,10,4,6,0.4,9,5,4,0.556
21600131,1610612761,1610612752,118.0,107.0,0.47,0.4539999999999999,1,2016-11-12,9,7,2,0.778,9,3,6,0.3329999999999999
21600132,1610612737,1610612755,117.0,96.0,0.505,0.434,1,2016-11-12,9,7,2,0.778,9,1,8,0.111
21600133,1610612741,1610612764,106.0,95.0,0.402,0.418,1,2016-11-12,10,6,4,0.6,9,2,7,0.222
21600134,1610612745,1610612759,100.0,106.0,0.382,0.539,0,2016-11-12,9,5,4,0.556,10,7,3,0.7
21600135,1610612750,1610612746,105.0,119.0,0.449,0.526,0,2016-11-12,8,2,6,0.25,10,9,1,0.9
21600136,1610612748,1610612762,91.0,102.0,0.469,0.494,0,2016-11-12,8,2,6,0.25,11,7,4,0.636
21600137,1610612749,1610612763,106.0,96.0,0.529,0.449,1,2016-11-12,9,5,4,0.556,9,4,5,0.444
21600138,1610612743,1610612765,95.0,106.0,0.429,0.511,0,2016-11-12,9,3,6,0.3329999999999999,10,5,5,0.5
21600139,1610612756,1610612751,104.0,122.0,0.374,0.476,0,2016-11-12,10,3,7,0.3,9,4,5,0.444
21600121,1610612755,1610612754,109.0,105.0,0.419,0.4429999999999999,1,2016-11-11,8,1,7,0.125,9,4,5,0.444
21600122,1610612764,1610612739,94.0,105.0,0.4370000000000001,0.419,0,2016-11-11,8,2,6,0.25,8,7,1,0.875
21600123,1610612766,1610612761,111.0,113.0,0.409,0.478,0,2016-11-11,8,6,2,0.75,8,6,2,0.75
21600124,1610612753,1610612762,74.0,87.0,0.3329999999999999,0.407,0,2016-11-11,9,3,6,0.3329999999999999,10,6,4,0.6
21600125,1610612738,1610612752,115.0,87.0,0.389,0.351,1,2016-11-11,8,4,4,0.5,8,3,5,0.375
21600126,1610612760,1610612746,108.0,110.0,0.4320000000000001,0.4529999999999999,0,2016-11-11,9,6,3,0.667,9,8,1,0.889
21600127,1610612759,1610612765,96.0,86.0,0.444,0.421,1,2016-11-11,9,6,3,0.667,9,4,5,0.444
21600128,1610612757,1610612758,122.0,120.0,0.523,0.489,1,2016-11-11,10,6,4,0.6,11,4,7,0.364
21600117,1610612749,1610612740,106.0,112.0,0.44,0.4379999999999999,0,2016-11-10,8,4,4,0.5,9,1,8,0.111
21600118,1610612748,1610612741,95.0,98.0,0.409,0.416,0,2016-11-10,7,2,5,0.286,9,5,4,0.556
21600119,1610612743,1610612744,101.0,125.0,0.4039999999999999,0.541,0,2016-11-10,8,3,5,0.375,9,7,2,0.778
21600120,1610612758,1610612747,91.0,101.0,0.4,0.514,0,2016-11-10,10,4,6,0.4,9,5,4,0.556
21600106,1610612752,1610612751,110.0,96.0,0.478,0.418,1,2016-11-09,7,3,4,0.429,8,3,5,0.375
21600107,1610612764,1610612738,118.0,93.0,0.5,0.4320000000000001,1,2016-11-09,7,2,5,0.286,7,3,4,0.429
21600108,1610612766,1610612762,104.0,98.0,0.4629999999999999,0.4629999999999999,1,2016-11-09,7,6,1,0.857,9,5,4,0.556
21600109,1610612753,1610612750,107.0,123.0,0.447,0.517,0,2016-11-09,8,3,5,0.375,7,2,5,0.286
21600110,1610612754,1610612755,122.0,115.0,0.544,0.484,1,2016-11-09,8,4,4,0.5,7,0,7,0.0
21600111,1610612737,1610612741,115.0,107.0,0.506,0.451,1,2016-11-09,8,6,2,0.75,8,4,4,0.5
21600112,1610612760,1610612761,102.0,112.0,0.419,0.518,0,2016-11-09,8,6,2,0.75,7,5,2,0.7140000000000001
21600113,1610612756,1610612765,107.0,100.0,0.452,0.36,1,2016-11-09,9,3,6,0.3329999999999999,8,4,4,0.5
21600114,1610612759,1610612745,99.0,101.0,0.3929999999999999,0.474,0,2016-11-09,8,5,3,0.625,8,5,3,0.625
21600115,1610612746,1610612757,111.0,80.0,0.4370000000000001,0.352,1,2016-11-09,8,7,1,0.875,9,5,4,0.556
21600116,1610612744,1610612742,116.0,95.0,0.581,0.395,1,2016-11-09,8,6,2,0.75,8,2,6,0.25
21600100,1610612739,1610612737,106.0,110.0,0.374,0.506,0,2016-11-08,7,6,1,0.857,7,5,2,0.7140000000000001
21600101,1610612751,1610612750,119.0,110.0,0.5529999999999999,0.424,1,2016-11-08,7,3,4,0.429,6,1,5,0.1669999999999999
21600102,1610612763,1610612743,108.0,107.0,0.512,0.5,1,2016-11-08,8,4,4,0.5,7,3,4,0.429
21600103,1610612757,1610612756,124.0,121.0,0.556,0.5,1,2016-11-08,8,5,3,0.625,8,2,6,0.25
21600104,1610612747,1610612742,97.0,109.0,0.487,0.524,0,2016-11-08,8,4,4,0.5,7,2,5,0.286
21600105,1610612758,1610612740,102.0,94.0,0.481,0.452,1,2016-11-08,9,4,5,0.444,8,0,8,0.0
21600093,1610612755,1610612762,84.0,109.0,0.4029999999999999,0.506,0,2016-11-07,6,0,6,0.0,8,5,3,0.625
21600094,1610612764,1610612745,106.0,114.0,0.415,0.519,0,2016-11-07,6,1,5,0.1669999999999999,7,4,3,0.5710000000000001
21600095,1610612766,1610612754,122.0,100.0,0.488,0.426,1,2016-11-07,6,5,1,0.833,7,3,4,0.429
21600096,1610612741,1610612753,112.0,80.0,0.472,0.3879999999999999,1,2016-11-07,7,4,3,0.5710000000000001,7,3,4,0.429
21600097,1610612760,1610612748,97.0,85.0,0.435,0.369,1,2016-11-07,7,6,1,0.857,6,2,4,0.3329999999999999
21600098,1610612746,1610612765,114.0,82.0,0.539,0.366,1,2016-11-07,7,6,1,0.857,7,4,3,0.5710000000000001
21600099,1610612744,1610612740,116.0,106.0,0.5,0.488,1,2016-11-07,7,5,2,0.7140000000000001,7,0,7,0.0
21600087,1610612752,1610612762,109.0,114.0,0.506,0.507,0,2016-11-06,6,2,4,0.3329999999999999,7,4,3,0.5710000000000001
21600088,1610612763,1610612757,94.0,100.0,0.3829999999999999,0.451,0,2016-11-06,7,3,4,0.429,7,4,3,0.5710000000000001
21600089,1610612761,1610612758,91.0,96.0,0.357,0.436,0,2016-11-06,6,4,2,0.667,8,3,5,0.375
21600090,1610612742,1610612749,86.0,75.0,0.375,0.366,1,2016-11-06,6,1,5,0.1669999999999999,7,4,3,0.5710000000000001
21600091,1610612738,1610612743,107.0,123.0,0.456,0.524,0,2016-11-06,6,3,3,0.5,6,3,3,0.5
21600092,1610612747,1610612756,119.0,108.0,0.456,0.44,1,2016-11-06,7,4,3,0.5710000000000001,7,2,5,0.286
21600079,1610612760,1610612750,112.0,92.0,0.523,0.3929999999999999,1,2016-11-05,6,5,1,0.833,5,1,4,0.2
21600080,1610612755,1610612739,101.0,102.0,0.46,0.407,0,2016-11-05,5,0,5,0.0,6,6,0,1.0
21600081,1610612753,1610612764,88.0,86.0,0.397,0.395,1,2016-11-05,6,3,3,0.5,5,1,4,0.2
21600082,1610612765,1610612743,103.0,86.0,0.476,0.33,1,2016-11-05,6,4,2,0.667,5,2,3,0.4
21600083,1610612754,1610612741,111.0,94.0,0.535,0.43,1,2016-11-05,6,3,3,0.5,6,3,3,0.5
21600084,1610612737,1610612745,112.0,97.0,0.529,0.435,1,2016-11-05,6,4,2,0.667,6,3,3,0.5
21600085,1610612749,1610612758,117.0,91.0,0.5,0.3929999999999999,1,2016-11-05,6,4,2,0.667,7,2,5,0.286
21600086,1610612759,1610612746,92.0,116.0,0.405,0.516,0,2016-11-05,7,5,2,0.7140000000000001,6,5,1,0.833
21600070,1610612764,1610612737,95.0,92.0,0.3879999999999999,0.386,1,2016-11-04,4,1,3,0.25,5,3,2,0.6
21600071,1610612761,1610612748,96.0,87.0,0.44,0.386,1,2016-11-04,5,4,1,0.8,5,2,3,0.4
21600072,1610612751,1610612766,95.0,99.0,0.402,0.419,0,2016-11-04,6,2,4,0.3329999999999999,5,4,1,0.8
21600073,1610612741,1610612752,104.0,117.0,0.44,0.517,0,2016-11-04,5,3,2,0.6,5,2,3,0.4
21600074,1610612763,1610612746,88.0,99.0,0.369,0.376,0,2016-11-04,6,3,3,0.5,5,4,1,0.8
21600075,1610612740,1610612756,111.0,112.0,0.457,0.43,0,2016-11-04,6,0,6,0.0,6,2,4,0.3329999999999999
21600076,1610612742,1610612757,95.0,105.0,0.41,0.45,0,2016-11-04,5,0,5,0.0,6,3,3,0.5
21600077,1610612762,1610612759,86.0,100.0,0.375,0.446,0,2016-11-04,6,3,3,0.5,6,5,1,0.833
21600078,1610612747,1610612744,117.0,97.0,0.474,0.4529999999999999,1,2016-11-04,6,3,3,0.5,6,4,2,0.667
21600065,1610612753,1610612758,102.0,94.0,0.452,0.475,1,2016-11-03,5,2,3,0.4,6,2,4,0.3329999999999999
21600066,1610612749,1610612754,125.0,107.0,0.573,0.469,1,2016-11-03,5,3,2,0.6,5,2,3,0.4
21600067,1610612750,1610612743,99.0,102.0,0.3979999999999999,0.481,0,2016-11-03,4,1,3,0.25,4,2,2,0.5
21600068,1610612739,1610612738,128.0,122.0,0.488,0.479,1,2016-11-03,5,5,0,1.0,5,3,2,0.6
21600069,1610612744,1610612760,122.0,96.0,0.517,0.402,1,2016-11-03,5,4,1,0.8,5,4,1,0.8
21600055,1610612764,1610612761,103.0,113.0,0.583,0.5579999999999999,0,2016-11-02,3,0,3,0.0,4,3,1,0.75
21600056,1610612766,1610612755,109.0,93.0,0.494,0.395,1,2016-11-02,4,3,1,0.75,4,0,4,0.0
21600057,1610612751,1610612765,109.0,101.0,0.539,0.42,1,2016-11-02,5,2,3,0.4,5,3,2,0.6
21600058,1610612752,1610612745,99.0,118.0,0.435,0.472,0,2016-11-02,4,1,3,0.25,5,3,2,0.6
21600059,1610612737,1610612747,116.0,123.0,0.482,0.5329999999999999,0,2016-11-02,4,3,1,0.75,5,2,3,0.4
21600060,1610612763,1610612740,89.0,83.0,0.351,0.37,1,2016-11-02,5,3,2,0.6,5,0,5,0.0
21600061,1610612738,1610612741,107.0,100.0,0.471,0.4320000000000001,1,2016-11-02,4,3,1,0.75,4,3,1,0.75
21600062,1610612762,1610612742,97.0,81.0,0.455,0.429,1,2016-11-02,5,3,2,0.6,4,0,4,0.0
21600063,1610612756,1610612757,118.0,115.0,0.4270000000000001,0.416,1,2016-11-02,5,1,4,0.2,5,2,3,0.4
21600064,1610612746,1610612760,83.0,85.0,0.391,0.405,0,2016-11-02,4,3,1,0.75,4,4,0,1.0
21600047,1610612739,1610612745,128.0,120.0,0.518,0.478,1,2016-11-01,4,4,0,1.0,4,2,2,0.5
21600046,1610612755,1610612753,101.0,103.0,0.494,0.452,0,2016-11-01,3,0,3,0.0,4,1,3,0.25
21600048,1610612754,1610612747,115.0,108.0,0.471,0.449,1,2016-11-01,4,2,2,0.5,4,1,3,0.25
21600049,1610612748,1610612758,108.0,96.0,0.43,0.382,1,2016-11-01,4,2,2,0.5,5,2,3,0.4
21600050,1610612765,1610612752,102.0,89.0,0.461,0.407,1,2016-11-01,4,3,1,0.75,3,1,2,0.3329999999999999
21600051,1610612740,1610612749,113.0,117.0,0.439,0.484,0,2016-11-01,4,0,4,0.0,4,2,2,0.5
21600052,1610612750,1610612763,116.0,80.0,0.551,0.36,1,2016-11-01,3,1,2,0.3329999999999999,4,2,2,0.5
21600053,1610612759,1610612762,91.0,106.0,0.434,0.5,0,2016-11-01,5,4,1,0.8,4,2,2,0.5
21600054,1610612757,1610612744,104.0,127.0,0.43,0.562,0,2016-11-01,4,2,2,0.5,4,3,1,0.75
21600042,1610612761,1610612743,105.0,102.0,0.466,0.407,1,2016-10-31,3,2,1,0.667,3,1,2,0.3329999999999999
21600043,1610612751,1610612741,88.0,118.0,0.344,0.506,0,2016-10-31,4,1,3,0.25,3,3,0,1.0
21600044,1610612737,1610612758,106.0,95.0,0.418,0.48,1,2016-10-31,3,3,0,1.0,4,2,2,0.5
21600045,1610612746,1610612756,116.0,98.0,0.5,0.417,1,2016-10-31,3,3,0,1.0,4,0,4,0.0
21600035,1610612746,1610612762,88.0,75.0,0.41,0.397,1,2016-10-30,2,2,0,1.0,3,1,2,0.3329999999999999
21600036,1610612756,1610612744,100.0,106.0,0.411,0.422,0,2016-10-30,3,0,3,0.0,3,2,1,0.667
21600037,1610612748,1610612759,99.0,106.0,0.4629999999999999,0.451,0,2016-10-30,3,1,2,0.3329999999999999,4,4,0,1.0
21600038,1610612765,1610612749,98.0,83.0,0.4429999999999999,0.391,1,2016-10-30,3,2,1,0.667,3,1,2,0.3329999999999999
21600040,1610612760,1610612747,113.0,96.0,0.474,0.402,1,2016-10-30,3,3,0,1.0,3,1,2,0.3329999999999999
21600039,1610612763,1610612764,112.0,103.0,0.4429999999999999,0.442,1,2016-10-30,3,2,1,0.667,2,0,2,0.0
21600041,1610612745,1610612742,93.0,92.0,0.42,0.3720000000000001,1,2016-10-30,3,2,1,0.667,3,0,3,0.0
21600026,1610612755,1610612737,72.0,104.0,0.35,0.494,0,2016-10-29,2,0,2,0.0,2,2,0,1.0
21600027,1610612766,1610612738,98.0,104.0,0.405,0.481,0,2016-10-29,3,2,1,0.667,3,2,1,0.667
21600028,1610612752,1610612763,111.0,104.0,0.526,0.43,1,2016-10-29,2,1,1,0.5,2,1,1,0.5
21600029,1610612739,1610612753,105.0,99.0,0.409,0.452,1,2016-10-29,3,3,0,1.0,3,0,3,0.0
21600030,1610612741,1610612754,118.0,101.0,0.523,0.489,1,2016-10-29,2,2,0,1.0,3,1,2,0.3329999999999999
21600031,1610612749,1610612751,110.0,108.0,0.466,0.44,1,2016-10-29,2,1,1,0.5,3,1,2,0.3329999999999999
21600032,1610612759,1610612740,98.0,79.0,0.422,0.3720000000000001,1,2016-10-29,3,3,0,1.0,3,0,3,0.0
21600033,1610612743,1610612757,113.0,115.0,0.38,0.4589999999999999,0,2016-10-29,2,1,1,0.5,3,2,1,0.667
21600034,1610612758,1610612750,106.0,103.0,0.4589999999999999,0.529,1,2016-10-29,3,2,1,0.667,2,0,2,0.0
21600018,1610612761,1610612739,91.0,94.0,0.389,0.418,0,2016-10-28,2,1,1,0.5,2,2,0,1.0
21600019,1610612751,1610612754,103.0,94.0,0.4370000000000001,0.3779999999999999,1,2016-10-28,2,1,1,0.5,2,1,1,0.5
21600020,1610612765,1610612753,108.0,82.0,0.505,0.347,1,2016-10-28,2,1,1,0.5,2,0,2,0.0
21600021,1610612760,1610612756,113.0,110.0,0.417,0.447,1,2016-10-28,2,2,0,1.0,2,0,2,0.0
21600022,1610612748,1610612766,91.0,97.0,0.3720000000000001,0.38,0,2016-10-28,2,1,1,0.5,2,2,0,1.0
21600023,1610612742,1610612745,98.0,106.0,0.4379999999999999,0.471,0,2016-10-28,2,0,2,0.0,2,1,1,0.5
21600024,1610612762,1610612747,96.0,89.0,0.413,0.381,1,2016-10-28,2,1,1,0.5,2,1,1,0.5
21600025,1610612740,1610612744,114.0,122.0,0.47,0.484,0,2016-10-28,2,0,2,0.0,2,1,1,0.5
21600014,1610612737,1610612764,114.0,99.0,0.5,0.426,1,2016-10-27,1,1,0,1.0,1,0,1,0.0
21600015,1610612741,1610612738,105.0,99.0,0.391,0.5,1,2016-10-27,1,1,0,1.0,2,1,1,0.5
21600016,1610612758,1610612759,94.0,102.0,0.4,0.456,0,2016-10-27,2,1,1,0.5,2,2,0,1.0
21600017,1610612757,1610612746,106.0,114.0,0.4589999999999999,0.407,0,2016-10-27,2,1,1,0.5,1,1,0,1.0
21600004,1610612753,1610612748,96.0,108.0,0.382,0.485,0,2016-10-26,1,0,1,0.0,1,1,0,1.0
21600005,1610612754,1610612742,130.0,121.0,0.505,0.433,1,2016-10-26,1,1,0,1.0,1,0,1,0.0
21600006,1610612738,1610612751,122.0,117.0,0.539,0.4429999999999999,1,2016-10-26,1,1,0,1.0,1,0,1,0.0
21600007,1610612761,1610612765,109.0,91.0,0.477,0.417,1,2016-10-26,1,1,0,1.0,1,0,1,0.0
21600008,1610612749,1610612766,96.0,107.0,0.424,0.449,0,2016-10-26,1,0,1,0.0,1,1,0,1.0
21600009,1610612763,1610612750,102.0,98.0,0.45,0.419,1,2016-10-26,1,1,0,1.0,1,0,1,0.0
21600010,1610612740,1610612743,102.0,107.0,0.413,0.446,0,2016-10-26,1,0,1,0.0,1,1,0,1.0
21600011,1610612755,1610612760,97.0,103.0,0.429,0.415,0,2016-10-26,1,0,1,0.0,1,1,0,1.0
21600012,1610612756,1610612758,94.0,113.0,0.4679999999999999,0.512,0,2016-10-26,1,0,1,0.0,1,1,0,1.0
21600013,1610612747,1610612745,120.0,114.0,0.506,0.512,1,2016-10-26,1,1,0,1.0,1,0,1,0.0
21600001,1610612739,1610612752,117.0,88.0,0.479,0.368,1,2016-10-25,1,1,0,1.0,1,0,1,0.0
21600002,1610612757,1610612762,113.0,104.0,0.52,0.488,1,2016-10-25,1,1,0,1.0,1,0,1,0.0
21600003,1610612744,1610612759,100.0,129.0,0.471,0.48,0,2016-10-25,1,0,1,0.0,1,1,0,1.0
11600096,1610612764,1610612761,119.0,82.0,0.5760000000000001,0.354,1,2016-10-21,7,4,3,0.5710000000000001,7,4,3,0.5710000000000001
11600100,1610612748,1610612755,110.0,113.0,0.507,0.444,0,2016-10-21,8,4,4,0.5,7,2,5,0.286
11600097,1610612750,1610612766,109.0,74.0,0.488,0.316,1,2016-10-21,7,5,2,0.7140000000000001,7,3,4,0.429
11600101,1610612759,1610612745,114.0,99.0,0.506,0.409,1,2016-10-21,6,4,2,0.667,7,5,2,0.7140000000000001
11600098,1610612743,1610612742,101.0,75.0,0.513,0.38,1,2016-10-21,8,4,4,0.5,7,2,5,0.286
11600099,1610612747,1610612756,94.0,98.0,0.391,0.3929999999999999,0,2016-10-21,8,2,6,0.25,6,4,2,0.667
11600102,1610612744,1610612757,107.0,96.0,0.433,0.416,1,2016-10-21,7,6,1,0.857,7,4,3,0.5710000000000001
11600092,1610612766,1610612748,96.0,88.0,0.415,0.36,1,2016-10-20,6,3,3,0.5,7,4,3,0.5710000000000001
11600093,1610612753,1610612740,114.0,111.0,0.426,0.4270000000000001,1,2016-10-20,7,2,5,0.286,6,1,5,0.1669999999999999
11600095,1610612751,1610612752,111.0,116.0,0.476,0.494,0,2016-10-20,6,1,5,0.1669999999999999,6,4,2,0.667
11600094,1610612741,1610612737,81.0,97.0,0.305,0.471,0,2016-10-20,7,3,4,0.429,7,5,2,0.7140000000000001
11600089,1610612738,1610612752,96.0,121.0,0.417,0.489,0,2016-10-19,7,5,2,0.7140000000000001,5,3,2,0.6
11600090,1610612765,1610612761,92.0,103.0,0.455,0.4320000000000001,0,2016-10-19,6,3,3,0.5,6,4,2,0.667
11600085,1610612749,1610612754,111.0,103.0,0.481,0.429,1,2016-10-19,6,3,3,0.5,6,3,3,0.5
11600086,1610612750,1610612763,101.0,94.0,0.413,0.3979999999999999,1,2016-10-19,6,4,2,0.667,6,4,2,0.667
11600091,1610612742,1610612745,91.0,106.0,0.373,0.43,0,2016-10-19,6,2,4,0.3329999999999999,6,5,1,0.833
11600087,1610612762,1610612757,84.0,88.0,0.3720000000000001,0.462,0,2016-10-19,6,3,3,0.5,6,4,2,0.667
11600088,1610612747,1610612744,112.0,123.0,0.457,0.478,0,2016-10-19,7,2,5,0.286,6,5,1,0.833
11600080,1610612739,1610612764,91.0,96.0,0.439,0.415,0,2016-10-18,6,2,4,0.3329999999999999,6,3,3,0.5
11600083,1610612737,1610612740,96.0,89.0,0.419,0.3879999999999999,1,2016-10-18,6,4,2,0.667,5,1,4,0.2
11600084,1610612748,1610612753,107.0,77.0,0.512,0.337,1,2016-10-18,6,4,2,0.667,6,1,5,0.1669999999999999
11600081,1610612760,1610612743,97.0,87.0,0.452,0.348,1,2016-10-18,6,3,3,0.5,7,3,4,0.429
11600082,1610612758,1610612746,89.0,92.0,0.42,0.455,0,2016-10-18,6,3,3,0.5,6,3,3,0.5
11600078,1610612738,1610612751,120.0,99.0,0.488,0.414,1,2016-10-17,6,5,1,0.833,5,1,4,0.2
11600079,1610612765,1610612749,102.0,78.0,0.487,0.37,1,2016-10-17,5,3,2,0.6,5,2,3,0.4
11600076,1610612741,1610612766,104.0,108.0,0.426,0.3329999999999999,0,2016-10-17,6,3,3,0.5,5,2,3,0.4
11600077,1610612762,1610612746,104.0,78.0,0.519,0.392,1,2016-10-17,5,3,2,0.6,5,2,3,0.4
11600073,1610612753,1610612737,98.0,105.0,0.442,0.409,0,2016-10-16,5,1,4,0.2,5,3,2,0.6
11600074,1610612760,1610612750,112.0,94.0,0.5,0.4,1,2016-10-16,5,2,3,0.4,5,3,2,0.6
11600075,1610612757,1610612743,97.0,106.0,0.3979999999999999,0.451,0,2016-10-16,5,3,2,0.6,6,3,3,0.5
11600066,1610612755,1610612765,76.0,97.0,0.368,0.4679999999999999,0,2016-10-15,6,1,5,0.1669999999999999,4,2,2,0.5
11600069,1610612758,1610612764,124.0,119.0,0.6,0.485,1,2016-10-15,5,3,2,0.6,5,2,3,0.4
11600070,1610612752,1610612738,107.0,119.0,0.457,0.589,0,2016-10-15,4,2,2,0.5,5,4,1,0.8
11600071,1610612748,1610612750,96.0,101.0,0.41,0.481,0,2016-10-15,5,3,2,0.6,4,3,1,0.75
11600067,1610612745,1610612763,125.0,134.0,0.426,0.413,0,2016-10-15,5,4,1,0.8,5,4,1,0.8
11600072,1610612749,1610612741,86.0,107.0,0.442,0.4679999999999999,0,2016-10-15,4,2,2,0.5,5,3,2,0.6
11600068,1610612747,1610612744,107.0,112.0,0.429,0.5429999999999999,0,2016-10-15,6,2,4,0.3329999999999999,5,4,1,0.8
11600061,1610612753,1610612754,114.0,106.0,0.506,0.466,1,2016-10-14,4,1,3,0.25,5,3,2,0.6
11600062,1610612741,1610612739,118.0,108.0,0.516,0.4429999999999999,1,2016-10-14,4,2,2,0.5,5,2,3,0.4
11600065,1610612759,1610612748,100.0,108.0,0.446,0.483,0,2016-10-14,5,3,2,0.6,4,3,1,0.75
11600063,1610612743,1610612744,128.0,129.0,0.4629999999999999,0.4589999999999999,0,2016-10-14,5,2,3,0.4,4,3,1,0.75
11600064,1610612756,1610612742,112.0,107.0,0.4039999999999999,0.429,1,2016-10-14,5,3,2,0.6,5,2,3,0.4
11600053,1610612764,1610612755,100.0,79.0,0.42,0.3289999999999999,1,2016-10-13,4,2,2,0.5,5,1,4,0.2
11600055,1610612751,1610612738,97.0,100.0,0.384,0.417,0,2016-10-13,4,1,3,0.25,4,3,1,0.75
11600056,1610612737,1610612765,94.0,99.0,0.434,0.425,0,2016-10-13,4,2,2,0.5,3,1,2,0.3329999999999999
11600054,1610612760,1610612763,94.0,110.0,0.424,0.3979999999999999,0,2016-10-13,4,1,3,0.25,4,3,1,0.75
11600059,1610612739,1610612761,94.0,119.0,0.41,0.5770000000000001,0,2016-10-13,4,2,2,0.5,4,2,2,0.5
11600057,1610612746,1610612757,109.0,108.0,0.442,0.481,1,2016-10-13,4,2,2,0.5,4,3,1,0.75
11600058,1610612747,1610612758,104.0,116.0,0.465,0.5870000000000001,0,2016-10-13,5,2,3,0.4,4,2,2,0.5
11600052,1610612740,1610612745,104.0,116.0,0.439,0.4320000000000001,0,2016-10-12,4,1,3,0.25,4,4,0,1.0
11600049,1610612753,1610612759,89.0,95.0,0.395,0.3879999999999999,0,2016-10-12,3,0,3,0.0,4,3,1,0.75
11600048,1610612754,1610612749,101.0,83.0,0.43,0.337,1,2016-10-12,4,3,1,0.75,3,2,1,0.667
11600050,1610612750,1610612743,105.0,88.0,0.415,0.411,1,2016-10-12,3,2,1,0.667,4,2,2,0.5
11600051,1610612762,1610612756,110.0,111.0,0.408,0.447,0,2016-10-12,4,2,2,0.5,4,2,2,0.5
11600045,1610612748,1610612751,121.0,100.0,0.5,0.39,1,2016-10-11,3,2,1,0.667,3,1,2,0.3329999999999999
11600044,1610612763,1610612755,121.0,91.0,0.483,0.3829999999999999,1,2016-10-11,3,2,1,0.667,4,1,3,0.25
11600046,1610612742,1610612760,114.0,109.0,0.465,0.406,1,2016-10-11,4,2,2,0.5,3,1,2,0.3329999999999999
11600047,1610612747,1610612757,106.0,109.0,0.4320000000000001,0.4479999999999999,0,2016-10-11,4,2,2,0.5,3,3,0,1.0
11600038,1610612766,1610612750,98.0,86.0,0.435,0.347,1,2016-10-10,4,1,3,0.25,2,1,1,0.5
11600039,1610612752,1610612764,90.0,88.0,0.41,0.439,1,2016-10-10,3,2,1,0.667,3,1,2,0.3329999999999999
11600040,1610612737,1610612739,99.0,93.0,0.4579999999999999,0.392,1,2016-10-10,3,2,1,0.667,3,2,1,0.667
11600041,1610612765,1610612759,81.0,86.0,0.407,0.413,0,2016-10-10,2,0,2,0.0,3,2,1,0.667
11600042,1610612746,1610612762,94.0,96.0,0.4,0.5,0,2016-10-10,3,1,2,0.3329999999999999,3,2,1,0.667
11600037,1610612745,1610612740,123.0,117.0,0.472,0.471,1,2016-10-09,3,3,0,1.0,3,1,2,0.3329999999999999
11600036,1610612747,1610612743,124.0,115.0,0.531,0.476,1,2016-10-09,3,2,1,0.667,3,2,1,0.667
11600029,1610612738,1610612766,104.0,86.0,0.444,0.3829999999999999,1,2016-10-08,3,2,1,0.667,3,0,3,0.0
11600031,1610612752,1610612751,116.0,98.0,0.536,0.387,1,2016-10-08,2,1,1,0.5,2,1,1,0.5
11600033,1610612739,1610612755,108.0,105.0,0.4589999999999999,0.371,1,2016-10-08,2,2,0,1.0,3,1,2,0.3329999999999999
11600030,1610612741,1610612754,121.0,105.0,0.513,0.5,1,2016-10-08,3,1,2,0.3329999999999999,3,2,1,0.667
11600032,1610612748,1610612750,100.0,109.0,0.4629999999999999,0.3929999999999999,0,2016-10-08,2,1,1,0.5,1,1,0,1.0
11600034,1610612749,1610612742,88.0,74.0,0.418,0.337,1,2016-10-08,2,2,0,1.0,3,1,2,0.3329999999999999
11600035,1610612759,1610612737,102.0,91.0,0.456,0.415,1,2016-10-08,2,1,1,0.5,2,1,1,0.5
11600027,1610612757,1610612756,115.0,110.0,0.416,0.4639999999999999,1,2016-10-07,2,2,0,1.0,3,1,2,0.3329999999999999
11600028,1610612747,1610612743,97.0,101.0,0.3939999999999999,0.354,0,2016-10-07,2,1,1,0.5,2,2,0,1.0
11600021,1610612755,1610612764,119.0,125.0,0.489,0.48,0,2016-10-06,2,1,1,0.5,2,1,1,0.5
11600022,1610612754,1610612741,115.0,108.0,0.484,0.4270000000000001,1,2016-10-06,2,2,0,1.0,2,0,2,0.0
11600024,1610612751,1610612765,101.0,94.0,0.449,0.4379999999999999,1,2016-10-06,1,1,0,1.0,1,0,1,0.0
11600025,1610612766,1610612738,92.0,107.0,0.425,0.455,0,2016-10-06,2,0,2,0.0,2,1,1,0.5
11600023,1610612763,1610612737,83.0,104.0,0.366,0.477,0,2016-10-06,2,1,1,0.5,1,1,0,1.0
11600026,1610612744,1610612758,105.0,96.0,0.4429999999999999,0.422,1,2016-10-06,3,2,1,0.667,2,0,2,0.0
11600017,1610612739,1610612753,117.0,102.0,0.532,0.44,1,2016-10-05,1,1,0,1.0,2,0,2,0.0
11600018,1610612756,1610612762,99.0,104.0,0.384,0.493,0,2016-10-05,2,1,1,0.5,2,1,1,0.5
11600019,1610612746,1610612761,104.0,98.0,0.522,0.442,1,2016-10-05,2,1,1,0.5,3,1,2,0.3329999999999999
11600011,1610612755,1610612738,92.0,89.0,0.423,0.4,1,2016-10-04,1,1,0,1.0,1,0,1,0.0
11600012,1610612764,1610612748,95.0,106.0,0.3929999999999999,0.551,0,2016-10-04,1,0,1,0.0,1,1,0,1.0
11600013,1610612740,1610612754,96.0,113.0,0.408,0.433,0,2016-10-04,2,1,1,0.5,1,1,0,1.0
11600014,1610612745,1610612752,130.0,103.0,0.537,0.406,1,2016-10-04,2,2,0,1.0,1,0,1,0.0
11600015,1610612747,1610612758,103.0,84.0,0.4589999999999999,0.359,1,2016-10-04,1,1,0,1.0,1,0,1,0.0
11600016,1610612744,1610612746,120.0,75.0,0.514,0.325,1,2016-10-04,2,1,1,0.5,1,0,1,0.0
11600005,1610612741,1610612749,91.0,93.0,0.461,0.375,0,2016-10-03,1,0,1,0.0,1,1,0,1.0
11600006,1610612763,1610612753,102.0,97.0,0.472,0.479,1,2016-10-03,1,1,0,1.0,1,0,1,0.0
11600009,1610612742,1610612766,95.0,88.0,0.422,0.368,1,2016-10-03,2,1,1,0.5,1,0,1,0.0
11600004,1610612761,1610612743,106.0,108.0,0.433,0.461,0,2016-10-03,2,1,1,0.5,1,1,0,1.0
11600007,1610612756,1610612759,91.0,86.0,0.3779999999999999,0.4,1,2016-10-03,1,1,0,1.0,1,0,1,0.0
11600001,1610612761,1610612744,97.0,93.0,0.43,0.3929999999999999,1,2016-10-01,1,1,0,1.0,1,0,1,0.0
11600002,1610612740,1610612742,116.0,102.0,0.573,0.429,1,2016-10-01,1,1,0,1.0,1,0,1,0.0
41500407,1610612744,1610612739,89.0,93.0,0.386,0.402,0,2016-06-19,82,73,9,0.89,82,57,25,0.695
41500406,1610612739,1610612744,115.0,101.0,0.519,0.402,1,2016-06-16,82,57,25,0.695,82,73,9,0.89
41500405,1610612744,1610612739,97.0,112.0,0.364,0.53,0,2016-06-13,82,73,9,0.89,82,57,25,0.695
41500404,1610612739,1610612744,97.0,108.0,0.469,0.407,0,2016-06-10,82,57,25,0.695,82,73,9,0.89
41500403,1610612739,1610612744,120.0,90.0,0.527,0.421,1,2016-06-08,82,57,25,0.695,82,73,9,0.89
41500402,1610612744,1610612739,110.0,77.0,0.5429999999999999,0.354,1,2016-06-05,82,73,9,0.89,82,57,25,0.695
41500401,1610612744,1610612739,104.0,89.0,0.494,0.381,1,2016-06-02,82,73,9,0.89,82,57,25,0.695
41500317,1610612744,1610612760,96.0,88.0,0.435,0.382,1,2016-05-30,82,73,9,0.89,82,55,27,0.6709999999999999
41500316,1610612760,1610612744,101.0,108.0,0.422,0.409,0,2016-05-28,82,55,27,0.6709999999999999,82,73,9,0.89
41500306,1610612761,1610612739,87.0,113.0,0.418,0.541,0,2016-05-27,82,56,26,0.6829999999999999,82,57,25,0.695
41500315,1610612744,1610612760,120.0,111.0,0.471,0.429,1,2016-05-26,82,73,9,0.89,82,55,27,0.6709999999999999
41500305,1610612739,1610612761,116.0,78.0,0.5710000000000001,0.391,1,2016-05-25,82,57,25,0.695,82,56,26,0.6829999999999999
41500314,1610612760,1610612744,118.0,94.0,0.433,0.413,1,2016-05-24,82,55,27,0.6709999999999999,82,73,9,0.89
41500304,1610612761,1610612739,105.0,99.0,0.5379999999999999,0.47,1,2016-05-23,82,56,26,0.6829999999999999,82,57,25,0.695
41500313,1610612760,1610612744,133.0,105.0,0.5,0.413,1,2016-05-22,82,55,27,0.6709999999999999,82,73,9,0.89
41500303,1610612761,1610612739,99.0,84.0,0.4579999999999999,0.354,1,2016-05-21,82,56,26,0.6829999999999999,82,57,25,0.695
41500302,1610612739,1610612761,108.0,89.0,0.5,0.402,1,2016-05-19,82,57,25,0.695,82,56,26,0.6829999999999999
41500312,1610612744,1610612760,118.0,91.0,0.506,0.449,1,2016-05-18,82,73,9,0.89,82,55,27,0.6709999999999999
41500301,1610612739,1610612761,115.0,84.0,0.5539999999999999,0.421,1,2016-05-17,82,57,25,0.695,82,56,26,0.6829999999999999
41500311,1610612744,1610612760,102.0,108.0,0.44,0.4379999999999999,0,2016-05-16,82,73,9,0.89,82,55,27,0.6709999999999999
41500217,1610612761,1610612748,116.0,89.0,0.4589999999999999,0.444,1,2016-05-15,82,56,26,0.6829999999999999,82,48,34,0.585
41500216,1610612748,1610612761,103.0,91.0,0.476,0.415,1,2016-05-13,82,48,34,0.585,82,56,26,0.6829999999999999
41500236,1610612760,1610612759,113.0,99.0,0.471,0.43,1,2016-05-12,82,55,27,0.6709999999999999,82,67,15,0.8170000000000001
41500215,1610612761,1610612748,99.0,91.0,0.4320000000000001,0.4029999999999999,1,2016-05-11,82,56,26,0.6829999999999999,82,48,34,0.585
41500225,1610612744,1610612757,125.0,121.0,0.512,0.413,1,2016-05-11,82,73,9,0.89,82,44,38,0.537
41500235,1610612759,1610612760,91.0,95.0,0.3979999999999999,0.436,0,2016-05-10,82,67,15,0.8170000000000001,82,55,27,0.6709999999999999
41500214,1610612748,1610612761,94.0,87.0,0.45,0.3929999999999999,1,2016-05-09,82,48,34,0.585,82,56,26,0.6829999999999999
41500224,1610612757,1610612744,125.0,132.0,0.406,0.4629999999999999,0,2016-05-09,82,44,38,0.537,82,73,9,0.89
41500204,1610612737,1610612739,99.0,100.0,0.482,0.4320000000000001,0,2016-05-08,82,48,34,0.585,82,57,25,0.695
41500234,1610612760,1610612759,111.0,97.0,0.506,0.471,1,2016-05-08,82,55,27,0.6709999999999999,82,67,15,0.8170000000000001
41500213,1610612748,1610612761,91.0,95.0,0.429,0.471,0,2016-05-07,82,48,34,0.585,82,56,26,0.6829999999999999
41500223,1610612757,1610612744,120.0,108.0,0.465,0.477,1,2016-05-07,82,44,38,0.537,82,73,9,0.89
41500203,1610612737,1610612739,108.0,121.0,0.488,0.494,0,2016-05-06,82,48,34,0.585,82,57,25,0.695
41500233,1610612760,1610612759,96.0,100.0,0.415,0.434,0,2016-05-06,82,55,27,0.6709999999999999,82,67,15,0.8170000000000001
41500212,1610612761,1610612748,96.0,92.0,0.419,0.494,1,2016-05-05,82,56,26,0.6829999999999999,82,48,34,0.585
41500202,1610612739,1610612737,123.0,98.0,0.471,0.423,1,2016-05-04,82,57,25,0.695,82,48,34,0.585
41500211,1610612761,1610612748,96.0,102.0,0.449,0.449,0,2016-05-03,82,56,26,0.6829999999999999,82,48,34,0.585
41500222,1610612744,1610612757,110.0,99.0,0.462,0.444,1,2016-05-03,82,73,9,0.89,82,44,38,0.537
41500201,1610612739,1610612737,104.0,93.0,0.446,0.379,1,2016-05-02,82,57,25,0.695,82,48,34,0.585
41500232,1610612759,1610612760,97.0,98.0,0.426,0.481,0,2016-05-02,82,67,15,0.8170000000000001,82,55,27,0.6709999999999999
41500127,1610612748,1610612766,106.0,73.0,0.483,0.321,1,2016-05-01,82,48,34,0.585,82,48,34,0.585
41500221,1610612744,1610612757,118.0,106.0,0.473,0.402,1,2016-05-01,82,73,9,0.89,82,44,38,0.537
41500117,1610612761,1610612754,89.0,84.0,0.382,0.466,1,2016-05-01,82,56,26,0.6829999999999999,82,45,37,0.5489999999999999
41500231,1610612759,1610612760,124.0,92.0,0.607,0.412,1,2016-04-30,82,67,15,0.8170000000000001,82,55,27,0.6709999999999999
41500116,1610612754,1610612761,101.0,83.0,0.461,0.3670000000000001,1,2016-04-29,82,45,37,0.5489999999999999,82,56,26,0.6829999999999999
41500126,1610612766,1610612748,90.0,97.0,0.421,0.4579999999999999,0,2016-04-29,82,48,34,0.585,82,48,34,0.585
41500176,1610612757,1610612746,106.0,103.0,0.442,0.4479999999999999,1,2016-04-29,82,44,38,0.537,82,53,29,0.6459999999999999
41500136,1610612738,1610612737,92.0,104.0,0.362,0.514,0,2016-04-28,82,48,34,0.585,82,48,34,0.585
41500125,1610612748,1610612766,88.0,90.0,0.42,0.3929999999999999,0,2016-04-27,82,48,34,0.585,82,48,34,0.585
41500175,1610612746,1610612757,98.0,108.0,0.419,0.446,0,2016-04-27,82,53,29,0.6459999999999999,82,44,38,0.537
41500145,1610612744,1610612745,114.0,81.0,0.5489999999999999,0.326,1,2016-04-27,82,73,9,0.89,82,41,41,0.5
41500115,1610612761,1610612754,102.0,99.0,0.402,0.452,1,2016-04-26,82,56,26,0.6829999999999999,82,45,37,0.5489999999999999
41500135,1610612737,1610612738,110.0,83.0,0.4379999999999999,0.377,1,2016-04-26,82,48,34,0.585,82,48,34,0.585
41500124,1610612766,1610612748,89.0,85.0,0.4,0.395,1,2016-04-25,82,48,34,0.585,82,48,34,0.585
41500165,1610612760,1610612742,118.0,104.0,0.506,0.469,1,2016-04-25,82,55,27,0.6709999999999999,82,42,40,0.512
41500174,1610612757,1610612746,98.0,84.0,0.409,0.357,1,2016-04-25,82,44,38,0.537,82,53,29,0.6459999999999999
41500154,1610612763,1610612759,95.0,116.0,0.449,0.494,0,2016-04-24,82,42,40,0.512,82,67,15,0.8170000000000001
41500144,1610612745,1610612744,94.0,121.0,0.423,0.517,0,2016-04-24,82,41,41,0.5,82,73,9,0.89
41500134,1610612738,1610612737,104.0,95.0,0.426,0.374,1,2016-04-24,82,48,34,0.585,82,48,34,0.585
41500104,1610612765,1610612739,98.0,100.0,0.487,0.419,0,2016-04-24,82,44,38,0.537,82,57,25,0.695
41500114,1610612754,1610612761,100.0,83.0,0.471,0.365,1,2016-04-23,82,45,37,0.5489999999999999,82,56,26,0.6829999999999999
41500123,1610612766,1610612748,96.0,80.0,0.389,0.342,1,2016-04-23,82,48,34,0.585,82,48,34,0.585
41500164,1610612742,1610612760,108.0,119.0,0.518,0.53,0,2016-04-23,82,42,40,0.512,82,55,27,0.6709999999999999
41500173,1610612757,1610612746,96.0,88.0,0.425,0.409,1,2016-04-23,82,44,38,0.537,82,53,29,0.6459999999999999
41500103,1610612765,1610612739,91.0,101.0,0.486,0.488,0,2016-04-22,82,44,38,0.537,82,57,25,0.695
41500133,1610612738,1610612737,111.0,103.0,0.4629999999999999,0.442,1,2016-04-22,82,48,34,0.585,82,48,34,0.585
41500153,1610612763,1610612759,87.0,96.0,0.415,0.455,0,2016-04-22,82,42,40,0.512,82,67,15,0.8170000000000001
41500163,1610612742,1610612760,102.0,131.0,0.474,0.5770000000000001,0,2016-04-21,82,42,40,0.512,82,55,27,0.6709999999999999
41500113,1610612754,1610612761,85.0,101.0,0.382,0.415,0,2016-04-21,82,45,37,0.5489999999999999,82,56,26,0.6829999999999999
41500143,1610612745,1610612744,97.0,96.0,0.391,0.43,1,2016-04-21,82,41,41,0.5,82,73,9,0.89
41500122,1610612748,1610612766,115.0,103.0,0.579,0.4270000000000001,1,2016-04-20,82,48,34,0.585,82,48,34,0.585
41500102,1610612739,1610612765,107.0,90.0,0.5,0.436,1,2016-04-20,82,57,25,0.695,82,44,38,0.537
41500172,1610612746,1610612757,102.0,81.0,0.46,0.341,1,2016-04-20,82,53,29,0.6459999999999999,82,44,38,0.537
41500132,1610612737,1610612738,89.0,72.0,0.39,0.318,1,2016-04-19,82,48,34,0.585,82,48,34,0.585
41500152,1610612759,1610612763,94.0,68.0,0.47,0.326,1,2016-04-19,82,67,15,0.8170000000000001,82,42,40,0.512
41500112,1610612761,1610612754,98.0,87.0,0.4379999999999999,0.414,1,2016-04-18,82,56,26,0.6829999999999999,82,45,37,0.5489999999999999
41500162,1610612760,1610612742,84.0,85.0,0.337,0.4270000000000001,0,2016-04-18,82,55,27,0.6709999999999999,82,42,40,0.512
41500142,1610612744,1610612745,115.0,106.0,0.494,0.4429999999999999,1,2016-04-18,82,73,9,0.89,82,41,41,0.5
41500101,1610612739,1610612765,106.0,101.0,0.4429999999999999,0.507,1,2016-04-17,82,57,25,0.695,82,44,38,0.537
41500121,1610612748,1610612766,123.0,91.0,0.5760000000000001,0.431,1,2016-04-17,82,48,34,0.585,82,48,34,0.585
41500151,1610612759,1610612763,106.0,74.0,0.519,0.392,1,2016-04-17,82,67,15,0.8170000000000001,82,42,40,0.512
41500171,1610612746,1610612757,115.0,95.0,0.5379999999999999,0.3979999999999999,1,2016-04-17,82,53,29,0.6459999999999999,82,44,38,0.537
41500111,1610612761,1610612754,90.0,100.0,0.38,0.43,0,2016-04-16,82,56,26,0.6829999999999999,82,45,37,0.5489999999999999
41500141,1610612744,1610612745,104.0,78.0,0.429,0.357,1,2016-04-16,82,73,9,0.89,82,41,41,0.5
41500131,1610612737,1610612738,102.0,101.0,0.407,0.363,1,2016-04-16,82,48,34,0.585,82,48,34,0.585
41500161,1610612760,1610612742,108.0,70.0,0.45,0.298,1,2016-04-16,82,55,27,0.6709999999999999,82,42,40,0.512
21501217,1610612738,1610612748,98.0,88.0,0.43,0.4320000000000001,1,2016-04-13,82,48,34,0.585,82,48,34,0.585
21501218,1610612751,1610612761,96.0,103.0,0.4379999999999999,0.441,0,2016-04-13,82,21,61,0.256,82,56,26,0.6829999999999999
21501219,1610612766,1610612753,117.0,103.0,0.547,0.462,1,2016-04-13,82,48,34,0.585,82,35,47,0.4270000000000001
21501220,1610612739,1610612765,110.0,112.0,0.474,0.435,0,2016-04-13,82,57,25,0.695,82,44,38,0.537
21501221,1610612764,1610612737,109.0,98.0,0.477,0.395,1,2016-04-13,82,41,41,0.5,82,48,34,0.585
21501222,1610612741,1610612755,115.0,105.0,0.47,0.457,1,2016-04-13,82,42,40,0.512,82,10,72,0.122
21501223,1610612742,1610612759,91.0,96.0,0.4029999999999999,0.473,0,2016-04-13,82,42,40,0.512,82,67,15,0.8170000000000001
21501224,1610612745,1610612758,116.0,81.0,0.485,0.3329999999999999,1,2016-04-13,82,41,41,0.5,82,33,49,0.402
21501225,1610612749,1610612754,92.0,97.0,0.425,0.433,0,2016-04-13,82,33,49,0.402,82,45,37,0.5489999999999999
21501226,1610612750,1610612740,144.0,109.0,0.6509999999999999,0.435,1,2016-04-13,82,29,53,0.354,82,30,52,0.366
21501227,1610612744,1610612763,125.0,104.0,0.529,0.429,1,2016-04-13,82,73,9,0.89,82,42,40,0.512
21501228,1610612747,1610612762,101.0,96.0,0.482,0.47,1,2016-04-13,82,17,65,0.207,82,40,42,0.488
21501229,1610612756,1610612746,114.0,105.0,0.455,0.4479999999999999,1,2016-04-13,82,23,59,0.28,82,53,29,0.6459999999999999
21501230,1610612757,1610612743,107.0,99.0,0.4379999999999999,0.426,1,2016-04-13,82,44,38,0.537,82,33,49,0.402
21501212,1610612754,1610612752,102.0,90.0,0.513,0.45,1,2016-04-12,81,44,37,0.5429999999999999,82,32,50,0.39
21501213,1610612765,1610612748,93.0,99.0,0.405,0.487,0,2016-04-12,81,43,38,0.531,81,48,33,0.593
21501214,1610612761,1610612755,122.0,98.0,0.505,0.455,1,2016-04-12,81,55,26,0.679,81,10,71,0.123
21501215,1610612759,1610612760,102.0,98.0,0.425,0.402,1,2016-04-12,81,66,15,0.815,82,55,27,0.6709999999999999
21501216,1610612746,1610612763,110.0,84.0,0.547,0.407,1,2016-04-12,81,53,28,0.654,81,42,39,0.519
21501203,1610612739,1610612737,109.0,94.0,0.482,0.4479999999999999,1,2016-04-11,81,57,24,0.7040000000000001,81,48,33,0.593
21501204,1610612753,1610612749,107.0,98.0,0.488,0.526,1,2016-04-11,81,35,46,0.4320000000000001,81,33,48,0.407
21501205,1610612738,1610612766,100.0,114.0,0.382,0.506,0,2016-04-11,81,47,34,0.58,81,47,34,0.58
21501206,1610612751,1610612764,111.0,120.0,0.449,0.517,0,2016-04-11,81,21,60,0.259,81,40,41,0.494
21501207,1610612750,1610612745,105.0,129.0,0.4579999999999999,0.5579999999999999,0,2016-04-11,81,28,53,0.346,81,40,41,0.494
21501208,1610612740,1610612741,116.0,121.0,0.513,0.5710000000000001,0,2016-04-11,81,30,51,0.37,81,41,40,0.506
21501209,1610612760,1610612747,112.0,79.0,0.4379999999999999,0.284,1,2016-04-11,81,55,26,0.679,81,16,65,0.198
21501210,1610612762,1610612742,92.0,101.0,0.455,0.444,0,2016-04-11,81,40,41,0.494,81,42,39,0.519
21501211,1610612756,1610612758,101.0,105.0,0.41,0.494,0,2016-04-11,81,22,59,0.272,81,33,48,0.407
21501194,1610612764,1610612766,113.0,98.0,0.525,0.346,1,2016-04-10,80,39,41,0.488,80,46,34,0.575
21501195,1610612745,1610612747,130.0,110.0,0.51,0.494,1,2016-04-10,80,39,41,0.488,80,16,64,0.2
21501196,1610612746,1610612742,98.0,91.0,0.487,0.405,1,2016-04-10,80,52,28,0.65,80,41,39,0.513
21501197,1610612755,1610612749,108.0,109.0,0.406,0.46,0,2016-04-10,80,10,70,0.125,80,33,47,0.413
21501198,1610612743,1610612762,84.0,100.0,0.4,0.456,0,2016-04-10,81,33,48,0.407,80,40,40,0.5
21501199,1610612754,1610612751,129.0,105.0,0.5579999999999999,0.385,1,2016-04-10,80,43,37,0.5379999999999999,80,21,59,0.263
21501200,1610612748,1610612753,118.0,96.0,0.5579999999999999,0.446,1,2016-04-10,80,47,33,0.588,80,34,46,0.425
21501201,1610612759,1610612744,86.0,92.0,0.3779999999999999,0.442,0,2016-04-10,80,65,15,0.813,81,72,9,0.889
21501202,1610612752,1610612761,89.0,93.0,0.36,0.474,0,2016-04-10,81,32,49,0.395,80,54,26,0.675
21501189,1610612740,1610612756,100.0,121.0,0.411,0.518,0,2016-04-09,80,30,50,0.375,80,22,58,0.275
21501188,1610612737,1610612738,118.0,107.0,0.523,0.444,1,2016-04-09,80,48,32,0.6,80,47,33,0.588
21501190,1610612763,1610612744,99.0,100.0,0.385,0.4479999999999999,0,2016-04-09,80,42,38,0.525,80,71,9,0.888
21501191,1610612741,1610612739,105.0,102.0,0.449,0.434,1,2016-04-09,80,40,40,0.5,80,56,24,0.7
21501192,1610612757,1610612750,105.0,106.0,0.5,0.488,0,2016-04-09,81,43,38,0.531,80,28,52,0.35
21501193,1610612758,1610612760,114.0,112.0,0.479,0.481,1,2016-04-09,80,32,48,0.4,80,54,26,0.675
21501178,1610612766,1610612751,113.0,99.0,0.494,0.424,1,2016-04-08,79,46,33,0.5820000000000001,79,21,58,0.266
21501179,1610612753,1610612748,112.0,109.0,0.524,0.45,1,2016-04-08,79,34,45,0.43,79,46,33,0.5820000000000001
21501180,1610612755,1610612752,102.0,109.0,0.352,0.473,0,2016-04-08,79,10,69,0.127,80,32,48,0.4
21501181,1610612738,1610612749,124.0,109.0,0.564,0.488,1,2016-04-08,79,47,32,0.595,79,32,47,0.405
21501182,1610612765,1610612764,112.0,99.0,0.4679999999999999,0.442,1,2016-04-08,80,43,37,0.5379999999999999,79,38,41,0.481
21501183,1610612761,1610612754,111.0,98.0,0.544,0.446,1,2016-04-08,79,53,26,0.6709999999999999,79,42,37,0.532
21501184,1610612740,1610612747,110.0,102.0,0.532,0.42,1,2016-04-08,79,30,49,0.38,79,16,63,0.203
21501185,1610612742,1610612763,103.0,93.0,0.5,0.402,1,2016-04-08,79,41,38,0.519,79,42,37,0.532
21501186,1610612743,1610612759,102.0,98.0,0.465,0.424,1,2016-04-08,80,33,47,0.413,79,65,14,0.823
21501187,1610612762,1610612746,99.0,102.0,0.439,0.446,0,2016-04-08,79,39,40,0.494,79,51,28,0.6459999999999999
21501173,1610612737,1610612761,95.0,87.0,0.434,0.381,1,2016-04-07,79,47,32,0.595,78,52,26,0.667
21501174,1610612748,1610612741,106.0,98.0,0.478,0.449,1,2016-04-07,78,46,32,0.59,79,39,40,0.494
21501175,1610612745,1610612756,115.0,124.0,0.568,0.4679999999999999,0,2016-04-07,79,38,41,0.481,79,21,58,0.266
21501176,1610612758,1610612750,97.0,105.0,0.424,0.45,0,2016-04-07,79,31,48,0.392,79,27,52,0.342
21501177,1610612744,1610612759,112.0,101.0,0.542,0.488,1,2016-04-07,79,70,9,0.8859999999999999,78,65,13,0.833
21501165,1610612754,1610612739,123.0,109.0,0.563,0.473,1,2016-04-06,78,42,36,0.5379999999999999,79,56,23,0.7090000000000001
21501166,1610612753,1610612765,104.0,108.0,0.478,0.4529999999999999,0,2016-04-06,78,33,45,0.423,79,42,37,0.532
21501167,1610612764,1610612751,121.0,103.0,0.505,0.424,1,2016-04-06,78,38,40,0.487,78,21,57,0.2689999999999999
21501168,1610612738,1610612740,104.0,97.0,0.414,0.436,1,2016-04-06,78,46,32,0.59,78,29,49,0.3720000000000001
21501169,1610612752,1610612766,97.0,111.0,0.474,0.467,0,2016-04-06,79,31,48,0.392,78,45,33,0.5770000000000001
21501170,1610612742,1610612745,88.0,86.0,0.413,0.436,1,2016-04-06,78,40,38,0.513,78,38,40,0.487
21501171,1610612757,1610612760,120.0,115.0,0.512,0.473,1,2016-04-06,80,43,37,0.5379999999999999,79,54,25,0.684
21501172,1610612747,1610612746,81.0,91.0,0.356,0.446,0,2016-04-06,78,16,62,0.205,78,50,28,0.6409999999999999
21501154,1610612755,1610612740,107.0,93.0,0.455,0.451,1,2016-04-05,78,10,68,0.128,77,29,48,0.377
21501156,1610612761,1610612766,96.0,90.0,0.436,0.364,1,2016-04-05,77,52,25,0.675,77,44,33,0.5710000000000001
21501155,1610612748,1610612765,107.0,89.0,0.524,0.4,1,2016-04-05,77,45,32,0.584,78,41,37,0.526
21501157,1610612737,1610612756,103.0,90.0,0.411,0.37,1,2016-04-05,78,46,32,0.59,78,20,58,0.256
21501158,1610612763,1610612741,108.0,92.0,0.4479999999999999,0.442,1,2016-04-05,78,42,36,0.5379999999999999,78,39,39,0.5
21501159,1610612749,1610612739,80.0,109.0,0.3979999999999999,0.547,0,2016-04-05,78,32,46,0.41,78,56,22,0.718
21501160,1610612743,1610612760,102.0,124.0,0.42,0.529,0,2016-04-05,79,32,47,0.405,78,54,24,0.6920000000000001
21501161,1610612762,1610612759,86.0,88.0,0.471,0.444,0,2016-04-05,78,39,39,0.5,77,65,12,0.8440000000000001
21501162,1610612758,1610612757,107.0,115.0,0.526,0.43,0,2016-04-05,78,31,47,0.397,79,42,37,0.532
21501163,1610612744,1610612750,117.0,124.0,0.5,0.512,0,2016-04-05,78,69,9,0.885,78,26,52,0.3329999999999999
21501164,1610612746,1610612747,103.0,81.0,0.513,0.313,1,2016-04-05,77,49,28,0.636,77,16,61,0.208
21501143,1610612751,1610612740,87.0,106.0,0.3879999999999999,0.5529999999999999,0,2016-04-03,77,21,56,0.273,76,29,47,0.382
21501144,1610612739,1610612766,112.0,103.0,0.542,0.447,1,2016-04-03,77,55,22,0.7140000000000001,76,44,32,0.579
21501145,1610612745,1610612760,118.0,110.0,0.402,0.4629999999999999,1,2016-04-03,77,38,39,0.494,77,53,24,0.688
21501146,1610612750,1610612742,78.0,88.0,0.408,0.386,0,2016-04-03,77,25,52,0.325,77,39,38,0.506
21501147,1610612746,1610612764,114.0,109.0,0.506,0.457,1,2016-04-03,76,48,28,0.632,77,37,40,0.481
21501148,1610612753,1610612763,119.0,107.0,0.478,0.461,1,2016-04-03,77,33,44,0.429,77,41,36,0.532
21501149,1610612756,1610612762,86.0,101.0,0.423,0.481,0,2016-04-03,77,20,57,0.26,77,39,38,0.506
21501150,1610612749,1610612741,98.0,102.0,0.471,0.527,0,2016-04-03,77,32,45,0.416,77,39,38,0.506
21501151,1610612752,1610612754,87.0,92.0,0.344,0.42,0,2016-04-03,78,31,47,0.397,77,41,36,0.532
21501152,1610612744,1610612757,136.0,111.0,0.568,0.447,1,2016-04-03,77,69,8,0.8959999999999999,78,41,37,0.526
21501153,1610612747,1610612738,100.0,107.0,0.411,0.451,0,2016-04-03,76,16,60,0.211,77,45,32,0.584
21501138,1610612755,1610612754,102.0,115.0,0.41,0.524,0,2016-04-02,77,9,68,0.1169999999999999,76,40,36,0.526
21501139,1610612741,1610612765,90.0,94.0,0.386,0.421,0,2016-04-02,76,38,38,0.5,77,41,36,0.532
21501140,1610612759,1610612761,102.0,95.0,0.455,0.5,1,2016-04-02,76,64,12,0.8420000000000001,76,51,25,0.6709999999999999
21501141,1610612743,1610612758,106.0,115.0,0.435,0.466,0,2016-04-02,78,32,46,0.41,77,31,46,0.4029999999999999
21501142,1610612757,1610612748,110.0,93.0,0.519,0.386,1,2016-04-02,77,41,36,0.532,76,44,32,0.579
21501128,1610612766,1610612755,100.0,91.0,0.429,0.3670000000000001,1,2016-04-01,75,44,31,0.5870000000000001,76,9,67,0.118
21501129,1610612765,1610612742,89.0,98.0,0.3829999999999999,0.4589999999999999,0,2016-04-01,76,40,36,0.526,76,38,38,0.5
21501130,1610612752,1610612751,105.0,91.0,0.5,0.356,1,2016-04-01,77,31,46,0.4029999999999999,76,21,55,0.276
21501131,1610612737,1610612739,108.0,110.0,0.4,0.3979999999999999,0,2016-04-01,77,45,32,0.584,76,54,22,0.711
21501132,1610612763,1610612761,95.0,99.0,0.407,0.423,0,2016-04-01,76,41,35,0.539,75,51,24,0.68
21501133,1610612749,1610612753,113.0,110.0,0.547,0.535,1,2016-04-01,76,32,44,0.421,76,32,44,0.421
21501134,1610612762,1610612750,98.0,85.0,0.528,0.4429999999999999,1,2016-04-01,76,38,38,0.5,76,25,51,0.3289999999999999
21501135,1610612758,1610612748,106.0,112.0,0.4370000000000001,0.512,0,2016-04-01,76,30,46,0.395,75,44,31,0.5870000000000001
21501136,1610612744,1610612738,106.0,109.0,0.4579999999999999,0.471,0,2016-04-01,76,68,8,0.895,76,44,32,0.579
21501137,1610612756,1610612764,99.0,106.0,0.387,0.442,0,2016-04-01,76,20,56,0.263,76,37,39,0.487
21501122,1610612739,1610612751,107.0,87.0,0.4370000000000001,0.3720000000000001,1,2016-03-31,75,53,22,0.7070000000000001,75,21,54,0.28
21501123,1610612754,1610612753,94.0,114.0,0.419,0.5329999999999999,0,2016-03-31,75,39,36,0.52,75,32,43,0.4270000000000001
21501124,1610612745,1610612741,100.0,103.0,0.4,0.481,0,2016-03-31,76,37,39,0.487,75,38,37,0.507
21501125,1610612740,1610612743,101.0,95.0,0.444,0.434,1,2016-03-31,75,28,47,0.373,77,32,45,0.416
21501126,1610612760,1610612746,119.0,117.0,0.517,0.5529999999999999,1,2016-03-31,76,53,23,0.6970000000000001,75,47,28,0.627
21501127,1610612757,1610612738,116.0,109.0,0.456,0.42,1,2016-03-31,76,40,36,0.526,75,43,32,0.573
21501113,1610612761,1610612737,105.0,97.0,0.45,0.446,1,2016-03-30,74,50,24,0.6759999999999999,76,45,31,0.5920000000000001
21501114,1610612763,1610612743,105.0,109.0,0.4320000000000001,0.487,0,2016-03-30,75,41,34,0.547,76,32,44,0.421
21501115,1610612749,1610612756,105.0,94.0,0.481,0.452,1,2016-03-30,75,31,44,0.413,75,20,55,0.267
21501116,1610612750,1610612746,79.0,99.0,0.345,0.44,0,2016-03-30,75,25,50,0.3329999999999999,74,47,27,0.635
21501117,1610612742,1610612752,91.0,89.0,0.412,0.455,1,2016-03-30,75,37,38,0.493,76,30,46,0.395
21501118,1610612759,1610612740,100.0,92.0,0.48,0.45,1,2016-03-30,75,63,12,0.84,74,27,47,0.365
21501119,1610612762,1610612744,96.0,103.0,0.402,0.4379999999999999,0,2016-03-30,75,37,38,0.493,75,68,7,0.907
21501120,1610612758,1610612764,120.0,111.0,0.56,0.483,1,2016-03-30,75,30,45,0.4,75,36,39,0.48
21501121,1610612747,1610612748,102.0,100.0,0.363,0.477,1,2016-03-30,75,16,59,0.213,74,43,31,0.581
21501107,1610612754,1610612741,96.0,98.0,0.433,0.425,0,2016-03-29,74,39,35,0.527,74,37,37,0.5
21501108,1610612753,1610612751,139.0,105.0,0.615,0.4679999999999999,1,2016-03-29,74,31,43,0.419,74,21,53,0.284
21501109,1610612755,1610612766,85.0,100.0,0.313,0.4370000000000001,0,2016-03-29,75,9,66,0.12,74,43,31,0.581
21501110,1610612765,1610612760,88.0,82.0,0.379,0.3779999999999999,1,2016-03-29,75,40,35,0.5329999999999999,75,52,23,0.693
21501111,1610612739,1610612745,100.0,106.0,0.36,0.481,0,2016-03-29,74,52,22,0.703,75,37,38,0.493
21501112,1610612744,1610612764,102.0,94.0,0.4370000000000001,0.419,1,2016-03-29,74,67,7,0.905,74,36,38,0.486
21501097,1610612748,1610612751,110.0,99.0,0.5710000000000001,0.532,1,2016-03-28,73,43,30,0.589,73,21,52,0.288
21501098,1610612761,1610612760,100.0,119.0,0.409,0.477,0,2016-03-28,73,49,24,0.6709999999999999,74,52,22,0.703
21501099,1610612741,1610612737,100.0,102.0,0.377,0.424,0,2016-03-28,73,36,37,0.493,75,45,30,0.6
21501100,1610612763,1610612759,87.0,101.0,0.3979999999999999,0.514,0,2016-03-28,74,41,33,0.5539999999999999,74,62,12,0.838
21501101,1610612750,1610612756,121.0,116.0,0.506,0.488,1,2016-03-28,74,25,49,0.3379999999999999,74,20,54,0.27
21501102,1610612740,1610612752,99.0,91.0,0.4270000000000001,0.4039999999999999,1,2016-03-28,73,27,46,0.37,75,30,45,0.4
21501103,1610612743,1610612742,88.0,97.0,0.4429999999999999,0.409,0,2016-03-28,75,31,44,0.413,74,36,38,0.486
21501104,1610612762,1610612747,123.0,75.0,0.517,0.306,1,2016-03-28,74,37,37,0.5,74,15,59,0.203
21501105,1610612757,1610612758,105.0,93.0,0.475,0.416,1,2016-03-28,75,39,36,0.52,74,29,45,0.392
21501106,1610612746,1610612738,114.0,90.0,0.524,0.348,1,2016-03-28,73,46,27,0.63,74,43,31,0.581
21501092,1610612746,1610612743,105.0,90.0,0.475,0.3939999999999999,1,2016-03-27,72,45,27,0.625,74,31,43,0.419
21501093,1610612754,1610612745,104.0,101.0,0.471,0.447,1,2016-03-27,73,39,34,0.534,74,36,38,0.486
21501095,1610612758,1610612742,133.0,111.0,0.622,0.477,1,2016-03-27,73,29,44,0.397,73,35,38,0.479
21501094,1610612744,1610612755,117.0,105.0,0.53,0.467,1,2016-03-27,73,66,7,0.904,74,9,65,0.122
21501096,1610612747,1610612764,88.0,101.0,0.379,0.542,0,2016-03-27,73,15,58,0.205,73,36,37,0.493
21501082,1610612751,1610612754,120.0,110.0,0.545,0.481,1,2016-03-26,72,21,51,0.292,72,38,34,0.528
21501083,1610612753,1610612741,111.0,89.0,0.539,0.409,1,2016-03-26,73,30,43,0.411,72,36,36,0.5
21501084,1610612740,1610612761,91.0,115.0,0.435,0.534,0,2016-03-26,72,26,46,0.361,72,49,23,0.6809999999999999
21501085,1610612765,1610612737,95.0,112.0,0.386,0.4529999999999999,0,2016-03-26,74,39,35,0.527,74,44,30,0.595
21501086,1610612752,1610612739,93.0,107.0,0.418,0.446,0,2016-03-26,74,30,44,0.405,73,52,21,0.7120000000000001
21501087,1610612750,1610612762,84.0,93.0,0.381,0.47,0,2016-03-26,73,24,49,0.3289999999999999,73,36,37,0.493
21501088,1610612760,1610612759,111.0,92.0,0.518,0.43,1,2016-03-26,73,51,22,0.6990000000000001,73,61,12,0.836
21501089,1610612749,1610612766,91.0,115.0,0.44,0.5539999999999999,0,2016-03-26,74,30,44,0.405,73,42,31,0.575
21501090,1610612756,1610612738,99.0,102.0,0.435,0.417,0,2016-03-26,73,20,53,0.2739999999999999,73,43,30,0.589
21501091,1610612757,1610612755,108.0,105.0,0.418,0.419,1,2016-03-26,74,38,36,0.514,73,9,64,0.123
21501073,1610612764,1610612750,129.0,132.0,0.5,0.531,0,2016-03-25,72,35,37,0.486,72,24,48,0.3329999999999999
21501074,1610612765,1610612766,112.0,105.0,0.462,0.3979999999999999,1,2016-03-25,73,39,34,0.534,72,41,31,0.569
21501075,1610612748,1610612753,108.0,97.0,0.5,0.429,1,2016-03-25,72,42,30,0.583,72,29,43,0.4029999999999999
21501076,1610612737,1610612749,101.0,90.0,0.423,0.417,1,2016-03-25,73,43,30,0.589,73,30,43,0.411
21501077,1610612745,1610612761,112.0,109.0,0.519,0.415,1,2016-03-25,73,36,37,0.493,71,48,23,0.6759999999999999
21501078,1610612759,1610612763,110.0,104.0,0.5710000000000001,0.53,1,2016-03-25,72,61,11,0.847,73,41,32,0.562
21501079,1610612758,1610612756,116.0,94.0,0.444,0.3720000000000001,1,2016-03-25,72,28,44,0.389,72,20,52,0.278
21501080,1610612744,1610612742,128.0,120.0,0.489,0.4479999999999999,1,2016-03-25,72,65,7,0.903,72,35,37,0.486
21501081,1610612747,1610612743,105.0,116.0,0.435,0.479,0,2016-03-25,72,15,57,0.208,73,31,42,0.425
21501068,1610612754,1610612740,92.0,84.0,0.456,0.412,1,2016-03-24,71,38,33,0.535,71,26,45,0.366
21501069,1610612751,1610612739,104.0,95.0,0.461,0.4379999999999999,1,2016-03-24,71,20,51,0.282,72,51,21,0.708
21501070,1610612752,1610612741,106.0,94.0,0.513,0.416,1,2016-03-24,73,30,43,0.411,71,36,35,0.507
21501071,1610612760,1610612762,113.0,91.0,0.542,0.479,1,2016-03-24,72,50,22,0.6940000000000001,72,35,37,0.486
21501072,1610612746,1610612757,96.0,94.0,0.451,0.4,1,2016-03-24,71,44,27,0.62,73,37,36,0.507
21501056,1610612764,1610612737,101.0,122.0,0.424,0.536,0,2016-03-23,71,35,36,0.493,72,42,30,0.583
21501059,1610612739,1610612749,113.0,104.0,0.482,0.5379999999999999,1,2016-03-23,71,51,20,0.718,72,30,42,0.417
21501057,1610612738,1610612761,91.0,79.0,0.4379999999999999,0.348,1,2016-03-23,72,42,30,0.583,70,48,22,0.6859999999999999
21501058,1610612765,1610612753,118.0,102.0,0.5379999999999999,0.3979999999999999,1,2016-03-23,72,38,34,0.528,71,29,42,0.408
21501060,1610612741,1610612752,107.0,115.0,0.4629999999999999,0.517,0,2016-03-23,70,36,34,0.514,72,29,43,0.4029999999999999
21501061,1610612745,1610612762,87.0,89.0,0.446,0.4029999999999999,0,2016-03-23,72,35,37,0.486,71,35,36,0.493
21501062,1610612750,1610612758,113.0,104.0,0.563,0.462,1,2016-03-23,71,23,48,0.324,71,27,44,0.38
21501063,1610612759,1610612748,112.0,88.0,0.519,0.481,1,2016-03-23,71,60,11,0.845,71,41,30,0.5770000000000001
21501064,1610612743,1610612755,104.0,103.0,0.434,0.3939999999999999,1,2016-03-23,72,30,42,0.417,72,9,63,0.125
21501065,1610612756,1610612747,119.0,107.0,0.505,0.419,1,2016-03-23,71,20,51,0.282,71,15,56,0.211
21501067,1610612757,1610612742,109.0,103.0,0.449,0.4379999999999999,1,2016-03-23,72,37,35,0.514,71,35,36,0.493
21501066,1610612744,1610612746,114.0,98.0,0.4479999999999999,0.424,1,2016-03-23,71,64,7,0.901,70,43,27,0.614
21501052,1610612751,1610612766,100.0,105.0,0.4589999999999999,0.476,0,2016-03-22,70,19,51,0.271,71,41,30,0.5770000000000001
21501053,1610612740,1610612748,99.0,113.0,0.391,0.5,0,2016-03-22,70,26,44,0.371,70,41,29,0.586
21501054,1610612760,1610612745,111.0,107.0,0.451,0.435,1,2016-03-22,71,49,22,0.69,71,35,36,0.493
21501055,1610612747,1610612763,107.0,100.0,0.506,0.5,1,2016-03-22,70,15,55,0.214,72,41,31,0.569
21501043,1610612766,1610612759,91.0,88.0,0.402,0.43,1,2016-03-21,70,40,30,0.5710000000000001,70,59,11,0.843
21501044,1610612739,1610612743,124.0,91.0,0.5579999999999999,0.395,1,2016-03-21,70,50,20,0.7140000000000001,71,29,42,0.408
21501045,1610612754,1610612755,91.0,75.0,0.4320000000000001,0.3879999999999999,1,2016-03-21,70,37,33,0.529,71,9,62,0.127
21501046,1610612738,1610612753,107.0,96.0,0.471,0.419,1,2016-03-21,71,41,30,0.5770000000000001,70,29,41,0.414
21501047,1610612765,1610612749,92.0,91.0,0.412,0.539,1,2016-03-21,71,37,34,0.521,71,30,41,0.423
21501048,1610612737,1610612764,102.0,117.0,0.487,0.505,0,2016-03-21,71,41,30,0.5770000000000001,70,35,35,0.5
21501049,1610612741,1610612758,109.0,102.0,0.451,0.455,1,2016-03-21,69,36,33,0.522,70,27,43,0.386
21501050,1610612750,1610612744,104.0,109.0,0.439,0.494,0,2016-03-21,70,22,48,0.314,70,63,7,0.9
21501051,1610612756,1610612763,97.0,103.0,0.395,0.433,0,2016-03-21,70,19,51,0.271,71,41,30,0.5770000000000001
21501037,1610612742,1610612757,132.0,120.0,0.551,0.4039999999999999,1,2016-03-20,70,35,35,0.5,71,36,35,0.507
21501038,1610612761,1610612753,105.0,100.0,0.4320000000000001,0.482,1,2016-03-20,69,48,21,0.696,69,29,40,0.42
21501039,1610612755,1610612738,105.0,120.0,0.424,0.489,0,2016-03-20,70,9,61,0.129,70,40,30,0.5710000000000001
21501040,1610612740,1610612746,109.0,105.0,0.493,0.402,1,2016-03-20,69,26,43,0.377,69,43,26,0.623
21501041,1610612749,1610612762,85.0,94.0,0.523,0.41,0,2016-03-20,70,30,40,0.429,70,34,36,0.486
21501042,1610612752,1610612758,80.0,88.0,0.352,0.3979999999999999,0,2016-03-20,71,28,43,0.3939999999999999,69,27,42,0.391
21501028,1610612766,1610612743,93.0,101.0,0.422,0.4370000000000001,0,2016-03-19,69,39,30,0.565,70,29,41,0.414
21501030,1610612765,1610612751,115.0,103.0,0.489,0.525,1,2016-03-19,70,36,34,0.514,69,19,50,0.275
21501031,1610612754,1610612760,111.0,115.0,0.482,0.525,0,2016-03-19,69,36,33,0.522,70,48,22,0.6859999999999999
21501032,1610612764,1610612752,99.0,89.0,0.4479999999999999,0.395,1,2016-03-19,69,34,35,0.493,70,28,42,0.4
21501029,1610612737,1610612745,109.0,97.0,0.5,0.3929999999999999,1,2016-03-19,70,41,29,0.586,70,35,35,0.5
21501033,1610612748,1610612739,122.0,101.0,0.5479999999999999,0.526,1,2016-03-19,69,40,29,0.58,69,49,20,0.71
21501034,1610612741,1610612762,92.0,85.0,0.488,0.407,1,2016-03-19,68,35,33,0.515,69,33,36,0.478
21501035,1610612763,1610612746,113.0,102.0,0.488,0.47,1,2016-03-19,70,40,30,0.5710000000000001,68,43,25,0.632
21501036,1610612759,1610612744,87.0,79.0,0.41,0.3779999999999999,1,2016-03-19,69,59,10,0.855,69,62,7,0.899
21501020,1610612753,1610612739,103.0,109.0,0.451,0.5,0,2016-03-18,68,29,39,0.426,68,49,19,0.721
21501021,1610612755,1610612760,97.0,111.0,0.3929999999999999,0.506,0,2016-03-18,69,9,60,0.13,69,47,22,0.6809999999999999
21501022,1610612765,1610612758,115.0,108.0,0.478,0.506,1,2016-03-18,69,35,34,0.507,68,26,42,0.382
21501023,1610612761,1610612738,105.0,91.0,0.481,0.439,1,2016-03-18,68,47,21,0.691,69,39,30,0.565
21501024,1610612745,1610612750,116.0,111.0,0.565,0.506,1,2016-03-18,69,35,34,0.507,69,22,47,0.319
21501025,1610612740,1610612757,112.0,117.0,0.482,0.462,0,2016-03-18,68,25,43,0.368,70,36,34,0.514
21501026,1610612742,1610612744,112.0,130.0,0.441,0.505,0,2016-03-18,69,34,35,0.493,68,62,6,0.912
21501027,1610612747,1610612756,90.0,95.0,0.36,0.36,0,2016-03-18,69,14,55,0.203,69,19,50,0.275
21501012,1610612754,1610612761,94.0,101.0,0.385,0.364,0,2016-03-17,68,36,32,0.529,67,46,21,0.687
21501013,1610612755,1610612764,94.0,99.0,0.385,0.444,0,2016-03-17,68,9,59,0.132,68,33,35,0.485
21501014,1610612748,1610612766,106.0,109.0,0.5329999999999999,0.465,0,2016-03-17,68,39,29,0.574,68,39,29,0.574
21501015,1610612737,1610612743,116.0,98.0,0.5,0.4479999999999999,1,2016-03-17,69,40,29,0.58,69,28,41,0.406
21501016,1610612741,1610612751,118.0,102.0,0.489,0.465,1,2016-03-17,67,34,33,0.507,68,19,49,0.2789999999999999
21501017,1610612749,1610612763,96.0,86.0,0.493,0.37,1,2016-03-17,69,30,39,0.435,69,39,30,0.565
21501018,1610612759,1610612757,118.0,110.0,0.523,0.4379999999999999,1,2016-03-17,68,58,10,0.853,69,35,34,0.507
21501019,1610612762,1610612756,103.0,69.0,0.489,0.341,1,2016-03-17,68,33,35,0.485,68,18,50,0.265
21501003,1610612738,1610612760,109.0,130.0,0.43,0.49,0,2016-03-16,68,39,29,0.574,68,46,22,0.6759999999999999
21501004,1610612766,1610612753,107.0,99.0,0.4,0.422,1,2016-03-16,67,38,29,0.5670000000000001,67,29,38,0.433
21501005,1610612739,1610612742,99.0,98.0,0.4429999999999999,0.4679999999999999,1,2016-03-16,67,48,19,0.716,68,34,34,0.5
21501006,1610612764,1610612741,117.0,96.0,0.489,0.402,1,2016-03-16,67,32,35,0.478,66,33,33,0.5
21501007,1610612765,1610612737,114.0,118.0,0.4639999999999999,0.4379999999999999,0,2016-03-16,68,34,34,0.5,68,39,29,0.574
21501008,1610612763,1610612750,108.0,114.0,0.44,0.563,0,2016-03-16,68,39,29,0.574,68,22,46,0.324
21501009,1610612745,1610612746,106.0,122.0,0.488,0.5660000000000001,0,2016-03-16,68,34,34,0.5,67,43,24,0.642
21501010,1610612758,1610612740,108.0,123.0,0.467,0.544,0,2016-03-16,67,26,41,0.3879999999999999,67,25,42,0.373
21501011,1610612744,1610612752,121.0,85.0,0.505,0.396,1,2016-03-16,67,61,6,0.91,69,28,41,0.406
21500997,1610612754,1610612738,103.0,98.0,0.4639999999999999,0.3829999999999999,1,2016-03-15,67,36,31,0.537,67,39,28,0.5820000000000001
21500998,1610612753,1610612743,116.0,110.0,0.5429999999999999,0.5,1,2016-03-15,66,29,37,0.439,68,28,40,0.412
21500999,1610612751,1610612755,131.0,114.0,0.522,0.466,1,2016-03-15,67,19,48,0.284,67,9,58,0.134
21501000,1610612749,1610612761,89.0,107.0,0.442,0.47,0,2016-03-15,68,29,39,0.426,66,45,21,0.682
21501001,1610612759,1610612746,108.0,87.0,0.537,0.4639999999999999,1,2016-03-15,67,57,10,0.851,66,42,24,0.636
21501002,1610612747,1610612758,98.0,106.0,0.44,0.481,0,2016-03-15,68,14,54,0.206,66,26,40,0.3939999999999999
21500988,1610612766,1610612742,96.0,107.0,0.421,0.483,0,2016-03-14,66,37,29,0.561,67,34,33,0.507
21500990,1610612748,1610612743,124.0,119.0,0.595,0.527,1,2016-03-14,67,39,28,0.5820000000000001,67,28,39,0.418
21500991,1610612761,1610612741,107.0,109.0,0.446,0.494,0,2016-03-14,65,44,21,0.677,65,33,32,0.508
21500989,1610612764,1610612765,124.0,81.0,0.5670000000000001,0.405,1,2016-03-14,66,31,35,0.47,67,34,33,0.507
21500992,1610612745,1610612763,130.0,81.0,0.541,0.297,1,2016-03-14,67,34,33,0.507,67,39,28,0.5820000000000001
21500993,1610612760,1610612757,128.0,94.0,0.59,0.341,1,2016-03-14,67,45,22,0.672,68,35,33,0.515
21500995,1610612756,1610612750,107.0,104.0,0.421,0.44,1,2016-03-14,67,18,49,0.2689999999999999,67,21,46,0.313
21500994,1610612762,1610612739,94.0,85.0,0.493,0.3979999999999999,1,2016-03-14,67,32,35,0.478,66,47,19,0.7120000000000001
21500996,1610612744,1610612740,125.0,107.0,0.58,0.376,1,2016-03-14,66,60,6,0.909,66,24,42,0.364
21500983,1610612746,1610612739,90.0,114.0,0.405,0.488,0,2016-03-13,65,42,23,0.6459999999999999,65,47,18,0.723
21500984,1610612737,1610612754,104.0,75.0,0.471,0.379,1,2016-03-13,67,38,29,0.5670000000000001,66,35,31,0.53
21500986,1610612758,1610612762,99.0,108.0,0.469,0.476,0,2016-03-13,65,25,40,0.385,66,31,35,0.47
21500985,1610612751,1610612749,100.0,109.0,0.557,0.506,0,2016-03-13,66,18,48,0.273,67,29,38,0.433
21500987,1610612747,1610612752,87.0,90.0,0.4,0.44,0,2016-03-13,67,14,53,0.209,68,28,40,0.412
21500973,1610612742,1610612754,105.0,112.0,0.482,0.469,0,2016-03-12,66,33,33,0.5,65,35,30,0.5379999999999999
21500975,1610612766,1610612745,125.0,109.0,0.545,0.462,1,2016-03-12,65,37,28,0.569,66,33,33,0.5
21500976,1610612755,1610612765,111.0,125.0,0.4639999999999999,0.5379999999999999,0,2016-03-12,66,9,57,0.136,66,34,32,0.515
21500977,1610612761,1610612748,112.0,104.0,0.44,0.3779999999999999,1,2016-03-12,64,44,20,0.688,66,38,28,0.5760000000000001
21500974,1610612737,1610612763,95.0,83.0,0.429,0.347,1,2016-03-12,66,37,29,0.561,66,39,27,0.591
21500978,1610612749,1610612740,103.0,92.0,0.494,0.3929999999999999,1,2016-03-12,66,28,38,0.424,65,24,41,0.369
21500979,1610612759,1610612760,93.0,85.0,0.4,0.3829999999999999,1,2016-03-12,66,56,10,0.848,66,44,22,0.667
21500980,1610612743,1610612764,116.0,100.0,0.525,0.419,1,2016-03-12,66,28,38,0.424,65,30,35,0.462
21500981,1610612744,1610612756,123.0,116.0,0.5,0.489,1,2016-03-12,65,59,6,0.908,66,17,49,0.258
21500982,1610612757,1610612753,121.0,84.0,0.56,0.374,1,2016-03-12,67,35,32,0.522,65,28,37,0.431
21500963,1610612766,1610612765,118.0,103.0,0.506,0.474,1,2016-03-11,64,36,28,0.563,65,33,32,0.508
21500964,1610612755,1610612751,95.0,89.0,0.452,0.379,1,2016-03-11,65,9,56,0.138,65,18,47,0.2769999999999999
21500965,1610612738,1610612745,98.0,102.0,0.374,0.455,0,2016-03-11,66,39,27,0.591,65,33,32,0.508
21500966,1610612741,1610612748,96.0,118.0,0.469,0.516,0,2016-03-11,64,32,32,0.5,65,38,27,0.585
21500967,1610612763,1610612740,121.0,114.0,0.49,0.4379999999999999,1,2016-03-11,65,39,26,0.6,64,24,40,0.375
21500968,1610612760,1610612750,96.0,99.0,0.429,0.43,0,2016-03-11,65,44,21,0.677,66,21,45,0.318
21500969,1610612762,1610612764,114.0,93.0,0.5670000000000001,0.4379999999999999,1,2016-03-11,65,30,35,0.462,64,30,34,0.469
21500970,1610612758,1610612753,100.0,107.0,0.3979999999999999,0.519,0,2016-03-11,64,25,39,0.391,64,28,36,0.4379999999999999
21500971,1610612744,1610612757,128.0,112.0,0.449,0.43,1,2016-03-11,64,58,6,0.906,66,34,32,0.515
21500972,1610612746,1610612752,101.0,94.0,0.447,0.41,1,2016-03-11,64,42,22,0.6559999999999999,67,27,40,0.4029999999999999
21500959,1610612761,1610612737,104.0,96.0,0.4629999999999999,0.4270000000000001,1,2016-03-10,63,43,20,0.6829999999999999,65,36,29,0.5539999999999999
21500960,1610612759,1610612741,109.0,101.0,0.473,0.4529999999999999,1,2016-03-10,65,55,10,0.846,63,32,31,0.508
21500961,1610612743,1610612756,116.0,98.0,0.484,0.371,1,2016-03-10,65,27,38,0.415,65,17,48,0.262
21500962,1610612747,1610612739,108.0,120.0,0.525,0.529,0,2016-03-10,66,14,52,0.212,64,46,18,0.7190000000000001
21500950,1610612766,1610612740,122.0,113.0,0.4629999999999999,0.471,1,2016-03-09,63,35,28,0.556,63,24,39,0.381
21500951,1610612755,1610612745,104.0,118.0,0.407,0.442,0,2016-03-09,64,8,56,0.125,64,32,32,0.5
21500953,1610612738,1610612763,116.0,96.0,0.471,0.381,1,2016-03-09,65,39,26,0.6,64,38,26,0.594
21500952,1610612749,1610612748,114.0,108.0,0.525,0.525,1,2016-03-09,65,27,38,0.415,64,37,27,0.578
21500954,1610612742,1610612765,96.0,102.0,0.4529999999999999,0.447,0,2016-03-09,65,33,32,0.508,64,33,31,0.516
21500956,1610612756,1610612752,97.0,128.0,0.4379999999999999,0.561,0,2016-03-09,64,17,47,0.266,66,27,39,0.409
21500955,1610612760,1610612746,120.0,108.0,0.527,0.506,1,2016-03-09,64,44,20,0.688,63,41,22,0.6509999999999999
21500957,1610612758,1610612739,111.0,120.0,0.476,0.433,0,2016-03-09,63,25,38,0.397,63,45,18,0.7140000000000001
21500958,1610612744,1610612762,115.0,94.0,0.5710000000000001,0.405,1,2016-03-09,63,57,6,0.905,64,29,35,0.4529999999999999
21500944,1610612761,1610612751,104.0,99.0,0.474,0.512,1,2016-03-08,62,42,20,0.677,64,18,46,0.281
21500945,1610612750,1610612759,91.0,116.0,0.456,0.5529999999999999,0,2016-03-08,65,20,45,0.308,64,54,10,0.8440000000000001
21500946,1610612743,1610612752,110.0,94.0,0.455,0.44,1,2016-03-08,64,26,38,0.406,65,26,39,0.4
21500947,1610612762,1610612737,84.0,91.0,0.349,0.475,0,2016-03-08,63,29,34,0.46,64,36,28,0.563
21500948,1610612757,1610612764,116.0,109.0,0.461,0.455,1,2016-03-08,65,34,31,0.523,63,30,33,0.476
21500949,1610612747,1610612753,107.0,98.0,0.494,0.487,1,2016-03-08,65,14,51,0.215,63,27,36,0.429
21500937,1610612766,1610612750,108.0,103.0,0.456,0.488,1,2016-03-07,62,34,28,0.5479999999999999,64,20,44,0.313
21500938,1610612739,1610612763,103.0,106.0,0.45,0.477,0,2016-03-07,62,44,18,0.71,63,38,25,0.603
21500939,1610612754,1610612759,99.0,91.0,0.41,0.354,1,2016-03-07,64,34,30,0.531,63,53,10,0.841
21500940,1610612741,1610612749,100.0,90.0,0.5,0.396,1,2016-03-07,62,32,30,0.516,64,26,38,0.406
21500941,1610612740,1610612758,115.0,112.0,0.479,0.494,1,2016-03-07,62,24,38,0.387,62,25,37,0.4029999999999999
21500942,1610612742,1610612746,90.0,109.0,0.37,0.47,0,2016-03-07,64,33,31,0.516,62,41,21,0.6609999999999999
21500943,1610612744,1610612753,119.0,113.0,0.5,0.444,1,2016-03-07,62,56,6,0.903,62,27,35,0.435
21500930,1610612749,1610612760,96.0,104.0,0.3779999999999999,0.421,0,2016-03-06,63,26,37,0.413,63,43,20,0.6829999999999999
21500931,1610612747,1610612744,112.0,95.0,0.471,0.402,1,2016-03-06,64,13,51,0.203,61,55,6,0.902
21500932,1610612763,1610612756,100.0,109.0,0.4,0.521,0,2016-03-06,62,37,25,0.597,63,17,46,0.27
21500933,1610612743,1610612742,116.0,114.0,0.411,0.441,1,2016-03-06,63,25,38,0.397,63,33,30,0.524
21500934,1610612765,1610612757,123.0,103.0,0.524,0.449,1,2016-03-06,63,32,31,0.508,64,33,31,0.516
21500935,1610612748,1610612755,103.0,98.0,0.444,0.435,1,2016-03-06,63,37,26,0.5870000000000001,63,8,55,0.127
21500936,1610612761,1610612745,107.0,113.0,0.481,0.487,0,2016-03-06,61,41,20,0.672,63,31,32,0.4920000000000001
21500922,1610612739,1610612738,120.0,103.0,0.512,0.4629999999999999,1,2016-03-05,61,44,17,0.721,64,38,26,0.594
21500923,1610612752,1610612765,102.0,89.0,0.532,0.391,1,2016-03-05,64,26,38,0.406,62,31,31,0.5
21500924,1610612764,1610612754,99.0,100.0,0.4379999999999999,0.446,0,2016-03-05,62,30,32,0.484,63,33,30,0.524
21500925,1610612740,1610612762,94.0,106.0,0.413,0.474,0,2016-03-05,61,23,38,0.377,62,29,33,0.4679999999999999
21500926,1610612750,1610612751,132.0,118.0,0.684,0.489,1,2016-03-05,63,20,43,0.317,63,18,45,0.286
21500927,1610612741,1610612745,108.0,100.0,0.456,0.402,1,2016-03-05,61,31,30,0.508,62,30,32,0.484
21500928,1610612759,1610612758,104.0,94.0,0.494,0.457,1,2016-03-05,62,53,9,0.855,61,25,36,0.41
21500929,1610612746,1610612737,97.0,107.0,0.43,0.449,0,2016-03-05,61,40,21,0.6559999999999999,63,35,28,0.556
21500912,1610612766,1610612754,108.0,101.0,0.481,0.411,1,2016-03-04,61,33,28,0.541,62,32,30,0.516
21500913,1610612753,1610612756,84.0,102.0,0.347,0.449,0,2016-03-04,61,27,34,0.4429999999999999,62,16,46,0.258
21500914,1610612755,1610612748,102.0,112.0,0.379,0.4429999999999999,0,2016-03-04,62,8,54,0.129,62,36,26,0.581
21500915,1610612738,1610612752,105.0,104.0,0.456,0.457,1,2016-03-04,63,38,25,0.603,63,25,38,0.397
21500916,1610612761,1610612757,117.0,115.0,0.507,0.47,1,2016-03-04,60,41,19,0.6829999999999999,63,33,30,0.524
21500917,1610612739,1610612764,108.0,83.0,0.467,0.395,1,2016-03-04,60,43,17,0.7170000000000001,61,30,31,0.4920000000000001
21500918,1610612763,1610612762,94.0,88.0,0.457,0.4270000000000001,1,2016-03-04,61,37,24,0.607,61,28,33,0.4589999999999999
21500919,1610612749,1610612750,116.0,101.0,0.518,0.483,1,2016-03-04,62,26,36,0.419,62,19,43,0.306
21500920,1610612743,1610612751,120.0,121.0,0.479,0.505,0,2016-03-04,62,24,38,0.387,62,18,44,0.29
21500921,1610612747,1610612737,77.0,106.0,0.341,0.544,0,2016-03-04,63,12,51,0.19,62,34,28,0.5479999999999999
21500908,1610612748,1610612756,108.0,92.0,0.482,0.402,1,2016-03-03,61,35,26,0.574,61,15,46,0.246
21500909,1610612740,1610612759,86.0,94.0,0.3929999999999999,0.444,0,2016-03-03,60,23,37,0.3829999999999999,61,52,9,0.852
21500910,1610612742,1610612758,101.0,104.0,0.479,0.525,0,2016-03-03,62,33,29,0.532,60,25,35,0.417
21500911,1610612744,1610612760,121.0,106.0,0.54,0.465,1,2016-03-03,60,55,5,0.917,62,42,20,0.677
21500897,1610612753,1610612741,102.0,89.0,0.402,0.384,1,2016-03-02,60,27,33,0.45,60,30,30,0.5
21500898,1610612755,1610612766,99.0,119.0,0.4,0.494,0,2016-03-02,61,8,53,0.131,60,32,28,0.5329999999999999
21500899,1610612738,1610612757,116.0,93.0,0.402,0.405,1,2016-03-02,62,37,25,0.597,62,33,29,0.532
21500900,1610612761,1610612762,104.0,94.0,0.5,0.446,1,2016-03-02,59,40,19,0.6779999999999999,60,28,32,0.467
21500901,1610612745,1610612740,100.0,95.0,0.444,0.4,1,2016-03-02,61,30,31,0.4920000000000001,59,23,36,0.39
21500902,1610612763,1610612758,104.0,98.0,0.4429999999999999,0.476,1,2016-03-02,60,36,24,0.6,59,24,35,0.407
21500903,1610612749,1610612754,99.0,104.0,0.447,0.475,0,2016-03-02,61,25,36,0.41,61,32,29,0.525
21500904,1610612750,1610612764,98.0,104.0,0.4270000000000001,0.5,0,2016-03-02,61,19,42,0.311,60,30,30,0.5
21500905,1610612759,1610612765,97.0,81.0,0.512,0.397,1,2016-03-02,60,51,9,0.85,61,31,30,0.508
21500906,1610612743,1610612747,117.0,107.0,0.487,0.4429999999999999,1,2016-03-02,61,24,37,0.3929999999999999,62,12,50,0.1939999999999999
21500907,1610612746,1610612760,103.0,98.0,0.408,0.3979999999999999,1,2016-03-02,60,40,20,0.667,61,42,19,0.6890000000000001
21500891,1610612766,1610612756,126.0,92.0,0.484,0.363,1,2016-03-01,59,31,28,0.525,60,15,45,0.25
21500892,1610612748,1610612741,129.0,111.0,0.675,0.456,1,2016-03-01,60,34,26,0.5670000000000001,59,30,29,0.508
21500893,1610612752,1610612757,85.0,104.0,0.375,0.42,0,2016-03-01,62,25,37,0.4029999999999999,61,33,28,0.541
21500894,1610612742,1610612753,121.0,108.0,0.5579999999999999,0.451,1,2016-03-01,61,33,28,0.541,59,26,33,0.441
21500895,1610612744,1610612737,109.0,105.0,0.3979999999999999,0.4629999999999999,1,2016-03-01,59,54,5,0.915,61,33,28,0.541
21500896,1610612747,1610612751,107.0,101.0,0.494,0.4379999999999999,1,2016-03-01,61,12,49,0.1969999999999999,61,17,44,0.2789999999999999
21500884,1610612739,1610612754,100.0,96.0,0.422,0.4629999999999999,1,2016-02-29,59,42,17,0.7120000000000001,60,31,29,0.517
21500885,1610612764,1610612755,116.0,108.0,0.483,0.483,1,2016-02-29,59,29,30,0.4920000000000001,60,8,52,0.133
21500886,1610612738,1610612762,100.0,95.0,0.44,0.376,1,2016-02-29,61,36,25,0.59,59,28,31,0.475
21500887,1610612749,1610612745,128.0,121.0,0.593,0.471,1,2016-02-29,60,25,35,0.417,60,29,31,0.483
21500888,1610612743,1610612763,96.0,103.0,0.5329999999999999,0.48,0,2016-02-29,60,23,37,0.3829999999999999,59,35,24,0.593
21500889,1610612758,1610612760,116.0,131.0,0.449,0.573,0,2016-02-29,58,24,34,0.414,60,42,18,0.7
21500890,1610612746,1610612751,105.0,95.0,0.494,0.416,1,2016-02-29,59,39,20,0.6609999999999999,60,17,43,0.283
21500877,1610612764,1610612739,113.0,99.0,0.494,0.4,1,2016-02-28,58,28,30,0.483,58,41,17,0.7070000000000001
21500878,1610612737,1610612766,87.0,76.0,0.494,0.3329999999999999,1,2016-02-28,60,33,27,0.55,58,30,28,0.517
21500879,1610612765,1610612761,114.0,101.0,0.5770000000000001,0.488,1,2016-02-28,60,31,29,0.517,58,39,19,0.672
21500880,1610612754,1610612757,102.0,111.0,0.43,0.506,0,2016-02-28,59,31,28,0.525,60,32,28,0.5329999999999999
21500881,1610612753,1610612755,130.0,116.0,0.57,0.532,1,2016-02-28,58,26,32,0.4479999999999999,59,8,51,0.136
21500882,1610612742,1610612750,128.0,101.0,0.528,0.3779999999999999,1,2016-02-28,60,32,28,0.5329999999999999,60,19,41,0.317
21500883,1610612752,1610612748,81.0,98.0,0.368,0.476,0,2016-02-28,61,25,36,0.41,59,33,26,0.5589999999999999
21500869,1610612738,1610612748,101.0,89.0,0.406,0.414,1,2016-02-27,60,35,25,0.583,58,32,26,0.552
21500870,1610612740,1610612750,110.0,112.0,0.4639999999999999,0.5,0,2016-02-27,58,23,35,0.397,59,19,40,0.322
21500871,1610612741,1610612757,95.0,103.0,0.415,0.4370000000000001,0,2016-02-27,58,30,28,0.517,59,31,28,0.525
21500872,1610612745,1610612759,94.0,104.0,0.417,0.487,0,2016-02-27,59,29,30,0.4920000000000001,59,50,9,0.847
21500873,1610612749,1610612765,91.0,102.0,0.487,0.42,0,2016-02-27,59,24,35,0.407,59,30,29,0.508
21500874,1610612760,1610612744,118.0,121.0,0.479,0.474,0,2016-02-27,59,41,18,0.695,58,53,5,0.914
21500875,1610612756,1610612763,111.0,106.0,0.4629999999999999,0.4,1,2016-02-27,59,15,44,0.254,58,34,24,0.586
21500876,1610612762,1610612751,96.0,98.0,0.416,0.476,0,2016-02-27,58,28,30,0.483,59,17,42,0.288
21500861,1610612754,1610612766,95.0,96.0,0.412,0.434,0,2016-02-26,58,31,27,0.534,57,30,27,0.526
21500862,1610612755,1610612764,94.0,103.0,0.4270000000000001,0.426,0,2016-02-26,58,8,50,0.138,57,27,30,0.474
21500863,1610612752,1610612753,108.0,95.0,0.4629999999999999,0.419,1,2016-02-26,60,25,35,0.417,57,25,32,0.439
21500864,1610612761,1610612739,99.0,97.0,0.507,0.473,1,2016-02-26,57,39,18,0.684,57,41,16,0.7190000000000001
21500865,1610612737,1610612741,103.0,88.0,0.416,0.364,1,2016-02-26,59,32,27,0.542,57,30,27,0.526
21500866,1610612742,1610612743,122.0,116.0,0.511,0.462,1,2016-02-26,59,31,28,0.525,59,23,36,0.39
21500867,1610612758,1610612746,107.0,117.0,0.436,0.483,0,2016-02-26,57,24,33,0.421,58,38,20,0.655
21500868,1610612747,1610612763,95.0,112.0,0.41,0.506,0,2016-02-26,60,11,49,0.183,57,34,23,0.596
21500855,1610612753,1610612744,114.0,130.0,0.456,0.602,0,2016-02-25,56,25,31,0.446,57,52,5,0.912
21500856,1610612738,1610612749,112.0,107.0,0.488,0.483,1,2016-02-25,59,34,25,0.5760000000000001,58,24,34,0.414
21500857,1610612740,1610612760,123.0,119.0,0.522,0.547,1,2016-02-25,57,23,34,0.4039999999999999,58,41,17,0.7070000000000001
21500858,1610612756,1610612751,106.0,116.0,0.429,0.493,0,2016-02-25,58,14,44,0.241,58,16,42,0.276
21500859,1610612757,1610612745,105.0,119.0,0.4629999999999999,0.537,0,2016-02-25,58,30,28,0.517,58,29,29,0.5
21500860,1610612762,1610612759,78.0,96.0,0.429,0.481,0,2016-02-25,57,28,29,0.491,58,49,9,0.845
21500845,1610612739,1610612766,114.0,103.0,0.495,0.487,1,2016-02-24,56,41,15,0.732,56,29,27,0.518
21500846,1610612754,1610612752,108.0,105.0,0.505,0.455,1,2016-02-24,57,31,26,0.544,59,24,35,0.407
21500847,1610612765,1610612755,111.0,91.0,0.47,0.3979999999999999,1,2016-02-24,58,29,29,0.5,57,8,49,0.14
21500848,1610612748,1610612744,112.0,118.0,0.465,0.467,0,2016-02-24,57,32,25,0.561,56,51,5,0.911
21500849,1610612761,1610612750,114.0,105.0,0.482,0.5,1,2016-02-24,56,38,18,0.679,58,18,40,0.31
21500850,1610612741,1610612764,109.0,104.0,0.5,0.422,1,2016-02-24,56,30,26,0.536,56,26,30,0.4639999999999999
21500851,1610612763,1610612747,128.0,119.0,0.565,0.4429999999999999,1,2016-02-24,56,33,23,0.589,59,11,48,0.186
21500852,1610612742,1610612760,103.0,116.0,0.407,0.483,0,2016-02-24,58,30,28,0.517,57,41,16,0.7190000000000001
21500853,1610612746,1610612743,81.0,87.0,0.353,0.3779999999999999,0,2016-02-24,57,37,20,0.649,58,23,35,0.397
21500854,1610612758,1610612759,92.0,108.0,0.406,0.518,0,2016-02-24,56,24,32,0.429,57,48,9,0.8420000000000001
21500840,1610612755,1610612753,115.0,124.0,0.544,0.482,0,2016-02-23,56,8,48,0.143,55,25,30,0.455
21500841,1610612764,1610612740,109.0,89.0,0.457,0.349,1,2016-02-23,55,26,29,0.473,56,22,34,0.3929999999999999
21500842,1610612743,1610612758,110.0,114.0,0.41,0.518,0,2016-02-23,57,22,35,0.386,55,24,31,0.436
21500843,1610612762,1610612745,117.0,114.0,0.514,0.414,1,2016-02-23,56,28,28,0.5,57,28,29,0.491
21500844,1610612757,1610612751,112.0,104.0,0.5,0.478,1,2016-02-23,57,30,27,0.526,57,15,42,0.263
21500833,1610612739,1610612765,88.0,96.0,0.43,0.4629999999999999,0,2016-02-22,55,40,15,0.727,57,28,29,0.491
21500834,1610612748,1610612754,101.0,93.0,0.38,0.391,1,2016-02-22,56,32,24,0.5710000000000001,56,30,26,0.536
21500835,1610612752,1610612761,95.0,122.0,0.44,0.529,0,2016-02-22,58,24,34,0.414,55,37,18,0.6729999999999999
21500836,1610612737,1610612744,92.0,102.0,0.419,0.4379999999999999,0,2016-02-22,58,31,27,0.534,55,50,5,0.909
21500837,1610612749,1610612747,108.0,101.0,0.512,0.368,1,2016-02-22,57,24,33,0.421,58,11,47,0.19
21500838,1610612750,1610612738,124.0,122.0,0.518,0.485,1,2016-02-22,57,18,39,0.316,58,33,25,0.569
21500839,1610612746,1610612756,124.0,84.0,0.55,0.352,1,2016-02-22,56,37,19,0.6609999999999999,57,14,43,0.246
21500823,1610612765,1610612740,106.0,111.0,0.416,0.477,0,2016-02-21,56,27,29,0.482,55,22,33,0.4
21500824,1610612760,1610612739,92.0,115.0,0.411,0.513,0,2016-02-21,56,40,16,0.7140000000000001,54,40,14,0.741
21500825,1610612743,1610612738,101.0,121.0,0.466,0.485,0,2016-02-21,56,22,34,0.3929999999999999,57,33,24,0.579
21500826,1610612756,1610612759,111.0,118.0,0.462,0.524,0,2016-02-21,56,14,42,0.25,56,47,9,0.8390000000000001
21500827,1610612751,1610612766,96.0,104.0,0.4320000000000001,0.506,0,2016-02-21,56,15,41,0.268,55,29,26,0.527
21500828,1610612753,1610612754,102.0,105.0,0.418,0.5,0,2016-02-21,54,24,30,0.444,55,30,25,0.545
21500829,1610612761,1610612763,98.0,85.0,0.407,0.368,1,2016-02-21,54,36,18,0.667,55,32,23,0.5820000000000001
21500830,1610612742,1610612755,129.0,103.0,0.482,0.481,1,2016-02-21,57,30,27,0.526,55,8,47,0.145
21500831,1610612741,1610612747,126.0,115.0,0.557,0.462,1,2016-02-21,55,29,26,0.527,57,11,46,0.193
21500832,1610612757,1610612762,115.0,111.0,0.433,0.5,1,2016-02-21,56,29,27,0.518,55,27,28,0.491
21500819,1610612737,1610612749,109.0,117.0,0.415,0.442,0,2016-02-20,57,31,26,0.544,56,23,33,0.411
21500820,1610612748,1610612764,114.0,94.0,0.49,0.4039999999999999,1,2016-02-20,55,31,24,0.564,54,25,29,0.4629999999999999
21500821,1610612750,1610612752,95.0,103.0,0.429,0.506,0,2016-02-20,56,17,39,0.304,57,24,33,0.421
21500822,1610612746,1610612744,112.0,115.0,0.447,0.512,0,2016-02-20,55,36,19,0.655,54,49,5,0.907
21500805,1610612753,1610612742,110.0,104.0,0.402,0.416,1,2016-02-19,53,24,29,0.4529999999999999,56,29,27,0.518
21500806,1610612764,1610612765,98.0,86.0,0.462,0.4270000000000001,1,2016-02-19,53,25,28,0.472,55,27,28,0.491
21500807,1610612751,1610612752,109.0,98.0,0.488,0.439,1,2016-02-19,55,15,40,0.273,56,23,33,0.411
21500808,1610612737,1610612748,111.0,115.0,0.471,0.5,0,2016-02-19,56,31,25,0.5539999999999999,54,30,24,0.556
21500809,1610612741,1610612761,116.0,106.0,0.516,0.4320000000000001,1,2016-02-19,54,28,26,0.519,53,35,18,0.66
21500810,1610612763,1610612750,109.0,104.0,0.488,0.413,1,2016-02-19,54,32,22,0.593,55,17,38,0.309
21500811,1610612740,1610612755,121.0,114.0,0.506,0.526,1,2016-02-19,54,21,33,0.389,54,8,46,0.148
21500812,1610612760,1610612754,98.0,101.0,0.4379999999999999,0.4429999999999999,0,2016-02-19,55,40,15,0.727,54,29,25,0.537
21500813,1610612749,1610612766,95.0,98.0,0.444,0.43,0,2016-02-19,55,22,33,0.4,54,28,26,0.519
21500814,1610612756,1610612745,100.0,116.0,0.366,0.474,0,2016-02-19,55,14,41,0.255,56,28,28,0.5
21500815,1610612757,1610612744,137.0,105.0,0.536,0.391,1,2016-02-19,55,28,27,0.509,53,48,5,0.906
21500816,1610612758,1610612743,116.0,110.0,0.494,0.467,1,2016-02-19,54,23,31,0.426,55,22,33,0.4
21500817,1610612762,1610612738,111.0,93.0,0.544,0.37,1,2016-02-19,54,27,27,0.5,56,32,24,0.5710000000000001
21500818,1610612747,1610612759,113.0,119.0,0.494,0.545,0,2016-02-19,56,11,45,0.196,55,46,9,0.836
21500654,1610612764,1610612762,103.0,89.0,0.488,0.4029999999999999,1,2016-02-18,52,24,28,0.462,53,26,27,0.491
21500803,1610612739,1610612741,106.0,95.0,0.462,0.3979999999999999,1,2016-02-18,53,39,14,0.736,53,27,26,0.509
21500804,1610612746,1610612759,105.0,86.0,0.5,0.422,1,2016-02-18,54,36,18,0.667,54,45,9,0.833
21500801,1610612749,1610612764,99.0,92.0,0.439,0.386,1,2016-02-11,54,22,32,0.407,51,23,28,0.451
21500802,1610612760,1610612740,121.0,95.0,0.523,0.4320000000000001,1,2016-02-11,54,40,14,0.741,53,20,33,0.377
21500789,1610612754,1610612766,95.0,117.0,0.435,0.517,0,2016-02-10,53,28,25,0.528,53,27,26,0.509
21500790,1610612753,1610612759,96.0,98.0,0.407,0.4270000000000001,0,2016-02-10,52,23,29,0.442,53,45,8,0.8490000000000001
21500791,1610612755,1610612758,110.0,114.0,0.462,0.506,0,2016-02-10,53,8,45,0.151,53,22,31,0.415
21500792,1610612738,1610612746,139.0,134.0,0.495,0.518,1,2016-02-10,55,32,23,0.5820000000000001,53,35,18,0.66
21500793,1610612751,1610612763,90.0,109.0,0.465,0.523,0,2016-02-10,54,14,40,0.259,53,31,22,0.585
21500794,1610612765,1610612743,92.0,103.0,0.4320000000000001,0.47,0,2016-02-10,54,27,27,0.5,54,22,32,0.407
21500795,1610612739,1610612747,120.0,111.0,0.511,0.442,1,2016-02-10,52,38,14,0.731,55,11,44,0.2
21500796,1610612741,1610612737,90.0,113.0,0.442,0.478,0,2016-02-10,52,27,25,0.519,55,31,24,0.564
21500797,1610612750,1610612761,117.0,112.0,0.461,0.4529999999999999,1,2016-02-10,54,17,37,0.315,52,35,17,0.6729999999999999
21500798,1610612740,1610612762,100.0,96.0,0.476,0.471,1,2016-02-10,52,20,32,0.385,52,26,26,0.5
21500799,1610612756,1610612744,104.0,112.0,0.441,0.416,0,2016-02-10,54,14,40,0.259,52,48,4,0.923
21500800,1610612757,1610612745,116.0,103.0,0.461,0.481,1,2016-02-10,54,27,27,0.5,55,27,28,0.491
21500784,1610612748,1610612759,101.0,119.0,0.5710000000000001,0.528,0,2016-02-09,53,29,24,0.547,52,44,8,0.846
21500785,1610612752,1610612764,108.0,111.0,0.53,0.5,0,2016-02-09,55,23,32,0.418,50,23,27,0.46
21500786,1610612749,1610612738,112.0,111.0,0.511,0.4639999999999999,1,2016-02-09,53,21,32,0.396,54,31,23,0.574
21500787,1610612742,1610612762,119.0,121.0,0.48,0.522,0,2016-02-09,55,29,26,0.527,51,26,25,0.51
21500788,1610612744,1610612745,123.0,110.0,0.4679999999999999,0.425,1,2016-02-09,51,47,4,0.922,54,27,27,0.5
21500774,1610612766,1610612741,108.0,91.0,0.4379999999999999,0.389,1,2016-02-08,52,26,26,0.5,51,27,24,0.529
21500775,1610612739,1610612758,120.0,100.0,0.479,0.439,1,2016-02-08,51,37,14,0.725,52,21,31,0.4039999999999999
21500776,1610612754,1610612747,89.0,87.0,0.397,0.312,1,2016-02-08,52,28,24,0.5379999999999999,54,11,43,0.204
21500777,1610612755,1610612746,92.0,98.0,0.3779999999999999,0.368,0,2016-02-08,52,8,44,0.154,52,35,17,0.6729999999999999
21500778,1610612751,1610612743,105.0,104.0,0.519,0.467,1,2016-02-08,53,14,39,0.264,53,21,32,0.396
21500779,1610612765,1610612761,89.0,103.0,0.45,0.557,0,2016-02-08,53,27,26,0.509,51,35,16,0.6859999999999999
21500780,1610612737,1610612753,110.0,117.0,0.467,0.495,0,2016-02-08,54,30,24,0.556,51,23,28,0.451
21500781,1610612763,1610612757,106.0,112.0,0.5,0.494,0,2016-02-08,52,30,22,0.5770000000000001,53,26,27,0.491
21500782,1610612750,1610612740,102.0,116.0,0.444,0.485,0,2016-02-08,53,16,37,0.302,51,19,32,0.373
21500783,1610612756,1610612760,106.0,122.0,0.507,0.494,0,2016-02-08,53,14,39,0.264,53,39,14,0.736
21500770,1610612752,1610612743,96.0,101.0,0.44,0.43,0,2016-02-07,54,23,31,0.426,52,21,31,0.4039999999999999
21500771,1610612753,1610612737,96.0,94.0,0.4589999999999999,0.385,1,2016-02-07,50,22,28,0.44,53,30,23,0.5660000000000001
21500773,1610612738,1610612758,128.0,119.0,0.56,0.495,1,2016-02-07,53,31,22,0.585,51,21,30,0.412
21500772,1610612748,1610612746,93.0,100.0,0.3979999999999999,0.457,0,2016-02-07,52,29,23,0.5579999999999999,51,34,17,0.667
21500760,1610612745,1610612757,79.0,96.0,0.325,0.402,0,2016-02-06,53,27,26,0.509,52,25,27,0.481
21500761,1610612766,1610612764,108.0,104.0,0.469,0.442,1,2016-02-06,51,25,26,0.49,49,22,27,0.449
21500762,1610612754,1610612765,112.0,104.0,0.539,0.481,1,2016-02-06,51,27,24,0.529,52,27,25,0.519
21500763,1610612739,1610612740,99.0,84.0,0.433,0.391,1,2016-02-06,50,36,14,0.72,50,18,32,0.36
21500764,1610612755,1610612751,103.0,98.0,0.469,0.461,1,2016-02-06,51,8,43,0.157,52,13,39,0.25
21500765,1610612763,1610612742,110.0,114.0,0.5,0.4320000000000001,0,2016-02-06,51,30,21,0.588,54,29,25,0.537
21500766,1610612750,1610612741,112.0,105.0,0.517,0.471,1,2016-02-06,52,16,36,0.308,50,27,23,0.54
21500767,1610612759,1610612747,106.0,102.0,0.4429999999999999,0.395,1,2016-02-06,51,43,8,0.843,53,11,42,0.208
21500768,1610612756,1610612762,89.0,98.0,0.375,0.436,0,2016-02-06,52,14,38,0.2689999999999999,50,25,25,0.5
21500769,1610612744,1610612760,116.0,108.0,0.495,0.424,1,2016-02-06,50,46,4,0.92,52,38,14,0.731
21500750,1610612737,1610612754,102.0,96.0,0.513,0.418,1,2016-02-05,52,30,22,0.5770000000000001,50,26,24,0.52
21500751,1610612766,1610612748,95.0,98.0,0.444,0.457,0,2016-02-05,50,24,26,0.48,51,29,22,0.569
21500752,1610612753,1610612746,93.0,107.0,0.42,0.541,0,2016-02-05,49,21,28,0.429,50,33,17,0.66
21500753,1610612764,1610612755,106.0,94.0,0.524,0.425,1,2016-02-05,48,22,26,0.4579999999999999,50,7,43,0.14
21500754,1610612751,1610612758,128.0,119.0,0.5579999999999999,0.506,1,2016-02-05,51,13,38,0.255,50,21,29,0.42
21500755,1610612739,1610612738,103.0,104.0,0.425,0.4320000000000001,0,2016-02-05,49,35,14,0.7140000000000001,52,30,22,0.5770000000000001
21500756,1610612752,1610612763,85.0,91.0,0.375,0.434,0,2016-02-05,53,23,30,0.434,50,30,20,0.6
21500757,1610612743,1610612741,115.0,110.0,0.4479999999999999,0.462,1,2016-02-05,51,20,31,0.392,49,27,22,0.551
21500758,1610612762,1610612749,84.0,81.0,0.39,0.423,1,2016-02-05,49,24,25,0.49,52,20,32,0.385
21500759,1610612742,1610612759,90.0,116.0,0.452,0.513,0,2016-02-05,53,28,25,0.528,50,42,8,0.84
21500746,1610612765,1610612752,111.0,105.0,0.506,0.429,1,2016-02-04,51,27,24,0.529,52,23,29,0.442
21500749,1610612756,1610612745,105.0,111.0,0.386,0.43,0,2016-02-04,51,14,37,0.275,52,27,25,0.519
21500747,1610612740,1610612747,96.0,99.0,0.4589999999999999,0.481,0,2016-02-04,49,18,31,0.3670000000000001,52,11,41,0.212
21500748,1610612757,1610612761,103.0,110.0,0.469,0.471,0,2016-02-04,51,24,27,0.471,50,34,16,0.68
21500735,1610612766,1610612739,106.0,97.0,0.494,0.4579999999999999,1,2016-02-03,49,24,25,0.49,48,35,13,0.7290000000000001
21500736,1610612755,1610612737,86.0,124.0,0.417,0.522,0,2016-02-03,49,7,42,0.143,51,29,22,0.569
21500737,1610612738,1610612765,102.0,95.0,0.4379999999999999,0.376,1,2016-02-03,51,29,22,0.569,50,26,24,0.52
21500738,1610612751,1610612754,100.0,114.0,0.444,0.5,0,2016-02-03,50,12,38,0.24,49,26,23,0.531
21500739,1610612764,1610612744,121.0,134.0,0.505,0.527,0,2016-02-03,47,21,26,0.447,49,45,4,0.918
21500740,1610612760,1610612753,117.0,114.0,0.473,0.495,1,2016-02-03,51,38,13,0.745,48,21,27,0.4379999999999999
21500741,1610612742,1610612748,90.0,93.0,0.391,0.42,0,2016-02-03,52,28,24,0.5379999999999999,50,28,22,0.56
21500742,1610612759,1610612740,110.0,97.0,0.519,0.456,1,2016-02-03,49,41,8,0.8370000000000001,48,18,30,0.375
21500743,1610612762,1610612743,85.0,81.0,0.446,0.371,1,2016-02-03,48,23,25,0.479,50,19,31,0.38
21500744,1610612758,1610612741,102.0,107.0,0.477,0.455,0,2016-02-03,49,21,28,0.429,48,27,21,0.563
21500745,1610612746,1610612750,102.0,108.0,0.44,0.506,0,2016-02-03,49,32,17,0.653,51,15,36,0.294
21500730,1610612752,1610612738,89.0,97.0,0.3779999999999999,0.444,0,2016-02-02,51,23,28,0.451,50,28,22,0.56
21500731,1610612745,1610612748,115.0,102.0,0.524,0.447,1,2016-02-02,51,26,25,0.51,49,27,22,0.551
21500732,1610612756,1610612761,97.0,104.0,0.4679999999999999,0.473,0,2016-02-02,50,14,36,0.28,49,33,16,0.6729999999999999
21500733,1610612757,1610612749,107.0,95.0,0.4589999999999999,0.442,1,2016-02-02,50,24,26,0.48,51,20,31,0.392
21500734,1610612747,1610612750,119.0,115.0,0.5,0.575,1,2016-02-02,51,10,41,0.196,50,14,36,0.28
21500721,1610612754,1610612739,106.0,111.0,0.426,0.5,0,2016-02-01,48,25,23,0.521,47,35,12,0.745
21500722,1610612751,1610612765,100.0,105.0,0.488,0.429,0,2016-02-01,49,12,37,0.245,49,26,23,0.531
21500723,1610612737,1610612742,112.0,97.0,0.525,0.365,1,2016-02-01,50,28,22,0.56,51,28,23,0.5489999999999999
21500724,1610612740,1610612763,95.0,110.0,0.409,0.606,0,2016-02-01,47,18,29,0.3829999999999999,49,29,20,0.5920000000000001
21500725,1610612760,1610612764,114.0,98.0,0.518,0.465,1,2016-02-01,50,37,13,0.74,46,21,25,0.457
21500726,1610612759,1610612753,107.0,92.0,0.513,0.406,1,2016-02-01,48,40,8,0.833,47,21,26,0.447
21500727,1610612743,1610612761,112.0,93.0,0.542,0.3720000000000001,1,2016-02-01,49,19,30,0.3879999999999999,48,32,16,0.667
21500728,1610612762,1610612741,105.0,96.0,0.447,0.433,1,2016-02-01,47,22,25,0.4679999999999999,47,26,21,0.5529999999999999
21500729,1610612758,1610612749,111.0,104.0,0.4529999999999999,0.5,1,2016-02-01,48,21,27,0.4379999999999999,50,20,30,0.4
21500714,1610612746,1610612741,120.0,93.0,0.536,0.43,1,2016-01-31,48,32,16,0.667,46,26,20,0.565
21500715,1610612748,1610612737,105.0,87.0,0.481,0.386,1,2016-01-31,48,27,21,0.563,49,27,22,0.551
21500716,1610612753,1610612738,119.0,114.0,0.537,0.419,1,2016-01-31,46,21,25,0.457,49,27,22,0.551
21500717,1610612742,1610612756,91.0,78.0,0.397,0.365,1,2016-01-31,50,28,22,0.56,49,14,35,0.286
21500718,1610612752,1610612744,95.0,116.0,0.3670000000000001,0.575,0,2016-01-31,50,23,27,0.46,48,44,4,0.917
21500719,1610612757,1610612750,96.0,93.0,0.421,0.4379999999999999,1,2016-01-31,49,23,26,0.469,49,14,35,0.286
21500720,1610612747,1610612766,82.0,101.0,0.3379999999999999,0.375,0,2016-01-31,50,9,41,0.18,48,23,25,0.479
21500707,1610612755,1610612744,105.0,108.0,0.457,0.495,0,2016-01-30,48,7,41,0.146,47,43,4,0.915
21500708,1610612761,1610612765,111.0,107.0,0.462,0.4479999999999999,1,2016-01-30,47,32,15,0.6809999999999999,48,25,23,0.521
21500709,1610612754,1610612743,109.0,105.0,0.44,0.46,1,2016-01-30,47,25,22,0.532,48,18,30,0.375
21500710,1610612740,1610612751,105.0,103.0,0.462,0.476,1,2016-01-30,46,18,28,0.391,48,12,36,0.25
21500711,1610612745,1610612764,122.0,123.0,0.477,0.523,0,2016-01-30,50,25,25,0.5,45,21,24,0.467
21500712,1610612763,1610612758,121.0,117.0,0.519,0.413,1,2016-01-30,48,28,20,0.583,47,20,27,0.426
21500713,1610612739,1610612759,117.0,103.0,0.5489999999999999,0.494,1,2016-01-30,46,34,12,0.7390000000000001,47,39,8,0.83
21500698,1610612738,1610612753,113.0,94.0,0.5,0.405,1,2016-01-29,48,27,21,0.563,45,20,25,0.444
21500699,1610612765,1610612739,106.0,114.0,0.476,0.47,0,2016-01-29,47,25,22,0.532,45,33,12,0.733
21500700,1610612752,1610612756,102.0,84.0,0.429,0.412,1,2016-01-29,49,23,26,0.469,48,14,34,0.292
21500701,1610612760,1610612745,116.0,108.0,0.477,0.379,1,2016-01-29,49,36,13,0.735,49,25,24,0.51
21500703,1610612749,1610612748,103.0,107.0,0.475,0.5,0,2016-01-29,49,20,29,0.408,47,26,21,0.5529999999999999
21500702,1610612742,1610612751,91.0,79.0,0.4629999999999999,0.359,1,2016-01-29,49,27,22,0.551,47,12,35,0.255
21500704,1610612762,1610612750,103.0,90.0,0.526,0.467,1,2016-01-29,46,21,25,0.457,48,14,34,0.292
21500705,1610612757,1610612766,109.0,91.0,0.489,0.3879999999999999,1,2016-01-29,48,22,26,0.4579999999999999,47,22,25,0.4679999999999999
21500706,1610612746,1610612747,105.0,93.0,0.494,0.436,1,2016-01-29,47,31,16,0.66,49,9,40,0.184
21500692,1610612754,1610612737,111.0,92.0,0.487,0.3979999999999999,1,2016-01-28,46,24,22,0.522,48,27,21,0.563
21500693,1610612764,1610612743,113.0,117.0,0.4429999999999999,0.506,0,2016-01-28,44,20,24,0.455,47,18,29,0.3829999999999999
21500694,1610612761,1610612752,103.0,93.0,0.435,0.4370000000000001,1,2016-01-28,46,31,15,0.674,48,22,26,0.4579999999999999
21500695,1610612763,1610612749,103.0,83.0,0.475,0.3670000000000001,1,2016-01-28,47,27,20,0.574,48,20,28,0.417
21500696,1610612740,1610612758,114.0,105.0,0.439,0.449,1,2016-01-28,45,17,28,0.3779999999999999,46,20,26,0.435
21500697,1610612747,1610612741,91.0,114.0,0.376,0.495,0,2016-01-28,48,9,39,0.188,45,26,19,0.578
21500684,1610612739,1610612756,115.0,93.0,0.556,0.471,1,2016-01-27,44,32,12,0.727,47,14,33,0.298
21500685,1610612738,1610612743,111.0,103.0,0.4270000000000001,0.429,1,2016-01-27,47,26,21,0.5529999999999999,46,17,29,0.37
21500686,1610612765,1610612755,110.0,97.0,0.429,0.476,1,2016-01-27,46,25,21,0.5429999999999999,47,7,40,0.149
21500687,1610612737,1610612746,83.0,85.0,0.418,0.3879999999999999,0,2016-01-27,47,27,20,0.574,46,30,16,0.652
21500688,1610612750,1610612760,123.0,126.0,0.556,0.527,0,2016-01-27,47,14,33,0.298,48,35,13,0.7290000000000001
21500689,1610612759,1610612745,130.0,99.0,0.556,0.384,1,2016-01-27,46,39,7,0.848,48,25,23,0.521
21500690,1610612762,1610612766,102.0,73.0,0.494,0.368,1,2016-01-27,45,20,25,0.444,46,22,24,0.478
21500691,1610612744,1610612742,127.0,107.0,0.58,0.506,1,2016-01-27,46,42,4,0.913,48,26,22,0.542
21500676,1610612754,1610612746,89.0,91.0,0.422,0.41,0,2016-01-26,45,23,22,0.511,45,29,16,0.644
21500677,1610612755,1610612756,113.0,103.0,0.481,0.47,1,2016-01-26,46,7,39,0.152,46,14,32,0.304
21500678,1610612751,1610612748,98.0,102.0,0.507,0.542,0,2016-01-26,46,12,34,0.261,46,25,21,0.5429999999999999
21500679,1610612752,1610612760,122.0,128.0,0.4629999999999999,0.465,0,2016-01-26,47,22,25,0.4679999999999999,47,34,13,0.723
21500680,1610612761,1610612764,106.0,89.0,0.4429999999999999,0.41,1,2016-01-26,45,30,15,0.667,43,20,23,0.465
21500681,1610612749,1610612753,107.0,100.0,0.494,0.413,1,2016-01-26,47,20,27,0.426,44,20,24,0.455
21500682,1610612757,1610612758,112.0,97.0,0.489,0.419,1,2016-01-26,47,21,26,0.447,45,20,25,0.444
21500683,1610612747,1610612742,90.0,92.0,0.405,0.434,0,2016-01-26,47,9,38,0.191,47,26,21,0.5529999999999999
21500667,1610612739,1610612750,114.0,107.0,0.506,0.488,1,2016-01-25,43,31,12,0.721,46,14,32,0.304
21500668,1610612764,1610612738,91.0,116.0,0.4270000000000001,0.489,0,2016-01-25,42,20,22,0.476,46,25,21,0.5429999999999999
21500669,1610612741,1610612748,84.0,89.0,0.3979999999999999,0.457,0,2016-01-25,44,25,19,0.568,45,24,21,0.5329999999999999
21500670,1610612763,1610612753,108.0,102.0,0.43,0.465,1,2016-01-25,46,26,20,0.565,43,20,23,0.465
21500671,1610612740,1610612745,111.0,112.0,0.462,0.475,0,2016-01-25,44,16,28,0.364,47,25,22,0.532
21500672,1610612743,1610612737,105.0,119.0,0.3929999999999999,0.5,0,2016-01-25,45,17,28,0.3779999999999999,46,27,19,0.5870000000000001
21500673,1610612762,1610612765,92.0,95.0,0.4,0.4529999999999999,0,2016-01-25,44,19,25,0.4320000000000001,45,24,21,0.5329999999999999
21500674,1610612758,1610612766,128.0,129.0,0.527,0.4,0,2016-01-25,44,20,24,0.455,45,22,23,0.489
21500675,1610612744,1610612759,120.0,90.0,0.518,0.419,1,2016-01-25,45,41,4,0.911,45,38,7,0.8440000000000001
21500665,1610612745,1610612742,115.0,104.0,0.483,0.456,1,2016-01-24,46,24,22,0.522,46,25,21,0.5429999999999999
21500666,1610612761,1610612746,112.0,94.0,0.494,0.447,1,2016-01-24,44,29,15,0.659,44,28,16,0.636
21500656,1610612755,1610612738,92.0,112.0,0.3929999999999999,0.4429999999999999,0,2016-01-24,45,6,39,0.133,45,24,21,0.5329999999999999
21500664,1610612751,1610612760,116.0,106.0,0.479,0.462,1,2016-01-24,45,12,33,0.267,46,33,13,0.7170000000000001
21500655,1610612766,1610612752,97.0,84.0,0.341,0.377,1,2016-01-23,44,21,23,0.477,46,22,24,0.478
21500657,1610612740,1610612749,116.0,99.0,0.457,0.527,1,2016-01-23,43,16,27,0.3720000000000001,46,19,27,0.413
21500658,1610612750,1610612763,106.0,101.0,0.5,0.4679999999999999,1,2016-01-23,45,14,31,0.311,45,25,20,0.556
21500659,1610612739,1610612741,83.0,96.0,0.3720000000000001,0.4370000000000001,0,2016-01-23,42,30,12,0.7140000000000001,43,25,18,0.581
21500660,1610612756,1610612737,98.0,95.0,0.4,0.405,1,2016-01-23,45,14,31,0.311,45,26,19,0.578
21500661,1610612743,1610612765,104.0,101.0,0.462,0.476,1,2016-01-23,44,17,27,0.386,44,23,21,0.523
21500662,1610612757,1610612747,121.0,103.0,0.505,0.493,1,2016-01-23,46,20,26,0.435,46,9,37,0.196
21500663,1610612758,1610612754,108.0,97.0,0.447,0.419,1,2016-01-23,43,20,23,0.465,44,23,21,0.523
21500645,1610612753,1610612766,116.0,120.0,0.495,0.446,0,2016-01-22,42,20,22,0.476,43,20,23,0.465
21500646,1610612738,1610612741,110.0,101.0,0.4479999999999999,0.4270000000000001,1,2016-01-22,44,23,21,0.523,42,24,18,0.5710000000000001
21500647,1610612751,1610612762,86.0,108.0,0.44,0.573,0,2016-01-22,44,11,33,0.25,43,19,24,0.442
21500648,1610612752,1610612746,88.0,116.0,0.3879999999999999,0.5660000000000001,0,2016-01-22,45,22,23,0.489,43,28,15,0.6509999999999999
21500649,1610612761,1610612748,101.0,81.0,0.467,0.407,1,2016-01-22,43,28,15,0.6509999999999999,44,23,21,0.523
21500650,1610612745,1610612749,102.0,98.0,0.4039999999999999,0.4589999999999999,1,2016-01-22,45,23,22,0.511,45,19,26,0.422
21500651,1610612742,1610612760,106.0,109.0,0.46,0.495,0,2016-01-22,45,25,20,0.556,45,33,12,0.733
21500652,1610612744,1610612754,122.0,110.0,0.478,0.4629999999999999,1,2016-01-22,44,40,4,0.909,43,23,20,0.535
21500653,1610612747,1610612759,95.0,108.0,0.452,0.506,0,2016-01-22,45,9,36,0.2,44,38,6,0.8640000000000001
21500640,1610612739,1610612746,115.0,102.0,0.506,0.45,1,2016-01-21,41,30,11,0.732,42,27,15,0.643
21500641,1610612740,1610612765,115.0,99.0,0.535,0.418,1,2016-01-21,42,15,27,0.357,43,23,20,0.535
21500642,1610612743,1610612763,101.0,102.0,0.45,0.5,0,2016-01-21,43,16,27,0.3720000000000001,44,25,19,0.568
21500643,1610612758,1610612737,91.0,88.0,0.359,0.417,1,2016-01-21,42,19,23,0.452,44,26,18,0.591
21500644,1610612756,1610612759,89.0,117.0,0.395,0.488,0,2016-01-21,44,13,31,0.295,43,37,6,0.86
21500629,1610612753,1610612755,87.0,96.0,0.3929999999999999,0.486,0,2016-01-20,41,20,21,0.488,44,6,38,0.136
21500630,1610612764,1610612748,106.0,87.0,0.523,0.485,1,2016-01-20,41,20,21,0.488,43,23,20,0.535
21500631,1610612751,1610612739,78.0,91.0,0.417,0.4679999999999999,0,2016-01-20,43,11,32,0.256,40,29,11,0.725
21500632,1610612752,1610612762,118.0,111.0,0.522,0.43,1,2016-01-20,44,22,22,0.5,42,18,24,0.429
21500633,1610612761,1610612738,115.0,109.0,0.5539999999999999,0.506,1,2016-01-20,42,27,15,0.643,43,22,21,0.512
21500634,1610612741,1610612744,94.0,125.0,0.37,0.526,0,2016-01-20,41,24,17,0.585,43,39,4,0.907
21500635,1610612745,1610612765,114.0,123.0,0.4529999999999999,0.475,0,2016-01-20,44,22,22,0.5,42,23,19,0.5479999999999999
21500636,1610612760,1610612766,109.0,95.0,0.47,0.42,1,2016-01-20,44,32,12,0.727,42,19,23,0.452
21500637,1610612742,1610612750,106.0,94.0,0.433,0.44,1,2016-01-20,44,25,19,0.568,44,13,31,0.295
21500638,1610612747,1610612758,93.0,112.0,0.356,0.483,0,2016-01-20,44,9,35,0.205,41,18,23,0.439
21500639,1610612757,1610612737,98.0,104.0,0.436,0.4479999999999999,0,2016-01-20,45,19,26,0.422,43,26,17,0.605
21500625,1610612748,1610612749,79.0,91.0,0.365,0.486,0,2016-01-19,42,23,19,0.5479999999999999,44,19,25,0.4320000000000001
21500626,1610612740,1610612750,114.0,99.0,0.506,0.474,1,2016-01-19,41,14,27,0.341,43,13,30,0.302
21500627,1610612743,1610612760,104.0,110.0,0.422,0.423,0,2016-01-19,42,16,26,0.381,43,31,12,0.721
21500628,1610612756,1610612754,94.0,97.0,0.346,0.41,0,2016-01-19,43,13,30,0.302,42,23,19,0.5479999999999999
21500615,1610612752,1610612755,119.0,113.0,0.4429999999999999,0.441,1,2016-01-18,43,21,22,0.488,43,5,38,0.1159999999999999
21500616,1610612766,1610612762,124.0,119.0,0.466,0.423,1,2016-01-18,41,19,22,0.4629999999999999,41,18,23,0.439
21500617,1610612764,1610612757,98.0,108.0,0.481,0.512,0,2016-01-18,40,19,21,0.475,44,19,25,0.4320000000000001
21500618,1610612763,1610612740,101.0,99.0,0.467,0.486,1,2016-01-18,43,24,19,0.5579999999999999,40,13,27,0.325
21500619,1610612765,1610612741,101.0,111.0,0.442,0.524,0,2016-01-18,41,22,19,0.537,40,24,16,0.6
21500620,1610612737,1610612753,98.0,81.0,0.513,0.345,1,2016-01-18,42,25,17,0.595,40,20,20,0.5
21500621,1610612761,1610612751,112.0,100.0,0.506,0.513,1,2016-01-18,41,26,15,0.634,42,11,31,0.262
21500622,1610612739,1610612744,98.0,132.0,0.481,0.541,0,2016-01-18,39,28,11,0.718,42,38,4,0.905
21500623,1610612742,1610612738,118.0,113.0,0.43,0.426,1,2016-01-18,43,24,19,0.5579999999999999,42,22,20,0.524
21500624,1610612746,1610612745,140.0,132.0,0.516,0.5,1,2016-01-18,41,27,14,0.659,43,22,21,0.512
21500610,1610612750,1610612756,117.0,87.0,0.565,0.4320000000000001,1,2016-01-17,42,13,29,0.31,42,13,29,0.31
21500611,1610612760,1610612748,99.0,74.0,0.455,0.417,1,2016-01-17,42,30,12,0.7140000000000001,41,23,18,0.561
21500612,1610612759,1610612742,112.0,83.0,0.467,0.358,1,2016-01-17,42,36,6,0.857,42,23,19,0.5479999999999999
21500613,1610612743,1610612754,129.0,126.0,0.505,0.585,1,2016-01-17,41,16,25,0.39,41,22,19,0.537
21500614,1610612747,1610612745,95.0,112.0,0.451,0.484,0,2016-01-17,43,9,34,0.209,42,22,20,0.524
21500603,1610612766,1610612749,92.0,105.0,0.379,0.542,0,2016-01-16,40,18,22,0.45,43,18,25,0.419
21500602,1610612737,1610612751,114.0,86.0,0.557,0.436,1,2016-01-16,41,24,17,0.585,41,11,30,0.268
21500604,1610612764,1610612738,117.0,119.0,0.449,0.4429999999999999,0,2016-01-16,39,19,20,0.487,41,22,19,0.537
21500605,1610612765,1610612744,113.0,95.0,0.465,0.362,1,2016-01-16,40,22,18,0.55,41,37,4,0.902
21500606,1610612755,1610612757,114.0,89.0,0.5529999999999999,0.391,1,2016-01-16,42,5,37,0.119,43,18,25,0.419
21500607,1610612763,1610612752,103.0,95.0,0.476,0.455,1,2016-01-16,42,23,19,0.5479999999999999,42,20,22,0.476
21500608,1610612762,1610612747,109.0,82.0,0.494,0.344,1,2016-01-16,40,18,22,0.45,42,9,33,0.214
21500609,1610612746,1610612758,103.0,110.0,0.396,0.474,0,2016-01-16,40,26,14,0.65,40,17,23,0.425
21500593,1610612754,1610612764,104.0,118.0,0.475,0.52,0,2016-01-15,40,22,18,0.55,38,19,19,0.5
21500594,1610612760,1610612750,113.0,93.0,0.528,0.4,1,2016-01-15,41,29,12,0.7070000000000001,41,12,29,0.293
21500595,1610612738,1610612756,117.0,103.0,0.4379999999999999,0.3929999999999999,1,2016-01-15,40,21,19,0.525,41,13,28,0.317
21500596,1610612751,1610612757,104.0,116.0,0.447,0.505,0,2016-01-15,40,11,29,0.275,42,18,24,0.429
21500597,1610612741,1610612742,77.0,83.0,0.36,0.39,0,2016-01-15,39,23,16,0.59,41,23,18,0.561
21500598,1610612740,1610612766,109.0,107.0,0.494,0.488,1,2016-01-15,39,13,26,0.3329999999999999,39,18,21,0.462
21500599,1610612749,1610612737,108.0,101.0,0.417,0.43,1,2016-01-15,42,17,25,0.405,40,23,17,0.575
21500600,1610612743,1610612748,95.0,98.0,0.41,0.494,0,2016-01-15,40,15,25,0.375,40,23,17,0.575
21500601,1610612745,1610612739,77.0,91.0,0.351,0.391,0,2016-01-15,41,21,20,0.512,38,28,10,0.737
21500588,1610612753,1610612761,103.0,106.0,0.4539999999999999,0.411,0,2016-01-14,39,20,19,0.513,40,25,15,0.625
21500587,1610612755,1610612741,111.0,115.0,0.452,0.466,0,2016-01-14,41,4,37,0.098,38,23,15,0.605
21500589,1610612763,1610612765,103.0,101.0,0.487,0.514,1,2016-01-14,41,22,19,0.537,39,21,18,0.5379999999999999
21500590,1610612759,1610612739,99.0,95.0,0.4579999999999999,0.4629999999999999,1,2016-01-14,41,35,6,0.8540000000000001,37,27,10,0.73
21500591,1610612762,1610612758,101.0,103.0,0.422,0.4589999999999999,0,2016-01-14,39,17,22,0.436,39,16,23,0.41
21500592,1610612744,1610612747,116.0,98.0,0.5,0.444,1,2016-01-14,40,37,3,0.925,41,9,32,0.22
21500577,1610612766,1610612737,107.0,84.0,0.439,0.37,1,2016-01-13,38,18,20,0.474,39,23,16,0.59
21500578,1610612764,1610612749,106.0,101.0,0.452,0.528,1,2016-01-13,37,18,19,0.486,41,16,25,0.39
21500579,1610612751,1610612752,110.0,104.0,0.523,0.451,1,2016-01-13,39,11,28,0.282,41,20,21,0.488
21500580,1610612738,1610612754,103.0,94.0,0.444,0.407,1,2016-01-13,39,20,19,0.513,39,22,17,0.564
21500581,1610612745,1610612750,107.0,104.0,0.493,0.462,1,2016-01-13,40,21,19,0.525,40,12,28,0.3
21500582,1610612760,1610612742,108.0,89.0,0.4629999999999999,0.39,1,2016-01-13,40,28,12,0.7,40,22,18,0.55
21500583,1610612743,1610612744,112.0,110.0,0.425,0.477,1,2016-01-13,39,15,24,0.385,39,36,3,0.923
21500584,1610612757,1610612762,99.0,85.0,0.4429999999999999,0.408,1,2016-01-13,41,17,24,0.415,38,17,21,0.447
21500585,1610612758,1610612740,97.0,109.0,0.488,0.42,0,2016-01-13,38,15,23,0.395,38,12,26,0.316
21500586,1610612746,1610612748,104.0,90.0,0.426,0.4429999999999999,1,2016-01-13,39,26,13,0.667,39,22,17,0.564
21500569,1610612754,1610612756,116.0,97.0,0.519,0.4039999999999999,1,2016-01-12,38,22,16,0.579,40,13,27,0.325
21500570,1610612765,1610612759,99.0,109.0,0.418,0.482,0,2016-01-12,38,21,17,0.5529999999999999,40,34,6,0.85
21500571,1610612752,1610612738,120.0,114.0,0.531,0.488,1,2016-01-12,40,20,20,0.5,38,19,19,0.5
21500572,1610612763,1610612745,91.0,107.0,0.4579999999999999,0.429,0,2016-01-12,40,21,19,0.525,39,20,19,0.513
21500573,1610612749,1610612741,106.0,101.0,0.462,0.412,1,2016-01-12,40,16,24,0.4,37,22,15,0.595
21500574,1610612750,1610612760,96.0,101.0,0.444,0.4639999999999999,0,2016-01-12,39,12,27,0.308,39,27,12,0.6920000000000001
21500575,1610612742,1610612739,107.0,110.0,0.494,0.412,0,2016-01-12,39,22,17,0.564,36,27,9,0.75
21500576,1610612747,1610612740,95.0,91.0,0.368,0.418,1,2016-01-12,40,9,31,0.225,37,11,26,0.297
21500566,1610612751,1610612759,79.0,106.0,0.452,0.537,0,2016-01-11,38,10,28,0.263,39,33,6,0.846
21500567,1610612741,1610612764,100.0,114.0,0.42,0.485,0,2016-01-11,36,22,14,0.611,36,17,19,0.472
21500568,1610612744,1610612748,111.0,103.0,0.477,0.451,1,2016-01-11,38,36,2,0.947,38,22,16,0.579
21500558,1610612746,1610612740,114.0,111.0,0.472,0.4,1,2016-01-10,38,25,13,0.6579999999999999,36,11,25,0.306
21500557,1610612750,1610612742,87.0,93.0,0.418,0.4679999999999999,0,2016-01-10,38,12,26,0.316,38,22,16,0.579
21500559,1610612755,1610612739,85.0,95.0,0.455,0.389,0,2016-01-10,40,4,36,0.1,35,26,9,0.743
21500560,1610612763,1610612738,101.0,98.0,0.369,0.42,1,2016-01-10,39,21,18,0.5379999999999999,37,19,18,0.514
21500561,1610612745,1610612754,107.0,103.0,0.4379999999999999,0.478,1,2016-01-10,38,19,19,0.5,37,21,16,0.568
21500562,1610612752,1610612749,100.0,88.0,0.4639999999999999,0.4,1,2016-01-10,39,19,20,0.487,39,15,24,0.385
21500563,1610612743,1610612766,95.0,92.0,0.416,0.361,1,2016-01-10,38,14,24,0.368,37,17,20,0.4589999999999999
21500564,1610612757,1610612760,115.0,110.0,0.42,0.487,1,2016-01-10,40,16,24,0.4,38,26,12,0.684
21500565,1610612747,1610612762,74.0,86.0,0.326,0.449,0,2016-01-10,39,8,31,0.205,37,17,20,0.4589999999999999
21500550,1610612746,1610612766,97.0,83.0,0.44,0.369,1,2016-01-09,37,24,13,0.649,36,17,19,0.472
21500551,1610612737,1610612741,120.0,105.0,0.521,0.434,1,2016-01-09,38,23,15,0.605,35,22,13,0.629
21500552,1610612753,1610612764,99.0,105.0,0.514,0.5529999999999999,0,2016-01-09,38,20,18,0.526,35,16,19,0.457
21500553,1610612765,1610612751,103.0,89.0,0.467,0.4629999999999999,1,2016-01-09,37,21,16,0.568,37,10,27,0.27
21500554,1610612755,1610612761,95.0,108.0,0.488,0.547,0,2016-01-09,39,4,35,0.103,39,24,15,0.615
21500555,1610612762,1610612748,98.0,83.0,0.5489999999999999,0.415,1,2016-01-09,36,16,20,0.444,37,22,15,0.595
21500556,1610612758,1610612744,116.0,128.0,0.467,0.563,0,2016-01-09,37,15,22,0.405,37,35,2,0.946
21500540,1610612764,1610612761,88.0,97.0,0.3929999999999999,0.4529999999999999,0,2016-01-08,34,15,19,0.441,38,23,15,0.605
21500541,1610612751,1610612753,77.0,83.0,0.397,0.3979999999999999,0,2016-01-08,36,10,26,0.278,37,20,17,0.541
21500542,1610612763,1610612743,91.0,84.0,0.366,0.368,1,2016-01-08,38,20,18,0.526,37,13,24,0.351
21500543,1610612750,1610612739,99.0,125.0,0.456,0.531,0,2016-01-08,37,12,25,0.324,34,25,9,0.735
21500544,1610612740,1610612754,86.0,91.0,0.373,0.444,0,2016-01-08,35,11,24,0.314,36,21,15,0.583
21500545,1610612749,1610612742,96.0,95.0,0.4629999999999999,0.417,1,2016-01-08,38,15,23,0.395,37,21,16,0.568
21500546,1610612759,1610612752,100.0,99.0,0.441,0.418,1,2016-01-08,38,32,6,0.8420000000000001,38,18,20,0.474
21500547,1610612756,1610612748,95.0,103.0,0.435,0.493,0,2016-01-08,39,13,26,0.3329999999999999,36,22,14,0.611
21500548,1610612757,1610612744,108.0,128.0,0.396,0.529,0,2016-01-08,39,15,24,0.385,36,34,2,0.944
21500549,1610612747,1610612760,113.0,117.0,0.476,0.506,0,2016-01-08,38,8,30,0.211,37,26,11,0.703
21500536,1610612755,1610612737,98.0,126.0,0.4529999999999999,0.5329999999999999,0,2016-01-07,38,4,34,0.105,37,22,15,0.595
21500537,1610612741,1610612738,101.0,92.0,0.415,0.357,1,2016-01-07,34,22,12,0.647,36,19,17,0.528
21500538,1610612745,1610612762,103.0,94.0,0.52,0.487,1,2016-01-07,37,18,19,0.486,35,15,20,0.429
21500539,1610612758,1610612747,118.0,115.0,0.5529999999999999,0.539,1,2016-01-07,36,15,21,0.417,37,8,29,0.216
21500525,1610612748,1610612752,90.0,98.0,0.451,0.557,0,2016-01-06,35,21,14,0.6,37,18,19,0.486
21500526,1610612753,1610612754,86.0,95.0,0.405,0.421,0,2016-01-06,36,19,17,0.528,35,20,15,0.5710000000000001
21500527,1610612764,1610612739,115.0,121.0,0.5529999999999999,0.539,0,2016-01-06,33,15,18,0.455,33,24,9,0.727
21500528,1610612738,1610612765,94.0,99.0,0.374,0.446,0,2016-01-06,35,19,16,0.5429999999999999,36,20,16,0.556
21500529,1610612751,1610612761,74.0,91.0,0.397,0.4379999999999999,0,2016-01-06,35,10,25,0.286,37,22,15,0.595
21500530,1610612750,1610612743,74.0,78.0,0.384,0.358,0,2016-01-06,36,12,24,0.3329999999999999,36,13,23,0.361
21500531,1610612740,1610612742,91.0,100.0,0.37,0.425,0,2016-01-06,34,11,23,0.324,36,21,15,0.583
21500532,1610612759,1610612762,123.0,98.0,0.605,0.4679999999999999,1,2016-01-06,37,31,6,0.838,34,15,19,0.441
21500533,1610612756,1610612766,111.0,102.0,0.488,0.4370000000000001,1,2016-01-06,38,13,25,0.342,35,17,18,0.486
21500534,1610612760,1610612763,112.0,94.0,0.4579999999999999,0.389,1,2016-01-06,36,25,11,0.6940000000000001,37,19,18,0.514
21500535,1610612757,1610612746,98.0,109.0,0.442,0.506,0,2016-01-06,38,15,23,0.395,36,23,13,0.639
21500521,1610612737,1610612752,101.0,107.0,0.425,0.476,0,2016-01-05,36,21,15,0.583,36,17,19,0.472
21500522,1610612741,1610612749,117.0,106.0,0.5539999999999999,0.451,1,2016-01-05,33,21,12,0.636,37,14,23,0.3779999999999999
21500523,1610612742,1610612758,117.0,116.0,0.4589999999999999,0.475,1,2016-01-05,35,20,15,0.5710000000000001,35,14,21,0.4
21500524,1610612747,1610612744,88.0,109.0,0.319,0.465,0,2016-01-05,36,8,28,0.222,35,33,2,0.943
21500511,1610612739,1610612761,122.0,100.0,0.5539999999999999,0.493,1,2016-01-04,32,23,9,0.7190000000000001,36,21,15,0.583
21500512,1610612755,1610612750,109.0,99.0,0.552,0.534,1,2016-01-04,37,4,33,0.108,35,12,23,0.3429999999999999
21500513,1610612751,1610612738,94.0,103.0,0.376,0.446,0,2016-01-04,34,10,24,0.294,34,19,15,0.5589999999999999
21500514,1610612765,1610612753,115.0,89.0,0.489,0.444,1,2016-01-04,35,19,16,0.5429999999999999,35,19,16,0.5429999999999999
21500515,1610612748,1610612754,103.0,100.0,0.3779999999999999,0.3939999999999999,1,2016-01-04,34,21,13,0.618,34,19,15,0.5589999999999999
21500516,1610612749,1610612759,98.0,123.0,0.481,0.544,0,2016-01-04,36,14,22,0.389,36,30,6,0.833
21500517,1610612760,1610612758,104.0,116.0,0.4379999999999999,0.449,0,2016-01-04,35,24,11,0.6859999999999999,34,14,20,0.412
21500518,1610612762,1610612745,91.0,93.0,0.4,0.485,0,2016-01-04,33,15,18,0.455,36,17,19,0.472
21500519,1610612757,1610612763,78.0,91.0,0.389,0.385,0,2016-01-04,37,15,22,0.405,36,19,17,0.528
21500520,1610612744,1610612766,111.0,101.0,0.517,0.442,1,2016-01-04,34,32,2,0.941,34,17,17,0.5
21500506,1610612752,1610612737,111.0,97.0,0.5,0.44,1,2016-01-03,35,16,19,0.457,35,21,14,0.6
21500507,1610612761,1610612741,113.0,115.0,0.457,0.512,0,2016-01-03,35,21,14,0.6,32,20,12,0.625
21500508,1610612764,1610612748,75.0,97.0,0.341,0.4529999999999999,0,2016-01-03,32,15,17,0.469,33,20,13,0.606
21500509,1610612743,1610612757,106.0,112.0,0.425,0.513,0,2016-01-03,35,12,23,0.3429999999999999,36,15,21,0.417
21500510,1610612747,1610612756,97.0,77.0,0.452,0.36,1,2016-01-03,35,8,27,0.2289999999999999,37,12,25,0.324
21500495,1610612738,1610612751,97.0,100.0,0.386,0.409,0,2016-01-02,33,18,15,0.545,33,10,23,0.303
21500496,1610612758,1610612756,142.0,119.0,0.609,0.518,1,2016-01-02,33,13,20,0.3939999999999999,36,12,24,0.3329999999999999
21500497,1610612766,1610612760,90.0,109.0,0.345,0.4429999999999999,0,2016-01-02,33,17,16,0.515,34,24,10,0.706
21500498,1610612754,1610612765,94.0,82.0,0.452,0.355,1,2016-01-02,33,19,14,0.5760000000000001,34,18,16,0.529
21500499,1610612739,1610612753,104.0,79.0,0.415,0.382,1,2016-01-02,31,22,9,0.71,34,19,15,0.5589999999999999
21500500,1610612750,1610612749,85.0,95.0,0.3929999999999999,0.4270000000000001,0,2016-01-02,34,12,22,0.353,35,14,21,0.4
21500501,1610612742,1610612740,98.0,105.0,0.434,0.482,0,2016-01-02,34,19,15,0.5589999999999999,33,11,22,0.3329999999999999
21500502,1610612759,1610612745,121.0,103.0,0.523,0.5,1,2016-01-02,35,29,6,0.8290000000000001,35,16,19,0.457
21500503,1610612762,1610612763,92.0,87.0,0.413,0.407,1,2016-01-02,32,15,17,0.469,35,18,17,0.514
21500504,1610612744,1610612743,111.0,108.0,0.5,0.419,1,2016-01-02,33,31,2,0.939,34,12,22,0.353
21500505,1610612746,1610612755,130.0,99.0,0.605,0.461,1,2016-01-02,35,22,13,0.629,36,3,33,0.083
21500490,1610612764,1610612753,103.0,91.0,0.467,0.471,1,2016-01-01,31,15,16,0.484,33,19,14,0.5760000000000001
21500491,1610612748,1610612742,106.0,82.0,0.561,0.364,1,2016-01-01,32,19,13,0.594,33,19,14,0.5760000000000001
21500492,1610612761,1610612766,104.0,94.0,0.396,0.4,1,2016-01-01,34,21,13,0.618,32,17,15,0.531
21500493,1610612741,1610612752,108.0,81.0,0.4589999999999999,0.369,1,2016-01-01,31,19,12,0.613,34,15,19,0.441
21500494,1610612747,1610612755,93.0,84.0,0.379,0.369,1,2016-01-01,34,7,27,0.206,35,3,32,0.086
21500484,1610612754,1610612749,116.0,120.0,0.5,0.584,0,2015-12-31,32,18,14,0.563,34,13,21,0.382
21500486,1610612765,1610612750,115.0,90.0,0.477,0.407,1,2015-12-31,33,18,15,0.545,33,12,21,0.364
21500485,1610612745,1610612744,110.0,114.0,0.462,0.512,0,2015-12-31,34,16,18,0.471,32,30,2,0.938
21500487,1610612740,1610612746,89.0,95.0,0.439,0.389,0,2015-12-31,32,10,22,0.313,34,21,13,0.618
21500488,1610612760,1610612756,110.0,106.0,0.525,0.524,1,2015-12-31,33,23,10,0.6970000000000001,35,12,23,0.3429999999999999
21500489,1610612762,1610612757,109.0,96.0,0.5,0.449,1,2015-12-31,31,14,17,0.452,35,14,21,0.4
21500474,1610612766,1610612746,117.0,122.0,0.4320000000000001,0.521,0,2015-12-30,31,17,14,0.5479999999999999,33,20,13,0.606
21500475,1610612753,1610612751,100.0,93.0,0.439,0.422,1,2015-12-30,32,19,13,0.594,32,9,23,0.281
21500476,1610612738,1610612747,104.0,112.0,0.4320000000000001,0.457,0,2015-12-30,32,18,14,0.563,33,6,27,0.182
21500477,1610612761,1610612764,94.0,91.0,0.341,0.402,1,2015-12-30,33,20,13,0.606,30,14,16,0.467
21500478,1610612741,1610612754,102.0,100.0,0.43,0.381,1,2015-12-30,30,18,12,0.6,31,18,13,0.581
21500479,1610612750,1610612762,94.0,80.0,0.4679999999999999,0.35,1,2015-12-30,32,12,20,0.375,30,13,17,0.433
21500480,1610612742,1610612744,114.0,91.0,0.512,0.407,1,2015-12-30,32,19,13,0.594,31,29,2,0.935
21500481,1610612759,1610612756,112.0,79.0,0.5660000000000001,0.395,1,2015-12-30,34,28,6,0.8240000000000001,34,12,22,0.353
21500482,1610612757,1610612743,110.0,103.0,0.471,0.425,1,2015-12-30,34,14,20,0.412,33,12,21,0.364
21500483,1610612758,1610612755,105.0,110.0,0.486,0.426,0,2015-12-30,32,12,20,0.375,34,3,31,0.088
21500469,1610612752,1610612765,108.0,96.0,0.544,0.416,1,2015-12-29,33,15,18,0.455,32,17,15,0.531
21500470,1610612745,1610612737,115.0,121.0,0.542,0.434,0,2015-12-29,33,16,17,0.485,34,21,13,0.618
21500471,1610612763,1610612748,99.0,90.0,0.4370000000000001,0.4429999999999999,1,2015-12-29,34,18,16,0.529,31,18,13,0.581
21500472,1610612760,1610612749,131.0,123.0,0.5,0.49,1,2015-12-29,32,22,10,0.688,33,12,21,0.364
21500473,1610612743,1610612739,87.0,93.0,0.416,0.442,0,2015-12-29,32,12,20,0.375,30,21,9,0.7
21500458,1610612766,1610612747,108.0,98.0,0.483,0.412,1,2015-12-28,30,17,13,0.5670000000000001,32,5,27,0.156
21500459,1610612754,1610612737,93.0,87.0,0.4370000000000001,0.419,1,2015-12-28,30,18,12,0.6,33,20,13,0.606
21500460,1610612753,1610612740,104.0,89.0,0.5489999999999999,0.446,1,2015-12-28,31,18,13,0.581,31,10,21,0.3229999999999999
21500461,1610612764,1610612746,91.0,108.0,0.391,0.526,0,2015-12-28,29,14,15,0.483,32,19,13,0.594
21500462,1610612748,1610612751,105.0,111.0,0.462,0.439,0,2015-12-28,30,18,12,0.6,31,9,22,0.29
21500463,1610612741,1610612761,104.0,97.0,0.46,0.4320000000000001,1,2015-12-28,29,17,12,0.586,32,19,13,0.594
21500464,1610612742,1610612749,103.0,93.0,0.452,0.481,1,2015-12-28,31,18,13,0.581,32,12,20,0.375
21500465,1610612759,1610612750,101.0,95.0,0.514,0.476,1,2015-12-28,33,27,6,0.818,31,11,20,0.355
21500466,1610612756,1610612739,97.0,101.0,0.456,0.465,0,2015-12-28,33,12,21,0.364,29,20,9,0.69
21500467,1610612762,1610612755,95.0,91.0,0.3329999999999999,0.419,1,2015-12-28,29,13,16,0.4479999999999999,33,2,31,0.061
21500468,1610612744,1610612758,122.0,103.0,0.483,0.389,1,2015-12-28,30,29,1,0.967,31,12,19,0.387
21500455,1610612763,1610612747,112.0,96.0,0.563,0.381,1,2015-12-27,33,17,16,0.515,31,5,26,0.161
21500454,1610612738,1610612752,100.0,91.0,0.424,0.371,1,2015-12-27,31,18,13,0.581,32,14,18,0.4379999999999999
21500456,1610612760,1610612743,122.0,112.0,0.578,0.489,1,2015-12-27,31,21,10,0.677,31,12,19,0.387
21500457,1610612758,1610612757,94.0,98.0,0.395,0.413,0,2015-12-27,30,12,18,0.4,33,13,20,0.3939999999999999
21500447,1610612751,1610612764,96.0,111.0,0.483,0.5,0,2015-12-26,30,8,22,0.267,28,14,14,0.5
21500441,1610612749,1610612761,90.0,111.0,0.42,0.519,0,2015-12-26,31,12,19,0.387,31,19,12,0.613
21500443,1610612766,1610612763,98.0,92.0,0.406,0.411,1,2015-12-26,29,16,13,0.552,32,16,16,0.5
21500444,1610612753,1610612748,101.0,108.0,0.544,0.494,0,2015-12-26,30,17,13,0.5670000000000001,29,18,11,0.621
21500445,1610612740,1610612745,110.0,108.0,0.507,0.452,1,2015-12-26,30,10,20,0.3329999999999999,32,16,16,0.5
21500442,1610612737,1610612752,117.0,98.0,0.534,0.481,1,2015-12-26,32,20,12,0.625,31,14,17,0.452
21500446,1610612765,1610612738,93.0,99.0,0.385,0.4639999999999999,0,2015-12-26,31,17,14,0.5479999999999999,30,17,13,0.5670000000000001
21500448,1610612750,1610612754,88.0,102.0,0.467,0.5,0,2015-12-26,30,11,19,0.3670000000000001,29,17,12,0.586
21500449,1610612742,1610612741,118.0,111.0,0.46,0.5379999999999999,1,2015-12-26,30,17,13,0.5670000000000001,28,16,12,0.5710000000000001
21500450,1610612759,1610612743,101.0,86.0,0.481,0.442,1,2015-12-26,32,26,6,0.813,30,12,18,0.4
21500451,1610612756,1610612755,104.0,111.0,0.386,0.481,0,2015-12-26,32,12,20,0.375,32,2,30,0.063
21500452,1610612762,1610612746,104.0,109.0,0.486,0.481,0,2015-12-26,28,12,16,0.429,31,18,13,0.581
21500453,1610612757,1610612739,105.0,76.0,0.461,0.364,1,2015-12-26,32,12,20,0.375,28,19,9,0.679
21500436,1610612748,1610612740,94.0,88.0,0.3979999999999999,0.4,1,2015-12-25,28,17,11,0.607,29,9,20,0.31
21500437,1610612760,1610612741,96.0,105.0,0.385,0.435,0,2015-12-25,30,20,10,0.667,27,16,11,0.593
21500438,1610612744,1610612739,89.0,83.0,0.41,0.316,1,2015-12-25,29,28,1,0.966,27,19,8,0.7040000000000001
21500439,1610612745,1610612759,88.0,84.0,0.4320000000000001,0.409,1,2015-12-25,31,16,15,0.516,31,25,6,0.8059999999999999
21500440,1610612747,1610612746,84.0,94.0,0.416,0.447,0,2015-12-25,30,5,25,0.1669999999999999,30,17,13,0.5670000000000001
21500423,1610612766,1610612738,89.0,102.0,0.358,0.424,0,2015-12-23,28,15,13,0.536,29,16,13,0.552
21500424,1610612739,1610612752,91.0,84.0,0.386,0.39,1,2015-12-23,26,19,7,0.731,30,14,16,0.467
21500425,1610612754,1610612758,106.0,108.0,0.461,0.517,0,2015-12-23,28,16,12,0.5710000000000001,29,12,17,0.414
21500426,1610612753,1610612745,104.0,101.0,0.524,0.494,1,2015-12-23,29,17,12,0.586,30,15,15,0.5
21500427,1610612764,1610612763,100.0,91.0,0.451,0.4579999999999999,1,2015-12-23,27,13,14,0.481,31,16,15,0.516
21500428,1610612751,1610612742,118.0,119.0,0.505,0.5489999999999999,0,2015-12-23,29,8,21,0.276,29,16,13,0.552
21500429,1610612737,1610612765,107.0,100.0,0.483,0.4270000000000001,1,2015-12-23,31,19,12,0.613,30,17,13,0.5670000000000001
21500430,1610612749,1610612755,113.0,100.0,0.6,0.457,1,2015-12-23,30,12,18,0.4,31,1,30,0.032
21500431,1610612750,1610612759,83.0,108.0,0.417,0.537,0,2015-12-23,29,11,18,0.379,30,25,5,0.833
21500432,1610612740,1610612757,115.0,89.0,0.482,0.347,1,2015-12-23,28,9,19,0.321,31,11,20,0.355
21500433,1610612756,1610612743,96.0,104.0,0.414,0.462,0,2015-12-23,31,12,19,0.387,29,12,17,0.414
21500434,1610612744,1610612762,103.0,85.0,0.47,0.413,1,2015-12-23,28,27,1,0.964,27,12,15,0.444
21500435,1610612747,1610612760,85.0,120.0,0.36,0.537,0,2015-12-23,29,5,24,0.172,29,20,9,0.69
21500419,1610612755,1610612763,90.0,104.0,0.47,0.471,0,2015-12-22,30,1,29,0.033,30,16,14,0.5329999999999999
21500420,1610612748,1610612765,92.0,93.0,0.4429999999999999,0.449,0,2015-12-22,27,16,11,0.593,29,17,12,0.586
21500421,1610612761,1610612742,103.0,99.0,0.473,0.435,1,2015-12-22,30,18,12,0.6,28,15,13,0.536
21500422,1610612743,1610612747,107.0,111.0,0.456,0.476,0,2015-12-22,28,11,17,0.3929999999999999,28,5,23,0.179
21500410,1610612764,1610612758,113.0,99.0,0.506,0.407,1,2015-12-21,26,12,14,0.462,28,11,17,0.3929999999999999
21500411,1610612738,1610612750,113.0,99.0,0.517,0.456,1,2015-12-21,28,15,13,0.536,28,11,17,0.3929999999999999
21500412,1610612752,1610612753,99.0,107.0,0.513,0.512,0,2015-12-21,29,14,15,0.483,28,16,12,0.5710000000000001
21500413,1610612737,1610612757,106.0,97.0,0.481,0.469,1,2015-12-21,30,18,12,0.6,30,11,19,0.3670000000000001
21500414,1610612741,1610612751,102.0,105.0,0.4529999999999999,0.457,0,2015-12-21,26,15,11,0.5770000000000001,28,8,20,0.286
21500415,1610612745,1610612766,102.0,95.0,0.465,0.349,1,2015-12-21,29,15,14,0.517,27,15,12,0.556
21500416,1610612759,1610612754,106.0,92.0,0.517,0.422,1,2015-12-21,29,24,5,0.828,27,16,11,0.593
21500417,1610612762,1610612756,110.0,89.0,0.456,0.392,1,2015-12-21,26,12,14,0.462,30,12,18,0.4
21500418,1610612746,1610612760,99.0,100.0,0.471,0.471,0,2015-12-21,29,16,13,0.552,28,19,9,0.679
21500403,1610612751,1610612750,85.0,100.0,0.41,0.475,0,2015-12-20,27,7,20,0.259,27,11,16,0.407
21500404,1610612748,1610612757,116.0,109.0,0.573,0.488,1,2015-12-20,26,16,10,0.615,29,11,18,0.379
21500405,1610612739,1610612755,108.0,86.0,0.471,0.349,1,2015-12-20,25,18,7,0.72,29,1,28,0.034
21500406,1610612756,1610612749,95.0,101.0,0.446,0.519,0,2015-12-20,29,12,17,0.414,29,11,18,0.379
21500407,1610612753,1610612737,100.0,103.0,0.469,0.5,0,2015-12-20,27,15,12,0.556,29,17,12,0.586
21500408,1610612761,1610612758,94.0,104.0,0.3720000000000001,0.526,0,2015-12-20,29,17,12,0.586,27,11,16,0.407
21500409,1610612743,1610612740,125.0,130.0,0.469,0.564,0,2015-12-20,27,11,16,0.407,27,8,19,0.296
21500398,1610612760,1610612747,118.0,78.0,0.5479999999999999,0.349,1,2015-12-19,27,18,9,0.667,27,4,23,0.148
21500399,1610612764,1610612766,109.0,101.0,0.506,0.419,1,2015-12-19,25,11,14,0.44,26,15,11,0.5770000000000001
21500400,1610612752,1610612741,107.0,91.0,0.5,0.3939999999999999,1,2015-12-19,28,14,14,0.5,25,15,10,0.6
21500401,1610612745,1610612746,107.0,97.0,0.447,0.395,1,2015-12-19,28,14,14,0.5,28,16,12,0.5710000000000001
21500402,1610612763,1610612754,96.0,84.0,0.446,0.39,1,2015-12-19,29,15,14,0.517,26,16,10,0.615
21500386,1610612754,1610612751,104.0,97.0,0.416,0.419,1,2015-12-18,25,16,9,0.64,26,7,19,0.2689999999999999
21500387,1610612753,1610612757,102.0,94.0,0.4639999999999999,0.4379999999999999,1,2015-12-18,26,15,11,0.5770000000000001,28,11,17,0.3929999999999999
21500388,1610612755,1610612752,97.0,107.0,0.481,0.471,0,2015-12-18,28,1,27,0.036,27,13,14,0.481
21500389,1610612738,1610612737,101.0,109.0,0.442,0.466,0,2015-12-18,27,14,13,0.519,28,16,12,0.5710000000000001
21500390,1610612748,1610612761,94.0,108.0,0.473,0.513,0,2015-12-18,25,15,10,0.6,28,17,11,0.607
21500391,1610612741,1610612765,144.0,147.0,0.417,0.452,0,2015-12-18,24,15,9,0.625,28,16,12,0.5710000000000001
21500392,1610612750,1610612758,99.0,95.0,0.476,0.469,1,2015-12-18,26,10,16,0.385,26,10,16,0.385
21500393,1610612759,1610612746,115.0,107.0,0.494,0.5,1,2015-12-18,28,23,5,0.821,27,16,11,0.593
21500394,1610612742,1610612763,97.0,88.0,0.436,0.375,1,2015-12-18,27,15,12,0.556,28,14,14,0.5
21500395,1610612762,1610612743,97.0,88.0,0.466,0.392,1,2015-12-18,25,11,14,0.44,26,11,15,0.423
21500396,1610612756,1610612740,104.0,88.0,0.524,0.366,1,2015-12-18,28,12,16,0.429,26,7,19,0.2689999999999999
21500397,1610612744,1610612749,121.0,112.0,0.483,0.462,1,2015-12-18,27,26,1,0.963,28,10,18,0.357
21500383,1610612766,1610612761,109.0,99.0,0.435,0.361,1,2015-12-17,25,15,10,0.6,27,16,11,0.593
21500384,1610612739,1610612760,104.0,100.0,0.466,0.473,1,2015-12-17,24,17,7,0.708,26,17,9,0.654
21500385,1610612747,1610612745,87.0,107.0,0.429,0.386,0,2015-12-17,26,4,22,0.154,27,13,14,0.481
21500371,1610612754,1610612742,107.0,81.0,0.483,0.3670000000000001,1,2015-12-16,24,15,9,0.625,26,14,12,0.5379999999999999
21500372,1610612753,1610612766,113.0,98.0,0.5579999999999999,0.456,1,2015-12-16,25,14,11,0.56,24,14,10,0.583
21500373,1610612751,1610612748,98.0,104.0,0.472,0.5329999999999999,0,2015-12-16,25,7,18,0.28,24,15,9,0.625
21500374,1610612765,1610612738,119.0,116.0,0.487,0.483,1,2015-12-16,27,15,12,0.556,26,14,12,0.5379999999999999
21500375,1610612752,1610612750,107.0,102.0,0.435,0.416,1,2015-12-16,26,12,14,0.462,25,9,16,0.36
21500376,1610612737,1610612755,127.0,106.0,0.615,0.52,1,2015-12-16,27,15,12,0.556,27,1,26,0.037
21500377,1610612741,1610612763,98.0,85.0,0.442,0.421,1,2015-12-16,23,15,8,0.652,27,14,13,0.519
21500378,1610612760,1610612757,106.0,90.0,0.481,0.348,1,2015-12-16,25,17,8,0.68,27,11,16,0.407
21500379,1610612759,1610612764,114.0,95.0,0.53,0.417,1,2015-12-16,27,22,5,0.815,24,10,14,0.417
21500380,1610612762,1610612740,94.0,104.0,0.478,0.466,0,2015-12-16,24,10,14,0.417,25,7,18,0.28
21500381,1610612744,1610612756,128.0,103.0,0.523,0.451,1,2015-12-16,26,25,1,0.962,27,11,16,0.407
21500382,1610612746,1610612749,103.0,90.0,0.48,0.4320000000000001,1,2015-12-16,26,16,10,0.615,27,10,17,0.37
21500367,1610612738,1610612739,77.0,89.0,0.322,0.462,0,2015-12-15,25,14,11,0.56,23,16,7,0.696
21500368,1610612750,1610612743,100.0,112.0,0.4679999999999999,0.562,0,2015-12-15,24,9,15,0.375,25,11,14,0.44
21500369,1610612758,1610612745,107.0,97.0,0.507,0.415,1,2015-12-15,25,10,15,0.4,26,12,14,0.462
21500370,1610612747,1610612749,113.0,95.0,0.461,0.471,1,2015-12-15,25,4,21,0.16,26,10,16,0.385
21500357,1610612754,1610612761,106.0,90.0,0.477,0.3670000000000001,1,2015-12-14,23,14,9,0.609,26,16,10,0.615
21500358,1610612751,1610612753,82.0,105.0,0.3879999999999999,0.539,0,2015-12-14,24,7,17,0.292,24,13,11,0.542
21500359,1610612765,1610612746,103.0,105.0,0.416,0.4539999999999999,0,2015-12-14,26,14,12,0.5379999999999999,25,15,10,0.6
21500360,1610612737,1610612748,88.0,100.0,0.3929999999999999,0.449,0,2015-12-14,26,14,12,0.5379999999999999,23,14,9,0.609
21500361,1610612741,1610612755,115.0,96.0,0.506,0.413,1,2015-12-14,22,14,8,0.636,26,1,25,0.038
21500362,1610612763,1610612764,112.0,95.0,0.564,0.43,1,2015-12-14,26,14,12,0.5379999999999999,23,10,13,0.435
21500363,1610612742,1610612756,104.0,94.0,0.494,0.413,1,2015-12-14,25,14,11,0.56,26,11,15,0.423
21500364,1610612759,1610612762,118.0,81.0,0.56,0.405,1,2015-12-14,26,21,5,0.8079999999999999,23,10,13,0.435
21500365,1610612743,1610612745,114.0,108.0,0.512,0.471,1,2015-12-14,24,10,14,0.417,25,12,13,0.48
21500366,1610612757,1610612740,105.0,101.0,0.4320000000000001,0.439,1,2015-12-14,26,11,15,0.423,24,6,18,0.25
21500353,1610612756,1610612750,108.0,101.0,0.4479999999999999,0.452,1,2015-12-13,25,11,14,0.44,23,9,14,0.391
21500354,1610612748,1610612763,100.0,97.0,0.481,0.519,1,2015-12-13,22,13,9,0.591,25,13,12,0.52
21500355,1610612761,1610612755,96.0,76.0,0.41,0.3329999999999999,1,2015-12-13,25,16,9,0.64,25,1,24,0.04
21500356,1610612760,1610612762,104.0,98.0,0.4429999999999999,0.415,1,2015-12-13,24,16,8,0.667,22,10,12,0.455
21500344,1610612751,1610612746,100.0,105.0,0.4429999999999999,0.5,0,2015-12-12,23,7,16,0.304,24,14,10,0.583
21500345,1610612766,1610612738,93.0,98.0,0.409,0.417,0,2015-12-12,23,14,9,0.609,24,14,10,0.583
21500346,1610612765,1610612754,118.0,96.0,0.5,0.5,1,2015-12-12,25,14,11,0.56,22,13,9,0.591
21500347,1610612737,1610612759,78.0,103.0,0.375,0.486,0,2015-12-12,25,14,11,0.56,25,20,5,0.8
21500348,1610612741,1610612740,98.0,94.0,0.423,0.449,1,2015-12-12,21,13,8,0.619,23,6,17,0.261
21500349,1610612745,1610612747,126.0,97.0,0.522,0.3979999999999999,1,2015-12-12,24,12,12,0.5,24,3,21,0.125
21500350,1610612742,1610612764,111.0,114.0,0.4270000000000001,0.518,0,2015-12-12,24,13,11,0.542,22,10,12,0.455
21500351,1610612749,1610612744,108.0,95.0,0.489,0.4039999999999999,1,2015-12-12,25,10,15,0.4,25,24,1,0.96
21500352,1610612757,1610612752,110.0,112.0,0.461,0.52,0,2015-12-12,25,10,15,0.4,25,11,14,0.44
21500333,1610612754,1610612748,96.0,83.0,0.419,0.4320000000000001,1,2015-12-11,21,13,8,0.619,21,12,9,0.5710000000000001
21500334,1610612753,1610612739,76.0,111.0,0.389,0.569,0,2015-12-11,23,12,11,0.522,22,15,7,0.682
21500335,1610612755,1610612765,95.0,107.0,0.45,0.462,0,2015-12-11,24,1,23,0.042,24,13,11,0.542
21500336,1610612738,1610612744,119.0,124.0,0.43,0.3929999999999999,0,2015-12-11,23,13,10,0.565,24,24,0,1.0
21500337,1610612761,1610612749,90.0,83.0,0.486,0.413,1,2015-12-11,24,15,9,0.625,24,9,15,0.375
21500338,1610612763,1610612766,99.0,123.0,0.4,0.5,0,2015-12-11,24,13,11,0.542,22,14,8,0.636
21500339,1610612740,1610612764,107.0,105.0,0.494,0.5,1,2015-12-11,22,6,16,0.273,21,9,12,0.429
21500340,1610612743,1610612750,111.0,108.0,0.442,0.4370000000000001,1,2015-12-11,23,9,14,0.391,22,9,13,0.409
21500341,1610612762,1610612760,90.0,94.0,0.423,0.4679999999999999,0,2015-12-11,21,10,11,0.476,23,15,8,0.652
21500342,1610612759,1610612747,109.0,87.0,0.537,0.409,1,2015-12-11,24,19,5,0.792,23,3,20,0.13
21500343,1610612756,1610612757,96.0,106.0,0.434,0.469,0,2015-12-11,24,10,14,0.417,24,10,14,0.417
21500329,1610612751,1610612755,100.0,91.0,0.5,0.391,1,2015-12-10,22,7,15,0.318,23,1,22,0.043
21500330,1610612741,1610612746,83.0,80.0,0.356,0.341,1,2015-12-10,20,12,8,0.6,23,13,10,0.565
21500331,1610612760,1610612737,107.0,94.0,0.488,0.449,1,2015-12-10,22,14,8,0.636,24,14,10,0.583
21500332,1610612758,1610612752,99.0,97.0,0.452,0.3979999999999999,1,2015-12-10,24,9,15,0.375,24,10,14,0.417
21500319,1610612738,1610612741,105.0,100.0,0.413,0.429,1,2015-12-09,22,13,9,0.591,19,11,8,0.579
21500320,1610612766,1610612748,99.0,81.0,0.494,0.387,1,2015-12-09,21,13,8,0.619,20,12,8,0.6
21500321,1610612764,1610612745,103.0,109.0,0.4379999999999999,0.482,0,2015-12-09,20,9,11,0.45,23,11,12,0.478
21500322,1610612765,1610612763,92.0,93.0,0.425,0.466,0,2015-12-09,23,12,11,0.522,23,13,10,0.565
21500323,1610612761,1610612759,97.0,94.0,0.578,0.447,1,2015-12-09,23,14,9,0.609,23,18,5,0.7829999999999999
21500324,1610612749,1610612746,95.0,109.0,0.467,0.469,0,2015-12-09,23,9,14,0.391,22,13,9,0.591
21500325,1610612750,1610612747,123.0,122.0,0.495,0.516,1,2015-12-09,21,9,12,0.429,22,3,19,0.136
21500326,1610612756,1610612753,107.0,104.0,0.513,0.471,1,2015-12-09,23,10,13,0.435,22,12,10,0.545
21500327,1610612762,1610612752,106.0,85.0,0.488,0.397,1,2015-12-09,20,10,10,0.5,23,10,13,0.435
21500328,1610612742,1610612737,95.0,98.0,0.36,0.481,0,2015-12-09,23,13,10,0.565,23,14,9,0.609
21500313,1610612739,1610612757,105.0,100.0,0.506,0.506,1,2015-12-08,21,14,7,0.667,23,9,14,0.391
21500314,1610612754,1610612744,123.0,131.0,0.44,0.547,0,2015-12-08,20,12,8,0.6,23,23,0,1.0
21500315,1610612751,1610612745,110.0,105.0,0.556,0.476,1,2015-12-08,21,6,15,0.286,22,10,12,0.455
21500316,1610612763,1610612760,88.0,125.0,0.407,0.56,0,2015-12-08,22,12,10,0.545,21,13,8,0.619
21500317,1610612743,1610612753,74.0,85.0,0.3329999999999999,0.4320000000000001,0,2015-12-08,22,8,14,0.364,21,12,9,0.5710000000000001
21500318,1610612758,1610612762,114.0,106.0,0.5579999999999999,0.413,1,2015-12-08,23,8,15,0.348,19,9,10,0.474
21500304,1610612766,1610612765,104.0,84.0,0.429,0.368,1,2015-12-07,20,12,8,0.6,22,12,10,0.545
21500305,1610612755,1610612759,68.0,119.0,0.347,0.618,0,2015-12-07,22,1,21,0.045,22,18,4,0.818
21500306,1610612748,1610612764,103.0,114.0,0.594,0.5,0,2015-12-07,19,12,7,0.632,19,9,10,0.474
21500307,1610612752,1610612742,97.0,104.0,0.476,0.451,0,2015-12-07,22,10,12,0.455,22,13,9,0.591
21500308,1610612761,1610612747,102.0,93.0,0.4589999999999999,0.41,1,2015-12-07,22,13,9,0.591,21,3,18,0.143
21500309,1610612741,1610612756,101.0,103.0,0.456,0.446,0,2015-12-07,18,11,7,0.611,22,9,13,0.409
21500310,1610612749,1610612757,90.0,88.0,0.411,0.3879999999999999,1,2015-12-07,22,9,13,0.409,22,9,13,0.409
21500311,1610612750,1610612746,106.0,110.0,0.439,0.442,0,2015-12-07,20,8,12,0.4,21,12,9,0.5710000000000001
21500312,1610612740,1610612738,93.0,111.0,0.411,0.494,0,2015-12-07,21,5,16,0.238,21,12,9,0.5710000000000001
21500299,1610612763,1610612756,95.0,93.0,0.4,0.439,1,2015-12-06,21,12,9,0.5710000000000001,21,8,13,0.381
21500300,1610612751,1610612744,98.0,114.0,0.4379999999999999,0.512,0,2015-12-06,20,5,15,0.25,22,22,0,1.0
21500301,1610612765,1610612747,111.0,91.0,0.441,0.4,1,2015-12-06,21,12,9,0.5710000000000001,20,3,17,0.15
21500302,1610612764,1610612742,104.0,116.0,0.472,0.5,0,2015-12-06,18,8,10,0.444,21,12,9,0.5710000000000001
21500303,1610612760,1610612758,98.0,95.0,0.407,0.3979999999999999,1,2015-12-06,20,12,8,0.6,22,7,15,0.318
21500289,1610612755,1610612743,105.0,108.0,0.5,0.457,0,2015-12-05,21,1,20,0.048,21,8,13,0.381
21500290,1610612761,1610612744,109.0,112.0,0.44,0.479,0,2015-12-05,21,12,9,0.5710000000000001,21,21,0,1.0
21500291,1610612748,1610612739,99.0,84.0,0.544,0.365,1,2015-12-05,18,12,6,0.667,20,13,7,0.65
21500292,1610612741,1610612766,96.0,102.0,0.416,0.416,0,2015-12-05,17,11,6,0.647,19,11,8,0.579
21500293,1610612745,1610612758,120.0,113.0,0.462,0.469,1,2015-12-05,21,10,11,0.476,21,7,14,0.3329999999999999
21500294,1610612750,1610612757,103.0,109.0,0.4579999999999999,0.506,0,2015-12-05,19,8,11,0.421,21,9,12,0.429
21500295,1610612749,1610612752,106.0,91.0,0.494,0.421,1,2015-12-05,21,8,13,0.381,21,10,11,0.476
21500296,1610612759,1610612738,108.0,105.0,0.53,0.4529999999999999,1,2015-12-05,21,17,4,0.81,20,11,9,0.55
21500297,1610612762,1610612754,122.0,119.0,0.467,0.43,1,2015-12-05,18,9,9,0.5,19,12,7,0.632
21500298,1610612746,1610612753,103.0,101.0,0.451,0.444,1,2015-12-05,20,11,9,0.55,20,11,9,0.55
21500283,1610612752,1610612751,108.0,91.0,0.4479999999999999,0.429,1,2015-12-04,20,10,10,0.5,19,5,14,0.263
21500284,1610612764,1610612756,109.0,106.0,0.488,0.512,1,2015-12-04,17,8,9,0.471,20,8,12,0.4
21500285,1610612765,1610612749,102.0,95.0,0.415,0.4479999999999999,1,2015-12-04,20,11,9,0.55,20,7,13,0.35
21500286,1610612737,1610612747,100.0,87.0,0.5,0.3720000000000001,1,2015-12-04,22,13,9,0.591,19,3,16,0.158
21500287,1610612742,1610612745,96.0,100.0,0.457,0.4639999999999999,0,2015-12-04,20,11,9,0.55,20,9,11,0.45
21500288,1610612740,1610612739,114.0,108.0,0.494,0.4379999999999999,1,2015-12-04,20,5,15,0.25,19,13,6,0.684
21500277,1610612748,1610612760,97.0,95.0,0.494,0.4429999999999999,1,2015-12-03,17,11,6,0.647,19,11,8,0.579
21500278,1610612761,1610612743,105.0,106.0,0.424,0.469,0,2015-12-03,20,12,8,0.6,20,7,13,0.35
21500279,1610612762,1610612753,94.0,103.0,0.431,0.449,0,2015-12-03,17,8,9,0.471,19,11,8,0.579
21500280,1610612763,1610612759,83.0,103.0,0.375,0.5,0,2015-12-03,20,11,9,0.55,20,16,4,0.8
21500281,1610612757,1610612754,123.0,111.0,0.518,0.4320000000000001,1,2015-12-03,20,8,12,0.4,18,12,6,0.667
21500282,1610612758,1610612738,97.0,114.0,0.377,0.476,0,2015-12-03,20,7,13,0.35,19,11,8,0.579
21500268,1610612766,1610612744,99.0,116.0,0.3720000000000001,0.523,0,2015-12-02,18,10,8,0.556,20,20,0,1.0
21500269,1610612764,1610612747,104.0,108.0,0.4679999999999999,0.4270000000000001,0,2015-12-02,16,7,9,0.4379999999999999,18,3,15,0.1669999999999999
21500270,1610612765,1610612756,127.0,122.0,0.506,0.485,1,2015-12-02,19,10,9,0.526,19,8,11,0.421
21500271,1610612752,1610612755,99.0,87.0,0.4320000000000001,0.3720000000000001,1,2015-12-02,19,9,10,0.474,20,1,19,0.05
21500272,1610612737,1610612761,86.0,96.0,0.3670000000000001,0.456,0,2015-12-02,21,12,9,0.5710000000000001,19,12,7,0.632
21500273,1610612741,1610612743,99.0,90.0,0.4039999999999999,0.387,1,2015-12-02,16,11,5,0.688,19,6,13,0.316
21500274,1610612745,1610612740,108.0,101.0,0.414,0.409,1,2015-12-02,19,8,11,0.421,19,4,15,0.211
21500275,1610612759,1610612749,95.0,70.0,0.411,0.3329999999999999,1,2015-12-02,19,15,4,0.789,19,7,12,0.368
21500276,1610612746,1610612754,91.0,103.0,0.38,0.421,0,2015-12-02,19,10,9,0.526,17,12,5,0.706
21500262,1610612739,1610612764,85.0,97.0,0.337,0.47,0,2015-12-01,18,13,5,0.722,15,7,8,0.467
21500263,1610612755,1610612747,103.0,91.0,0.4679999999999999,0.371,1,2015-12-01,19,1,18,0.053,17,2,15,0.118
21500264,1610612751,1610612756,94.0,91.0,0.488,0.44,1,2015-12-01,18,5,13,0.278,18,8,10,0.444
21500265,1610612750,1610612753,93.0,96.0,0.377,0.442,0,2015-12-01,18,8,10,0.444,18,10,8,0.556
21500266,1610612740,1610612763,104.0,113.0,0.4320000000000001,0.478,0,2015-12-01,18,4,14,0.222,19,11,8,0.579
21500267,1610612757,1610612742,112.0,115.0,0.41,0.457,0,2015-12-01,19,7,12,0.368,19,11,8,0.579
21500254,1610612765,1610612745,116.0,105.0,0.529,0.3979999999999999,1,2015-11-30,18,9,9,0.5,18,7,11,0.389
21500255,1610612748,1610612738,95.0,105.0,0.48,0.475,0,2015-11-30,16,10,6,0.625,18,10,8,0.556
21500256,1610612737,1610612760,106.0,100.0,0.433,0.3979999999999999,1,2015-11-30,20,12,8,0.6,18,11,7,0.611
21500257,1610612741,1610612759,92.0,89.0,0.43,0.411,1,2015-11-30,15,10,5,0.667,18,14,4,0.778
21500258,1610612749,1610612743,92.0,74.0,0.455,0.373,1,2015-11-30,18,7,11,0.389,18,6,12,0.3329999999999999
21500259,1610612762,1610612744,103.0,106.0,0.449,0.488,0,2015-11-30,16,8,8,0.5,19,19,0,1.0
21500260,1610612758,1610612742,112.0,98.0,0.456,0.429,1,2015-11-30,19,7,12,0.368,18,10,8,0.556
21500261,1610612746,1610612757,102.0,87.0,0.3879999999999999,0.379,1,2015-11-30,18,10,8,0.556,18,7,11,0.389
21500246,1610612766,1610612749,87.0,82.0,0.386,0.402,1,2015-11-29,17,10,7,0.588,17,6,11,0.353
21500247,1610612746,1610612750,107.0,99.0,0.52,0.451,1,2015-11-29,17,9,8,0.529,17,8,9,0.471
21500248,1610612751,1610612765,87.0,83.0,0.4320000000000001,0.337,1,2015-11-29,17,4,13,0.235,17,8,9,0.471
21500249,1610612753,1610612738,110.0,91.0,0.484,0.409,1,2015-11-29,17,9,8,0.529,17,9,8,0.529
21500250,1610612761,1610612756,102.0,107.0,0.442,0.426,0,2015-11-29,18,11,7,0.611,17,8,9,0.471
21500251,1610612763,1610612755,92.0,84.0,0.42,0.39,1,2015-11-29,18,10,8,0.556,18,0,18,0.0
21500252,1610612752,1610612745,111.0,116.0,0.5770000000000001,0.4529999999999999,0,2015-11-29,18,8,10,0.444,17,7,10,0.412
21500253,1610612747,1610612754,103.0,107.0,0.384,0.41,0,2015-11-29,16,2,14,0.125,16,11,5,0.688
21500239,1610612764,1610612761,82.0,84.0,0.3289999999999999,0.431,0,2015-11-28,14,6,8,0.429,17,11,6,0.647
21500240,1610612739,1610612751,90.0,88.0,0.402,0.407,1,2015-11-28,17,13,4,0.765,16,3,13,0.188
21500241,1610612742,1610612743,92.0,81.0,0.429,0.4,1,2015-11-28,17,10,7,0.588,17,6,11,0.353
21500242,1610612759,1610612737,108.0,88.0,0.471,0.425,1,2015-11-28,17,14,3,0.8240000000000001,19,11,8,0.579
21500243,1610612762,1610612740,101.0,87.0,0.4629999999999999,0.42,1,2015-11-28,15,8,7,0.5329999999999999,17,4,13,0.235
21500244,1610612757,1610612747,108.0,96.0,0.487,0.439,1,2015-11-28,17,7,10,0.412,15,2,13,0.133
21500245,1610612744,1610612758,120.0,101.0,0.488,0.39,1,2015-11-28,18,18,0,1.0,18,6,12,0.3329999999999999
21500227,1610612766,1610612739,90.0,95.0,0.413,0.42,0,2015-11-27,16,9,7,0.563,16,12,4,0.75
21500228,1610612753,1610612749,114.0,90.0,0.524,0.419,1,2015-11-27,16,8,8,0.5,16,6,10,0.375
21500229,1610612738,1610612764,111.0,78.0,0.433,0.321,1,2015-11-27,16,9,7,0.563,13,6,7,0.462
21500230,1610612752,1610612748,78.0,97.0,0.376,0.434,0,2015-11-27,17,8,9,0.471,15,10,5,0.667
21500231,1610612754,1610612741,104.0,92.0,0.425,0.348,1,2015-11-27,15,10,5,0.667,14,9,5,0.643
21500232,1610612745,1610612755,116.0,114.0,0.521,0.482,1,2015-11-27,16,6,10,0.375,17,0,17,0.0
21500233,1610612763,1610612737,101.0,116.0,0.4379999999999999,0.467,0,2015-11-27,17,9,8,0.529,18,11,7,0.611
21500234,1610612760,1610612765,103.0,87.0,0.4679999999999999,0.344,1,2015-11-27,17,11,6,0.647,16,8,8,0.5
21500235,1610612743,1610612759,80.0,91.0,0.4029999999999999,0.48,0,2015-11-27,16,6,10,0.375,16,13,3,0.813
21500236,1610612756,1610612744,116.0,135.0,0.489,0.568,0,2015-11-27,16,7,9,0.4379999999999999,17,17,0,1.0
21500237,1610612758,1610612750,91.0,101.0,0.43,0.481,0,2015-11-27,17,6,11,0.353,16,8,8,0.5
21500238,1610612746,1610612740,111.0,90.0,0.482,0.362,1,2015-11-27,16,8,8,0.5,16,4,12,0.25
21500215,1610612766,1610612764,101.0,87.0,0.47,0.356,1,2015-11-25,15,9,6,0.6,12,6,6,0.5
21500216,1610612753,1610612752,100.0,91.0,0.395,0.373,1,2015-11-25,15,7,8,0.467,16,8,8,0.5
21500217,1610612738,1610612755,84.0,80.0,0.341,0.373,1,2015-11-25,15,8,7,0.5329999999999999,16,0,16,0.0
21500218,1610612765,1610612748,104.0,81.0,0.418,0.405,1,2015-11-25,15,8,7,0.5329999999999999,14,9,5,0.643
21500219,1610612761,1610612739,103.0,99.0,0.506,0.439,1,2015-11-25,16,10,6,0.625,15,11,4,0.733
21500220,1610612745,1610612763,93.0,102.0,0.423,0.488,0,2015-11-25,15,5,10,0.3329999999999999,16,9,7,0.563
21500221,1610612749,1610612758,118.0,129.0,0.477,0.5710000000000001,0,2015-11-25,15,6,9,0.4,16,6,10,0.375
21500222,1610612750,1610612737,99.0,95.0,0.415,0.3779999999999999,1,2015-11-25,15,7,8,0.467,17,10,7,0.588
21500223,1610612760,1610612751,110.0,99.0,0.526,0.457,1,2015-11-25,16,10,6,0.625,15,3,12,0.2
21500224,1610612759,1610612742,88.0,83.0,0.407,0.41,1,2015-11-25,15,12,3,0.8,16,9,7,0.563
21500225,1610612756,1610612740,114.0,120.0,0.4579999999999999,0.519,0,2015-11-25,15,7,8,0.467,15,4,11,0.267
21500226,1610612746,1610612762,91.0,102.0,0.507,0.506,0,2015-11-25,15,7,8,0.467,14,7,7,0.5
21500209,1610612764,1610612754,106.0,123.0,0.4579999999999999,0.55,0,2015-11-24,11,6,5,0.545,14,9,5,0.643
21500210,1610612737,1610612738,121.0,97.0,0.563,0.415,1,2015-11-24,16,10,6,0.625,14,7,7,0.5
21500211,1610612763,1610612742,110.0,96.0,0.43,0.39,1,2015-11-24,15,8,7,0.5329999999999999,15,9,6,0.6
21500212,1610612743,1610612746,94.0,111.0,0.397,0.4679999999999999,0,2015-11-24,15,6,9,0.4,14,7,7,0.5
21500213,1610612757,1610612741,88.0,93.0,0.352,0.384,0,2015-11-24,16,6,10,0.375,13,9,4,0.6920000000000001
21500214,1610612744,1610612747,111.0,77.0,0.489,0.373,1,2015-11-24,16,16,0,1.0,14,2,12,0.143
21500202,1610612766,1610612758,127.0,122.0,0.5,0.5,1,2015-11-23,14,8,6,0.5710000000000001,15,5,10,0.3329999999999999
21500203,1610612739,1610612753,117.0,103.0,0.531,0.494,1,2015-11-23,14,11,3,0.7859999999999999,14,6,8,0.429
21500204,1610612748,1610612752,95.0,78.0,0.3829999999999999,0.322,1,2015-11-23,13,9,4,0.6920000000000001,15,8,7,0.5329999999999999
21500205,1610612749,1610612765,109.0,88.0,0.518,0.341,1,2015-11-23,14,6,8,0.429,14,7,7,0.5
21500206,1610612750,1610612755,100.0,95.0,0.462,0.41,1,2015-11-23,14,6,8,0.429,15,0,15,0.0
21500207,1610612759,1610612756,98.0,84.0,0.512,0.466,1,2015-11-23,14,11,3,0.7859999999999999,14,7,7,0.5
21500208,1610612762,1610612760,89.0,111.0,0.384,0.545,0,2015-11-23,13,6,7,0.462,15,9,6,0.6
21500196,1610612746,1610612761,80.0,91.0,0.392,0.3720000000000001,0,2015-11-22,13,6,7,0.462,15,9,6,0.6
21500197,1610612751,1610612738,111.0,101.0,0.506,0.4270000000000001,1,2015-11-22,14,3,11,0.214,13,7,6,0.5379999999999999
21500198,1610612740,1610612756,122.0,116.0,0.4589999999999999,0.389,1,2015-11-22,14,3,11,0.214,13,7,6,0.5379999999999999
21500199,1610612760,1610612742,117.0,114.0,0.522,0.53,1,2015-11-22,14,8,6,0.5710000000000001,14,9,5,0.643
21500200,1610612743,1610612744,105.0,118.0,0.43,0.528,0,2015-11-22,14,6,8,0.429,15,15,0,1.0
21500201,1610612747,1610612757,93.0,107.0,0.364,0.494,0,2015-11-22,13,2,11,0.154,15,6,9,0.4
21500189,1610612753,1610612758,91.0,97.0,0.413,0.3829999999999999,0,2015-11-21,13,6,7,0.462,14,5,9,0.357
21500190,1610612754,1610612749,123.0,86.0,0.516,0.43,1,2015-11-21,13,8,5,0.615,13,5,8,0.385
21500191,1610612739,1610612737,109.0,97.0,0.482,0.3720000000000001,1,2015-11-21,13,10,3,0.769,15,9,6,0.6
21500192,1610612765,1610612764,95.0,97.0,0.456,0.487,0,2015-11-21,13,7,6,0.5379999999999999,10,6,4,0.6
21500193,1610612748,1610612755,96.0,91.0,0.435,0.3779999999999999,1,2015-11-21,12,8,4,0.667,14,0,14,0.0
21500194,1610612745,1610612752,102.0,107.0,0.4320000000000001,0.425,0,2015-11-21,14,5,9,0.357,14,8,6,0.5710000000000001
21500195,1610612759,1610612763,92.0,82.0,0.472,0.4320000000000001,1,2015-11-21,13,10,3,0.769,14,7,7,0.5
21500178,1610612766,1610612755,113.0,88.0,0.494,0.405,1,2015-11-20,13,7,6,0.5379999999999999,13,0,13,0.0
21500179,1610612738,1610612751,120.0,95.0,0.586,0.3929999999999999,1,2015-11-20,12,7,5,0.583,13,2,11,0.154
21500180,1610612763,1610612745,96.0,84.0,0.424,0.3779999999999999,1,2015-11-20,13,7,6,0.5379999999999999,13,5,8,0.385
21500181,1610612750,1610612765,86.0,96.0,0.429,0.46,0,2015-11-20,13,5,8,0.385,12,7,5,0.583
21500182,1610612740,1610612759,104.0,90.0,0.455,0.405,1,2015-11-20,13,2,11,0.154,12,9,3,0.75
21500183,1610612760,1610612752,90.0,93.0,0.38,0.4579999999999999,0,2015-11-20,13,7,6,0.5379999999999999,13,7,6,0.5379999999999999
21500184,1610612742,1610612762,102.0,93.0,0.47,0.4379999999999999,1,2015-11-20,13,9,4,0.6920000000000001,12,6,6,0.5
21500185,1610612743,1610612756,107.0,114.0,0.456,0.506,0,2015-11-20,13,6,7,0.462,12,7,5,0.583
21500186,1610612757,1610612746,102.0,91.0,0.422,0.442,1,2015-11-20,14,5,9,0.357,12,6,6,0.5
21500187,1610612744,1610612741,106.0,94.0,0.494,0.3979999999999999,1,2015-11-20,14,14,0,1.0,12,8,4,0.667
21500188,1610612747,1610612761,91.0,102.0,0.455,0.436,0,2015-11-20,12,2,10,0.1669999999999999,14,8,6,0.5710000000000001
21500175,1610612748,1610612758,116.0,109.0,0.472,0.512,1,2015-11-19,11,7,4,0.636,13,4,9,0.308
21500176,1610612739,1610612749,115.0,100.0,0.563,0.521,1,2015-11-19,12,9,3,0.75,12,5,7,0.417
21500177,1610612746,1610612744,117.0,124.0,0.5,0.521,0,2015-11-19,11,6,5,0.545,13,13,0,1.0
21500165,1610612766,1610612751,116.0,111.0,0.488,0.484,1,2015-11-18,12,6,6,0.5,12,2,10,0.1669999999999999
21500166,1610612753,1610612750,104.0,101.0,0.373,0.424,1,2015-11-18,12,6,6,0.5,12,5,7,0.417
21500167,1610612755,1610612754,85.0,112.0,0.461,0.457,0,2015-11-18,12,0,12,0.0,12,7,5,0.583
21500168,1610612738,1610612742,102.0,106.0,0.413,0.514,0,2015-11-18,11,6,5,0.545,12,8,4,0.667
21500169,1610612737,1610612758,103.0,97.0,0.4270000000000001,0.442,1,2015-11-18,14,9,5,0.643,12,4,8,0.3329999999999999
21500170,1610612745,1610612757,108.0,103.0,0.348,0.3979999999999999,1,2015-11-18,12,5,7,0.417,13,4,9,0.308
21500171,1610612760,1610612740,110.0,103.0,0.447,0.4529999999999999,1,2015-11-18,12,7,5,0.583,12,1,11,0.083
21500172,1610612759,1610612743,109.0,98.0,0.488,0.3879999999999999,1,2015-11-18,11,9,2,0.818,12,6,6,0.5
21500173,1610612762,1610612761,93.0,89.0,0.486,0.425,1,2015-11-18,11,6,5,0.545,13,7,6,0.5379999999999999
21500174,1610612756,1610612741,97.0,103.0,0.407,0.494,0,2015-11-18,11,6,5,0.545,11,8,3,0.727
21500158,1610612764,1610612749,115.0,86.0,0.529,0.431,1,2015-11-17,9,5,4,0.556,11,5,6,0.455
21500159,1610612751,1610612737,90.0,88.0,0.44,0.434,1,2015-11-17,11,2,9,0.182,13,8,5,0.615
21500160,1610612765,1610612739,104.0,99.0,0.429,0.475,1,2015-11-17,11,6,5,0.545,11,8,3,0.727
21500161,1610612748,1610612750,91.0,103.0,0.456,0.371,0,2015-11-17,10,6,4,0.6,11,5,6,0.455
21500162,1610612752,1610612766,102.0,94.0,0.4039999999999999,0.439,1,2015-11-17,12,6,6,0.5,11,5,6,0.455
21500163,1610612740,1610612743,98.0,115.0,0.494,0.529,0,2015-11-17,11,1,10,0.091,11,6,5,0.545
21500164,1610612744,1610612761,115.0,110.0,0.5379999999999999,0.4679999999999999,1,2015-11-17,12,12,0,1.0,12,7,5,0.583
21500152,1610612755,1610612742,86.0,92.0,0.447,0.395,0,2015-11-16,11,0,11,0.0,11,7,4,0.636
21500153,1610612741,1610612754,96.0,95.0,0.407,0.402,1,2015-11-16,10,7,3,0.7,11,6,5,0.545
21500154,1610612745,1610612738,95.0,111.0,0.424,0.473,0,2015-11-16,11,4,7,0.364,10,6,4,0.6
21500155,1610612763,1610612760,122.0,114.0,0.44,0.506,1,2015-11-16,12,6,6,0.5,11,6,5,0.545
21500156,1610612759,1610612757,93.0,80.0,0.4270000000000001,0.413,1,2015-11-16,10,8,2,0.8,12,4,8,0.3329999999999999
21500157,1610612756,1610612747,120.0,101.0,0.484,0.481,1,2015-11-16,10,6,4,0.6,11,2,9,0.182
21500145,1610612752,1610612740,95.0,87.0,0.4320000000000001,0.451,1,2015-11-15,11,5,6,0.455,10,1,9,0.1
21500146,1610612750,1610612763,106.0,114.0,0.5,0.563,0,2015-11-15,10,4,6,0.4,11,5,6,0.455
21500147,1610612766,1610612757,106.0,94.0,0.494,0.3929999999999999,1,2015-11-15,10,5,5,0.5,11,4,7,0.364
21500148,1610612737,1610612762,96.0,97.0,0.487,0.513,0,2015-11-15,12,8,4,0.667,10,5,5,0.5
21500149,1610612760,1610612738,85.0,100.0,0.364,0.476,0,2015-11-15,10,6,4,0.6,9,5,4,0.556
21500150,1610612758,1610612761,107.0,101.0,0.513,0.4370000000000001,1,2015-11-15,11,4,7,0.364,11,7,4,0.636
21500151,1610612747,1610612765,97.0,85.0,0.413,0.365,1,2015-11-15,10,2,8,0.2,10,5,5,0.5
21500138,1610612746,1610612765,101.0,96.0,0.4679999999999999,0.446,1,2015-11-14,10,6,4,0.6,9,5,4,0.556
21500139,1610612764,1610612753,108.0,99.0,0.47,0.4370000000000001,1,2015-11-14,8,4,4,0.5,11,5,6,0.455
21500140,1610612745,1610612742,98.0,110.0,0.381,0.483,0,2015-11-14,10,4,6,0.4,10,6,4,0.6
21500141,1610612749,1610612739,108.0,105.0,0.422,0.407,1,2015-11-14,10,5,5,0.5,10,8,2,0.8
21500142,1610612759,1610612755,92.0,83.0,0.3879999999999999,0.402,1,2015-11-14,9,7,2,0.778,10,0,10,0.0
21500143,1610612756,1610612743,105.0,81.0,0.44,0.347,1,2015-11-14,9,5,4,0.556,10,5,5,0.5
21500144,1610612744,1610612751,107.0,99.0,0.4429999999999999,0.418,1,2015-11-14,11,11,0,1.0,10,1,9,0.1
21500127,1610612754,1610612750,107.0,103.0,0.477,0.506,1,2015-11-13,10,6,4,0.6,9,4,5,0.444
21500128,1610612753,1610612762,102.0,93.0,0.421,0.391,1,2015-11-13,10,5,5,0.5,9,4,5,0.444
21500129,1610612738,1610612737,106.0,93.0,0.408,0.474,1,2015-11-13,8,4,4,0.5,11,8,3,0.727
21500130,1610612752,1610612739,84.0,90.0,0.3670000000000001,0.423,0,2015-11-13,10,4,6,0.4,9,8,1,0.889
21500131,1610612761,1610612740,100.0,81.0,0.442,0.366,1,2015-11-13,10,7,3,0.7,9,1,8,0.111
21500132,1610612741,1610612766,102.0,97.0,0.44,0.379,1,2015-11-13,9,6,3,0.667,9,4,5,0.444
21500133,1610612763,1610612757,101.0,100.0,0.419,0.478,1,2015-11-13,10,4,6,0.4,10,4,6,0.4
21500134,1610612760,1610612755,102.0,85.0,0.402,0.349,1,2015-11-13,9,6,3,0.667,9,0,9,0.0
21500135,1610612742,1610612747,90.0,82.0,0.366,0.33,1,2015-11-13,9,5,4,0.556,9,1,8,0.111
21500136,1610612743,1610612745,107.0,98.0,0.457,0.429,1,2015-11-13,9,5,4,0.556,9,4,5,0.444
21500137,1610612758,1610612751,111.0,109.0,0.426,0.472,1,2015-11-13,10,3,7,0.3,9,1,8,0.111
21500124,1610612748,1610612762,92.0,91.0,0.4679999999999999,0.382,1,2015-11-12,9,6,3,0.667,8,4,4,0.5
21500125,1610612750,1610612744,116.0,129.0,0.494,0.539,0,2015-11-12,8,4,4,0.5,10,10,0,1.0
21500126,1610612756,1610612746,118.0,104.0,0.53,0.444,1,2015-11-12,8,4,4,0.5,9,5,4,0.556
21500113,1610612766,1610612752,95.0,93.0,0.417,0.488,1,2015-11-11,8,4,4,0.5,9,4,5,0.444
21500114,1610612753,1610612747,101.0,99.0,0.4,0.494,1,2015-11-11,9,4,5,0.444,8,1,7,0.125
21500115,1610612755,1610612761,103.0,119.0,0.46,0.483,0,2015-11-11,8,0,8,0.0,9,6,3,0.667
21500116,1610612738,1610612754,91.0,102.0,0.416,0.481,0,2015-11-11,7,3,4,0.429,9,5,4,0.556
21500117,1610612737,1610612740,106.0,98.0,0.488,0.446,1,2015-11-11,10,8,2,0.8,8,1,7,0.125
21500118,1610612742,1610612746,118.0,108.0,0.5529999999999999,0.43,1,2015-11-11,8,4,4,0.5,8,5,3,0.625
21500119,1610612745,1610612751,98.0,106.0,0.429,0.429,0,2015-11-11,8,4,4,0.5,8,1,7,0.125
21500120,1610612763,1610612744,84.0,100.0,0.3429999999999999,0.48,0,2015-11-11,9,3,6,0.3329999999999999,9,9,0,1.0
21500121,1610612743,1610612749,103.0,102.0,0.494,0.532,1,2015-11-11,8,4,4,0.5,9,4,5,0.444
21500122,1610612758,1610612765,101.0,92.0,0.5,0.382,1,2015-11-11,9,2,7,0.222,8,5,3,0.625
21500123,1610612757,1610612759,101.0,113.0,0.4429999999999999,0.561,0,2015-11-11,9,4,5,0.444,8,6,2,0.75
21500106,1610612739,1610612762,118.0,114.0,0.5,0.488,1,2015-11-10,8,7,1,0.875,7,4,3,0.5710000000000001
21500107,1610612764,1610612760,101.0,125.0,0.392,0.512,0,2015-11-10,7,3,4,0.429,8,5,3,0.625
21500108,1610612748,1610612747,101.0,88.0,0.452,0.442,1,2015-11-10,8,5,3,0.625,7,1,6,0.143
21500109,1610612761,1610612752,109.0,111.0,0.44,0.442,0,2015-11-10,8,5,3,0.625,8,4,4,0.5
21500110,1610612749,1610612738,83.0,99.0,0.411,0.442,0,2015-11-10,8,4,4,0.5,6,3,3,0.5
21500111,1610612750,1610612766,95.0,104.0,0.45,0.487,0,2015-11-10,7,4,3,0.5710000000000001,7,3,4,0.429
21500112,1610612740,1610612742,120.0,105.0,0.5,0.4429999999999999,1,2015-11-10,7,1,6,0.143,7,3,4,0.429
21500099,1610612754,1610612753,97.0,84.0,0.442,0.397,1,2015-11-09,8,4,4,0.5,8,3,5,0.375
21500100,1610612755,1610612741,88.0,111.0,0.35,0.4270000000000001,0,2015-11-09,7,0,7,0.0,8,5,3,0.625
21500101,1610612737,1610612750,107.0,117.0,0.512,0.575,0,2015-11-09,9,7,2,0.778,6,4,2,0.667
21500102,1610612743,1610612757,108.0,104.0,0.519,0.396,1,2015-11-09,7,3,4,0.429,8,4,4,0.5
21500103,1610612758,1610612759,88.0,106.0,0.405,0.529,0,2015-11-09,8,1,7,0.125,7,5,2,0.7140000000000001
21500104,1610612744,1610612765,109.0,95.0,0.473,0.471,1,2015-11-09,8,8,0,1.0,7,5,2,0.7140000000000001
21500105,1610612746,1610612763,94.0,92.0,0.412,0.4379999999999999,1,2015-11-09,7,5,2,0.7140000000000001,8,3,5,0.375
21500094,1610612739,1610612754,101.0,97.0,0.4579999999999999,0.433,1,2015-11-08,7,6,1,0.857,7,3,4,0.429
21500095,1610612752,1610612747,99.0,95.0,0.3929999999999999,0.3829999999999999,1,2015-11-08,7,3,4,0.429,6,1,5,0.1669999999999999
21500096,1610612748,1610612761,96.0,76.0,0.422,0.3939999999999999,1,2015-11-08,7,4,3,0.5710000000000001,7,5,2,0.7140000000000001
21500097,1610612760,1610612756,124.0,103.0,0.521,0.452,1,2015-11-08,7,4,3,0.5710000000000001,7,3,4,0.429
21500098,1610612757,1610612765,103.0,120.0,0.539,0.49,0,2015-11-08,7,4,3,0.5710000000000001,6,5,1,0.833
21500085,1610612741,1610612750,93.0,102.0,0.355,0.406,0,2015-11-07,7,4,3,0.5710000000000001,5,3,2,0.6
21500087,1610612755,1610612753,97.0,105.0,0.45,0.47,0,2015-11-07,6,0,6,0.0,7,3,4,0.429
21500086,1610612737,1610612764,114.0,99.0,0.467,0.487,1,2015-11-07,8,7,1,0.875,6,3,3,0.5
21500088,1610612742,1610612740,107.0,98.0,0.476,0.4529999999999999,1,2015-11-07,6,3,3,0.5,6,0,6,0.0
21500089,1610612749,1610612751,94.0,86.0,0.451,0.415,1,2015-11-07,7,4,3,0.5710000000000001,7,0,7,0.0
21500090,1610612759,1610612766,114.0,94.0,0.556,0.466,1,2015-11-07,6,4,2,0.667,6,2,4,0.3329999999999999
21500091,1610612762,1610612763,89.0,79.0,0.419,0.33,1,2015-11-07,6,4,2,0.667,7,3,4,0.429
21500092,1610612758,1610612744,94.0,103.0,0.4370000000000001,0.413,0,2015-11-07,7,1,6,0.143,7,7,0,1.0
21500093,1610612746,1610612745,105.0,109.0,0.477,0.442,0,2015-11-07,6,4,2,0.667,7,4,3,0.5710000000000001
21500075,1610612753,1610612761,92.0,87.0,0.429,0.349,1,2015-11-06,6,2,4,0.3329999999999999,6,5,1,0.833
21500076,1610612738,1610612764,118.0,98.0,0.4539999999999999,0.409,1,2015-11-06,5,2,3,0.4,5,3,2,0.6
21500077,1610612751,1610612747,98.0,104.0,0.43,0.423,0,2015-11-06,6,0,6,0.0,5,1,4,0.2
21500078,1610612739,1610612755,108.0,102.0,0.511,0.519,1,2015-11-06,6,5,1,0.833,5,0,5,0.0
21500079,1610612752,1610612749,92.0,99.0,0.407,0.4320000000000001,0,2015-11-06,6,2,4,0.3329999999999999,6,3,3,0.5
21500080,1610612754,1610612748,90.0,87.0,0.45,0.444,1,2015-11-06,6,3,3,0.5,6,3,3,0.5
21500081,1610612740,1610612737,115.0,121.0,0.5,0.532,0,2015-11-06,5,0,5,0.0,7,6,1,0.857
21500082,1610612756,1610612765,92.0,100.0,0.402,0.5,0,2015-11-06,6,3,3,0.5,5,4,1,0.8
21500083,1610612744,1610612743,119.0,104.0,0.495,0.424,1,2015-11-06,6,6,0,1.0,6,2,4,0.3329999999999999
21500084,1610612758,1610612745,110.0,116.0,0.43,0.488,0,2015-11-06,6,1,5,0.1669999999999999,6,3,3,0.5
21500070,1610612741,1610612760,104.0,98.0,0.444,0.452,1,2015-11-05,6,4,2,0.667,6,3,3,0.5
21500071,1610612750,1610612748,84.0,96.0,0.353,0.487,0,2015-11-05,4,2,2,0.5,5,3,2,0.6
21500072,1610612742,1610612766,94.0,108.0,0.39,0.494,0,2015-11-05,5,2,3,0.4,5,2,3,0.4
21500073,1610612743,1610612762,84.0,96.0,0.389,0.435,0,2015-11-05,5,2,3,0.4,5,3,2,0.6
21500074,1610612757,1610612763,115.0,96.0,0.506,0.481,1,2015-11-05,6,4,2,0.667,6,3,3,0.5
21500060,1610612754,1610612738,100.0,98.0,0.385,0.422,1,2015-11-04,5,2,3,0.4,4,1,3,0.25
21500061,1610612764,1610612759,102.0,99.0,0.483,0.457,1,2015-11-04,4,3,1,0.75,5,3,2,0.6
21500062,1610612737,1610612751,101.0,87.0,0.487,0.434,1,2015-11-04,6,5,1,0.833,5,0,5,0.0
21500063,1610612739,1610612752,96.0,86.0,0.3979999999999999,0.3929999999999999,1,2015-11-04,5,4,1,0.8,5,2,3,0.4
21500064,1610612745,1610612753,119.0,114.0,0.477,0.505,1,2015-11-04,5,2,3,0.4,5,1,4,0.2
21500065,1610612749,1610612755,91.0,87.0,0.407,0.42,1,2015-11-04,5,2,3,0.4,4,0,4,0.0
21500066,1610612760,1610612761,98.0,103.0,0.476,0.418,0,2015-11-04,5,3,2,0.6,5,5,0,1.0
21500067,1610612756,1610612758,118.0,97.0,0.542,0.476,1,2015-11-04,5,3,2,0.6,5,1,4,0.2
21500068,1610612762,1610612757,92.0,108.0,0.375,0.532,0,2015-11-04,4,2,2,0.5,5,3,2,0.6
21500069,1610612744,1610612746,112.0,108.0,0.4589999999999999,0.489,1,2015-11-04,5,5,0,1.0,5,4,1,0.8
21500053,1610612766,1610612741,130.0,105.0,0.516,0.489,1,2015-11-03,4,1,3,0.25,5,3,2,0.6
21500054,1610612765,1610612754,82.0,94.0,0.384,0.4320000000000001,0,2015-11-03,4,3,1,0.75,4,1,3,0.25
21500055,1610612748,1610612737,92.0,98.0,0.442,0.411,0,2015-11-03,4,2,2,0.5,5,4,1,0.8
21500056,1610612740,1610612753,94.0,103.0,0.356,0.467,0,2015-11-03,4,0,4,0.0,4,1,3,0.25
21500057,1610612742,1610612761,91.0,102.0,0.384,0.451,0,2015-11-03,4,2,2,0.5,4,4,0,1.0
21500058,1610612758,1610612763,89.0,103.0,0.392,0.482,0,2015-11-03,4,1,3,0.25,5,3,2,0.6
21500059,1610612747,1610612743,109.0,120.0,0.419,0.506,0,2015-11-03,4,0,4,0.0,4,2,2,0.5
21500046,1610612755,1610612739,100.0,107.0,0.447,0.519,0,2015-11-02,3,0,3,0.0,4,3,1,0.75
21500047,1610612751,1610612749,96.0,103.0,0.456,0.521,0,2015-11-02,4,0,4,0.0,4,1,3,0.25
21500048,1610612752,1610612759,84.0,94.0,0.36,0.494,0,2015-11-02,4,2,2,0.5,4,3,1,0.75
21500049,1610612745,1610612760,110.0,105.0,0.461,0.476,1,2015-11-02,4,1,3,0.25,4,3,1,0.75
21500050,1610612750,1610612757,101.0,106.0,0.43,0.461,0,2015-11-02,3,2,1,0.667,4,2,2,0.5
21500051,1610612744,1610612763,119.0,69.0,0.512,0.271,1,2015-11-02,4,4,0,1.0,4,2,2,0.5
21500052,1610612746,1610612756,102.0,96.0,0.457,0.3670000000000001,1,2015-11-02,4,4,0,1.0,4,2,2,0.5
21500039,1610612766,1610612737,92.0,94.0,0.3720000000000001,0.42,0,2015-11-01,3,0,3,0.0,4,3,1,0.75
21500040,1610612738,1610612759,87.0,95.0,0.357,0.434,0,2015-11-01,3,1,2,0.3329999999999999,3,2,1,0.667
21500041,1610612748,1610612745,109.0,89.0,0.488,0.405,1,2015-11-01,3,2,1,0.667,3,0,3,0.0
21500042,1610612761,1610612749,106.0,87.0,0.456,0.42,1,2015-11-01,3,3,0,1.0,3,0,3,0.0
21500043,1610612741,1610612753,92.0,87.0,0.379,0.389,1,2015-11-01,4,3,1,0.75,3,0,3,0.0
21500044,1610612760,1610612743,117.0,93.0,0.523,0.38,1,2015-11-01,3,3,0,1.0,3,1,2,0.3329999999999999
21500045,1610612747,1610612742,93.0,103.0,0.365,0.46,0,2015-11-01,3,0,3,0.0,3,2,1,0.667
21500033,1610612754,1610612762,76.0,97.0,0.4,0.4429999999999999,0,2015-10-31,3,0,3,0.0,3,2,1,0.667
21500034,1610612764,1610612752,110.0,117.0,0.422,0.477,0,2015-10-31,3,2,1,0.667,3,2,1,0.667
21500035,1610612740,1610612744,120.0,134.0,0.46,0.5479999999999999,0,2015-10-31,3,0,3,0.0,3,3,0,1.0
21500036,1610612763,1610612751,101.0,91.0,0.425,0.481,1,2015-10-31,3,2,1,0.667,3,0,3,0.0
21500037,1610612757,1610612756,90.0,101.0,0.418,0.415,0,2015-10-31,3,1,2,0.3329999999999999,3,2,1,0.667
21500038,1610612746,1610612758,114.0,109.0,0.513,0.426,1,2015-10-31,3,3,0,1.0,3,1,2,0.3329999999999999
21500021,1610612739,1610612748,102.0,92.0,0.4529999999999999,0.429,1,2015-10-30,3,2,1,0.667,2,1,1,0.5
21500022,1610612753,1610612760,136.0,139.0,0.4429999999999999,0.455,0,2015-10-30,2,0,2,0.0,2,2,0,1.0
21500023,1610612755,1610612762,71.0,99.0,0.302,0.409,0,2015-10-30,2,0,2,0.0,2,1,1,0.5
21500024,1610612738,1610612761,103.0,113.0,0.376,0.439,0,2015-10-30,2,1,1,0.5,2,2,0,1.0
21500025,1610612765,1610612741,98.0,94.0,0.375,0.405,1,2015-10-30,3,3,0,1.0,3,2,1,0.667
21500026,1610612737,1610612766,97.0,94.0,0.434,0.409,1,2015-10-30,3,2,1,0.667,2,0,2,0.0
21500027,1610612749,1610612764,113.0,118.0,0.512,0.515,0,2015-10-30,2,0,2,0.0,2,2,0,1.0
21500028,1610612759,1610612751,102.0,75.0,0.465,0.4029999999999999,1,2015-10-30,2,1,1,0.5,2,0,2,0.0
21500029,1610612743,1610612750,78.0,95.0,0.305,0.423,0,2015-10-30,2,1,1,0.5,2,2,0,1.0
21500030,1610612745,1610612744,92.0,112.0,0.366,0.462,0,2015-10-30,2,0,2,0.0,2,2,0,1.0
21500031,1610612758,1610612747,132.0,114.0,0.515,0.461,1,2015-10-30,2,1,1,0.5,2,0,2,0.0
21500032,1610612756,1610612757,110.0,92.0,0.446,0.395,1,2015-10-30,2,1,1,0.5,2,1,1,0.5
21500018,1610612754,1610612763,103.0,112.0,0.474,0.5,0,2015-10-29,2,0,2,0.0,2,1,1,0.5
21500019,1610612752,1610612737,101.0,112.0,0.409,0.506,0,2015-10-29,2,1,1,0.5,2,1,1,0.5
21500020,1610612746,1610612742,104.0,88.0,0.4370000000000001,0.361,1,2015-10-29,2,2,0,1.0,2,1,1,0.5
21500004,1610612753,1610612764,87.0,88.0,0.37,0.3929999999999999,0,2015-10-28,1,0,1,0.0,1,1,0,1.0
21500005,1610612738,1610612755,112.0,95.0,0.4589999999999999,0.41,1,2015-10-28,1,1,0,1.0,1,0,1,0.0
21500006,1610612751,1610612741,100.0,115.0,0.419,0.5379999999999999,0,2015-10-28,1,0,1,0.0,2,2,0,1.0
21500007,1610612765,1610612762,92.0,87.0,0.405,0.467,1,2015-10-28,2,2,0,1.0,1,0,1,0.0
21500008,1610612748,1610612766,104.0,94.0,0.493,0.3929999999999999,1,2015-10-28,1,1,0,1.0,1,0,1,0.0
21500009,1610612761,1610612754,106.0,99.0,0.45,0.3720000000000001,1,2015-10-28,1,1,0,1.0,1,0,1,0.0
21500010,1610612745,1610612743,85.0,105.0,0.345,0.506,0,2015-10-28,1,0,1,0.0,1,1,0,1.0
21500011,1610612763,1610612739,76.0,106.0,0.354,0.488,0,2015-10-28,1,0,1,0.0,2,1,1,0.5
21500012,1610612749,1610612752,97.0,122.0,0.349,0.452,0,2015-10-28,1,0,1,0.0,1,1,0,1.0
21500013,1610612760,1610612759,112.0,106.0,0.488,0.484,1,2015-10-28,1,1,0,1.0,1,0,1,0.0
21500014,1610612756,1610612742,95.0,111.0,0.391,0.471,0,2015-10-28,1,0,1,0.0,1,1,0,1.0
21500015,1610612757,1610612740,112.0,94.0,0.5,0.396,1,2015-10-28,1,1,0,1.0,2,0,2,0.0
21500016,1610612758,1610612746,104.0,111.0,0.436,0.525,0,2015-10-28,1,0,1,0.0,1,1,0,1.0
21500017,1610612747,1610612750,111.0,112.0,0.389,0.4579999999999999,0,2015-10-28,1,0,1,0.0,1,1,0,1.0
21500001,1610612737,1610612765,94.0,106.0,0.451,0.385,0,2015-10-27,1,0,1,0.0,1,1,0,1.0
21500002,1610612741,1610612739,97.0,95.0,0.425,0.4039999999999999,1,2015-10-27,1,1,0,1.0,1,0,1,0.0
21500003,1610612744,1610612740,111.0,95.0,0.4270000000000001,0.422,1,2015-10-27,1,1,0,1.0,1,0,1,0.0
11500102,1610612753,1610612763,86.0,76.0,0.381,0.3289999999999999,1,2015-10-23,8,6,2,0.75,7,6,1,0.857
11500106,1610612738,1610612755,81.0,65.0,0.35,0.289,1,2015-10-23,7,6,1,0.857,7,2,5,0.286
11500107,1610612761,1610612764,92.0,82.0,0.359,0.392,1,2015-10-23,7,5,2,0.7140000000000001,7,4,3,0.5710000000000001
11500108,1610612765,1610612737,115.0,87.0,0.535,0.413,1,2015-10-23,8,3,5,0.375,7,4,3,0.5710000000000001
11500103,1610612741,1610612742,103.0,102.0,0.446,0.42,1,2015-10-23,8,4,4,0.5,7,0,7,0.0
11500104,1610612740,1610612748,93.0,90.0,0.3329999999999999,0.417,1,2015-10-23,7,3,4,0.429,8,4,4,0.5
11500105,1610612750,1610612749,112.0,108.0,0.482,0.4379999999999999,1,2015-10-23,7,2,5,0.286,6,2,4,0.3329999999999999
11500109,1610612759,1610612745,111.0,86.0,0.513,0.386,1,2015-10-23,6,2,4,0.3329999999999999,8,3,5,0.375
11500097,1610612754,1610612766,98.0,86.0,0.43,0.3779999999999999,1,2015-10-22,7,5,2,0.7140000000000001,8,7,1,0.875
11500100,1610612738,1610612752,99.0,85.0,0.422,0.384,1,2015-10-22,6,5,1,0.833,6,4,2,0.667
11500098,1610612762,1610612743,98.0,78.0,0.536,0.363,1,2015-10-22,7,3,4,0.429,7,4,3,0.5710000000000001
11500099,1610612747,1610612744,97.0,136.0,0.413,0.547,0,2015-10-22,8,3,5,0.375,7,3,4,0.429
11500101,1610612746,1610612757,115.0,109.0,0.53,0.4589999999999999,1,2015-10-22,6,3,3,0.5,7,3,4,0.429
11500092,1610612753,1610612740,110.0,107.0,0.402,0.3779999999999999,1,2015-10-21,7,5,2,0.7140000000000001,6,2,4,0.3329999999999999
11500093,1610612765,1610612766,94.0,99.0,0.382,0.39,0,2015-10-21,7,2,5,0.286,7,7,0,1.0
11500095,1610612737,1610612763,81.0,82.0,0.3779999999999999,0.326,0,2015-10-21,6,4,2,0.667,6,6,0,1.0
11500096,1610612748,1610612764,110.0,105.0,0.409,0.419,1,2015-10-21,7,4,3,0.5710000000000001,6,4,2,0.667
11500094,1610612742,1610612756,87.0,99.0,0.365,0.4270000000000001,0,2015-10-21,6,0,6,0.0,6,4,2,0.667
11500087,1610612741,1610612754,103.0,94.0,0.449,0.384,1,2015-10-20,7,3,4,0.429,6,4,2,0.667
11500088,1610612749,1610612750,106.0,88.0,0.506,0.3289999999999999,1,2015-10-20,5,2,3,0.4,6,1,5,0.1669999999999999
11500090,1610612759,1610612756,84.0,104.0,0.44,0.526,0,2015-10-20,5,1,4,0.2,5,3,2,0.6
11500089,1610612762,1610612760,102.0,113.0,0.4679999999999999,0.57,0,2015-10-20,6,2,4,0.3329999999999999,6,5,1,0.833
11500091,1610612746,1610612744,130.0,95.0,0.5489999999999999,0.41,1,2015-10-20,5,2,3,0.4,6,2,4,0.3329999999999999
11500082,1610612766,1610612741,94.0,86.0,0.416,0.376,1,2015-10-19,6,6,0,1.0,6,2,4,0.3329999999999999
11500083,1610612739,1610612742,103.0,97.0,0.389,0.434,1,2015-10-19,7,1,6,0.143,5,0,5,0.0
11500085,1610612738,1610612751,111.0,105.0,0.513,0.462,1,2015-10-19,5,4,1,0.8,6,2,4,0.3329999999999999
11500084,1610612745,1610612740,120.0,100.0,0.494,0.411,1,2015-10-19,7,3,4,0.429,5,2,3,0.4
11500086,1610612747,1610612757,104.0,102.0,0.447,0.42,1,2015-10-19,7,3,4,0.429,6,3,3,0.5
11500075,1610612751,1610612755,92.0,91.0,0.41,0.38,1,2015-10-18,5,2,3,0.4,6,2,4,0.3329999999999999
11500076,1610612759,1610612765,96.0,92.0,0.4579999999999999,0.3929999999999999,1,2015-10-18,4,1,3,0.25,6,2,4,0.3329999999999999
11500077,1610612763,1610612750,90.0,68.0,0.452,0.377,1,2015-10-18,5,5,0,1.0,5,1,4,0.2
11500078,1610612761,1610612739,87.0,81.0,0.384,0.392,1,2015-10-18,6,4,2,0.667,6,0,6,0.0
11500079,1610612760,1610612743,111.0,98.0,0.519,0.451,1,2015-10-18,5,4,1,0.8,6,4,2,0.667
11500081,1610612737,1610612748,92.0,101.0,0.44,0.391,0,2015-10-18,5,4,1,0.8,6,3,3,0.5
11500080,1610612757,1610612762,116.0,111.0,0.489,0.414,1,2015-10-18,5,3,2,0.6,5,2,3,0.4
11500070,1610612766,1610612752,97.0,93.0,0.4579999999999999,0.4479999999999999,1,2015-10-17,5,5,0,1.0,5,4,1,0.8
11500071,1610612740,1610612758,98.0,107.0,0.43,0.447,0,2015-10-17,4,2,2,0.5,6,5,1,0.833
11500072,1610612745,1610612748,100.0,105.0,0.374,0.527,0,2015-10-17,6,2,4,0.3329999999999999,5,2,3,0.4
11500074,1610612749,1610612764,101.0,105.0,0.4370000000000001,0.42,0,2015-10-17,4,1,3,0.25,5,4,1,0.8
11500073,1610612747,1610612744,85.0,70.0,0.46,0.387,1,2015-10-17,6,2,4,0.3329999999999999,5,2,3,0.4
11500064,1610612755,1610612764,118.0,127.0,0.447,0.573,0,2015-10-16,5,2,3,0.4,4,3,1,0.75
11500067,1610612752,1610612738,101.0,95.0,0.37,0.3979999999999999,1,2015-10-16,4,4,0,1.0,4,3,1,0.75
11500065,1610612763,1610612760,94.0,78.0,0.42,0.3670000000000001,1,2015-10-16,4,4,0,1.0,4,3,1,0.75
11500068,1610612742,1610612737,84.0,91.0,0.365,0.369,0,2015-10-16,4,0,4,0.0,4,4,0,1.0
11500066,1610612743,1610612756,106.0,81.0,0.41,0.3329999999999999,1,2015-10-16,5,4,1,0.8,4,2,2,0.5
11500062,1610612739,1610612754,85.0,107.0,0.4529999999999999,0.461,0,2015-10-15,5,0,5,0.0,5,4,1,0.8
11500063,1610612744,1610612745,123.0,101.0,0.5660000000000001,0.365,1,2015-10-15,4,2,2,0.5,5,2,3,0.4
11500061,1610612746,1610612766,71.0,113.0,0.359,0.449,0,2015-10-14,4,1,3,0.25,4,4,0,1.0
11500058,1610612750,1610612761,89.0,87.0,0.484,0.456,1,2015-10-14,4,1,3,0.25,5,3,2,0.6
11500059,1610612751,1610612738,105.0,109.0,0.402,0.471,0,2015-10-14,4,1,3,0.25,3,3,0,1.0
11500057,1610612741,1610612765,91.0,114.0,0.416,0.544,0,2015-10-14,5,2,3,0.4,5,2,3,0.4
11500060,1610612737,1610612759,100.0,86.0,0.41,0.3289999999999999,1,2015-10-14,3,3,0,1.0,3,0,3,0.0
11500050,1610612753,1610612748,95.0,92.0,0.359,0.385,1,2015-10-13,5,3,2,0.6,4,1,3,0.25
11500051,1610612739,1610612749,101.0,110.0,0.351,0.477,0,2015-10-13,4,0,4,0.0,3,1,2,0.3329999999999999
11500052,1610612754,1610612765,101.0,97.0,0.471,0.389,1,2015-10-13,4,3,1,0.75,4,1,3,0.25
11500053,1610612760,1610612742,100.0,88.0,0.46,0.3879999999999999,1,2015-10-13,3,3,0,1.0,3,0,3,0.0
11500054,1610612756,1610612745,129.0,135.0,0.455,0.475,0,2015-10-13,3,2,1,0.667,4,2,2,0.5
11500055,1610612747,1610612758,100.0,107.0,0.4379999999999999,0.456,0,2015-10-13,5,1,4,0.2,5,4,1,0.8
11500056,1610612744,1610612743,103.0,114.0,0.402,0.495,0,2015-10-13,3,1,2,0.3329999999999999,4,3,1,0.75
11500044,1610612739,1610612763,81.0,91.0,0.385,0.522,0,2015-10-12,3,0,3,0.0,3,3,0,1.0
11500047,1610612752,1610612755,94.0,88.0,0.43,0.358,1,2015-10-12,3,3,0,1.0,4,2,2,0.5
11500048,1610612761,1610612750,112.0,105.0,0.4679999999999999,0.451,1,2015-10-12,4,3,1,0.75,3,0,3,0.0
11500049,1610612748,1610612759,97.0,94.0,0.384,0.424,1,2015-10-12,3,1,2,0.3329999999999999,2,0,2,0.0
11500045,1610612741,1610612740,115.0,123.0,0.473,0.483,0,2015-10-12,4,2,2,0.5,3,2,1,0.667
11500046,1610612762,1610612757,81.0,88.0,0.312,0.385,0,2015-10-12,4,2,2,0.5,4,2,2,0.5
11500040,1610612766,1610612746,106.0,94.0,0.482,0.435,1,2015-10-11,3,3,0,1.0,3,1,2,0.3329999999999999
11500042,1610612745,1610612753,119.0,123.0,0.465,0.511,0,2015-10-11,3,1,2,0.3329999999999999,4,2,2,0.5
11500036,1610612755,1610612751,97.0,95.0,0.3979999999999999,0.368,1,2015-10-10,3,2,1,0.667,3,1,2,0.3329999999999999
11500037,1610612750,1610612741,105.0,114.0,0.4029999999999999,0.494,0,2015-10-10,2,0,2,0.0,3,2,1,0.667
11500039,1610612749,1610612765,88.0,117.0,0.421,0.5,0,2015-10-10,2,0,2,0.0,3,1,2,0.3329999999999999
11500038,1610612758,1610612757,94.0,90.0,0.408,0.415,1,2015-10-10,4,3,1,0.75,3,1,2,0.3329999999999999
11500031,1610612764,1610612752,104.0,115.0,0.436,0.5,0,2015-10-09,2,1,1,0.5,2,2,0,1.0
11500032,1610612740,1610612737,93.0,103.0,0.381,0.446,0,2015-10-09,2,1,1,0.5,2,2,0,1.0
11500035,1610612756,1610612762,101.0,85.0,0.446,0.4,1,2015-10-09,2,2,0,1.0,3,2,1,0.667
11500023,1610612755,1610612739,115.0,114.0,0.446,0.531,1,2015-10-08,2,1,1,0.5,2,0,2,0.0
11500033,1610612754,1610612753,97.0,92.0,0.413,0.4320000000000001,1,2015-10-08,3,2,1,0.667,3,1,2,0.3329999999999999
11500029,1610612765,1610612751,83.0,93.0,0.41,0.436,0,2015-10-08,2,0,2,0.0,2,1,1,0.5
11500025,1610612743,1610612741,112.0,94.0,0.47,0.344,1,2015-10-08,3,2,1,0.667,2,1,1,0.5
11500026,1610612757,1610612744,118.0,101.0,0.4429999999999999,0.3829999999999999,1,2015-10-08,2,1,1,0.5,2,1,1,0.5
11500027,1610612758,1610612759,95.0,92.0,0.455,0.4320000000000001,1,2015-10-08,3,2,1,0.667,1,0,1,0.0
11500028,1610612747,1610612761,97.0,105.0,0.461,0.487,0,2015-10-08,3,0,3,0.0,3,2,1,0.667
11500010,1610612747,1610612762,114.0,117.0,0.434,0.506,0,2015-10-07,2,0,2,0.0,2,2,0,1.0
11500017,1610612739,1610612737,96.0,98.0,0.422,0.44,0,2015-10-07,1,0,1,0.0,1,1,0,1.0
11500022,1610612748,1610612753,97.0,100.0,0.441,0.461,0,2015-10-07,2,0,2,0.0,2,1,1,0.5
11500018,1610612750,1610612760,99.0,122.0,0.444,0.556,0,2015-10-07,1,0,1,0.0,1,1,0,1.0
11500019,1610612745,1610612742,109.0,82.0,0.43,0.358,1,2015-10-07,2,1,1,0.5,2,0,2,0.0
11500020,1610612756,1610612758,102.0,98.0,0.402,0.41,1,2015-10-07,1,1,0,1.0,2,1,1,0.5
11500011,1610612764,1610612755,129.0,95.0,0.5,0.451,1,2015-10-06,1,1,0,1.0,1,0,1,0.0
11500014,1610612765,1610612754,112.0,115.0,0.488,0.447,0,2015-10-06,1,0,1,0.0,2,1,1,0.5
11500012,1610612741,1610612749,105.0,95.0,0.3329999999999999,0.455,1,2015-10-06,1,1,0,1.0,1,0,1,0.0
11500013,1610612763,1610612745,92.0,89.0,0.39,0.36,1,2015-10-06,1,1,0,1.0,1,0,1,0.0
11500015,1610612742,1610612743,86.0,96.0,0.395,0.424,0,2015-10-06,1,0,1,0.0,2,1,1,0.5
11500007,1610612757,1610612758,105.0,109.0,0.424,0.462,0,2015-10-05,1,0,1,0.0,1,1,0,1.0
11500009,1610612744,1610612761,95.0,87.0,0.5,0.376,1,2015-10-05,1,1,0,1.0,2,1,1,0.5
11500006,1610612748,1610612766,77.0,90.0,0.37,0.351,0,2015-10-04,1,0,1,0.0,2,2,0,1.0
11500005,1610612761,1610612746,93.0,73.0,0.425,0.38,1,2015-10-04,1,1,0,1.0,2,1,1,0.5
11500004,1610612747,1610612762,71.0,90.0,0.289,0.37,0,2015-10-04,1,0,1,0.0,1,1,0,1.0
11500002,1610612753,1610612766,100.0,106.0,0.4379999999999999,0.4529999999999999,0,2015-10-03,1,0,1,0.0,1,1,0,1.0
11500003,1610612754,1610612740,105.0,110.0,0.413,0.359,0,2015-10-03,1,0,1,0.0,1,1,0,1.0
11500001,1610612746,1610612743,103.0,96.0,0.407,0.425,1,2015-10-02,1,1,0,1.0,1,0,1,0.0
41400406,1610612739,1610612744,97.0,105.0,0.39,0.435,0,2015-06-16,82,53,29,0.6459999999999999,82,67,15,0.8170000000000001
41400405,1610612744,1610612739,104.0,91.0,0.48,0.395,1,2015-06-14,82,67,15,0.8170000000000001,82,53,29,0.6459999999999999
41400404,1610612739,1610612744,82.0,103.0,0.33,0.4679999999999999,0,2015-06-11,82,53,29,0.6459999999999999,82,67,15,0.8170000000000001
41400403,1610612739,1610612744,96.0,91.0,0.461,0.4,1,2015-06-09,82,53,29,0.6459999999999999,82,67,15,0.8170000000000001
41400402,1610612744,1610612739,93.0,95.0,0.3979999999999999,0.322,0,2015-06-07,82,67,15,0.8170000000000001,82,53,29,0.6459999999999999
41400401,1610612744,1610612739,108.0,100.0,0.4429999999999999,0.415,1,2015-06-04,82,67,15,0.8170000000000001,82,53,29,0.6459999999999999
41400315,1610612744,1610612745,104.0,90.0,0.407,0.351,1,2015-05-27,82,67,15,0.8170000000000001,82,56,26,0.6829999999999999
41400304,1610612739,1610612737,118.0,88.0,0.494,0.424,1,2015-05-26,82,53,29,0.6459999999999999,82,60,22,0.732
41400314,1610612745,1610612744,128.0,115.0,0.5660000000000001,0.4539999999999999,1,2015-05-25,82,56,26,0.6829999999999999,82,67,15,0.8170000000000001
41400303,1610612739,1610612737,114.0,111.0,0.412,0.409,1,2015-05-24,82,53,29,0.6459999999999999,82,60,22,0.732
41400313,1610612745,1610612744,80.0,115.0,0.337,0.4539999999999999,0,2015-05-23,82,56,26,0.6829999999999999,82,67,15,0.8170000000000001
41400302,1610612737,1610612739,82.0,94.0,0.418,0.434,0,2015-05-22,82,60,22,0.732,82,53,29,0.6459999999999999
41400312,1610612744,1610612745,99.0,98.0,0.532,0.4639999999999999,1,2015-05-21,82,67,15,0.8170000000000001,82,56,26,0.6829999999999999
41400301,1610612737,1610612739,89.0,97.0,0.442,0.44,0,2015-05-20,82,60,22,0.732,82,53,29,0.6459999999999999
41400311,1610612744,1610612745,110.0,106.0,0.467,0.465,1,2015-05-19,82,67,15,0.8170000000000001,82,56,26,0.6829999999999999
41400237,1610612745,1610612746,113.0,100.0,0.449,0.446,1,2015-05-17,82,56,26,0.6829999999999999,82,56,26,0.6829999999999999
41400206,1610612764,1610612737,91.0,94.0,0.366,0.429,0,2015-05-15,82,46,36,0.561,82,60,22,0.732
41400226,1610612763,1610612744,95.0,108.0,0.374,0.506,0,2015-05-15,82,55,27,0.6709999999999999,82,67,15,0.8170000000000001
41400216,1610612741,1610612739,73.0,94.0,0.375,0.418,0,2015-05-14,82,50,32,0.61,82,53,29,0.6459999999999999
41400236,1610612746,1610612745,107.0,119.0,0.418,0.425,0,2015-05-14,82,56,26,0.6829999999999999,82,56,26,0.6829999999999999
41400205,1610612737,1610612764,82.0,81.0,0.41,0.375,1,2015-05-13,82,60,22,0.732,82,46,36,0.561
41400225,1610612744,1610612763,98.0,78.0,0.469,0.3979999999999999,1,2015-05-13,82,67,15,0.8170000000000001,82,55,27,0.6709999999999999
41400215,1610612739,1610612741,106.0,101.0,0.506,0.395,1,2015-05-12,82,53,29,0.6459999999999999,82,50,32,0.61
41400235,1610612745,1610612746,124.0,103.0,0.541,0.418,1,2015-05-12,82,56,26,0.6829999999999999,82,56,26,0.6829999999999999
41400204,1610612764,1610612737,101.0,106.0,0.447,0.471,0,2015-05-11,82,46,36,0.561,82,60,22,0.732
41400224,1610612763,1610612744,84.0,101.0,0.375,0.475,0,2015-05-11,82,55,27,0.6709999999999999,82,67,15,0.8170000000000001
41400214,1610612741,1610612739,84.0,86.0,0.36,0.387,0,2015-05-10,82,50,32,0.61,82,53,29,0.6459999999999999
41400234,1610612746,1610612745,128.0,95.0,0.494,0.41,1,2015-05-10,82,56,26,0.6829999999999999,82,56,26,0.6829999999999999
41400203,1610612764,1610612737,103.0,101.0,0.474,0.444,1,2015-05-09,82,46,36,0.561,82,60,22,0.732
41400223,1610612763,1610612744,99.0,89.0,0.451,0.4320000000000001,1,2015-05-09,82,55,27,0.6709999999999999,82,67,15,0.8170000000000001
41400213,1610612741,1610612739,99.0,96.0,0.3779999999999999,0.39,1,2015-05-08,82,50,32,0.61,82,53,29,0.6459999999999999
41400233,1610612746,1610612745,124.0,99.0,0.5539999999999999,0.3979999999999999,1,2015-05-08,82,56,26,0.6829999999999999,82,56,26,0.6829999999999999
41400212,1610612739,1610612741,106.0,91.0,0.446,0.405,1,2015-05-06,82,53,29,0.6459999999999999,82,50,32,0.61
41400232,1610612745,1610612746,115.0,109.0,0.425,0.4529999999999999,1,2015-05-06,82,56,26,0.6829999999999999,82,56,26,0.6829999999999999
41400202,1610612737,1610612764,106.0,90.0,0.435,0.4270000000000001,1,2015-05-05,82,60,22,0.732,82,46,36,0.561
41400222,1610612744,1610612763,90.0,97.0,0.419,0.446,0,2015-05-05,82,67,15,0.8170000000000001,82,55,27,0.6709999999999999
41400211,1610612739,1610612741,92.0,99.0,0.42,0.5,0,2015-05-04,82,53,29,0.6459999999999999,82,50,32,0.61
41400231,1610612745,1610612746,101.0,117.0,0.452,0.488,0,2015-05-04,82,56,26,0.6829999999999999,82,56,26,0.6829999999999999
41400201,1610612737,1610612764,98.0,104.0,0.3779999999999999,0.418,0,2015-05-03,82,60,22,0.732,82,46,36,0.561
41400221,1610612744,1610612763,101.0,86.0,0.506,0.452,1,2015-05-03,82,67,15,0.8170000000000001,82,55,27,0.6709999999999999
41400167,1610612746,1610612759,111.0,109.0,0.526,0.483,1,2015-05-02,82,56,26,0.6829999999999999,82,55,27,0.6709999999999999
41400106,1610612751,1610612737,87.0,111.0,0.365,0.506,0,2015-05-01,82,38,44,0.4629999999999999,82,60,22,0.732
41400126,1610612749,1610612741,66.0,120.0,0.3289999999999999,0.511,0,2015-04-30,82,41,41,0.5,82,50,32,0.61
41400166,1610612759,1610612746,96.0,102.0,0.434,0.475,0,2015-04-30,82,55,27,0.6709999999999999,82,56,26,0.6829999999999999
41400105,1610612737,1610612751,107.0,97.0,0.482,0.474,1,2015-04-29,82,60,22,0.732,82,38,44,0.4629999999999999
41400175,1610612763,1610612757,99.0,93.0,0.416,0.402,1,2015-04-29,82,55,27,0.6709999999999999,82,51,31,0.622
41400155,1610612745,1610612742,103.0,94.0,0.451,0.38,1,2015-04-28,82,56,26,0.6829999999999999,82,50,32,0.61
41400165,1610612746,1610612759,107.0,111.0,0.465,0.444,0,2015-04-28,82,56,26,0.6829999999999999,82,55,27,0.6709999999999999
41400104,1610612751,1610612737,120.0,115.0,0.479,0.484,1,2015-04-27,82,38,44,0.4629999999999999,82,60,22,0.732
41400125,1610612741,1610612749,88.0,94.0,0.344,0.424,0,2015-04-27,82,50,32,0.61,82,41,41,0.5
41400174,1610612757,1610612763,99.0,92.0,0.414,0.439,1,2015-04-27,82,51,31,0.622,82,55,27,0.6709999999999999
41400114,1610612738,1610612739,93.0,101.0,0.3879999999999999,0.397,0,2015-04-26,82,40,42,0.488,82,53,29,0.6459999999999999
41400164,1610612759,1610612746,105.0,114.0,0.44,0.536,0,2015-04-26,82,55,27,0.6709999999999999,82,56,26,0.6829999999999999
41400134,1610612764,1610612761,125.0,94.0,0.5539999999999999,0.439,1,2015-04-26,82,46,36,0.561,82,49,33,0.598
41400154,1610612742,1610612745,121.0,109.0,0.5429999999999999,0.469,1,2015-04-26,82,50,32,0.61,82,56,26,0.6829999999999999
41400103,1610612751,1610612737,91.0,83.0,0.386,0.356,1,2015-04-25,82,38,44,0.4629999999999999,82,60,22,0.732
41400124,1610612749,1610612741,92.0,90.0,0.391,0.485,1,2015-04-25,82,41,41,0.5,82,50,32,0.61
41400144,1610612740,1610612744,98.0,109.0,0.482,0.506,0,2015-04-25,82,45,37,0.5489999999999999,82,67,15,0.8170000000000001
41400173,1610612757,1610612763,109.0,115.0,0.4679999999999999,0.4679999999999999,0,2015-04-25,82,51,31,0.622,82,55,27,0.6709999999999999
41400153,1610612742,1610612745,128.0,130.0,0.523,0.516,0,2015-04-24,82,50,32,0.61,82,56,26,0.6829999999999999
41400133,1610612764,1610612761,106.0,99.0,0.474,0.374,1,2015-04-24,82,46,36,0.561,82,49,33,0.598
41400163,1610612759,1610612746,100.0,73.0,0.526,0.341,1,2015-04-24,82,55,27,0.6709999999999999,82,56,26,0.6829999999999999
41400113,1610612738,1610612739,95.0,103.0,0.439,0.452,0,2015-04-23,82,40,42,0.488,82,53,29,0.6459999999999999
41400123,1610612749,1610612741,106.0,113.0,0.422,0.449,0,2015-04-23,82,41,41,0.5,82,50,32,0.61
41400143,1610612740,1610612744,119.0,123.0,0.511,0.4039999999999999,0,2015-04-23,82,45,37,0.5489999999999999,82,67,15,0.8170000000000001
41400102,1610612737,1610612751,96.0,91.0,0.389,0.449,1,2015-04-22,82,60,22,0.732,82,38,44,0.4629999999999999
41400172,1610612763,1610612757,97.0,82.0,0.4270000000000001,0.39,1,2015-04-22,82,55,27,0.6709999999999999,82,51,31,0.622
41400162,1610612746,1610612759,107.0,111.0,0.424,0.462,0,2015-04-22,82,56,26,0.6829999999999999,82,55,27,0.6709999999999999
41400112,1610612739,1610612738,99.0,91.0,0.447,0.3879999999999999,1,2015-04-21,82,53,29,0.6459999999999999,82,40,42,0.488
41400132,1610612761,1610612764,106.0,117.0,0.488,0.532,0,2015-04-21,82,49,33,0.598,82,46,36,0.561
41400152,1610612745,1610612742,111.0,99.0,0.4429999999999999,0.371,1,2015-04-21,82,56,26,0.6829999999999999,82,50,32,0.61
41400122,1610612741,1610612749,91.0,82.0,0.3829999999999999,0.356,1,2015-04-20,82,50,32,0.61,82,41,41,0.5
41400142,1610612744,1610612740,97.0,87.0,0.442,0.3829999999999999,1,2015-04-20,82,67,15,0.8170000000000001,82,45,37,0.5489999999999999
41400111,1610612739,1610612738,113.0,100.0,0.451,0.4679999999999999,1,2015-04-19,82,53,29,0.6459999999999999,82,40,42,0.488
41400101,1610612737,1610612751,99.0,92.0,0.43,0.456,1,2015-04-19,82,60,22,0.732,82,38,44,0.4629999999999999
41400171,1610612763,1610612757,100.0,86.0,0.4429999999999999,0.337,1,2015-04-19,82,55,27,0.6709999999999999,82,51,31,0.622
41400161,1610612746,1610612759,107.0,92.0,0.513,0.366,1,2015-04-19,82,56,26,0.6829999999999999,82,55,27,0.6709999999999999
41400131,1610612761,1610612764,86.0,93.0,0.38,0.3939999999999999,0,2015-04-18,82,49,33,0.598,82,46,36,0.561
41400141,1610612744,1610612740,106.0,99.0,0.457,0.422,1,2015-04-18,82,67,15,0.8170000000000001,82,45,37,0.5489999999999999
41400121,1610612741,1610612749,103.0,91.0,0.4579999999999999,0.3929999999999999,1,2015-04-18,82,50,32,0.61,82,41,41,0.5
41400151,1610612745,1610612742,118.0,108.0,0.447,0.444,1,2015-04-18,82,56,26,0.6829999999999999,82,50,32,0.61
21401228,1610612761,1610612766,92.0,87.0,0.494,0.423,1,2015-04-15,82,49,33,0.598,82,33,49,0.402
21401217,1610612741,1610612737,91.0,85.0,0.4029999999999999,0.391,1,2015-04-15,82,50,32,0.61,82,60,22,0.732
21401218,1610612742,1610612757,114.0,98.0,0.4529999999999999,0.418,1,2015-04-15,82,50,32,0.61,82,51,31,0.622
21401219,1610612745,1610612762,117.0,91.0,0.539,0.376,1,2015-04-15,82,56,26,0.6829999999999999,82,38,44,0.4629999999999999
21401221,1610612749,1610612738,100.0,105.0,0.461,0.494,0,2015-04-15,82,41,41,0.5,82,40,42,0.488
21401222,1610612750,1610612760,113.0,138.0,0.4639999999999999,0.547,0,2015-04-15,82,16,66,0.195,82,45,37,0.5489999999999999
21401223,1610612740,1610612759,108.0,103.0,0.518,0.57,1,2015-04-15,82,45,37,0.5489999999999999,82,55,27,0.6709999999999999
21401224,1610612751,1610612753,101.0,88.0,0.488,0.481,1,2015-04-15,82,38,44,0.4629999999999999,82,25,57,0.305
21401225,1610612739,1610612764,113.0,108.0,0.473,0.433,1,2015-04-15,82,53,29,0.6459999999999999,82,46,36,0.561
21401226,1610612752,1610612765,90.0,112.0,0.429,0.506,0,2015-04-15,82,17,65,0.207,82,32,50,0.39
21401227,1610612755,1610612748,101.0,105.0,0.4579999999999999,0.4379999999999999,0,2015-04-15,82,18,64,0.22,82,37,45,0.451
21401220,1610612763,1610612754,95.0,83.0,0.474,0.41,1,2015-04-15,82,55,27,0.6709999999999999,82,38,44,0.4629999999999999
21401229,1610612744,1610612743,133.0,126.0,0.522,0.542,1,2015-04-15,82,67,15,0.8170000000000001,82,30,52,0.366
21401230,1610612747,1610612758,99.0,122.0,0.3829999999999999,0.5479999999999999,0,2015-04-15,82,21,61,0.256,82,29,53,0.354
21401214,1610612738,1610612761,95.0,93.0,0.384,0.4379999999999999,1,2015-04-14,81,39,42,0.481,81,48,33,0.593
21401215,1610612754,1610612764,99.0,95.0,0.381,0.356,1,2015-04-14,81,38,43,0.469,81,46,35,0.568
21401216,1610612756,1610612746,101.0,112.0,0.488,0.483,0,2015-04-14,82,39,43,0.476,82,56,26,0.6829999999999999
21401202,1610612766,1610612745,90.0,100.0,0.41,0.412,0,2015-04-13,81,33,48,0.407,81,55,26,0.679
21401203,1610612739,1610612765,109.0,97.0,0.506,0.4579999999999999,1,2015-04-13,81,52,29,0.642,81,31,50,0.3829999999999999
21401204,1610612755,1610612749,97.0,107.0,0.395,0.494,0,2015-04-13,81,18,63,0.222,81,41,40,0.506
21401205,1610612737,1610612752,108.0,112.0,0.4429999999999999,0.5579999999999999,0,2015-04-13,81,60,21,0.741,81,17,64,0.21
21401206,1610612751,1610612741,86.0,113.0,0.368,0.5,0,2015-04-13,81,37,44,0.457,81,49,32,0.605
21401207,1610612748,1610612753,100.0,93.0,0.47,0.412,1,2015-04-13,81,36,45,0.444,81,25,56,0.309
21401208,1610612750,1610612740,88.0,100.0,0.397,0.44,0,2015-04-13,81,16,65,0.198,81,44,37,0.5429999999999999
21401209,1610612760,1610612757,101.0,90.0,0.406,0.4579999999999999,1,2015-04-13,81,44,37,0.5429999999999999,81,51,30,0.63
21401210,1610612762,1610612742,109.0,92.0,0.5,0.415,1,2015-04-13,81,38,43,0.469,81,49,32,0.605
21401211,1610612758,1610612747,102.0,92.0,0.486,0.417,1,2015-04-13,81,28,53,0.346,81,21,60,0.259
21401212,1610612744,1610612763,111.0,107.0,0.527,0.418,1,2015-04-13,81,66,15,0.815,81,54,27,0.667
21401213,1610612746,1610612743,110.0,103.0,0.451,0.376,1,2015-04-13,81,55,26,0.679,81,30,51,0.37
21401193,1610612749,1610612751,96.0,73.0,0.494,0.325,1,2015-04-12,80,40,40,0.5,80,37,43,0.4629999999999999
21401194,1610612738,1610612739,117.0,78.0,0.5479999999999999,0.392,1,2015-04-12,80,38,42,0.475,80,51,29,0.638
21401195,1610612765,1610612766,116.0,77.0,0.506,0.342,1,2015-04-12,80,31,49,0.3879999999999999,80,33,47,0.413
21401196,1610612743,1610612758,122.0,111.0,0.5489999999999999,0.514,1,2015-04-12,80,30,50,0.375,80,27,53,0.3379999999999999
21401197,1610612754,1610612760,116.0,104.0,0.532,0.4320000000000001,1,2015-04-12,80,37,43,0.4629999999999999,80,43,37,0.5379999999999999
21401198,1610612764,1610612737,108.0,99.0,0.4589999999999999,0.414,1,2015-04-12,80,46,34,0.575,80,60,20,0.75
21401199,1610612745,1610612740,121.0,114.0,0.534,0.484,1,2015-04-12,80,54,26,0.675,80,43,37,0.5379999999999999
21401200,1610612759,1610612756,107.0,91.0,0.507,0.412,1,2015-04-12,81,55,26,0.679,81,39,42,0.481
21401201,1610612747,1610612742,106.0,120.0,0.436,0.542,0,2015-04-12,80,21,59,0.263,80,49,31,0.613
21401187,1610612753,1610612752,79.0,80.0,0.357,0.3779999999999999,0,2015-04-11,80,25,55,0.313,80,16,64,0.2
21401188,1610612748,1610612761,104.0,107.0,0.457,0.422,0,2015-04-11,80,35,45,0.4379999999999999,80,48,32,0.6
21401189,1610612741,1610612755,114.0,107.0,0.444,0.416,1,2015-04-11,80,48,32,0.6,80,18,62,0.225
21401190,1610612746,1610612763,94.0,86.0,0.3979999999999999,0.442,1,2015-04-11,80,54,26,0.675,80,54,26,0.675
21401191,1610612757,1610612762,105.0,111.0,0.471,0.456,0,2015-04-11,80,51,29,0.638,80,37,43,0.4629999999999999
21401192,1610612744,1610612750,110.0,101.0,0.452,0.4429999999999999,1,2015-04-11,80,65,15,0.813,80,16,64,0.2
21401175,1610612753,1610612761,99.0,101.0,0.461,0.415,0,2015-04-10,79,25,54,0.316,79,47,32,0.595
21401176,1610612737,1610612766,104.0,80.0,0.5,0.361,1,2015-04-10,79,60,19,0.759,79,33,46,0.418
21401177,1610612751,1610612764,117.0,80.0,0.506,0.39,1,2015-04-10,79,37,42,0.4679999999999999,79,45,34,0.57
21401178,1610612739,1610612738,90.0,99.0,0.416,0.452,0,2015-04-10,79,51,28,0.6459999999999999,79,37,42,0.4679999999999999
21401179,1610612765,1610612754,103.0,107.0,0.449,0.481,0,2015-04-10,79,30,49,0.38,79,36,43,0.456
21401180,1610612752,1610612749,91.0,99.0,0.472,0.487,0,2015-04-10,79,15,64,0.19,79,39,40,0.494
21401181,1610612745,1610612759,103.0,104.0,0.47,0.482,0,2015-04-10,79,53,26,0.6709999999999999,80,54,26,0.675
21401182,1610612740,1610612756,90.0,75.0,0.44,0.353,1,2015-04-10,79,43,36,0.544,80,39,41,0.488
21401183,1610612760,1610612758,116.0,103.0,0.4539999999999999,0.457,1,2015-04-10,79,43,36,0.544,79,27,52,0.342
21401184,1610612743,1610612742,143.0,144.0,0.424,0.523,0,2015-04-10,79,29,50,0.3670000000000001,79,48,31,0.608
21401185,1610612762,1610612763,88.0,89.0,0.4370000000000001,0.474,0,2015-04-10,79,36,43,0.456,79,54,25,0.684
21401186,1610612747,1610612750,106.0,98.0,0.494,0.4320000000000001,1,2015-04-10,79,21,58,0.266,79,16,63,0.203
21401173,1610612748,1610612741,78.0,89.0,0.386,0.385,0,2015-04-09,79,35,44,0.4429999999999999,79,47,32,0.595
21401174,1610612744,1610612757,116.0,105.0,0.5329999999999999,0.469,1,2015-04-09,79,64,15,0.81,79,51,28,0.6459999999999999
21401160,1610612766,1610612761,74.0,92.0,0.346,0.429,0,2015-04-08,78,33,45,0.423,78,46,32,0.59
21401161,1610612753,1610612741,105.0,103.0,0.4629999999999999,0.43,1,2015-04-08,78,25,53,0.321,78,46,32,0.59
21401162,1610612755,1610612764,90.0,119.0,0.348,0.653,0,2015-04-08,79,18,61,0.228,78,45,33,0.5770000000000001
21401164,1610612765,1610612738,103.0,113.0,0.536,0.45,0,2015-04-08,78,30,48,0.385,78,36,42,0.462
21401163,1610612751,1610612737,111.0,114.0,0.471,0.5,0,2015-04-08,78,36,42,0.462,78,59,19,0.7559999999999999
21401165,1610612752,1610612754,86.0,102.0,0.345,0.494,0,2015-04-08,78,15,63,0.192,78,35,43,0.449
21401166,1610612763,1610612740,110.0,74.0,0.511,0.35,1,2015-04-08,78,53,25,0.679,78,42,36,0.5379999999999999
21401167,1610612749,1610612739,99.0,104.0,0.5,0.486,0,2015-04-08,78,38,40,0.487,78,51,27,0.654
21401168,1610612759,1610612745,110.0,98.0,0.505,0.4639999999999999,1,2015-04-08,79,53,26,0.6709999999999999,78,53,25,0.679
21401169,1610612743,1610612747,119.0,101.0,0.5,0.48,1,2015-04-08,78,29,49,0.3720000000000001,78,20,58,0.256
21401170,1610612762,1610612758,103.0,91.0,0.486,0.44,1,2015-04-08,78,36,42,0.462,78,27,51,0.346
21401171,1610612742,1610612756,107.0,104.0,0.479,0.488,1,2015-04-08,78,47,31,0.603,79,39,40,0.494
21401172,1610612757,1610612750,116.0,91.0,0.494,0.376,1,2015-04-08,78,51,27,0.654,78,16,62,0.205
21401154,1610612737,1610612756,96.0,69.0,0.494,0.313,1,2015-04-07,77,58,19,0.753,78,39,39,0.5
21401155,1610612748,1610612766,105.0,100.0,0.494,0.429,1,2015-04-07,78,35,43,0.449,77,33,44,0.429
21401156,1610612740,1610612744,103.0,100.0,0.434,0.442,1,2015-04-07,77,42,35,0.545,78,63,15,0.8079999999999999
21401157,1610612760,1610612759,88.0,113.0,0.405,0.528,0,2015-04-07,78,42,36,0.5379999999999999,78,52,26,0.667
21401158,1610612758,1610612750,116.0,111.0,0.525,0.484,1,2015-04-07,77,27,50,0.351,77,16,61,0.208
21401159,1610612746,1610612747,105.0,100.0,0.481,0.417,1,2015-04-07,79,53,26,0.6709999999999999,77,20,57,0.26
21400668,1610612751,1610612757,106.0,96.0,0.451,0.4479999999999999,1,2015-04-06,77,36,41,0.4679999999999999,77,50,27,0.649
21401147,1610612760,1610612745,112.0,115.0,0.435,0.469,0,2015-04-05,77,42,35,0.545,77,53,24,0.688
21401148,1610612739,1610612741,99.0,94.0,0.422,0.447,1,2015-04-05,77,50,27,0.649,77,46,31,0.597
21401149,1610612754,1610612748,112.0,89.0,0.435,0.451,1,2015-04-05,77,34,43,0.442,77,34,43,0.442
21401150,1610612759,1610612744,107.0,92.0,0.53,0.429,1,2015-04-05,77,51,26,0.662,77,63,14,0.818
21401151,1610612752,1610612755,101.0,91.0,0.514,0.384,1,2015-04-05,77,15,62,0.195,78,18,60,0.231
21401152,1610612758,1610612762,95.0,101.0,0.481,0.46,0,2015-04-05,76,26,50,0.342,77,35,42,0.455
21401153,1610612747,1610612746,78.0,106.0,0.387,0.5329999999999999,0,2015-04-05,76,20,56,0.263,78,52,26,0.667
21401137,1610612766,1610612755,92.0,91.0,0.407,0.368,1,2015-04-04,76,33,43,0.434,77,18,59,0.2339999999999999
21401138,1610612737,1610612751,131.0,99.0,0.598,0.488,1,2015-04-04,76,57,19,0.75,76,35,41,0.461
21401139,1610612765,1610612748,99.0,98.0,0.493,0.481,1,2015-04-04,77,30,47,0.39,76,34,42,0.447
21401140,1610612761,1610612738,116.0,117.0,0.482,0.485,0,2015-04-04,77,45,32,0.584,77,35,42,0.455
21401141,1610612763,1610612764,83.0,92.0,0.42,0.481,0,2015-04-04,77,52,25,0.675,77,44,33,0.5710000000000001
21401142,1610612742,1610612744,110.0,123.0,0.425,0.4529999999999999,0,2015-04-04,77,46,31,0.597,76,63,13,0.8290000000000001
21401143,1610612749,1610612753,90.0,97.0,0.4379999999999999,0.465,0,2015-04-04,77,38,39,0.494,77,24,53,0.312
21401144,1610612743,1610612746,92.0,107.0,0.376,0.43,0,2015-04-04,77,28,49,0.364,77,51,26,0.662
21401145,1610612756,1610612762,87.0,85.0,0.435,0.392,1,2015-04-04,77,39,38,0.506,76,34,42,0.447
21401146,1610612757,1610612740,99.0,90.0,0.429,0.4589999999999999,1,2015-04-04,76,50,26,0.6579999999999999,76,41,35,0.539
21401127,1610612754,1610612766,93.0,74.0,0.434,0.35,1,2015-04-03,76,33,43,0.434,75,32,43,0.4270000000000001
21401128,1610612764,1610612752,101.0,87.0,0.462,0.369,1,2015-04-03,76,43,33,0.5660000000000001,76,14,62,0.184
21401129,1610612738,1610612749,101.0,110.0,0.4429999999999999,0.529,0,2015-04-03,76,34,42,0.447,76,38,38,0.5
21401130,1610612751,1610612761,114.0,109.0,0.523,0.512,1,2015-04-03,75,35,40,0.467,76,45,31,0.5920000000000001
21401131,1610612741,1610612765,88.0,82.0,0.3879999999999999,0.4320000000000001,1,2015-04-03,76,46,30,0.605,76,29,47,0.382
21401132,1610612763,1610612760,100.0,92.0,0.475,0.409,1,2015-04-03,76,52,24,0.684,76,42,34,0.5529999999999999
21401133,1610612750,1610612753,84.0,97.0,0.4529999999999999,0.435,0,2015-04-03,76,16,60,0.211,76,23,53,0.303
21401134,1610612759,1610612743,123.0,93.0,0.5529999999999999,0.46,1,2015-04-03,76,50,26,0.6579999999999999,76,28,48,0.368
21401135,1610612758,1610612740,95.0,101.0,0.474,0.391,0,2015-04-03,75,26,49,0.347,75,41,34,0.547
21401136,1610612747,1610612757,77.0,107.0,0.3779999999999999,0.489,0,2015-04-03,75,20,55,0.267,75,49,26,0.653
21401124,1610612739,1610612748,114.0,88.0,0.5,0.4270000000000001,1,2015-04-02,76,49,27,0.645,75,34,41,0.4529999999999999
21401125,1610612742,1610612745,101.0,108.0,0.44,0.442,0,2015-04-02,76,46,30,0.605,76,52,24,0.684
21401126,1610612744,1610612756,107.0,106.0,0.462,0.467,1,2015-04-02,75,62,13,0.8270000000000001,76,38,38,0.5
21401112,1610612766,1610612765,102.0,78.0,0.422,0.352,1,2015-04-01,74,32,42,0.4320000000000001,75,29,46,0.387
21401113,1610612753,1610612759,91.0,103.0,0.419,0.407,0,2015-04-01,75,22,53,0.293,75,49,26,0.653
21401114,1610612764,1610612755,106.0,93.0,0.579,0.396,1,2015-04-01,75,42,33,0.56,76,18,58,0.237
21401115,1610612738,1610612754,100.0,87.0,0.4529999999999999,0.42,1,2015-04-01,75,34,41,0.4529999999999999,75,32,43,0.4270000000000001
21401116,1610612752,1610612751,98.0,100.0,0.457,0.506,0,2015-04-01,75,14,61,0.187,74,34,40,0.4589999999999999
21401117,1610612745,1610612758,115.0,111.0,0.461,0.5,1,2015-04-01,75,51,24,0.68,74,26,48,0.351
21401118,1610612749,1610612741,95.0,91.0,0.416,0.419,1,2015-04-01,75,37,38,0.493,75,45,30,0.6
21401119,1610612750,1610612761,99.0,113.0,0.532,0.5529999999999999,0,2015-04-01,75,16,59,0.213,75,45,30,0.6
21401120,1610612760,1610612742,131.0,135.0,0.484,0.615,0,2015-04-01,75,42,33,0.56,75,46,29,0.613
21401121,1610612762,1610612743,98.0,84.0,0.481,0.347,1,2015-04-01,75,34,41,0.4529999999999999,75,28,47,0.373
21401122,1610612757,1610612746,122.0,126.0,0.506,0.535,0,2015-04-01,74,48,26,0.649,76,50,26,0.6579999999999999
21401123,1610612747,1610612740,92.0,113.0,0.446,0.564,0,2015-04-01,74,20,54,0.27,74,40,34,0.541
21401108,1610612751,1610612754,111.0,106.0,0.5,0.451,1,2015-03-31,73,33,40,0.452,74,32,42,0.4320000000000001
21401109,1610612765,1610612737,105.0,95.0,0.494,0.476,1,2015-03-31,74,29,45,0.392,75,56,19,0.747
21401110,1610612748,1610612759,81.0,95.0,0.405,0.5,0,2015-03-31,74,34,40,0.4589999999999999,74,48,26,0.649
21401111,1610612746,1610612744,106.0,110.0,0.439,0.447,0,2015-03-31,75,49,26,0.653,74,61,13,0.8240000000000001
21401101,1610612766,1610612738,104.0,116.0,0.471,0.506,0,2015-03-30,73,31,42,0.425,74,33,41,0.446
21401102,1610612755,1610612747,111.0,113.0,0.406,0.488,0,2015-03-30,75,18,57,0.24,73,20,53,0.2739999999999999
21401103,1610612737,1610612749,101.0,88.0,0.456,0.4529999999999999,1,2015-03-30,74,56,18,0.757,74,36,38,0.486
21401104,1610612761,1610612745,99.0,96.0,0.449,0.417,1,2015-03-30,74,44,30,0.595,74,50,24,0.6759999999999999
21401105,1610612763,1610612758,97.0,83.0,0.4579999999999999,0.407,1,2015-03-30,75,51,24,0.68,73,26,47,0.356
21401106,1610612750,1610612762,84.0,104.0,0.368,0.476,0,2015-03-30,74,16,58,0.216,74,33,41,0.446
21401107,1610612757,1610612756,109.0,86.0,0.512,0.4370000000000001,1,2015-03-30,73,48,25,0.6579999999999999,75,38,37,0.507
21401097,1610612764,1610612745,91.0,99.0,0.387,0.425,0,2015-03-29,74,41,33,0.5539999999999999,73,50,23,0.685
21401093,1610612751,1610612747,107.0,99.0,0.483,0.462,1,2015-03-29,72,32,40,0.444,72,19,53,0.264
21401094,1610612740,1610612750,110.0,88.0,0.573,0.4270000000000001,1,2015-03-29,73,39,34,0.534,73,16,57,0.2189999999999999
21401092,1610612739,1610612755,87.0,86.0,0.3879999999999999,0.405,1,2015-03-29,75,48,27,0.64,74,18,56,0.243
21401095,1610612738,1610612746,106.0,119.0,0.419,0.488,0,2015-03-29,73,32,41,0.4379999999999999,74,49,25,0.662
21401096,1610612748,1610612765,109.0,102.0,0.476,0.482,1,2015-03-29,73,34,39,0.466,73,28,45,0.384
21401098,1610612759,1610612763,103.0,89.0,0.506,0.439,1,2015-03-29,73,47,26,0.644,74,50,24,0.6759999999999999
21401099,1610612754,1610612742,104.0,99.0,0.5,0.444,1,2015-03-29,73,32,41,0.4379999999999999,74,45,29,0.608
21401100,1610612756,1610612760,97.0,109.0,0.451,0.465,0,2015-03-29,74,38,36,0.514,74,42,32,0.568
21401087,1610612766,1610612737,115.0,100.0,0.525,0.43,1,2015-03-28,72,31,41,0.431,73,55,18,0.753
21401088,1610612741,1610612752,111.0,80.0,0.512,0.38,1,2015-03-28,74,45,29,0.608,74,14,60,0.1889999999999999
21401089,1610612749,1610612744,95.0,108.0,0.379,0.512,0,2015-03-28,73,36,37,0.493,73,60,13,0.8220000000000001
21401090,1610612762,1610612760,94.0,89.0,0.381,0.425,1,2015-03-28,73,32,41,0.4379999999999999,73,41,32,0.562
21401091,1610612757,1610612743,120.0,114.0,0.565,0.467,1,2015-03-28,72,47,25,0.653,74,28,46,0.3779999999999999
21401074,1610612753,1610612765,97.0,111.0,0.524,0.467,0,2015-03-27,74,22,52,0.297,72,28,44,0.389
21401075,1610612755,1610612746,98.0,119.0,0.419,0.537,0,2015-03-27,73,18,55,0.247,73,48,25,0.6579999999999999
21401076,1610612764,1610612766,110.0,107.0,0.389,0.346,1,2015-03-27,73,41,32,0.562,71,30,41,0.423
21401077,1610612737,1610612748,99.0,86.0,0.514,0.39,1,2015-03-27,72,55,17,0.764,72,33,39,0.4579999999999999
21401078,1610612751,1610612739,106.0,98.0,0.465,0.457,1,2015-03-27,71,31,40,0.4370000000000001,74,47,27,0.635
21401079,1610612752,1610612738,92.0,96.0,0.4370000000000001,0.42,0,2015-03-27,73,14,59,0.192,72,32,40,0.444
21401080,1610612761,1610612747,94.0,83.0,0.48,0.345,1,2015-03-27,73,43,30,0.589,71,19,52,0.268
21401081,1610612745,1610612750,120.0,110.0,0.53,0.487,1,2015-03-27,72,49,23,0.6809999999999999,72,16,56,0.222
21401082,1610612763,1610612744,84.0,107.0,0.447,0.433,0,2015-03-27,73,50,23,0.685,72,59,13,0.8190000000000001
21401083,1610612740,1610612758,102.0,88.0,0.512,0.4429999999999999,1,2015-03-27,72,38,34,0.528,72,26,46,0.361
21401084,1610612759,1610612742,94.0,76.0,0.44,0.3779999999999999,1,2015-03-27,72,46,26,0.639,73,45,28,0.616
21401085,1610612743,1610612762,107.0,91.0,0.513,0.395,1,2015-03-27,73,28,45,0.384,72,31,41,0.431
21401086,1610612756,1610612757,81.0,87.0,0.368,0.4039999999999999,0,2015-03-27,73,38,35,0.521,71,46,25,0.648
21401073,1610612749,1610612754,111.0,107.0,0.534,0.423,1,2015-03-26,72,36,36,0.5,72,31,41,0.431
21401060,1610612766,1610612751,88.0,91.0,0.396,0.429,0,2015-03-25,70,30,40,0.429,70,30,40,0.429
21401061,1610612752,1610612746,80.0,111.0,0.354,0.564,0,2015-03-25,72,14,58,0.1939999999999999,72,47,25,0.653
21401062,1610612753,1610612737,83.0,95.0,0.41,0.433,0,2015-03-25,73,22,51,0.301,71,54,17,0.7609999999999999
21401063,1610612764,1610612754,101.0,103.0,0.44,0.447,0,2015-03-25,72,40,32,0.556,71,31,40,0.4370000000000001
21401065,1610612761,1610612741,103.0,116.0,0.47,0.608,0,2015-03-25,72,42,30,0.583,73,44,29,0.603
21401064,1610612738,1610612748,86.0,93.0,0.406,0.442,0,2015-03-25,71,31,40,0.4370000000000001,71,33,38,0.465
21401066,1610612763,1610612739,89.0,111.0,0.435,0.512,0,2015-03-25,72,50,22,0.6940000000000001,73,47,26,0.644
21401067,1610612750,1610612747,99.0,101.0,0.423,0.424,0,2015-03-25,71,16,55,0.225,70,19,51,0.271
21401068,1610612740,1610612745,93.0,95.0,0.4529999999999999,0.494,0,2015-03-25,71,37,34,0.521,71,48,23,0.6759999999999999
21401069,1610612743,1610612755,85.0,99.0,0.345,0.417,0,2015-03-25,72,27,45,0.375,72,18,54,0.25
21401070,1610612762,1610612757,89.0,92.0,0.4379999999999999,0.42,0,2015-03-25,71,31,40,0.4370000000000001,70,45,25,0.643
21401071,1610612759,1610612760,130.0,91.0,0.58,0.4,1,2015-03-25,71,45,26,0.634,72,41,31,0.569
21401072,1610612756,1610612758,99.0,108.0,0.4370000000000001,0.494,0,2015-03-25,72,38,34,0.528,71,26,45,0.366
21401054,1610612765,1610612761,108.0,104.0,0.43,0.467,1,2015-03-24,71,27,44,0.38,71,42,29,0.5920000000000001
21401055,1610612749,1610612748,89.0,88.0,0.414,0.44,1,2015-03-24,71,35,36,0.493,70,32,38,0.457
21401056,1610612760,1610612747,127.0,117.0,0.5579999999999999,0.518,1,2015-03-24,71,41,30,0.5770000000000001,69,18,51,0.261
21401057,1610612742,1610612759,101.0,94.0,0.483,0.424,1,2015-03-24,72,45,27,0.625,70,44,26,0.629
21401058,1610612758,1610612755,107.0,106.0,0.361,0.494,1,2015-03-24,70,25,45,0.357,71,17,54,0.239
21401059,1610612757,1610612744,108.0,122.0,0.424,0.602,0,2015-03-24,69,44,25,0.638,71,58,13,0.8170000000000001
21401048,1610612754,1610612745,100.0,110.0,0.444,0.477,0,2015-03-23,70,30,40,0.429,70,47,23,0.6709999999999999
21401049,1610612751,1610612738,91.0,110.0,0.36,0.511,0,2015-03-23,69,29,40,0.42,70,31,39,0.4429999999999999
21401050,1610612752,1610612763,82.0,103.0,0.421,0.519,0,2015-03-23,71,14,57,0.1969999999999999,71,50,21,0.7040000000000001
21401051,1610612741,1610612766,98.0,86.0,0.451,0.346,1,2015-03-23,72,43,29,0.597,69,30,39,0.435
21401052,1610612762,1610612750,104.0,106.0,0.4370000000000001,0.474,0,2015-03-23,70,31,39,0.4429999999999999,70,16,54,0.2289999999999999
21401053,1610612744,1610612764,107.0,76.0,0.411,0.3329999999999999,1,2015-03-23,70,57,13,0.8140000000000001,71,40,31,0.563
21401037,1610612749,1610612739,90.0,108.0,0.5429999999999999,0.5,0,2015-03-22,70,34,36,0.486,72,46,26,0.639
21401038,1610612760,1610612748,93.0,75.0,0.444,0.395,1,2015-03-22,70,40,30,0.5710000000000001,69,32,37,0.4639999999999999
21401039,1610612737,1610612759,95.0,114.0,0.475,0.561,0,2015-03-22,70,53,17,0.757,69,44,25,0.638
21401040,1610612746,1610612740,107.0,100.0,0.462,0.507,1,2015-03-22,71,46,25,0.648,70,37,33,0.529
21401041,1610612761,1610612752,106.0,89.0,0.52,0.417,1,2015-03-22,70,42,28,0.6,70,14,56,0.2
21401042,1610612758,1610612764,109.0,86.0,0.506,0.402,1,2015-03-22,69,24,45,0.348,70,40,30,0.5710000000000001
21401043,1610612738,1610612765,97.0,105.0,0.362,0.4379999999999999,0,2015-03-22,69,30,39,0.435,70,26,44,0.371
21401044,1610612753,1610612743,100.0,119.0,0.482,0.467,0,2015-03-22,72,22,50,0.306,71,27,44,0.38
21401045,1610612750,1610612766,98.0,109.0,0.5539999999999999,0.506,0,2015-03-22,69,15,54,0.217,68,30,38,0.441
21401046,1610612756,1610612742,98.0,92.0,0.513,0.385,1,2015-03-22,71,38,33,0.535,71,44,27,0.62
21401047,1610612747,1610612755,101.0,87.0,0.481,0.36,1,2015-03-22,68,18,50,0.265,70,17,53,0.243
21401032,1610612754,1610612751,111.0,123.0,0.5,0.613,0,2015-03-21,69,30,39,0.435,68,29,39,0.426
21401033,1610612765,1610612741,107.0,91.0,0.489,0.429,1,2015-03-21,69,25,44,0.362,71,42,29,0.5920000000000001
21401034,1610612745,1610612756,102.0,117.0,0.471,0.5,0,2015-03-21,69,46,23,0.667,70,37,33,0.529
21401035,1610612763,1610612757,97.0,86.0,0.416,0.434,1,2015-03-21,70,49,21,0.7,68,44,24,0.647
21401036,1610612744,1610612762,106.0,91.0,0.487,0.4379999999999999,1,2015-03-21,69,56,13,0.812,69,31,38,0.449
21401020,1610612753,1610612757,111.0,104.0,0.457,0.475,1,2015-03-20,71,22,49,0.31,67,44,23,0.657
21401021,1610612755,1610612752,97.0,81.0,0.42,0.362,1,2015-03-20,69,17,52,0.246,69,14,55,0.203
21401022,1610612751,1610612749,129.0,127.0,0.43,0.38,1,2015-03-20,67,28,39,0.418,69,34,35,0.493
21401023,1610612739,1610612754,95.0,92.0,0.4270000000000001,0.429,1,2015-03-20,71,45,26,0.634,68,30,38,0.441
21401024,1610612748,1610612743,108.0,91.0,0.531,0.4679999999999999,1,2015-03-20,68,32,36,0.471,70,26,44,0.371
21401025,1610612741,1610612761,108.0,92.0,0.532,0.38,1,2015-03-20,70,42,28,0.6,69,41,28,0.594
21401026,1610612760,1610612737,123.0,115.0,0.512,0.5,1,2015-03-20,69,39,30,0.565,69,53,16,0.768
21401027,1610612742,1610612763,101.0,112.0,0.447,0.532,0,2015-03-20,70,44,26,0.629,69,48,21,0.696
21401028,1610612759,1610612738,101.0,89.0,0.469,0.3979999999999999,1,2015-03-20,68,43,25,0.632,68,30,38,0.441
21401029,1610612758,1610612766,101.0,91.0,0.474,0.396,1,2015-03-20,68,23,45,0.3379999999999999,67,29,38,0.433
21401030,1610612744,1610612740,112.0,96.0,0.5,0.429,1,2015-03-20,68,55,13,0.809,69,37,32,0.536
21401031,1610612746,1610612764,113.0,99.0,0.523,0.43,1,2015-03-20,70,45,25,0.643,69,40,29,0.58
21401016,1610612752,1610612750,92.0,95.0,0.412,0.41,0,2015-03-19,68,14,54,0.206,68,15,53,0.221
21401017,1610612745,1610612743,118.0,108.0,0.446,0.452,1,2015-03-19,68,46,22,0.6759999999999999,69,26,43,0.377
21401018,1610612756,1610612740,74.0,72.0,0.349,0.373,1,2015-03-19,69,36,33,0.522,68,37,31,0.544
21401019,1610612747,1610612762,73.0,80.0,0.4029999999999999,0.4029999999999999,0,2015-03-19,67,17,50,0.254,68,31,37,0.456
21401005,1610612739,1610612751,117.0,92.0,0.5489999999999999,0.45,1,2015-03-18,70,44,26,0.629,66,27,39,0.409
21401006,1610612755,1610612765,94.0,83.0,0.429,0.33,1,2015-03-18,68,16,52,0.235,68,24,44,0.353
21401007,1610612748,1610612757,108.0,104.0,0.529,0.506,1,2015-03-18,67,31,36,0.4629999999999999,66,44,22,0.667
21401008,1610612761,1610612750,105.0,100.0,0.4429999999999999,0.483,1,2015-03-18,68,41,27,0.603,67,14,53,0.209
21401009,1610612741,1610612754,103.0,86.0,0.415,0.395,1,2015-03-18,69,41,28,0.594,67,30,37,0.4479999999999999
21401010,1610612749,1610612759,103.0,114.0,0.488,0.5,0,2015-03-18,68,34,34,0.5,67,42,25,0.627
21401011,1610612760,1610612738,122.0,118.0,0.477,0.524,1,2015-03-18,68,38,30,0.5589999999999999,67,30,37,0.4479999999999999
21401012,1610612742,1610612753,107.0,102.0,0.488,0.46,1,2015-03-18,69,44,25,0.638,70,21,49,0.3
21401013,1610612758,1610612746,105.0,116.0,0.481,0.511,0,2015-03-18,67,22,45,0.3279999999999999,69,44,25,0.638
21401014,1610612744,1610612737,114.0,95.0,0.524,0.356,1,2015-03-18,67,54,13,0.8059999999999999,68,53,15,0.779
21401015,1610612762,1610612764,84.0,88.0,0.415,0.524,0,2015-03-18,67,30,37,0.4479999999999999,68,40,28,0.588
21401000,1610612765,1610612763,105.0,95.0,0.47,0.4379999999999999,1,2015-03-17,67,24,43,0.358,68,47,21,0.691
21401001,1610612752,1610612759,104.0,100.0,0.451,0.3829999999999999,1,2015-03-17,67,14,53,0.209,66,41,25,0.621
21401002,1610612745,1610612753,107.0,94.0,0.5,0.4270000000000001,1,2015-03-17,67,45,22,0.672,69,21,48,0.304
21401003,1610612740,1610612749,85.0,84.0,0.349,0.3720000000000001,1,2015-03-17,67,37,30,0.552,67,34,33,0.507
21401004,1610612746,1610612766,99.0,92.0,0.455,0.405,1,2015-03-17,68,43,25,0.632,66,29,37,0.439
21400990,1610612754,1610612761,98.0,117.0,0.4320000000000001,0.476,0,2015-03-16,66,30,36,0.455,67,40,27,0.597
21400991,1610612764,1610612757,105.0,97.0,0.5,0.4039999999999999,1,2015-03-16,67,39,28,0.5820000000000001,65,44,21,0.677
21400992,1610612738,1610612755,108.0,89.0,0.5,0.405,1,2015-03-16,66,30,36,0.455,67,15,52,0.2239999999999999
21400993,1610612763,1610612743,92.0,81.0,0.413,0.37,1,2015-03-16,67,47,20,0.701,68,26,42,0.382
21400994,1610612750,1610612751,106.0,122.0,0.466,0.578,0,2015-03-16,66,14,52,0.212,65,27,38,0.415
21400995,1610612748,1610612739,106.0,92.0,0.5529999999999999,0.38,1,2015-03-16,66,30,36,0.455,69,43,26,0.623
21400996,1610612742,1610612760,119.0,115.0,0.472,0.444,1,2015-03-16,68,43,25,0.632,67,37,30,0.552
21400997,1610612762,1610612766,94.0,66.0,0.423,0.295,1,2015-03-16,66,30,36,0.455,65,29,36,0.446
21400998,1610612758,1610612737,103.0,110.0,0.469,0.452,0,2015-03-16,66,22,44,0.3329999999999999,67,53,14,0.7909999999999999
21400999,1610612744,1610612747,108.0,105.0,0.476,0.4589999999999999,1,2015-03-16,66,53,13,0.8029999999999999,66,17,49,0.258
21400982,1610612760,1610612741,109.0,100.0,0.46,0.446,1,2015-03-15,66,37,29,0.561,68,40,28,0.588
21400983,1610612746,1610612745,98.0,100.0,0.439,0.3720000000000001,0,2015-03-15,67,42,25,0.627,66,44,22,0.667
21400984,1610612740,1610612743,111.0,118.0,0.465,0.442,0,2015-03-15,66,36,30,0.545,67,26,41,0.3879999999999999
21400985,1610612753,1610612739,108.0,123.0,0.477,0.5920000000000001,0,2015-03-15,68,21,47,0.309,68,43,25,0.632
21400986,1610612759,1610612750,123.0,97.0,0.583,0.442,1,2015-03-15,65,41,24,0.631,65,14,51,0.215
21400987,1610612761,1610612757,97.0,113.0,0.474,0.523,0,2015-03-15,66,39,27,0.591,64,44,20,0.688
21400988,1610612756,1610612752,102.0,89.0,0.494,0.4379999999999999,1,2015-03-15,68,35,33,0.515,66,13,53,0.1969999999999999
21400989,1610612747,1610612737,86.0,91.0,0.4,0.447,0,2015-03-15,65,17,48,0.262,66,52,14,0.7879999999999999
21400976,1610612754,1610612738,89.0,93.0,0.4,0.422,0,2015-03-14,65,30,35,0.462,65,29,36,0.446
21400977,1610612764,1610612758,113.0,97.0,0.531,0.455,1,2015-03-14,66,38,28,0.5760000000000001,65,22,43,0.3379999999999999
21400978,1610612755,1610612751,87.0,94.0,0.3720000000000001,0.44,0,2015-03-14,66,15,51,0.2269999999999999,64,26,38,0.406
21400979,1610612763,1610612749,96.0,83.0,0.474,0.417,1,2015-03-14,66,46,20,0.6970000000000001,66,34,32,0.515
21400980,1610612762,1610612765,88.0,85.0,0.478,0.381,1,2015-03-14,65,29,36,0.446,66,23,43,0.348
21400981,1610612744,1610612752,125.0,94.0,0.5,0.396,1,2015-03-14,65,52,13,0.8,65,13,52,0.2
21400967,1610612766,1610612741,101.0,91.0,0.371,0.3779999999999999,1,2015-03-13,64,29,35,0.4529999999999999,67,40,27,0.597
21400968,1610612755,1610612758,114.0,107.0,0.474,0.402,1,2015-03-13,65,15,50,0.231,64,22,42,0.344
21400969,1610612738,1610612753,95.0,88.0,0.43,0.425,1,2015-03-13,64,28,36,0.4379999999999999,67,21,46,0.313
21400970,1610612761,1610612748,102.0,92.0,0.43,0.4429999999999999,1,2015-03-13,65,39,26,0.6,65,29,36,0.446
21400971,1610612760,1610612750,113.0,99.0,0.436,0.436,1,2015-03-13,65,36,29,0.5539999999999999,64,14,50,0.2189999999999999
21400972,1610612742,1610612746,129.0,99.0,0.607,0.5,1,2015-03-13,67,42,25,0.627,66,42,24,0.636
21400973,1610612743,1610612744,114.0,103.0,0.5,0.424,1,2015-03-13,66,25,41,0.379,64,51,13,0.797
21400974,1610612756,1610612737,87.0,96.0,0.41,0.47,0,2015-03-13,67,34,33,0.507,65,51,14,0.785
21400975,1610612757,1610612765,118.0,99.0,0.575,0.451,1,2015-03-13,63,43,20,0.6829999999999999,65,23,42,0.354
21400962,1610612754,1610612749,109.0,103.0,0.494,0.385,1,2015-03-12,64,30,34,0.469,65,34,31,0.523
21400963,1610612764,1610612763,107.0,87.0,0.5,0.3879999999999999,1,2015-03-12,65,37,28,0.569,65,45,20,0.6920000000000001
21400965,1610612762,1610612745,109.0,91.0,0.478,0.43,1,2015-03-12,64,28,36,0.4379999999999999,65,43,22,0.662
21400964,1610612759,1610612739,125.0,128.0,0.563,0.484,0,2015-03-12,64,40,24,0.625,67,42,25,0.627
21400966,1610612747,1610612752,94.0,101.0,0.422,0.4679999999999999,0,2015-03-12,64,17,47,0.266,64,13,51,0.203
21400952,1610612766,1610612758,106.0,113.0,0.452,0.471,0,2015-03-11,63,28,35,0.444,63,22,41,0.349
21400953,1610612755,1610612741,95.0,104.0,0.346,0.46,0,2015-03-11,64,14,50,0.2189999999999999,66,40,26,0.606
21400954,1610612738,1610612763,95.0,92.0,0.435,0.474,1,2015-03-11,63,27,36,0.429,64,45,19,0.703
21400955,1610612748,1610612751,104.0,98.0,0.457,0.4379999999999999,1,2015-03-11,64,29,35,0.4529999999999999,63,25,38,0.397
21400956,1610612749,1610612753,97.0,91.0,0.494,0.4,1,2015-03-11,64,34,30,0.531,66,21,45,0.318
21400957,1610612760,1610612746,108.0,120.0,0.434,0.461,0,2015-03-11,64,35,29,0.547,65,42,23,0.6459999999999999
21400958,1610612743,1610612737,115.0,102.0,0.5,0.42,1,2015-03-11,65,24,41,0.369,64,50,14,0.7809999999999999
21400959,1610612756,1610612750,106.0,97.0,0.5,0.444,1,2015-03-11,66,34,32,0.515,63,14,49,0.222
21400960,1610612744,1610612765,105.0,98.0,0.524,0.429,1,2015-03-11,63,51,12,0.81,64,23,41,0.359
21400961,1610612757,1610612745,105.0,100.0,0.457,0.418,1,2015-03-11,62,42,20,0.677,64,43,21,0.672
21400946,1610612754,1610612753,118.0,86.0,0.529,0.37,1,2015-03-10,63,29,34,0.46,65,21,44,0.3229999999999999
21400947,1610612751,1610612740,91.0,111.0,0.417,0.517,0,2015-03-10,62,25,37,0.4029999999999999,65,36,29,0.5539999999999999
21400948,1610612742,1610612739,94.0,127.0,0.407,0.506,0,2015-03-10,66,41,25,0.621,66,41,25,0.621
21400949,1610612759,1610612761,117.0,107.0,0.482,0.4429999999999999,1,2015-03-10,63,40,23,0.635,64,38,26,0.594
21400950,1610612762,1610612752,87.0,82.0,0.429,0.392,1,2015-03-10,63,27,36,0.429,63,12,51,0.19
21400951,1610612747,1610612765,93.0,85.0,0.4270000000000001,0.381,1,2015-03-10,63,17,46,0.27,63,23,40,0.365
21400938,1610612766,1610612764,69.0,95.0,0.325,0.518,0,2015-03-09,62,28,34,0.452,64,36,28,0.563
21400939,1610612737,1610612758,130.0,105.0,0.602,0.481,1,2015-03-09,63,50,13,0.794,62,21,41,0.3389999999999999
21400940,1610612748,1610612738,90.0,100.0,0.42,0.4479999999999999,0,2015-03-09,63,28,35,0.444,62,26,36,0.419
21400941,1610612741,1610612763,91.0,101.0,0.4379999999999999,0.5,0,2015-03-09,65,39,26,0.6,63,45,18,0.7140000000000001
21400942,1610612749,1610612740,103.0,114.0,0.521,0.5870000000000001,0,2015-03-09,63,33,30,0.524,64,35,29,0.547
21400943,1610612743,1610612752,106.0,78.0,0.4370000000000001,0.387,1,2015-03-09,64,23,41,0.359,62,12,50,0.1939999999999999
21400944,1610612756,1610612744,80.0,98.0,0.377,0.422,0,2015-03-09,65,33,32,0.508,62,50,12,0.8059999999999999
21400945,1610612746,1610612750,89.0,76.0,0.4429999999999999,0.373,1,2015-03-09,64,41,23,0.6409999999999999,62,14,48,0.226
21400931,1610612759,1610612741,116.0,105.0,0.489,0.507,1,2015-03-08,62,39,23,0.629,64,39,25,0.609
21400932,1610612744,1610612746,106.0,98.0,0.5,0.482,1,2015-03-08,61,49,12,0.8029999999999999,63,40,23,0.635
21400933,1610612751,1610612762,88.0,95.0,0.5,0.472,0,2015-03-08,61,25,36,0.41,62,26,36,0.419
21400934,1610612765,1610612766,101.0,108.0,0.4379999999999999,0.519,0,2015-03-08,62,23,39,0.371,61,28,33,0.4589999999999999
21400935,1610612753,1610612738,103.0,98.0,0.4370000000000001,0.3929999999999999,1,2015-03-08,64,21,43,0.3279999999999999,61,25,36,0.41
21400936,1610612760,1610612761,108.0,104.0,0.512,0.429,1,2015-03-08,63,35,28,0.556,63,38,25,0.603
21400937,1610612747,1610612742,93.0,100.0,0.4629999999999999,0.487,0,2015-03-08,62,16,46,0.258,65,41,24,0.631
21400923,1610612740,1610612763,95.0,89.0,0.475,0.4320000000000001,1,2015-03-07,63,34,29,0.54,62,44,18,0.71
21400924,1610612739,1610612756,89.0,79.0,0.413,0.357,1,2015-03-07,65,40,25,0.615,64,33,31,0.516
21400925,1610612748,1610612758,114.0,109.0,0.513,0.455,1,2015-03-07,62,28,34,0.452,61,21,40,0.344
21400926,1610612752,1610612754,86.0,92.0,0.385,0.38,0,2015-03-07,61,12,49,0.1969999999999999,62,28,34,0.452
21400927,1610612755,1610612737,92.0,84.0,0.368,0.39,1,2015-03-07,63,14,49,0.222,62,49,13,0.79
21400928,1610612750,1610612757,121.0,113.0,0.541,0.489,1,2015-03-07,61,14,47,0.23,61,41,20,0.672
21400929,1610612749,1610612764,91.0,85.0,0.462,0.3829999999999999,1,2015-03-07,62,33,29,0.532,63,35,28,0.556
21400930,1610612743,1610612745,100.0,114.0,0.413,0.465,0,2015-03-07,63,22,41,0.349,63,43,20,0.6829999999999999
21400911,1610612766,1610612761,103.0,94.0,0.471,0.407,1,2015-03-06,60,27,33,0.45,62,38,24,0.613
21400912,1610612754,1610612741,98.0,84.0,0.425,0.36,1,2015-03-06,61,27,34,0.4429999999999999,63,39,24,0.619
21400913,1610612753,1610612758,119.0,114.0,0.565,0.447,1,2015-03-06,63,20,43,0.317,60,21,39,0.35
21400914,1610612755,1610612762,83.0,89.0,0.364,0.38,0,2015-03-06,62,13,49,0.21,61,25,36,0.41
21400920,1610612764,1610612748,99.0,97.0,0.4629999999999999,0.4679999999999999,1,2015-03-06,62,35,27,0.565,61,27,34,0.4429999999999999
21400915,1610612737,1610612739,106.0,97.0,0.512,0.42,1,2015-03-06,61,49,12,0.8029999999999999,64,39,25,0.609
21400916,1610612751,1610612756,100.0,108.0,0.351,0.429,0,2015-03-06,60,25,35,0.417,63,33,30,0.524
21400917,1610612745,1610612765,103.0,93.0,0.418,0.363,1,2015-03-06,62,42,20,0.677,61,23,38,0.377
21400918,1610612763,1610612747,97.0,90.0,0.442,0.4639999999999999,1,2015-03-06,61,44,17,0.721,61,16,45,0.262
21400919,1610612740,1610612738,98.0,104.0,0.475,0.456,0,2015-03-06,62,33,29,0.532,60,25,35,0.417
21400921,1610612759,1610612743,120.0,111.0,0.544,0.523,1,2015-03-06,61,38,23,0.623,62,22,40,0.355
21400922,1610612744,1610612742,104.0,89.0,0.469,0.368,1,2015-03-06,60,48,12,0.8,64,40,24,0.625
21400909,1610612741,1610612760,108.0,105.0,0.46,0.466,1,2015-03-05,62,39,23,0.629,62,34,28,0.5479999999999999
21400910,1610612757,1610612742,94.0,75.0,0.415,0.375,1,2015-03-05,60,41,19,0.6829999999999999,63,40,23,0.635
21400896,1610612754,1610612752,105.0,82.0,0.475,0.395,1,2015-03-04,60,26,34,0.433,60,12,48,0.2
21400897,1610612753,1610612756,100.0,105.0,0.471,0.4679999999999999,0,2015-03-04,62,19,43,0.306,62,32,30,0.516
21400898,1610612738,1610612762,85.0,84.0,0.375,0.4529999999999999,1,2015-03-04,59,24,35,0.407,60,24,36,0.4
21400899,1610612751,1610612766,91.0,115.0,0.3979999999999999,0.494,0,2015-03-04,59,25,34,0.424,59,26,33,0.441
21400900,1610612761,1610612739,112.0,120.0,0.544,0.513,0,2015-03-04,61,38,23,0.623,63,39,24,0.619
21400901,1610612745,1610612763,100.0,102.0,0.488,0.506,0,2015-03-04,61,41,20,0.672,60,43,17,0.7170000000000001
21400902,1610612750,1610612743,85.0,100.0,0.39,0.457,0,2015-03-04,60,13,47,0.217,61,22,39,0.361
21400903,1610612740,1610612765,88.0,85.0,0.411,0.409,1,2015-03-04,61,33,28,0.541,60,23,37,0.3829999999999999
21400904,1610612760,1610612755,123.0,118.0,0.4579999999999999,0.354,1,2015-03-04,61,34,27,0.557,61,13,48,0.213
21400905,1610612748,1610612747,100.0,94.0,0.405,0.4320000000000001,1,2015-03-04,60,27,33,0.45,60,16,44,0.267
21400906,1610612759,1610612758,112.0,85.0,0.529,0.3720000000000001,1,2015-03-04,60,37,23,0.617,59,21,38,0.356
21400907,1610612744,1610612749,102.0,93.0,0.507,0.425,1,2015-03-04,59,47,12,0.797,61,32,29,0.525
21400908,1610612746,1610612757,93.0,98.0,0.385,0.391,0,2015-03-04,62,40,22,0.645,59,40,19,0.6779999999999999
21400669,1610612752,1610612758,86.0,124.0,0.366,0.494,0,2015-03-03,59,12,47,0.203,58,21,37,0.362
21400890,1610612766,1610612747,104.0,103.0,0.494,0.4529999999999999,1,2015-03-03,58,25,33,0.431,59,16,43,0.271
21400891,1610612739,1610612738,110.0,79.0,0.483,0.352,1,2015-03-03,62,38,24,0.613,58,23,35,0.397
21400892,1610612737,1610612745,104.0,96.0,0.4529999999999999,0.433,1,2015-03-03,60,48,12,0.8,60,41,19,0.6829999999999999
21400893,1610612741,1610612764,97.0,92.0,0.423,0.417,1,2015-03-03,61,38,23,0.623,61,34,27,0.557
21400894,1610612763,1610612762,82.0,93.0,0.402,0.45,0,2015-03-03,59,42,17,0.7120000000000001,59,24,35,0.407
21400895,1610612743,1610612749,106.0,95.0,0.4529999999999999,0.407,1,2015-03-03,60,21,39,0.35,60,32,28,0.5329999999999999
21400885,1610612755,1610612761,103.0,114.0,0.526,0.513,0,2015-03-02,60,13,47,0.217,60,38,22,0.633
21400886,1610612751,1610612744,110.0,108.0,0.494,0.467,1,2015-03-02,58,25,33,0.431,58,46,12,0.7929999999999999
21400887,1610612748,1610612756,115.0,98.0,0.524,0.423,1,2015-03-02,59,26,33,0.441,61,31,30,0.508
21400888,1610612750,1610612746,105.0,110.0,0.439,0.478,0,2015-03-02,59,13,46,0.22,61,40,21,0.6559999999999999
21400889,1610612742,1610612740,102.0,93.0,0.481,0.473,1,2015-03-02,62,40,22,0.645,60,32,28,0.5329999999999999
21400877,1610612741,1610612746,86.0,96.0,0.31,0.4370000000000001,0,2015-03-01,60,37,23,0.617,60,39,21,0.65
21400883,1610612745,1610612739,105.0,103.0,0.4589999999999999,0.408,1,2015-03-01,59,41,18,0.695,61,37,24,0.607
21400879,1610612758,1610612757,99.0,110.0,0.4529999999999999,0.494,0,2015-03-01,57,20,37,0.351,58,39,19,0.672
21400880,1610612738,1610612744,101.0,106.0,0.3670000000000001,0.421,0,2015-03-01,57,23,34,0.4039999999999999,57,46,11,0.807
21400881,1610612754,1610612755,94.0,74.0,0.409,0.345,1,2015-03-01,59,25,34,0.424,59,13,46,0.22
21400882,1610612753,1610612766,83.0,98.0,0.365,0.5,0,2015-03-01,61,19,42,0.311,57,24,33,0.421
21400878,1610612747,1610612760,101.0,108.0,0.444,0.412,0,2015-03-01,58,16,42,0.276,60,33,27,0.55
21400884,1610612743,1610612740,92.0,99.0,0.402,0.486,0,2015-03-01,59,20,39,0.3389999999999999,59,32,27,0.542
21400870,1610612764,1610612765,99.0,95.0,0.474,0.481,1,2015-02-28,60,34,26,0.5670000000000001,59,23,36,0.39
21400871,1610612748,1610612737,91.0,93.0,0.395,0.43,0,2015-02-28,58,25,33,0.431,59,47,12,0.797
21400872,1610612752,1610612761,103.0,98.0,0.44,0.42,1,2015-02-28,58,12,46,0.207,59,37,22,0.627
21400873,1610612750,1610612763,97.0,101.0,0.386,0.594,0,2015-02-28,58,13,45,0.2239999999999999,58,42,16,0.7240000000000001
21400874,1610612742,1610612751,94.0,104.0,0.4270000000000001,0.519,0,2015-02-28,61,39,22,0.639,57,24,33,0.421
21400875,1610612756,1610612759,74.0,101.0,0.298,0.446,0,2015-02-28,60,31,29,0.517,59,36,23,0.61
21400876,1610612762,1610612749,82.0,75.0,0.382,0.392,1,2015-02-28,58,23,35,0.397,59,32,27,0.542
21400856,1610612754,1610612739,93.0,86.0,0.425,0.359,1,2015-02-27,58,24,34,0.414,60,37,23,0.617
21400857,1610612755,1610612764,89.0,81.0,0.35,0.3229999999999999,1,2015-02-27,58,13,45,0.2239999999999999,59,33,26,0.5589999999999999
21400858,1610612737,1610612753,95.0,88.0,0.444,0.45,1,2015-02-27,58,46,12,0.7929999999999999,60,19,41,0.317
21400859,1610612738,1610612766,106.0,98.0,0.417,0.451,1,2015-02-27,56,23,33,0.411,56,23,33,0.411
21400860,1610612765,1610612752,115.0,121.0,0.402,0.413,0,2015-02-27,58,23,35,0.397,57,11,46,0.193
21400861,1610612761,1610612744,89.0,113.0,0.4029999999999999,0.483,0,2015-02-27,58,37,21,0.638,56,45,11,0.804
21400862,1610612741,1610612750,96.0,89.0,0.385,0.429,1,2015-02-27,59,37,22,0.627,57,13,44,0.228
21400863,1610612745,1610612751,102.0,98.0,0.4639999999999999,0.447,1,2015-02-27,58,40,18,0.69,56,23,33,0.411
21400864,1610612763,1610612746,79.0,97.0,0.379,0.462,0,2015-02-27,57,41,16,0.7190000000000001,59,38,21,0.644
21400865,1610612740,1610612748,104.0,102.0,0.513,0.488,1,2015-02-27,58,31,27,0.534,57,25,32,0.439
21400866,1610612743,1610612762,82.0,104.0,0.3329999999999999,0.574,0,2015-02-27,58,20,38,0.345,57,22,35,0.386
21400867,1610612758,1610612759,96.0,107.0,0.481,0.3979999999999999,0,2015-02-27,56,20,36,0.357,58,35,23,0.603
21400868,1610612747,1610612749,101.0,93.0,0.471,0.391,1,2015-02-27,57,16,41,0.281,58,32,26,0.552
21400869,1610612757,1610612760,115.0,112.0,0.4379999999999999,0.479,1,2015-02-27,57,38,19,0.667,59,32,27,0.542
21400854,1610612739,1610612744,110.0,99.0,0.4679999999999999,0.424,1,2015-02-26,59,37,22,0.627,55,44,11,0.8
21400855,1610612756,1610612760,117.0,113.0,0.495,0.386,1,2015-02-26,59,31,28,0.525,58,32,26,0.552
21400842,1610612753,1610612748,90.0,93.0,0.423,0.381,0,2015-02-25,59,19,40,0.322,56,25,31,0.446
21400843,1610612737,1610612742,104.0,87.0,0.4589999999999999,0.425,1,2015-02-25,57,45,12,0.789,60,39,21,0.65
21400844,1610612738,1610612752,115.0,94.0,0.506,0.415,1,2015-02-25,55,22,33,0.4,56,10,46,0.179
21400845,1610612741,1610612766,86.0,98.0,0.442,0.4639999999999999,0,2015-02-25,58,36,22,0.621,55,23,32,0.418
21400846,1610612745,1610612746,110.0,105.0,0.409,0.44,1,2015-02-25,57,39,18,0.684,58,37,21,0.638
21400847,1610612749,1610612755,104.0,88.0,0.537,0.413,1,2015-02-25,57,32,25,0.561,57,12,45,0.211
21400848,1610612750,1610612764,97.0,77.0,0.4320000000000001,0.379,1,2015-02-25,56,13,43,0.2319999999999999,58,33,25,0.569
21400849,1610612740,1610612751,102.0,96.0,0.514,0.424,1,2015-02-25,57,30,27,0.526,55,23,32,0.418
21400850,1610612743,1610612756,96.0,110.0,0.3829999999999999,0.429,0,2015-02-25,57,20,37,0.351,58,30,28,0.517
21400851,1610612762,1610612747,97.0,100.0,0.466,0.449,0,2015-02-25,56,21,35,0.375,56,15,41,0.268
21400852,1610612758,1610612763,102.0,90.0,0.488,0.405,1,2015-02-25,55,20,35,0.364,56,41,15,0.732
21400853,1610612757,1610612759,111.0,95.0,0.506,0.435,1,2015-02-25,56,37,19,0.6609999999999999,57,34,23,0.596
21400838,1610612764,1610612744,107.0,114.0,0.532,0.5,0,2015-02-24,57,33,24,0.579,54,44,10,0.815
21400839,1610612765,1610612739,93.0,102.0,0.402,0.442,0,2015-02-24,57,23,34,0.4039999999999999,58,36,22,0.621
21400840,1610612760,1610612754,105.0,92.0,0.417,0.4320000000000001,1,2015-02-24,57,32,25,0.561,57,23,34,0.4039999999999999
21400841,1610612742,1610612761,99.0,92.0,0.481,0.452,1,2015-02-24,59,39,20,0.6609999999999999,57,37,20,0.649
21400830,1610612748,1610612755,119.0,108.0,0.5539999999999999,0.476,1,2015-02-23,55,24,31,0.436,56,12,44,0.214
21400831,1610612741,1610612749,87.0,71.0,0.355,0.337,1,2015-02-23,57,36,21,0.632,56,31,25,0.5539999999999999
21400832,1610612745,1610612750,113.0,102.0,0.415,0.3329999999999999,1,2015-02-23,56,38,18,0.679,55,12,43,0.218
21400833,1610612740,1610612761,100.0,97.0,0.513,0.417,1,2015-02-23,56,29,27,0.518,56,37,19,0.6609999999999999
21400834,1610612743,1610612751,82.0,110.0,0.33,0.467,0,2015-02-23,56,20,36,0.357,54,23,31,0.426
21400835,1610612756,1610612738,110.0,115.0,0.4539999999999999,0.4379999999999999,0,2015-02-23,57,29,28,0.509,54,21,33,0.389
21400836,1610612762,1610612759,90.0,81.0,0.41,0.405,1,2015-02-23,55,21,34,0.382,56,34,22,0.607
21400837,1610612746,1610612763,87.0,90.0,0.4429999999999999,0.407,0,2015-02-23,57,37,20,0.649,55,41,14,0.745
21400821,1610612752,1610612739,83.0,101.0,0.374,0.506,0,2015-02-22,55,10,45,0.182,57,35,22,0.614
21400822,1610612749,1610612737,86.0,97.0,0.444,0.402,0,2015-02-22,55,31,24,0.564,56,44,12,0.7859999999999999
21400823,1610612765,1610612764,106.0,89.0,0.416,0.435,1,2015-02-22,56,23,33,0.411,56,33,23,0.589
21400824,1610612754,1610612744,104.0,98.0,0.481,0.382,1,2015-02-22,56,23,33,0.411,53,43,10,0.8109999999999999
21400825,1610612753,1610612755,103.0,98.0,0.476,0.462,1,2015-02-22,58,19,39,0.3279999999999999,55,12,43,0.218
21400826,1610612760,1610612743,119.0,94.0,0.522,0.361,1,2015-02-22,56,31,25,0.5539999999999999,55,20,35,0.364
21400827,1610612742,1610612766,92.0,81.0,0.462,0.3670000000000001,1,2015-02-22,58,38,20,0.655,54,22,32,0.407
21400828,1610612757,1610612763,92.0,98.0,0.402,0.472,0,2015-02-22,55,36,19,0.655,54,40,14,0.741
21400829,1610612747,1610612738,118.0,111.0,0.512,0.429,1,2015-02-22,55,14,41,0.255,53,20,33,0.377
21400816,1610612766,1610612760,103.0,110.0,0.43,0.442,0,2015-02-21,53,22,31,0.415,55,30,25,0.545
21400817,1610612748,1610612740,91.0,105.0,0.418,0.422,0,2015-02-21,54,23,31,0.426,55,28,27,0.509
21400818,1610612741,1610612756,112.0,107.0,0.483,0.534,1,2015-02-21,56,35,21,0.625,56,29,27,0.518
21400819,1610612745,1610612761,98.0,76.0,0.417,0.325,1,2015-02-21,55,37,18,0.6729999999999999,55,37,18,0.6729999999999999
21400820,1610612746,1610612758,126.0,99.0,0.484,0.341,1,2015-02-21,56,37,19,0.6609999999999999,54,19,35,0.352
21400803,1610612753,1610612740,95.0,84.0,0.5,0.42,1,2015-02-20,57,18,39,0.316,54,27,27,0.5
21400804,1610612755,1610612754,95.0,106.0,0.405,0.482,0,2015-02-20,54,12,42,0.222,55,22,33,0.4
21400805,1610612737,1610612761,80.0,105.0,0.33,0.4479999999999999,0,2015-02-20,55,43,12,0.782,54,37,17,0.685
21400806,1610612765,1610612741,100.0,91.0,0.452,0.423,1,2015-02-20,55,22,33,0.4,55,34,21,0.618
21400807,1610612752,1610612748,87.0,111.0,0.4270000000000001,0.481,0,2015-02-20,54,10,44,0.185,53,23,30,0.434
21400808,1610612750,1610612756,111.0,109.0,0.465,0.449,1,2015-02-20,54,12,42,0.222,55,29,26,0.527
21400809,1610612764,1610612739,89.0,127.0,0.442,0.511,0,2015-02-20,55,33,22,0.6,56,34,22,0.607
21400810,1610612742,1610612745,111.0,100.0,0.473,0.414,1,2015-02-20,57,37,20,0.649,54,36,18,0.667
21400811,1610612749,1610612743,89.0,81.0,0.423,0.357,1,2015-02-20,54,31,23,0.574,54,20,34,0.37
21400812,1610612762,1610612757,92.0,76.0,0.446,0.361,1,2015-02-20,54,20,34,0.37,54,36,18,0.667
21400813,1610612758,1610612738,109.0,101.0,0.482,0.4,1,2015-02-20,53,19,34,0.358,52,20,32,0.385
21400814,1610612744,1610612759,110.0,99.0,0.488,0.481,1,2015-02-20,52,43,9,0.8270000000000001,55,34,21,0.618
21400815,1610612747,1610612751,105.0,114.0,0.461,0.472,0,2015-02-20,54,13,41,0.241,53,22,31,0.415
21400801,1610612760,1610612742,104.0,89.0,0.418,0.363,1,2015-02-19,54,29,25,0.537,56,36,20,0.643
21400802,1610612746,1610612759,119.0,115.0,0.545,0.512,1,2015-02-19,55,36,19,0.655,54,34,20,0.63
21400800,1610612741,1610612739,113.0,98.0,0.457,0.435,1,2015-02-12,54,34,20,0.63,55,33,22,0.6
21400788,1610612753,1610612752,89.0,83.0,0.4629999999999999,0.342,1,2015-02-11,56,17,39,0.304,53,10,43,0.1889999999999999
21400789,1610612738,1610612737,89.0,88.0,0.3229999999999999,0.423,1,2015-02-11,51,20,31,0.392,54,43,11,0.7959999999999999
21400790,1610612765,1610612759,87.0,104.0,0.407,0.477,0,2015-02-11,54,21,33,0.389,53,34,19,0.642
21400791,1610612761,1610612764,95.0,93.0,0.408,0.4589999999999999,1,2015-02-11,53,36,17,0.679,54,33,21,0.611
21400792,1610612749,1610612758,111.0,103.0,0.488,0.429,1,2015-02-11,53,30,23,0.5660000000000001,52,18,34,0.346
21400793,1610612750,1610612744,91.0,94.0,0.384,0.444,0,2015-02-11,53,11,42,0.208,51,42,9,0.8240000000000001
21400794,1610612740,1610612754,93.0,106.0,0.4589999999999999,0.5329999999999999,0,2015-02-11,53,27,26,0.509,54,21,33,0.389
21400795,1610612760,1610612763,105.0,89.0,0.446,0.3720000000000001,1,2015-02-11,53,28,25,0.528,53,39,14,0.736
21400796,1610612739,1610612748,113.0,93.0,0.564,0.405,1,2015-02-11,54,33,21,0.611,52,22,30,0.423
21400797,1610612742,1610612762,87.0,82.0,0.373,0.375,1,2015-02-11,55,36,19,0.655,53,19,34,0.358
21400798,1610612757,1610612747,102.0,86.0,0.407,0.366,1,2015-02-11,53,36,17,0.679,53,13,40,0.245
21400799,1610612746,1610612745,110.0,95.0,0.481,0.391,1,2015-02-11,54,35,19,0.648,53,36,17,0.679
21400783,1610612766,1610612765,78.0,106.0,0.358,0.446,0,2015-02-10,52,22,30,0.423,53,21,32,0.396
21400784,1610612756,1610612745,118.0,127.0,0.471,0.505,0,2015-02-10,54,29,25,0.537,52,36,16,0.6920000000000001
21400785,1610612741,1610612758,104.0,86.0,0.525,0.467,1,2015-02-10,53,33,20,0.623,51,18,33,0.353
21400786,1610612763,1610612751,95.0,86.0,0.444,0.4320000000000001,1,2015-02-10,52,39,13,0.75,52,21,31,0.4039999999999999
21400787,1610612747,1610612743,96.0,106.0,0.435,0.544,0,2015-02-10,52,13,39,0.25,53,20,33,0.377
21400774,1610612754,1610612759,93.0,95.0,0.409,0.416,0,2015-02-09,53,20,33,0.377,52,33,19,0.635
21400775,1610612755,1610612744,84.0,89.0,0.418,0.4,0,2015-02-09,53,12,41,0.226,50,41,9,0.82
21400776,1610612764,1610612753,96.0,80.0,0.429,0.3979999999999999,1,2015-02-09,53,33,20,0.623,55,16,39,0.291
21400777,1610612748,1610612752,109.0,95.0,0.486,0.429,1,2015-02-09,51,22,29,0.431,52,10,42,0.192
21400778,1610612749,1610612751,103.0,97.0,0.416,0.5,1,2015-02-09,52,29,23,0.5579999999999999,51,21,30,0.412
21400779,1610612750,1610612737,105.0,117.0,0.452,0.512,0,2015-02-09,52,11,41,0.212,53,43,10,0.8109999999999999
21400780,1610612740,1610612762,96.0,100.0,0.418,0.419,0,2015-02-09,52,27,25,0.519,52,19,33,0.365
21400781,1610612742,1610612746,98.0,115.0,0.407,0.446,0,2015-02-09,54,35,19,0.648,53,34,19,0.642
21400782,1610612743,1610612760,114.0,124.0,0.483,0.5379999999999999,0,2015-02-09,52,19,33,0.365,52,27,25,0.519
21400765,1610612760,1610612746,131.0,108.0,0.523,0.467,1,2015-02-08,51,26,25,0.51,52,33,19,0.635
21400766,1610612739,1610612747,120.0,105.0,0.5489999999999999,0.41,1,2015-02-08,53,32,21,0.604,51,13,38,0.255
21400767,1610612763,1610612737,94.0,88.0,0.391,0.413,1,2015-02-08,51,38,13,0.745,52,42,10,0.8079999999999999
21400768,1610612766,1610612754,102.0,103.0,0.4679999999999999,0.44,0,2015-02-08,51,22,29,0.431,52,20,32,0.385
21400769,1610612765,1610612750,101.0,112.0,0.4679999999999999,0.513,0,2015-02-08,52,20,32,0.385,51,11,40,0.216
21400770,1610612753,1610612741,97.0,98.0,0.47,0.481,0,2015-02-08,54,16,38,0.296,52,32,20,0.615
21400771,1610612745,1610612757,98.0,109.0,0.3779999999999999,0.526,0,2015-02-08,51,35,16,0.6859999999999999,52,35,17,0.6729999999999999
21400772,1610612761,1610612759,87.0,82.0,0.4320000000000001,0.3329999999999999,1,2015-02-08,52,35,17,0.6729999999999999,51,32,19,0.627
21400773,1610612758,1610612756,85.0,83.0,0.4529999999999999,0.363,1,2015-02-08,50,18,32,0.36,53,29,24,0.547
21400758,1610612740,1610612741,72.0,107.0,0.3720000000000001,0.512,0,2015-02-07,51,27,24,0.529,51,31,20,0.608
21400759,1610612764,1610612751,114.0,77.0,0.506,0.3379999999999999,1,2015-02-07,52,32,20,0.615,50,21,29,0.42
21400760,1610612752,1610612744,92.0,106.0,0.402,0.457,0,2015-02-07,51,10,41,0.196,49,40,9,0.816
21400761,1610612755,1610612766,89.0,81.0,0.392,0.345,1,2015-02-07,52,12,40,0.231,50,22,28,0.44
21400762,1610612742,1610612757,111.0,101.0,0.41,0.416,1,2015-02-07,53,35,18,0.66,51,34,17,0.667
21400763,1610612749,1610612738,96.0,93.0,0.493,0.419,1,2015-02-07,51,28,23,0.5489999999999999,50,19,31,0.38
21400764,1610612762,1610612758,102.0,90.0,0.5,0.39,1,2015-02-07,51,18,33,0.353,49,17,32,0.347
21400746,1610612751,1610612752,92.0,88.0,0.5,0.382,1,2015-02-06,49,21,28,0.429,50,10,40,0.2
21400747,1610612754,1610612739,103.0,99.0,0.4679999999999999,0.449,1,2015-02-06,51,19,32,0.373,52,31,21,0.596
21400748,1610612753,1610612747,103.0,97.0,0.518,0.402,1,2015-02-06,53,16,37,0.302,50,13,37,0.26
21400752,1610612761,1610612746,123.0,107.0,0.5329999999999999,0.487,1,2015-02-06,51,34,17,0.667,51,33,18,0.647
21400749,1610612737,1610612744,124.0,116.0,0.494,0.456,1,2015-02-06,51,42,9,0.8240000000000001,48,39,9,0.813
21400750,1610612738,1610612755,107.0,96.0,0.4529999999999999,0.4429999999999999,1,2015-02-06,49,19,30,0.3879999999999999,51,11,40,0.216
21400751,1610612765,1610612743,98.0,88.0,0.451,0.3879999999999999,1,2015-02-06,51,20,31,0.392,51,19,32,0.373
21400753,1610612745,1610612749,117.0,111.0,0.506,0.505,1,2015-02-06,50,35,15,0.7,50,27,23,0.54
21400754,1610612750,1610612763,90.0,89.0,0.4320000000000001,0.522,1,2015-02-06,50,10,40,0.2,50,37,13,0.74
21400755,1610612760,1610612740,113.0,116.0,0.449,0.482,0,2015-02-06,50,25,25,0.5,50,27,23,0.54
21400756,1610612756,1610612762,100.0,93.0,0.452,0.4629999999999999,1,2015-02-06,52,29,23,0.5579999999999999,50,17,33,0.34
21400757,1610612759,1610612748,98.0,85.0,0.482,0.45,1,2015-02-06,50,32,18,0.64,50,21,29,0.42
21400742,1610612766,1610612764,94.0,87.0,0.434,0.417,1,2015-02-05,49,22,27,0.449,51,31,20,0.608
21400743,1610612739,1610612746,105.0,94.0,0.431,0.418,1,2015-02-05,51,31,20,0.608,50,33,17,0.66
21400744,1610612758,1610612742,78.0,101.0,0.3670000000000001,0.4270000000000001,0,2015-02-05,48,17,31,0.354,52,34,18,0.654
21400745,1610612757,1610612756,108.0,87.0,0.444,0.386,1,2015-02-05,50,34,16,0.68,51,28,23,0.5489999999999999
21400731,1610612754,1610612765,114.0,109.0,0.597,0.494,1,2015-02-04,50,18,32,0.36,50,19,31,0.38
21400732,1610612737,1610612764,105.0,96.0,0.475,0.442,1,2015-02-04,50,41,9,0.82,50,31,19,0.62
21400733,1610612738,1610612743,104.0,100.0,0.4039999999999999,0.413,1,2015-02-04,48,18,30,0.375,50,19,31,0.38
21400734,1610612761,1610612751,93.0,109.0,0.4429999999999999,0.494,0,2015-02-04,50,33,17,0.66,48,20,28,0.417
21400735,1610612745,1610612741,101.0,90.0,0.413,0.348,1,2015-02-04,49,34,15,0.6940000000000001,50,30,20,0.6
21400736,1610612749,1610612747,113.0,105.0,0.5,0.419,1,2015-02-04,49,27,22,0.551,49,13,36,0.265
21400737,1610612750,1610612748,102.0,101.0,0.514,0.488,1,2015-02-04,49,9,40,0.184,49,21,28,0.429
21400738,1610612740,1610612760,91.0,102.0,0.381,0.529,0,2015-02-04,49,26,23,0.531,49,25,24,0.51
21400739,1610612759,1610612753,110.0,103.0,0.524,0.5,1,2015-02-04,49,31,18,0.633,52,15,37,0.288
21400740,1610612762,1610612763,90.0,100.0,0.452,0.475,0,2015-02-04,49,17,32,0.347,49,37,12,0.755
21400741,1610612744,1610612742,128.0,114.0,0.523,0.418,1,2015-02-04,47,39,8,0.83,51,33,18,0.647
21400726,1610612755,1610612743,105.0,98.0,0.4429999999999999,0.3879999999999999,1,2015-02-03,50,11,39,0.22,49,19,30,0.3879999999999999
21400727,1610612765,1610612748,108.0,91.0,0.477,0.473,1,2015-02-03,49,19,30,0.3879999999999999,48,21,27,0.4379999999999999
21400728,1610612752,1610612738,97.0,108.0,0.494,0.545,0,2015-02-03,49,10,39,0.204,47,17,30,0.362
21400729,1610612757,1610612762,103.0,102.0,0.474,0.4589999999999999,1,2015-02-03,49,33,16,0.6729999999999999,48,17,31,0.354
21400730,1610612758,1610612744,96.0,121.0,0.4429999999999999,0.505,0,2015-02-03,47,17,30,0.362,46,38,8,0.826
21400718,1610612739,1610612755,97.0,84.0,0.449,0.397,1,2015-02-02,50,30,20,0.6,49,10,39,0.204
21400719,1610612764,1610612766,88.0,92.0,0.407,0.4679999999999999,0,2015-02-02,49,31,18,0.633,48,21,27,0.4379999999999999
21400720,1610612751,1610612746,102.0,100.0,0.494,0.472,1,2015-02-02,47,19,28,0.4039999999999999,49,33,16,0.6729999999999999
21400721,1610612761,1610612749,75.0,82.0,0.321,0.413,0,2015-02-02,49,33,16,0.6729999999999999,48,26,22,0.542
21400722,1610612740,1610612737,115.0,100.0,0.5,0.449,1,2015-02-02,48,26,22,0.542,49,40,9,0.816
21400723,1610612760,1610612753,104.0,97.0,0.493,0.422,1,2015-02-02,48,24,24,0.5,51,15,36,0.294
21400724,1610612742,1610612750,100.0,94.0,0.4639999999999999,0.415,1,2015-02-02,50,33,17,0.66,48,8,40,0.1669999999999999
21400725,1610612756,1610612763,101.0,102.0,0.5,0.434,0,2015-02-02,50,28,22,0.56,48,36,12,0.75
21400716,1610612738,1610612748,75.0,83.0,0.37,0.416,0,2015-02-01,46,16,30,0.348,47,21,26,0.447
21400717,1610612752,1610612747,92.0,80.0,0.44,0.355,1,2015-02-01,48,10,38,0.208,48,13,35,0.271
21400705,1610612754,1610612758,94.0,99.0,0.413,0.425,0,2015-01-31,49,17,32,0.347,46,17,29,0.37
21400706,1610612753,1610612742,93.0,108.0,0.423,0.568,0,2015-01-31,50,15,35,0.3,49,32,17,0.653
21400707,1610612764,1610612761,116.0,120.0,0.4679999999999999,0.5,0,2015-01-31,48,31,17,0.6459999999999999,48,33,15,0.688
21400708,1610612737,1610612755,91.0,85.0,0.436,0.3829999999999999,1,2015-01-31,48,40,8,0.833,48,10,38,0.208
21400709,1610612765,1610612745,114.0,101.0,0.5,0.4479999999999999,1,2015-01-31,48,18,30,0.375,48,33,15,0.688
21400710,1610612763,1610612760,85.0,74.0,0.374,0.346,1,2015-01-31,47,35,12,0.745,47,23,24,0.489
21400711,1610612750,1610612739,90.0,106.0,0.415,0.483,0,2015-01-31,47,8,39,0.17,49,29,20,0.5920000000000001
21400712,1610612749,1610612757,95.0,88.0,0.451,0.371,1,2015-01-31,47,25,22,0.532,48,32,16,0.667
21400713,1610612743,1610612766,86.0,104.0,0.359,0.473,0,2015-01-31,48,19,29,0.396,47,20,27,0.426
21400714,1610612759,1610612746,85.0,105.0,0.373,0.44,0,2015-01-31,48,30,18,0.625,48,33,15,0.688
21400715,1610612744,1610612756,106.0,87.0,0.46,0.363,1,2015-01-31,45,37,8,0.8220000000000001,49,28,21,0.5710000000000001
21400696,1610612755,1610612750,103.0,94.0,0.5,0.447,1,2015-01-30,47,10,37,0.213,46,8,38,0.174
21400697,1610612737,1610612757,105.0,99.0,0.476,0.4479999999999999,1,2015-01-30,47,39,8,0.83,47,32,15,0.6809999999999999
21400698,1610612738,1610612745,87.0,93.0,0.356,0.417,0,2015-01-30,45,16,29,0.356,47,33,14,0.7020000000000001
21400699,1610612751,1610612761,122.0,127.0,0.485,0.511,0,2015-01-30,46,18,28,0.391,47,32,15,0.6809999999999999
21400700,1610612739,1610612758,101.0,90.0,0.475,0.357,1,2015-01-30,48,28,20,0.583,45,16,29,0.356
21400701,1610612740,1610612746,108.0,103.0,0.419,0.457,1,2015-01-30,47,25,22,0.532,47,32,15,0.6809999999999999
21400702,1610612748,1610612742,72.0,93.0,0.33,0.415,0,2015-01-30,46,20,26,0.435,48,31,17,0.6459999999999999
21400703,1610612762,1610612744,110.0,100.0,0.447,0.43,1,2015-01-30,47,17,30,0.362,44,36,8,0.818
21400704,1610612756,1610612741,99.0,93.0,0.433,0.414,1,2015-01-30,48,28,20,0.583,49,30,19,0.612
21400692,1610612753,1610612749,100.0,115.0,0.451,0.517,0,2015-01-29,49,15,34,0.306,46,24,22,0.522
21400694,1610612754,1610612752,103.0,82.0,0.532,0.42,1,2015-01-29,48,17,31,0.354,47,9,38,0.191
21400693,1610612763,1610612743,99.0,69.0,0.4429999999999999,0.3329999999999999,1,2015-01-29,46,34,12,0.7390000000000001,47,19,28,0.4039999999999999
21400695,1610612747,1610612741,123.0,118.0,0.472,0.413,1,2015-01-29,47,13,34,0.2769999999999999,48,30,18,0.625
21400681,1610612739,1610612757,99.0,94.0,0.4,0.4379999999999999,1,2015-01-28,47,27,20,0.574,46,32,14,0.696
21400682,1610612755,1610612765,89.0,69.0,0.474,0.307,1,2015-01-28,46,9,37,0.196,47,17,30,0.362
21400684,1610612761,1610612758,119.0,102.0,0.512,0.479,1,2015-01-28,46,31,15,0.674,44,16,28,0.364
21400683,1610612737,1610612751,113.0,102.0,0.4629999999999999,0.4479999999999999,1,2015-01-28,46,38,8,0.826,45,18,27,0.4
21400685,1610612745,1610612742,99.0,94.0,0.409,0.4270000000000001,1,2015-01-28,46,32,14,0.696,47,30,17,0.638
21400686,1610612750,1610612738,110.0,98.0,0.494,0.462,1,2015-01-28,45,8,37,0.178,44,16,28,0.364
21400687,1610612740,1610612743,85.0,93.0,0.39,0.4589999999999999,0,2015-01-28,46,24,22,0.522,46,19,27,0.413
21400688,1610612752,1610612760,100.0,92.0,0.44,0.4,1,2015-01-28,46,9,37,0.196,46,23,23,0.5
21400689,1610612759,1610612766,95.0,86.0,0.422,0.41,1,2015-01-28,47,30,17,0.638,46,19,27,0.413
21400690,1610612762,1610612746,89.0,94.0,0.4320000000000001,0.447,0,2015-01-28,46,16,30,0.348,46,32,14,0.696
21400691,1610612756,1610612764,106.0,98.0,0.455,0.42,1,2015-01-28,47,27,20,0.574,47,31,16,0.66
21400675,1610612754,1610612761,91.0,104.0,0.415,0.466,0,2015-01-27,47,16,31,0.34,45,30,15,0.667
21400676,1610612765,1610612739,95.0,103.0,0.422,0.419,0,2015-01-27,46,17,29,0.37,46,26,20,0.565
21400677,1610612748,1610612749,102.0,109.0,0.507,0.5489999999999999,0,2015-01-27,45,20,25,0.444,45,23,22,0.511
21400678,1610612742,1610612763,90.0,109.0,0.487,0.532,0,2015-01-27,46,30,16,0.652,45,33,12,0.733
21400679,1610612744,1610612741,111.0,113.0,0.425,0.429,0,2015-01-27,43,36,7,0.8370000000000001,47,30,17,0.638
21400680,1610612747,1610612764,92.0,98.0,0.425,0.487,0,2015-01-27,46,12,34,0.261,46,31,15,0.674
21400670,1610612763,1610612753,103.0,94.0,0.474,0.474,1,2015-01-26,44,32,12,0.727,48,15,33,0.313
21400671,1610612740,1610612755,99.0,74.0,0.4529999999999999,0.346,1,2015-01-26,45,24,21,0.5329999999999999,45,8,37,0.178
21400672,1610612760,1610612750,92.0,84.0,0.419,0.341,1,2015-01-26,45,23,22,0.511,44,7,37,0.159
21400673,1610612762,1610612738,90.0,99.0,0.4270000000000001,0.473,0,2015-01-26,45,16,29,0.356,43,16,27,0.3720000000000001
21400674,1610612746,1610612743,102.0,98.0,0.475,0.482,1,2015-01-26,45,31,14,0.6890000000000001,45,18,27,0.4
21400657,1610612741,1610612748,84.0,96.0,0.356,0.452,0,2015-01-25,46,29,17,0.63,44,20,24,0.455
21400658,1610612739,1610612760,108.0,98.0,0.439,0.3939999999999999,1,2015-01-25,45,25,20,0.556,44,22,22,0.5
21400659,1610612756,1610612746,100.0,120.0,0.425,0.494,0,2015-01-25,46,26,20,0.565,44,30,14,0.682
21400660,1610612740,1610612742,109.0,106.0,0.506,0.481,1,2015-01-25,44,23,21,0.523,45,30,15,0.667
21400661,1610612737,1610612750,112.0,100.0,0.563,0.521,1,2015-01-25,45,37,8,0.8220000000000001,43,7,36,0.163
21400662,1610612753,1610612754,99.0,106.0,0.487,0.518,0,2015-01-25,47,15,32,0.319,46,16,30,0.348
21400663,1610612759,1610612749,101.0,95.0,0.422,0.476,1,2015-01-25,46,29,17,0.63,44,22,22,0.5
21400664,1610612761,1610612765,114.0,110.0,0.531,0.456,1,2015-01-25,44,29,15,0.659,45,17,28,0.3779999999999999
21400665,1610612744,1610612738,114.0,111.0,0.472,0.4320000000000001,1,2015-01-25,42,36,6,0.857,42,15,27,0.357
21400666,1610612743,1610612764,115.0,117.0,0.406,0.5329999999999999,0,2015-01-25,44,18,26,0.409,45,30,15,0.667
21400667,1610612747,1610612745,87.0,99.0,0.43,0.402,0,2015-01-25,45,12,33,0.267,45,31,14,0.6890000000000001
21400652,1610612766,1610612752,76.0,71.0,0.3289999999999999,0.354,1,2015-01-24,45,19,26,0.422,45,8,37,0.178
21400653,1610612749,1610612765,101.0,86.0,0.506,0.36,1,2015-01-24,43,22,21,0.512,44,17,27,0.386
21400654,1610612763,1610612755,101.0,83.0,0.4679999999999999,0.3829999999999999,1,2015-01-24,43,31,12,0.721,44,8,36,0.182
21400655,1610612762,1610612751,108.0,73.0,0.532,0.387,1,2015-01-24,44,16,28,0.364,44,18,26,0.409
21400656,1610612757,1610612764,103.0,96.0,0.402,0.488,1,2015-01-24,45,32,13,0.711,44,29,15,0.659
21400641,1610612755,1610612761,86.0,91.0,0.3829999999999999,0.413,0,2015-01-23,43,8,35,0.186,43,28,15,0.6509999999999999
21400642,1610612737,1610612760,103.0,93.0,0.482,0.414,1,2015-01-23,44,36,8,0.818,43,22,21,0.512
21400643,1610612739,1610612766,129.0,90.0,0.517,0.4039999999999999,1,2015-01-23,44,24,20,0.545,44,18,26,0.409
21400644,1610612748,1610612754,89.0,87.0,0.48,0.41,1,2015-01-23,43,19,24,0.442,45,15,30,0.3329999999999999
21400645,1610612752,1610612753,113.0,106.0,0.473,0.506,1,2015-01-23,44,8,36,0.182,46,15,31,0.326
21400646,1610612742,1610612741,98.0,102.0,0.451,0.487,0,2015-01-23,44,30,14,0.682,45,29,16,0.644
21400647,1610612750,1610612740,84.0,92.0,0.417,0.5,0,2015-01-23,42,7,35,0.1669999999999999,43,22,21,0.512
21400648,1610612759,1610612747,99.0,85.0,0.429,0.3979999999999999,1,2015-01-23,45,28,17,0.622,44,12,32,0.273
21400649,1610612743,1610612738,99.0,100.0,0.416,0.493,0,2015-01-23,43,18,25,0.419,41,15,26,0.366
21400650,1610612756,1610612745,111.0,113.0,0.462,0.524,0,2015-01-23,45,26,19,0.578,44,30,14,0.682
21400651,1610612744,1610612758,126.0,101.0,0.479,0.415,1,2015-01-23,41,35,6,0.8540000000000001,43,16,27,0.3720000000000001
21400637,1610612741,1610612759,104.0,81.0,0.474,0.37,1,2015-01-22,44,28,16,0.636,44,27,17,0.614
21400638,1610612749,1610612762,99.0,101.0,0.457,0.451,0,2015-01-22,42,21,21,0.5,43,15,28,0.349
21400639,1610612757,1610612738,89.0,90.0,0.371,0.4479999999999999,0,2015-01-22,44,31,13,0.705,40,14,26,0.35
21400640,1610612746,1610612751,123.0,84.0,0.59,0.375,1,2015-01-22,43,29,14,0.674,43,18,25,0.419
21400625,1610612766,1610612748,78.0,76.0,0.3379999999999999,0.345,1,2015-01-21,43,18,25,0.419,42,18,24,0.429
21400626,1610612739,1610612762,106.0,92.0,0.519,0.417,1,2015-01-21,43,23,20,0.535,42,14,28,0.3329999999999999
21400627,1610612755,1610612752,91.0,98.0,0.3670000000000001,0.407,0,2015-01-21,42,8,34,0.19,43,7,36,0.163
21400628,1610612737,1610612754,110.0,91.0,0.5,0.397,1,2015-01-21,43,35,8,0.8140000000000001,44,15,29,0.341
21400629,1610612765,1610612753,128.0,118.0,0.521,0.495,1,2015-01-21,43,17,26,0.395,45,15,30,0.3329999999999999
21400630,1610612763,1610612761,92.0,86.0,0.4589999999999999,0.318,1,2015-01-21,42,30,12,0.7140000000000001,42,27,15,0.643
21400631,1610612750,1610612742,75.0,98.0,0.348,0.513,0,2015-01-21,41,7,34,0.171,43,30,13,0.698
21400632,1610612740,1610612747,96.0,80.0,0.4579999999999999,0.364,1,2015-01-21,42,21,21,0.5,43,12,31,0.2789999999999999
21400633,1610612764,1610612760,103.0,105.0,0.38,0.392,0,2015-01-21,43,29,14,0.674,42,22,20,0.524
21400634,1610612756,1610612757,118.0,113.0,0.511,0.4479999999999999,1,2015-01-21,44,26,18,0.591,43,31,12,0.721
21400635,1610612758,1610612751,100.0,103.0,0.4639999999999999,0.4679999999999999,0,2015-01-21,42,16,26,0.381,42,18,24,0.429
21400636,1610612744,1610612745,126.0,113.0,0.5,0.425,1,2015-01-21,40,34,6,0.85,43,29,14,0.674
21400623,1610612748,1610612760,86.0,94.0,0.471,0.446,0,2015-01-20,41,18,23,0.439,41,21,20,0.512
21400624,1610612743,1610612759,99.0,109.0,0.4679999999999999,0.452,0,2015-01-20,42,18,24,0.429,43,27,16,0.628
21400611,1610612766,1610612750,105.0,80.0,0.449,0.363,1,2015-01-19,42,17,25,0.405,40,7,33,0.175
21400612,1610612764,1610612755,111.0,76.0,0.556,0.3289999999999999,1,2015-01-19,42,29,13,0.69,41,8,33,0.195
21400613,1610612737,1610612765,93.0,82.0,0.44,0.354,1,2015-01-19,42,34,8,0.81,42,16,26,0.381
21400614,1610612746,1610612738,102.0,93.0,0.476,0.3929999999999999,1,2015-01-19,42,28,14,0.667,39,13,26,0.3329999999999999
21400615,1610612744,1610612743,122.0,79.0,0.5429999999999999,0.345,1,2015-01-19,39,33,6,0.846,41,18,23,0.439
21400616,1610612763,1610612742,95.0,103.0,0.424,0.447,0,2015-01-19,41,29,12,0.7070000000000001,42,29,13,0.69
21400617,1610612745,1610612754,110.0,98.0,0.514,0.4589999999999999,1,2015-01-19,42,29,13,0.69,43,15,28,0.349
21400618,1610612752,1610612740,99.0,92.0,0.487,0.417,1,2015-01-19,42,6,36,0.143,41,20,21,0.488
21400620,1610612739,1610612741,108.0,94.0,0.456,0.375,1,2015-01-19,42,22,20,0.524,43,27,16,0.628
21400619,1610612749,1610612761,89.0,92.0,0.447,0.4,0,2015-01-19,41,21,20,0.512,41,27,14,0.659
21400621,1610612757,1610612758,98.0,94.0,0.3979999999999999,0.447,1,2015-01-19,42,31,11,0.738,41,16,25,0.39
21400622,1610612756,1610612747,115.0,100.0,0.5,0.4529999999999999,1,2015-01-19,43,25,18,0.581,42,12,30,0.286
21400608,1610612761,1610612740,93.0,95.0,0.431,0.476,0,2015-01-18,40,26,14,0.65,40,20,20,0.5
21400609,1610612753,1610612760,99.0,127.0,0.3979999999999999,0.578,0,2015-01-18,44,15,29,0.341,40,20,20,0.5
21400610,1610612759,1610612762,89.0,69.0,0.3879999999999999,0.3329999999999999,1,2015-01-18,42,26,16,0.619,41,14,27,0.341
21400600,1610612766,1610612754,80.0,71.0,0.307,0.357,1,2015-01-17,41,16,25,0.39,42,15,27,0.357
21400601,1610612765,1610612755,107.0,89.0,0.4320000000000001,0.4629999999999999,1,2015-01-17,41,16,25,0.39,40,8,32,0.2
21400602,1610612741,1610612737,99.0,107.0,0.4629999999999999,0.476,0,2015-01-17,42,27,15,0.643,41,33,8,0.805
21400603,1610612745,1610612744,106.0,131.0,0.42,0.5489999999999999,0,2015-01-17,41,28,13,0.6829999999999999,38,32,6,0.8420000000000001
21400605,1610612751,1610612764,90.0,99.0,0.439,0.519,0,2015-01-17,41,17,24,0.415,41,28,13,0.6829999999999999
21400604,1610612763,1610612757,102.0,98.0,0.506,0.387,1,2015-01-17,40,29,11,0.725,41,30,11,0.732
21400606,1610612743,1610612750,105.0,113.0,0.413,0.5379999999999999,0,2015-01-17,40,18,22,0.45,39,7,32,0.179
21400607,1610612758,1610612746,108.0,117.0,0.461,0.478,0,2015-01-17,40,16,24,0.4,41,27,14,0.659
21400587,1610612754,1610612765,96.0,98.0,0.449,0.376,0,2015-01-16,41,15,26,0.366,40,15,25,0.375
21400588,1610612753,1610612763,96.0,106.0,0.456,0.46,0,2015-01-16,43,15,28,0.349,39,28,11,0.718
21400589,1610612755,1610612740,96.0,81.0,0.45,0.387,1,2015-01-16,39,8,31,0.205,39,19,20,0.487
21400590,1610612764,1610612751,80.0,102.0,0.425,0.457,0,2015-01-16,40,27,13,0.675,40,17,23,0.425
21400591,1610612738,1610612741,103.0,119.0,0.494,0.539,0,2015-01-16,38,13,25,0.342,41,27,14,0.659
21400592,1610612761,1610612737,89.0,110.0,0.4270000000000001,0.609,0,2015-01-16,39,26,13,0.667,40,32,8,0.8
21400593,1610612760,1610612744,127.0,115.0,0.526,0.457,1,2015-01-16,39,19,20,0.487,37,31,6,0.838
21400594,1610612742,1610612743,97.0,89.0,0.418,0.41,1,2015-01-16,41,28,13,0.6829999999999999,39,18,21,0.462
21400595,1610612759,1610612757,110.0,96.0,0.447,0.5,1,2015-01-16,41,25,16,0.61,40,30,10,0.75
21400596,1610612756,1610612750,110.0,99.0,0.552,0.462,1,2015-01-16,42,24,18,0.5710000000000001,38,6,32,0.158
21400597,1610612762,1610612747,94.0,85.0,0.424,0.477,1,2015-01-16,40,14,26,0.35,41,12,29,0.293
21400598,1610612758,1610612748,83.0,95.0,0.4270000000000001,0.473,0,2015-01-16,39,16,23,0.41,40,18,22,0.45
21400599,1610612746,1610612739,121.0,126.0,0.473,0.5539999999999999,0,2015-01-16,40,26,14,0.65,41,21,20,0.512
21400585,1610612749,1610612752,95.0,79.0,0.389,0.412,1,2015-01-15,40,21,19,0.525,41,5,36,0.122
21400584,1610612745,1610612760,112.0,101.0,0.477,0.4320000000000001,1,2015-01-15,40,28,12,0.7,38,18,20,0.474
21400586,1610612747,1610612739,102.0,109.0,0.513,0.474,0,2015-01-15,40,12,28,0.3,40,20,20,0.5
21400574,1610612766,1610612759,93.0,98.0,0.384,0.435,0,2015-01-14,40,15,25,0.375,40,24,16,0.6
21400575,1610612753,1610612745,120.0,113.0,0.489,0.506,1,2015-01-14,42,15,27,0.357,39,27,12,0.6920000000000001
21400576,1610612751,1610612763,92.0,103.0,0.48,0.47,0,2015-01-14,39,16,23,0.41,38,27,11,0.711
21400577,1610612765,1610612740,94.0,105.0,0.466,0.488,0,2015-01-14,39,14,25,0.359,38,19,19,0.5
21400578,1610612761,1610612755,100.0,84.0,0.4629999999999999,0.3879999999999999,1,2015-01-14,38,26,12,0.684,38,7,31,0.184
21400579,1610612741,1610612764,99.0,105.0,0.43,0.513,0,2015-01-14,40,26,14,0.65,39,27,12,0.6920000000000001
21400580,1610612738,1610612737,91.0,105.0,0.41,0.493,0,2015-01-14,37,13,24,0.351,39,31,8,0.795
21400581,1610612743,1610612742,114.0,107.0,0.5,0.41,1,2015-01-14,38,18,20,0.474,40,27,13,0.675
21400582,1610612744,1610612748,104.0,89.0,0.469,0.423,1,2015-01-14,36,31,5,0.861,39,17,22,0.436
21400583,1610612757,1610612746,94.0,100.0,0.402,0.42,0,2015-01-14,39,30,9,0.769,39,26,13,0.667
21400567,1610612754,1610612750,101.0,110.0,0.488,0.471,0,2015-01-13,40,15,25,0.375,37,6,31,0.162
21400568,1610612755,1610612737,87.0,105.0,0.408,0.483,0,2015-01-13,37,7,30,0.1889999999999999,38,30,8,0.789
21400569,1610612764,1610612759,101.0,93.0,0.493,0.396,1,2015-01-13,38,26,12,0.684,39,23,16,0.59
21400570,1610612756,1610612739,107.0,100.0,0.526,0.439,1,2015-01-13,41,23,18,0.561,39,19,20,0.487
21400571,1610612762,1610612744,105.0,116.0,0.481,0.505,0,2015-01-13,39,13,26,0.3329999999999999,35,30,5,0.857
21400572,1610612758,1610612742,104.0,108.0,0.442,0.43,0,2015-01-13,38,16,22,0.421,39,27,12,0.6920000000000001
21400573,1610612747,1610612748,75.0,78.0,0.315,0.423,0,2015-01-13,39,12,27,0.308,38,17,21,0.447
21400563,1610612738,1610612740,108.0,100.0,0.42,0.413,1,2015-01-12,36,13,23,0.361,37,18,19,0.486
21400564,1610612751,1610612745,99.0,113.0,0.4639999999999999,0.477,0,2015-01-12,38,16,22,0.421,38,27,11,0.711
21400565,1610612761,1610612765,111.0,114.0,0.54,0.4270000000000001,0,2015-01-12,37,25,12,0.6759999999999999,38,14,24,0.368
21400566,1610612741,1610612753,114.0,121.0,0.488,0.593,0,2015-01-12,39,26,13,0.667,41,14,27,0.341
21400558,1610612737,1610612764,120.0,89.0,0.472,0.474,1,2015-01-11,37,29,8,0.784,37,25,12,0.6759999999999999
21400559,1610612746,1610612748,90.0,104.0,0.4529999999999999,0.481,0,2015-01-11,38,25,13,0.6579999999999999,37,16,21,0.4320000000000001
21400560,1610612763,1610612756,122.0,110.0,0.48,0.42,1,2015-01-11,37,26,11,0.703,40,22,18,0.55
21400561,1610612758,1610612739,103.0,84.0,0.488,0.423,1,2015-01-11,37,16,21,0.4320000000000001,38,19,19,0.5
21400562,1610612747,1610612757,94.0,106.0,0.444,0.477,0,2015-01-11,38,12,26,0.316,38,30,8,0.789
21400549,1610612752,1610612766,82.0,110.0,0.3879999999999999,0.5,0,2015-01-10,40,5,35,0.125,39,15,24,0.385
21400550,1610612746,1610612742,120.0,100.0,0.523,0.442,1,2015-01-10,37,25,12,0.6759999999999999,38,26,12,0.684
21400551,1610612765,1610612751,98.0,93.0,0.425,0.42,1,2015-01-10,37,13,24,0.351,37,16,21,0.4320000000000001
21400552,1610612755,1610612754,93.0,92.0,0.4,0.3329999999999999,1,2015-01-10,36,7,29,0.1939999999999999,39,15,24,0.385
21400553,1610612761,1610612738,109.0,96.0,0.451,0.47,1,2015-01-10,36,25,11,0.6940000000000001,35,12,23,0.3429999999999999
21400554,1610612741,1610612749,95.0,87.0,0.3979999999999999,0.444,1,2015-01-10,38,26,12,0.684,39,20,19,0.513
21400555,1610612745,1610612762,97.0,82.0,0.429,0.414,1,2015-01-10,37,26,11,0.703,38,13,25,0.342
21400556,1610612750,1610612759,93.0,108.0,0.395,0.488,0,2015-01-10,36,5,31,0.139,38,23,15,0.605
21400557,1610612757,1610612753,103.0,92.0,0.474,0.402,1,2015-01-10,37,29,8,0.784,40,13,27,0.325
21400538,1610612754,1610612738,107.0,103.0,0.37,0.3979999999999999,1,2015-01-09,38,15,23,0.395,34,12,22,0.353
21400539,1610612751,1610612755,88.0,90.0,0.452,0.456,0,2015-01-09,36,16,20,0.444,35,6,29,0.171
21400540,1610612765,1610612737,103.0,106.0,0.396,0.488,0,2015-01-09,36,12,24,0.3329999999999999,36,28,8,0.778
21400541,1610612740,1610612763,106.0,95.0,0.457,0.439,1,2015-01-09,36,18,18,0.5,36,25,11,0.6940000000000001
21400542,1610612760,1610612762,99.0,94.0,0.462,0.486,1,2015-01-09,37,18,19,0.486,37,13,24,0.351
21400543,1610612764,1610612741,102.0,86.0,0.477,0.386,1,2015-01-09,36,25,11,0.6940000000000001,37,25,12,0.6759999999999999
21400544,1610612749,1610612750,98.0,84.0,0.52,0.405,1,2015-01-09,38,20,18,0.526,35,5,30,0.143
21400545,1610612759,1610612756,100.0,95.0,0.4270000000000001,0.446,1,2015-01-09,37,22,15,0.595,39,22,17,0.564
21400546,1610612758,1610612743,108.0,118.0,0.488,0.5529999999999999,0,2015-01-09,36,15,21,0.417,37,17,20,0.4589999999999999
21400547,1610612744,1610612739,112.0,94.0,0.5,0.407,1,2015-01-09,34,29,5,0.853,37,19,18,0.514
21400548,1610612747,1610612753,101.0,84.0,0.4,0.395,1,2015-01-09,37,12,25,0.324,39,13,26,0.3329999999999999
21400535,1610612761,1610612766,95.0,103.0,0.3979999999999999,0.477,0,2015-01-08,35,24,11,0.6859999999999999,38,14,24,0.368
21400536,1610612752,1610612745,96.0,120.0,0.4629999999999999,0.532,0,2015-01-08,39,5,34,0.128,36,25,11,0.6940000000000001
21400537,1610612757,1610612748,99.0,83.0,0.421,0.377,1,2015-01-08,36,28,8,0.778,36,15,21,0.417
21400522,1610612766,1610612740,98.0,94.0,0.43,0.45,1,2015-01-07,37,13,24,0.351,35,17,18,0.486
21400523,1610612739,1610612745,93.0,105.0,0.415,0.4529999999999999,0,2015-01-07,36,19,17,0.528,35,24,11,0.6859999999999999
21400524,1610612755,1610612749,77.0,97.0,0.301,0.539,0,2015-01-07,34,5,29,0.147,37,19,18,0.514
21400525,1610612764,1610612752,101.0,91.0,0.513,0.415,1,2015-01-07,35,24,11,0.6859999999999999,38,5,33,0.132
21400526,1610612737,1610612763,96.0,86.0,0.444,0.4429999999999999,1,2015-01-07,35,27,8,0.7709999999999999,35,25,10,0.7140000000000001
21400527,1610612751,1610612738,81.0,89.0,0.405,0.3979999999999999,0,2015-01-07,35,16,19,0.457,33,12,21,0.364
21400528,1610612741,1610612762,77.0,97.0,0.3329999999999999,0.474,0,2015-01-07,36,25,11,0.6940000000000001,36,13,23,0.361
21400529,1610612742,1610612765,95.0,108.0,0.4370000000000001,0.4429999999999999,0,2015-01-07,37,26,11,0.703,35,12,23,0.3429999999999999
21400530,1610612743,1610612753,93.0,90.0,0.446,0.3979999999999999,1,2015-01-07,36,16,20,0.444,38,13,25,0.342
21400531,1610612750,1610612756,111.0,113.0,0.478,0.479,0,2015-01-07,34,5,29,0.147,38,22,16,0.579
21400532,1610612758,1610612760,104.0,83.0,0.391,0.326,1,2015-01-07,35,15,20,0.429,36,17,19,0.472
21400533,1610612744,1610612754,117.0,102.0,0.495,0.457,1,2015-01-07,33,28,5,0.848,37,14,23,0.3779999999999999
21400534,1610612746,1610612747,114.0,89.0,0.471,0.435,1,2015-01-07,36,24,12,0.667,36,11,25,0.306
21400520,1610612749,1610612756,96.0,102.0,0.42,0.457,0,2015-01-06,36,18,18,0.5,37,21,16,0.568
21400521,1610612759,1610612765,104.0,105.0,0.456,0.471,0,2015-01-06,36,21,15,0.583,34,11,23,0.324
21400509,1610612755,1610612739,95.0,92.0,0.481,0.3879999999999999,1,2015-01-05,33,5,28,0.152,35,19,16,0.5429999999999999
21400510,1610612738,1610612766,95.0,104.0,0.396,0.487,0,2015-01-05,32,11,21,0.344,36,12,24,0.3329999999999999
21400511,1610612751,1610612742,88.0,96.0,0.3929999999999999,0.3939999999999999,0,2015-01-05,34,16,18,0.471,36,26,10,0.722
21400512,1610612741,1610612745,114.0,105.0,0.482,0.461,1,2015-01-05,35,25,10,0.7140000000000001,34,23,11,0.6759999999999999
21400513,1610612763,1610612752,105.0,83.0,0.524,0.434,1,2015-01-05,34,25,9,0.735,37,5,32,0.135
21400514,1610612750,1610612743,101.0,110.0,0.4270000000000001,0.5479999999999999,0,2015-01-05,33,5,28,0.152,35,15,20,0.429
21400515,1610612740,1610612764,85.0,92.0,0.446,0.481,0,2015-01-05,34,17,17,0.5,34,23,11,0.6759999999999999
21400516,1610612762,1610612754,101.0,105.0,0.4320000000000001,0.473,0,2015-01-05,35,12,23,0.3429999999999999,36,14,22,0.389
21400517,1610612757,1610612747,98.0,94.0,0.3979999999999999,0.42,1,2015-01-05,35,27,8,0.7709999999999999,35,11,24,0.314
21400518,1610612744,1610612760,117.0,91.0,0.466,0.306,1,2015-01-05,32,27,5,0.8440000000000001,35,17,18,0.486
21400519,1610612746,1610612737,98.0,107.0,0.446,0.444,0,2015-01-05,35,23,12,0.657,34,26,8,0.765
21400503,1610612739,1610612742,90.0,109.0,0.407,0.564,0,2015-01-04,34,19,15,0.5589999999999999,35,25,10,0.7140000000000001
21400504,1610612765,1610612758,114.0,95.0,0.495,0.4270000000000001,1,2015-01-04,33,10,23,0.303,34,14,20,0.412
21400505,1610612748,1610612751,88.0,84.0,0.4629999999999999,0.395,1,2015-01-04,35,15,20,0.429,33,16,17,0.485
21400506,1610612752,1610612749,82.0,95.0,0.408,0.455,0,2015-01-04,36,5,31,0.139,35,18,17,0.514
21400507,1610612756,1610612761,125.0,109.0,0.539,0.4579999999999999,1,2015-01-04,36,20,16,0.556,34,24,10,0.706
21400508,1610612747,1610612754,88.0,87.0,0.38,0.3670000000000001,1,2015-01-04,34,11,23,0.324,35,13,22,0.371
21400495,1610612753,1610612766,90.0,98.0,0.379,0.449,0,2015-01-03,37,13,24,0.351,35,11,24,0.314
21400496,1610612741,1610612738,109.0,104.0,0.37,0.45,1,2015-01-03,34,24,10,0.706,31,11,20,0.355
21400497,1610612745,1610612748,115.0,79.0,0.494,0.441,1,2015-01-03,33,23,10,0.6970000000000001,34,14,20,0.412
21400498,1610612750,1610612762,89.0,101.0,0.395,0.507,0,2015-01-03,32,5,27,0.156,34,12,22,0.353
21400499,1610612759,1610612764,101.0,92.0,0.551,0.488,1,2015-01-03,35,21,14,0.6,33,22,11,0.667
21400500,1610612743,1610612763,114.0,85.0,0.519,0.43,1,2015-01-03,34,14,20,0.412,33,24,9,0.727
21400501,1610612757,1610612737,107.0,115.0,0.452,0.512,0,2015-01-03,34,26,8,0.765,33,25,8,0.758
21400502,1610612746,1610612755,127.0,91.0,0.541,0.405,1,2015-01-03,34,23,11,0.6759999999999999,32,4,28,0.125
21400484,1610612766,1610612739,87.0,91.0,0.368,0.379,0,2015-01-02,34,10,24,0.294,33,19,14,0.5760000000000001
21400485,1610612753,1610612751,98.0,100.0,0.42,0.569,0,2015-01-02,36,13,23,0.361,32,16,16,0.5
21400486,1610612738,1610612742,101.0,119.0,0.4270000000000001,0.469,0,2015-01-02,30,11,19,0.3670000000000001,34,24,10,0.706
21400487,1610612752,1610612765,81.0,97.0,0.352,0.5,0,2015-01-02,35,5,30,0.143,32,9,23,0.281
21400488,1610612740,1610612745,111.0,83.0,0.53,0.3979999999999999,1,2015-01-02,33,17,16,0.515,32,22,10,0.688
21400489,1610612760,1610612764,109.0,102.0,0.53,0.4639999999999999,1,2015-01-02,34,17,17,0.5,32,22,10,0.688
21400490,1610612749,1610612754,91.0,94.0,0.4270000000000001,0.4320000000000001,0,2015-01-02,34,17,17,0.5,34,13,21,0.382
21400491,1610612756,1610612755,112.0,96.0,0.5,0.425,1,2015-01-02,35,19,16,0.5429999999999999,31,4,27,0.129
21400492,1610612762,1610612737,92.0,98.0,0.3720000000000001,0.407,0,2015-01-02,33,11,22,0.3329999999999999,32,24,8,0.75
21400493,1610612744,1610612761,126.0,105.0,0.5329999999999999,0.465,1,2015-01-02,31,26,5,0.8390000000000001,33,24,9,0.727
21400494,1610612747,1610612763,106.0,109.0,0.531,0.488,0,2015-01-02,33,10,23,0.303,32,24,8,0.75
21400482,1610612741,1610612743,106.0,101.0,0.418,0.402,1,2015-01-01,33,23,10,0.6970000000000001,33,13,20,0.3939999999999999
21400483,1610612750,1610612758,107.0,110.0,0.462,0.541,0,2015-01-01,31,5,26,0.161,33,14,19,0.424
21400475,1610612738,1610612758,106.0,84.0,0.4679999999999999,0.368,1,2014-12-31,29,11,18,0.379,32,13,19,0.406
21400476,1610612754,1610612748,106.0,95.0,0.4429999999999999,0.494,1,2014-12-31,33,12,21,0.364,33,14,19,0.424
21400477,1610612746,1610612752,99.0,78.0,0.439,0.381,1,2014-12-31,33,22,11,0.667,34,5,29,0.147
21400478,1610612745,1610612766,102.0,83.0,0.4320000000000001,0.382,1,2014-12-31,31,22,9,0.71,33,10,23,0.303
21400479,1610612739,1610612749,80.0,96.0,0.341,0.444,0,2014-12-31,32,18,14,0.563,33,17,16,0.515
21400481,1610612759,1610612740,95.0,93.0,0.4379999999999999,0.382,1,2014-12-31,34,20,14,0.588,32,16,16,0.5
21400480,1610612760,1610612756,137.0,134.0,0.414,0.511,1,2014-12-31,33,16,17,0.485,34,18,16,0.529
21400465,1610612753,1610612765,86.0,109.0,0.447,0.465,0,2014-12-30,35,13,22,0.371,31,8,23,0.258
21400466,1610612737,1610612739,109.0,101.0,0.506,0.44,1,2014-12-30,31,23,8,0.742,31,18,13,0.581
21400467,1610612741,1610612751,82.0,96.0,0.384,0.434,0,2014-12-30,32,22,10,0.688,31,15,16,0.484
21400468,1610612763,1610612759,95.0,87.0,0.486,0.449,1,2014-12-30,31,23,8,0.742,33,19,14,0.5760000000000001
21400469,1610612740,1610612756,110.0,106.0,0.519,0.477,1,2014-12-30,31,16,15,0.516,33,18,15,0.545
21400470,1610612742,1610612764,114.0,87.0,0.524,0.446,1,2014-12-30,33,23,10,0.6970000000000001,31,22,9,0.71
21400471,1610612743,1610612747,103.0,111.0,0.4479999999999999,0.526,0,2014-12-30,32,13,19,0.406,32,10,22,0.313
21400472,1610612762,1610612750,100.0,94.0,0.481,0.4629999999999999,1,2014-12-30,32,11,21,0.344,30,5,25,0.1669999999999999
21400473,1610612757,1610612761,102.0,97.0,0.4,0.4039999999999999,1,2014-12-30,33,26,7,0.7879999999999999,32,24,8,0.75
21400474,1610612744,1610612755,126.0,86.0,0.561,0.384,1,2014-12-30,30,25,5,0.833,30,4,26,0.133
21400459,1610612766,1610612749,94.0,104.0,0.3670000000000001,0.471,0,2014-12-29,32,10,22,0.313,32,16,16,0.5
21400460,1610612754,1610612741,90.0,92.0,0.434,0.345,0,2014-12-29,32,11,21,0.344,31,22,9,0.71
21400461,1610612751,1610612758,107.0,99.0,0.45,0.487,1,2014-12-29,30,14,16,0.467,31,13,18,0.419
21400462,1610612748,1610612753,101.0,102.0,0.524,0.532,0,2014-12-29,32,14,18,0.4379999999999999,34,13,21,0.382
21400463,1610612745,1610612764,103.0,104.0,0.465,0.479,0,2014-12-29,30,21,9,0.7,30,22,8,0.733
21400464,1610612746,1610612762,101.0,97.0,0.457,0.413,1,2014-12-29,32,21,11,0.6559999999999999,31,10,21,0.3229999999999999
21400453,1610612739,1610612765,80.0,103.0,0.3779999999999999,0.451,0,2014-12-28,30,18,12,0.6,30,7,23,0.233
21400454,1610612759,1610612745,110.0,106.0,0.47,0.494,1,2014-12-28,32,19,13,0.594,29,21,8,0.7240000000000001
21400455,1610612742,1610612760,112.0,107.0,0.4429999999999999,0.5,1,2014-12-28,32,22,10,0.688,32,15,17,0.469
21400456,1610612757,1610612752,101.0,79.0,0.469,0.3329999999999999,1,2014-12-28,32,25,7,0.7809999999999999,33,5,28,0.152
21400457,1610612743,1610612761,102.0,116.0,0.425,0.489,0,2014-12-28,31,13,18,0.419,31,24,7,0.774
21400458,1610612747,1610612756,107.0,116.0,0.519,0.506,0,2014-12-28,31,9,22,0.29,32,18,14,0.563
21400443,1610612746,1610612761,98.0,110.0,0.457,0.477,0,2014-12-27,31,20,11,0.645,30,23,7,0.767
21400444,1610612766,1610612753,94.0,102.0,0.419,0.4579999999999999,0,2014-12-27,31,10,21,0.3229999999999999,33,12,21,0.364
21400445,1610612764,1610612738,101.0,88.0,0.5,0.405,1,2014-12-27,29,21,8,0.7240000000000001,28,10,18,0.357
21400446,1610612748,1610612763,95.0,103.0,0.514,0.466,0,2014-12-27,31,14,17,0.452,30,22,8,0.733
21400447,1610612741,1610612740,107.0,100.0,0.461,0.466,1,2014-12-27,30,21,9,0.7,30,15,15,0.5
21400448,1610612751,1610612754,85.0,110.0,0.364,0.512,0,2014-12-27,29,13,16,0.4479999999999999,31,11,20,0.355
21400449,1610612749,1610612737,85.0,90.0,0.3879999999999999,0.3670000000000001,0,2014-12-27,31,15,16,0.484,30,22,8,0.733
21400450,1610612762,1610612755,88.0,71.0,0.357,0.324,1,2014-12-27,30,10,20,0.3329999999999999,29,4,25,0.138
21400451,1610612758,1610612752,135.0,129.0,0.551,0.495,1,2014-12-27,30,13,17,0.433,32,5,27,0.156
21400452,1610612744,1610612750,110.0,97.0,0.466,0.442,1,2014-12-27,29,24,5,0.828,29,5,24,0.172
21400432,1610612738,1610612751,107.0,109.0,0.517,0.494,0,2014-12-26,27,10,17,0.37,28,13,15,0.4639999999999999
21400433,1610612753,1610612739,89.0,98.0,0.493,0.413,0,2014-12-26,32,11,21,0.344,29,18,11,0.621
21400434,1610612737,1610612749,77.0,107.0,0.408,0.506,0,2014-12-26,29,21,8,0.7240000000000001,30,15,15,0.5
21400435,1610612765,1610612754,119.0,109.0,0.547,0.506,1,2014-12-26,29,6,23,0.207,30,10,20,0.3329999999999999
21400436,1610612763,1610612745,111.0,117.0,0.413,0.451,0,2014-12-26,29,21,8,0.7240000000000001,28,21,7,0.75
21400437,1610612740,1610612759,97.0,90.0,0.417,0.493,1,2014-12-26,29,15,14,0.517,31,18,13,0.581
21400438,1610612760,1610612766,98.0,75.0,0.409,0.287,1,2014-12-26,31,15,16,0.484,30,10,20,0.3329999999999999
21400439,1610612742,1610612747,102.0,98.0,0.506,0.364,1,2014-12-26,31,21,10,0.677,30,9,21,0.3
21400440,1610612743,1610612750,106.0,102.0,0.411,0.3979999999999999,1,2014-12-26,30,13,17,0.433,28,5,23,0.179
21400441,1610612757,1610612755,114.0,93.0,0.477,0.444,1,2014-12-26,31,24,7,0.774,28,4,24,0.143
21400442,1610612758,1610612756,106.0,115.0,0.441,0.489,0,2014-12-26,29,12,17,0.414,31,17,14,0.5479999999999999
21400427,1610612752,1610612764,91.0,102.0,0.45,0.512,0,2014-12-25,31,5,26,0.161,28,20,8,0.7140000000000001
21400428,1610612759,1610612760,106.0,114.0,0.519,0.519,0,2014-12-25,30,18,12,0.6,30,14,16,0.467
21400429,1610612748,1610612739,101.0,91.0,0.476,0.444,1,2014-12-25,30,14,16,0.467,28,17,11,0.607
21400430,1610612741,1610612747,113.0,93.0,0.488,0.391,1,2014-12-25,29,20,9,0.69,29,9,20,0.31
21400431,1610612746,1610612744,100.0,86.0,0.391,0.425,1,2014-12-25,30,20,10,0.667,28,23,5,0.821
21400416,1610612739,1610612750,125.0,104.0,0.524,0.4429999999999999,1,2014-12-23,27,17,10,0.63,27,5,22,0.185
21400417,1610612754,1610612740,96.0,84.0,0.5,0.3979999999999999,1,2014-12-23,29,10,19,0.345,28,14,14,0.5
21400418,1610612753,1610612738,100.0,95.0,0.47,0.3879999999999999,1,2014-12-23,31,11,20,0.355,26,10,16,0.385
21400419,1610612764,1610612741,91.0,99.0,0.4270000000000001,0.4589999999999999,0,2014-12-23,27,19,8,0.7040000000000001,28,19,9,0.679
21400420,1610612737,1610612746,107.0,104.0,0.447,0.402,1,2014-12-23,28,21,7,0.75,29,19,10,0.655
21400421,1610612751,1610612743,102.0,96.0,0.473,0.439,1,2014-12-23,27,12,15,0.444,29,12,17,0.414
21400422,1610612748,1610612755,87.0,91.0,0.413,0.429,0,2014-12-23,29,13,16,0.4479999999999999,27,4,23,0.148
21400423,1610612749,1610612766,101.0,108.0,0.476,0.439,0,2014-12-23,29,14,15,0.483,29,10,19,0.345
21400424,1610612760,1610612757,111.0,115.0,0.455,0.418,0,2014-12-23,29,13,16,0.4479999999999999,30,23,7,0.767
21400425,1610612756,1610612742,124.0,115.0,0.4539999999999999,0.466,1,2014-12-23,30,16,14,0.5329999999999999,30,20,10,0.667
21400426,1610612747,1610612744,115.0,105.0,0.517,0.4639999999999999,1,2014-12-23,28,9,19,0.321,27,23,4,0.852
21400409,1610612766,1610612743,110.0,82.0,0.5379999999999999,0.3779999999999999,1,2014-12-22,28,9,19,0.321,28,12,16,0.429
21400410,1610612741,1610612761,129.0,120.0,0.541,0.44,1,2014-12-22,27,18,9,0.667,29,22,7,0.759
21400411,1610612745,1610612757,110.0,95.0,0.471,0.447,1,2014-12-22,27,20,7,0.741,29,22,7,0.759
21400412,1610612763,1610612762,91.0,97.0,0.442,0.4529999999999999,0,2014-12-22,28,21,7,0.75,29,9,20,0.31
21400413,1610612742,1610612737,102.0,105.0,0.433,0.494,0,2014-12-22,29,20,9,0.69,27,20,7,0.741
21400414,1610612759,1610612746,125.0,118.0,0.636,0.5,1,2014-12-22,29,18,11,0.621,28,19,9,0.679
21400415,1610612744,1610612758,128.0,108.0,0.5379999999999999,0.478,1,2014-12-22,26,23,3,0.885,28,12,16,0.429
21400400,1610612761,1610612752,118.0,108.0,0.488,0.488,1,2014-12-21,28,22,6,0.7859999999999999,30,5,25,0.1669999999999999
21400401,1610612739,1610612763,105.0,91.0,0.605,0.4529999999999999,1,2014-12-21,26,16,10,0.615,27,21,6,0.778
21400402,1610612758,1610612747,108.0,101.0,0.481,0.379,1,2014-12-21,27,12,15,0.444,27,8,19,0.296
21400403,1610612751,1610612765,110.0,105.0,0.526,0.44,1,2014-12-21,26,11,15,0.423,28,5,23,0.179
21400404,1610612748,1610612738,100.0,84.0,0.474,0.3979999999999999,1,2014-12-21,28,13,15,0.4639999999999999,25,10,15,0.4
21400405,1610612753,1610612755,88.0,96.0,0.417,0.4270000000000001,0,2014-12-21,30,10,20,0.3329999999999999,26,3,23,0.115
21400406,1610612764,1610612756,92.0,104.0,0.41,0.513,0,2014-12-21,26,19,7,0.731,29,15,14,0.517
21400407,1610612750,1610612754,96.0,100.0,0.4679999999999999,0.5,0,2014-12-21,26,5,21,0.192,28,9,19,0.321
21400408,1610612760,1610612740,99.0,101.0,0.4579999999999999,0.478,0,2014-12-21,28,13,15,0.4639999999999999,27,14,13,0.519
21400393,1610612752,1610612756,90.0,99.0,0.3979999999999999,0.449,0,2014-12-20,29,5,24,0.172,28,14,14,0.5
21400394,1610612740,1610612757,88.0,114.0,0.353,0.5329999999999999,0,2014-12-20,26,13,13,0.5,28,22,6,0.7859999999999999
21400395,1610612766,1610612762,104.0,86.0,0.483,0.3879999999999999,1,2014-12-20,27,8,19,0.296,28,8,20,0.286
21400396,1610612745,1610612737,97.0,104.0,0.395,0.514,0,2014-12-20,26,19,7,0.731,26,19,7,0.731
21400397,1610612742,1610612759,99.0,93.0,0.43,0.416,1,2014-12-20,28,20,8,0.7140000000000001,28,17,11,0.607
21400398,1610612743,1610612754,76.0,73.0,0.366,0.307,1,2014-12-20,27,12,15,0.444,27,8,19,0.296
21400399,1610612746,1610612749,106.0,102.0,0.457,0.531,1,2014-12-20,27,19,8,0.7040000000000001,28,14,14,0.5
21400383,1610612753,1610612762,94.0,101.0,0.446,0.534,0,2014-12-19,29,10,19,0.345,27,8,19,0.296
21400384,1610612755,1610612766,91.0,109.0,0.451,0.439,0,2014-12-19,25,2,23,0.08,26,7,19,0.2689999999999999
21400385,1610612738,1610612750,114.0,98.0,0.565,0.452,1,2014-12-19,24,10,14,0.417,25,5,20,0.2
21400386,1610612739,1610612751,95.0,91.0,0.4029999999999999,0.474,1,2014-12-19,25,15,10,0.6,25,10,15,0.4
21400387,1610612765,1610612761,100.0,110.0,0.436,0.477,0,2014-12-19,27,5,22,0.185,27,21,6,0.778
21400388,1610612748,1610612764,103.0,105.0,0.5329999999999999,0.494,0,2014-12-19,27,12,15,0.444,25,19,6,0.76
21400389,1610612763,1610612741,97.0,103.0,0.3939999999999999,0.4379999999999999,0,2014-12-19,26,21,5,0.8079999999999999,26,17,9,0.654
21400390,1610612759,1610612757,119.0,129.0,0.413,0.4270000000000001,0,2014-12-19,27,17,10,0.63,27,21,6,0.778
21400391,1610612743,1610612746,109.0,106.0,0.475,0.4589999999999999,1,2014-12-19,26,11,15,0.423,26,18,8,0.6920000000000001
21400392,1610612747,1610612760,103.0,104.0,0.482,0.43,0,2014-12-19,26,8,18,0.308,27,13,14,0.481
21400379,1610612741,1610612752,103.0,97.0,0.4529999999999999,0.4629999999999999,1,2014-12-18,25,16,9,0.64,28,5,23,0.179
21400380,1610612745,1610612740,90.0,99.0,0.384,0.4629999999999999,0,2014-12-18,25,19,6,0.76,25,13,12,0.52
21400381,1610612758,1610612749,107.0,108.0,0.5670000000000001,0.493,0,2014-12-18,26,11,15,0.423,27,14,13,0.519
21400382,1610612744,1610612760,114.0,109.0,0.511,0.477,1,2014-12-18,25,22,3,0.88,26,12,14,0.462
21400369,1610612766,1610612756,106.0,111.0,0.465,0.524,0,2014-12-17,25,6,19,0.24,27,13,14,0.481
21400370,1610612739,1610612737,98.0,127.0,0.451,0.645,0,2014-12-17,24,14,10,0.583,25,18,7,0.72
21400371,1610612738,1610612753,109.0,92.0,0.55,0.435,1,2014-12-17,23,9,14,0.391,28,10,18,0.357
21400372,1610612765,1610612742,106.0,117.0,0.449,0.506,0,2014-12-17,26,5,21,0.192,27,19,8,0.7040000000000001
21400373,1610612748,1610612762,87.0,105.0,0.386,0.53,0,2014-12-17,26,12,14,0.462,26,7,19,0.2689999999999999
21400374,1610612761,1610612751,105.0,89.0,0.513,0.4320000000000001,1,2014-12-17,26,20,6,0.769,24,10,14,0.417
21400375,1610612759,1610612763,116.0,117.0,0.41,0.449,0,2014-12-17,26,17,9,0.654,25,21,4,0.84
21400376,1610612757,1610612749,104.0,97.0,0.471,0.481,1,2014-12-17,26,20,6,0.769,26,13,13,0.5
21400377,1610612746,1610612754,102.0,100.0,0.436,0.444,1,2014-12-17,25,18,7,0.72,26,8,18,0.308
21400378,1610612743,1610612745,111.0,115.0,0.4039999999999999,0.412,0,2014-12-17,25,10,15,0.4,24,19,5,0.792
21400363,1610612764,1610612750,109.0,95.0,0.5,0.444,1,2014-12-16,24,18,6,0.75,24,5,19,0.208
21400364,1610612751,1610612748,91.0,95.0,0.39,0.4579999999999999,0,2014-12-16,23,10,13,0.435,25,12,13,0.48
21400365,1610612763,1610612744,105.0,98.0,0.457,0.411,1,2014-12-16,24,20,4,0.833,24,21,3,0.875
21400366,1610612740,1610612762,119.0,111.0,0.595,0.5,1,2014-12-16,24,12,12,0.5,25,6,19,0.24
21400367,1610612752,1610612742,87.0,107.0,0.44,0.506,0,2014-12-16,27,5,22,0.185,26,18,8,0.6920000000000001
21400368,1610612758,1610612760,92.0,104.0,0.429,0.471,0,2014-12-16,25,11,14,0.44,25,12,13,0.48
21400355,1610612739,1610612766,97.0,88.0,0.4579999999999999,0.4579999999999999,1,2014-12-15,23,14,9,0.609,24,6,18,0.25
21400356,1610612754,1610612747,110.0,91.0,0.482,0.33,1,2014-12-15,25,8,17,0.32,25,8,17,0.32
21400357,1610612755,1610612738,87.0,105.0,0.355,0.442,0,2014-12-15,24,2,22,0.083,22,8,14,0.364
21400358,1610612737,1610612741,93.0,86.0,0.434,0.376,1,2014-12-15,24,17,7,0.708,24,15,9,0.625
21400359,1610612761,1610612753,95.0,82.0,0.446,0.486,1,2014-12-15,25,19,6,0.76,27,10,17,0.37
21400360,1610612756,1610612749,94.0,96.0,0.4,0.479,0,2014-12-15,26,12,14,0.462,25,13,12,0.52
21400361,1610612757,1610612759,108.0,95.0,0.461,0.487,1,2014-12-15,25,19,6,0.76,25,17,8,0.68
21400362,1610612746,1610612765,113.0,91.0,0.5379999999999999,0.422,1,2014-12-15,24,17,7,0.708,25,5,20,0.2
21400348,1610612740,1610612744,122.0,128.0,0.465,0.512,0,2014-12-14,23,11,12,0.478,23,21,2,0.913
21400349,1610612748,1610612741,75.0,93.0,0.35,0.465,0,2014-12-14,24,11,13,0.4579999999999999,23,15,8,0.652
21400350,1610612764,1610612762,93.0,84.0,0.488,0.385,1,2014-12-14,23,17,6,0.7390000000000001,24,6,18,0.25
21400351,1610612750,1610612747,94.0,100.0,0.422,0.42,0,2014-12-14,23,5,18,0.217,24,8,16,0.3329999999999999
21400352,1610612760,1610612756,112.0,88.0,0.488,0.3429999999999999,1,2014-12-14,24,11,13,0.4579999999999999,25,12,13,0.48
21400353,1610612752,1610612761,90.0,95.0,0.3720000000000001,0.462,0,2014-12-14,26,5,21,0.192,24,18,6,0.75
21400354,1610612743,1610612759,91.0,99.0,0.41,0.4589999999999999,0,2014-12-14,24,10,14,0.417,24,17,7,0.708
21400340,1610612742,1610612744,98.0,105.0,0.4039999999999999,0.446,0,2014-12-13,25,17,8,0.68,22,20,2,0.909
21400341,1610612766,1610612751,87.0,114.0,0.392,0.583,0,2014-12-13,23,6,17,0.261,22,10,12,0.455
21400342,1610612754,1610612757,85.0,95.0,0.386,0.444,0,2014-12-13,24,7,17,0.292,24,18,6,0.75
21400343,1610612753,1610612737,100.0,99.0,0.5,0.417,1,2014-12-13,26,10,16,0.385,23,16,7,0.696
21400344,1610612749,1610612746,111.0,106.0,0.5660000000000001,0.429,1,2014-12-13,24,12,12,0.5,23,16,7,0.696
21400345,1610612755,1610612763,115.0,120.0,0.488,0.484,0,2014-12-13,23,2,21,0.087,23,19,4,0.826
21400346,1610612745,1610612743,108.0,96.0,0.4429999999999999,0.375,1,2014-12-13,23,18,5,0.7829999999999999,23,10,13,0.435
21400347,1610612758,1610612765,90.0,95.0,0.355,0.4429999999999999,0,2014-12-13,24,11,13,0.4579999999999999,24,5,19,0.208
21400328,1610612741,1610612757,115.0,106.0,0.5,0.489,1,2014-12-12,22,14,8,0.636,23,17,6,0.7390000000000001
21400329,1610612764,1610612746,104.0,96.0,0.488,0.4270000000000001,1,2014-12-12,22,16,6,0.727,22,16,6,0.727
21400330,1610612737,1610612753,87.0,81.0,0.3720000000000001,0.39,1,2014-12-12,22,16,6,0.727,25,9,16,0.36
21400331,1610612738,1610612752,95.0,101.0,0.435,0.494,0,2014-12-12,21,7,14,0.3329999999999999,25,5,20,0.2
21400332,1610612751,1610612755,88.0,70.0,0.444,0.319,1,2014-12-12,21,9,12,0.429,22,2,20,0.091
21400333,1610612761,1610612754,106.0,94.0,0.418,0.413,1,2014-12-12,23,17,6,0.7390000000000001,23,7,16,0.304
21400334,1610612763,1610612766,113.0,107.0,0.4589999999999999,0.418,1,2014-12-12,22,18,4,0.818,22,6,16,0.273
21400335,1610612750,1610612760,92.0,111.0,0.462,0.511,0,2014-12-12,22,5,17,0.2269999999999999,23,10,13,0.435
21400336,1610612740,1610612739,119.0,114.0,0.557,0.494,1,2014-12-12,22,11,11,0.5,22,13,9,0.591
21400337,1610612756,1610612765,103.0,105.0,0.47,0.476,0,2014-12-12,24,12,12,0.5,23,4,19,0.174
21400338,1610612762,1610612748,95.0,100.0,0.442,0.5,0,2014-12-12,23,6,17,0.261,23,11,12,0.478
21400339,1610612759,1610612747,110.0,112.0,0.467,0.4579999999999999,0,2014-12-12,23,16,7,0.696,23,7,16,0.304
21400326,1610612760,1610612739,103.0,94.0,0.4370000000000001,0.365,1,2014-12-11,22,9,13,0.409,21,13,8,0.619
21400327,1610612758,1610612745,109.0,113.0,0.4639999999999999,0.4,0,2014-12-11,23,11,12,0.478,22,17,5,0.773
21400316,1610612766,1610612738,96.0,87.0,0.417,0.4370000000000001,1,2014-12-10,21,6,15,0.286,20,7,13,0.35
21400317,1610612754,1610612746,96.0,103.0,0.3929999999999999,0.477,0,2014-12-10,22,7,15,0.318,21,16,5,0.762
21400318,1610612753,1610612764,89.0,91.0,0.452,0.506,0,2014-12-10,24,9,15,0.375,21,15,6,0.7140000000000001
21400319,1610612737,1610612755,95.0,79.0,0.418,0.417,1,2014-12-10,21,15,6,0.7140000000000001,21,2,19,0.095
21400320,1610612741,1610612751,105.0,80.0,0.4679999999999999,0.33,1,2014-12-10,21,13,8,0.619,20,8,12,0.4
21400321,1610612750,1610612757,90.0,82.0,0.395,0.3879999999999999,1,2014-12-10,21,5,16,0.238,22,17,5,0.773
21400323,1610612742,1610612740,112.0,107.0,0.53,0.455,1,2014-12-10,24,17,7,0.708,21,10,11,0.476
21400322,1610612759,1610612752,109.0,95.0,0.507,0.487,1,2014-12-10,22,16,6,0.727,24,4,20,0.1669999999999999
21400324,1610612744,1610612745,105.0,93.0,0.494,0.411,1,2014-12-10,21,19,2,0.905,21,16,5,0.762
21400325,1610612743,1610612748,102.0,82.0,0.447,0.366,1,2014-12-10,22,10,12,0.455,22,10,12,0.455
21400308,1610612739,1610612761,105.0,101.0,0.494,0.512,1,2014-12-09,20,13,7,0.65,22,16,6,0.727
21400309,1610612765,1610612757,86.0,98.0,0.351,0.488,0,2014-12-09,22,3,19,0.136,21,17,4,0.81
21400310,1610612763,1610612742,114.0,105.0,0.482,0.447,1,2014-12-09,21,17,4,0.81,23,16,7,0.696
21400311,1610612740,1610612752,104.0,93.0,0.5,0.474,1,2014-12-09,20,10,10,0.5,23,4,19,0.174
21400312,1610612760,1610612749,114.0,101.0,0.5,0.405,1,2014-12-09,21,8,13,0.381,23,11,12,0.478
21400313,1610612756,1610612748,97.0,103.0,0.481,0.5379999999999999,0,2014-12-09,23,12,11,0.522,21,10,11,0.476
21400314,1610612762,1610612759,100.0,96.0,0.5,0.4639999999999999,1,2014-12-09,22,6,16,0.273,21,15,6,0.7140000000000001
21400315,1610612747,1610612758,98.0,95.0,0.396,0.457,1,2014-12-09,22,6,16,0.273,22,11,11,0.5
21400301,1610612754,1610612737,92.0,108.0,0.44,0.519,0,2014-12-08,21,7,14,0.3329999999999999,20,14,6,0.7
21400302,1610612764,1610612738,133.0,132.0,0.521,0.461,1,2014-12-08,20,14,6,0.7,19,7,12,0.368
21400303,1610612751,1610612739,88.0,110.0,0.444,0.478,0,2014-12-08,19,8,11,0.421,19,12,7,0.632
21400304,1610612761,1610612743,112.0,107.0,0.506,0.413,1,2014-12-08,21,16,5,0.762,21,9,12,0.429
21400305,1610612750,1610612744,86.0,102.0,0.364,0.462,0,2014-12-08,20,4,16,0.2,20,18,2,0.9
21400306,1610612758,1610612762,101.0,92.0,0.473,0.405,1,2014-12-08,21,11,10,0.524,21,5,16,0.238
21400307,1610612746,1610612756,121.0,120.0,0.4579999999999999,0.484,1,2014-12-08,20,15,5,0.75,22,12,10,0.545
21400294,1610612738,1610612764,101.0,93.0,0.409,0.366,1,2014-12-07,18,7,11,0.389,19,13,6,0.684
21400295,1610612737,1610612743,96.0,84.0,0.414,0.366,1,2014-12-07,19,13,6,0.684,20,9,11,0.45
21400296,1610612763,1610612748,103.0,87.0,0.589,0.488,1,2014-12-07,20,16,4,0.8,20,9,11,0.45
21400297,1610612765,1610612760,94.0,96.0,0.447,0.4479999999999999,0,2014-12-07,21,3,18,0.143,20,7,13,0.35
21400298,1610612742,1610612749,125.0,102.0,0.583,0.5,1,2014-12-07,22,16,6,0.727,22,11,11,0.5
21400299,1610612752,1610612757,99.0,103.0,0.519,0.424,0,2014-12-07,22,4,18,0.182,20,16,4,0.8
21400300,1610612747,1610612740,87.0,104.0,0.4,0.518,0,2014-12-07,21,5,16,0.238,19,9,10,0.474
21400288,1610612765,1610612755,101.0,108.0,0.391,0.46,0,2014-12-06,20,3,17,0.15,20,2,18,0.1
21400289,1610612741,1610612744,102.0,112.0,0.434,0.449,0,2014-12-06,20,12,8,0.6,19,17,2,0.895
21400290,1610612745,1610612756,100.0,95.0,0.407,0.366,1,2014-12-06,20,16,4,0.8,21,12,9,0.5710000000000001
21400291,1610612759,1610612750,123.0,101.0,0.573,0.422,1,2014-12-06,20,15,5,0.75,19,4,15,0.211
21400292,1610612758,1610612753,96.0,105.0,0.4429999999999999,0.506,0,2014-12-06,20,10,10,0.5,23,9,14,0.391
21400293,1610612746,1610612740,120.0,100.0,0.551,0.475,1,2014-12-06,19,14,5,0.737,18,8,10,0.444
21400276,1610612766,1610612752,103.0,102.0,0.477,0.4679999999999999,1,2014-12-05,20,5,15,0.25,21,4,17,0.19
21400277,1610612755,1610612760,91.0,103.0,0.381,0.493,0,2014-12-05,19,1,18,0.053,19,6,13,0.316
21400278,1610612764,1610612743,119.0,89.0,0.529,0.3779999999999999,1,2014-12-05,18,13,5,0.722,19,9,10,0.474
21400279,1610612738,1610612747,113.0,96.0,0.511,0.413,1,2014-12-05,17,6,11,0.353,20,5,15,0.25
21400280,1610612751,1610612737,75.0,98.0,0.375,0.4320000000000001,0,2014-12-05,18,8,10,0.444,18,12,6,0.667
21400281,1610612761,1610612739,91.0,105.0,0.407,0.488,0,2014-12-05,20,15,5,0.75,18,11,7,0.611
21400282,1610612763,1610612759,101.0,107.0,0.4629999999999999,0.476,0,2014-12-05,19,15,4,0.789,19,14,5,0.737
21400283,1610612750,1610612745,112.0,114.0,0.4639999999999999,0.487,0,2014-12-05,18,4,14,0.222,19,15,4,0.789
21400284,1610612742,1610612756,106.0,118.0,0.455,0.563,0,2014-12-05,21,15,6,0.7140000000000001,20,12,8,0.6
21400285,1610612749,1610612748,109.0,85.0,0.565,0.441,1,2014-12-05,21,11,10,0.524,19,9,10,0.474
21400286,1610612762,1610612753,93.0,98.0,0.456,0.5,0,2014-12-05,20,5,15,0.25,22,8,14,0.364
21400287,1610612758,1610612754,102.0,101.0,0.434,0.375,1,2014-12-05,19,10,9,0.526,20,7,13,0.35
21400273,1610612752,1610612739,87.0,90.0,0.42,0.457,0,2014-12-04,20,4,16,0.2,17,10,7,0.588
21400274,1610612757,1610612754,88.0,82.0,0.3979999999999999,0.396,1,2014-12-04,19,15,4,0.789,19,7,12,0.368
21400275,1610612744,1610612740,112.0,85.0,0.47,0.416,1,2014-12-04,18,16,2,0.889,17,8,9,0.471
21400263,1610612766,1610612741,95.0,102.0,0.4,0.4629999999999999,0,2014-12-03,19,4,15,0.211,19,12,7,0.632
21400264,1610612764,1610612747,111.0,95.0,0.484,0.3879999999999999,1,2014-12-03,17,12,5,0.706,19,5,14,0.263
21400265,1610612738,1610612765,109.0,102.0,0.3979999999999999,0.363,1,2014-12-03,16,5,11,0.313,19,3,16,0.158
21400266,1610612751,1610612759,95.0,93.0,0.411,0.356,1,2014-12-03,17,8,9,0.471,18,13,5,0.722
21400267,1610612748,1610612737,102.0,112.0,0.563,0.541,0,2014-12-03,18,9,9,0.5,17,11,6,0.647
21400268,1610612745,1610612763,105.0,96.0,0.441,0.513,1,2014-12-03,18,14,4,0.778,18,15,3,0.833
21400269,1610612749,1610612742,105.0,107.0,0.521,0.457,0,2014-12-03,20,10,10,0.5,20,15,5,0.75
21400270,1610612750,1610612755,77.0,85.0,0.357,0.39,0,2014-12-03,17,4,13,0.235,18,1,17,0.0559999999999999
21400271,1610612762,1610612761,104.0,123.0,0.483,0.57,0,2014-12-03,19,5,14,0.263,19,15,4,0.789
21400272,1610612746,1610612753,114.0,86.0,0.5379999999999999,0.418,1,2014-12-03,18,13,5,0.722,21,7,14,0.3329999999999999
21400253,1610612739,1610612749,111.0,108.0,0.534,0.489,1,2014-12-02,16,9,7,0.563,19,10,9,0.526
21400254,1610612737,1610612738,109.0,105.0,0.524,0.488,1,2014-12-02,16,10,6,0.625,15,4,11,0.267
21400255,1610612765,1610612747,96.0,106.0,0.3670000000000001,0.481,0,2014-12-02,18,3,15,0.1669999999999999,18,5,13,0.278
21400256,1610612752,1610612751,93.0,98.0,0.4320000000000001,0.4379999999999999,0,2014-12-02,19,4,15,0.211,16,7,9,0.4379999999999999
21400257,1610612741,1610612742,129.0,132.0,0.456,0.461,0,2014-12-02,18,11,7,0.611,19,14,5,0.737
21400258,1610612740,1610612760,112.0,104.0,0.4429999999999999,0.44,1,2014-12-02,16,8,8,0.5,18,5,13,0.278
21400259,1610612743,1610612757,103.0,105.0,0.506,0.5,0,2014-12-02,18,9,9,0.5,18,14,4,0.778
21400260,1610612756,1610612754,116.0,99.0,0.5,0.482,1,2014-12-02,19,11,8,0.579,18,7,11,0.389
21400261,1610612758,1610612761,109.0,117.0,0.52,0.5,0,2014-12-02,18,9,9,0.5,18,14,4,0.778
21400262,1610612744,1610612753,98.0,97.0,0.4629999999999999,0.4479999999999999,1,2014-12-02,17,15,2,0.882,20,7,13,0.35
21400249,1610612755,1610612759,103.0,109.0,0.4270000000000001,0.434,0,2014-12-01,17,0,17,0.0,17,13,4,0.765
21400250,1610612764,1610612748,107.0,86.0,0.542,0.4579999999999999,1,2014-12-01,16,11,5,0.688,17,9,8,0.529
21400251,1610612762,1610612743,101.0,103.0,0.429,0.471,0,2014-12-01,18,5,13,0.278,17,9,8,0.529
21400252,1610612746,1610612750,127.0,101.0,0.513,0.4270000000000001,1,2014-12-01,17,12,5,0.706,16,4,12,0.25
21400241,1610612738,1610612759,89.0,111.0,0.414,0.482,0,2014-11-30,14,4,10,0.286,16,12,4,0.75
21400242,1610612751,1610612741,84.0,102.0,0.3720000000000001,0.493,0,2014-11-30,15,6,9,0.4,17,11,6,0.647
21400243,1610612765,1610612744,93.0,104.0,0.363,0.4679999999999999,0,2014-11-30,17,3,14,0.176,16,14,2,0.875
21400244,1610612758,1610612763,85.0,97.0,0.471,0.481,0,2014-11-30,17,9,8,0.529,17,15,2,0.882
21400245,1610612752,1610612748,79.0,86.0,0.352,0.417,0,2014-11-30,18,4,14,0.222,16,9,7,0.563
21400246,1610612756,1610612753,90.0,93.0,0.4,0.461,0,2014-11-30,18,10,8,0.556,19,7,12,0.368
21400247,1610612757,1610612750,107.0,93.0,0.4529999999999999,0.433,1,2014-11-30,17,13,4,0.765,15,4,11,0.267
21400248,1610612747,1610612761,129.0,122.0,0.49,0.433,1,2014-11-30,17,4,13,0.235,17,13,4,0.765
21400235,1610612755,1610612742,103.0,110.0,0.424,0.449,0,2014-11-29,16,0,16,0.0,18,13,5,0.722
21400236,1610612764,1610612740,83.0,80.0,0.461,0.37,1,2014-11-29,15,10,5,0.667,15,7,8,0.467
21400237,1610612737,1610612766,105.0,75.0,0.5329999999999999,0.33,1,2014-11-29,15,9,6,0.6,18,4,14,0.222
21400238,1610612739,1610612754,109.0,97.0,0.526,0.3929999999999999,1,2014-11-29,15,8,7,0.5329999999999999,17,7,10,0.412
21400239,1610612762,1610612746,96.0,112.0,0.4529999999999999,0.563,0,2014-11-29,17,5,12,0.294,16,11,5,0.688
21400240,1610612749,1610612745,103.0,117.0,0.446,0.506,0,2014-11-29,18,10,8,0.556,17,13,4,0.765
21400223,1610612738,1610612741,102.0,109.0,0.402,0.411,0,2014-11-28,13,4,9,0.308,16,10,6,0.625
21400224,1610612766,1610612744,101.0,106.0,0.4370000000000001,0.424,0,2014-11-28,17,4,13,0.235,15,13,2,0.867
21400225,1610612737,1610612740,100.0,91.0,0.5,0.4039999999999999,1,2014-11-28,14,8,6,0.5710000000000001,14,7,7,0.5
21400226,1610612765,1610612749,88.0,104.0,0.41,0.506,0,2014-11-28,16,3,13,0.188,17,10,7,0.588
21400227,1610612761,1610612742,102.0,106.0,0.418,0.465,0,2014-11-28,16,13,3,0.813,17,12,5,0.706
21400228,1610612745,1610612746,85.0,102.0,0.39,0.469,0,2014-11-28,16,12,4,0.75,15,10,5,0.667
21400229,1610612760,1610612752,105.0,78.0,0.442,0.387,1,2014-11-28,17,5,12,0.294,17,4,13,0.235
21400230,1610612754,1610612753,98.0,83.0,0.436,0.4429999999999999,1,2014-11-28,16,7,9,0.4379999999999999,18,6,12,0.3329999999999999
21400231,1610612759,1610612758,112.0,104.0,0.512,0.507,1,2014-11-28,15,11,4,0.733,16,9,7,0.563
21400232,1610612743,1610612756,122.0,97.0,0.466,0.3879999999999999,1,2014-11-28,16,8,8,0.5,17,10,7,0.588
21400233,1610612757,1610612763,99.0,112.0,0.402,0.536,0,2014-11-28,16,12,4,0.75,16,14,2,0.875
21400234,1610612747,1610612750,119.0,120.0,0.539,0.57,0,2014-11-28,16,3,13,0.188,14,4,10,0.286
21400210,1610612766,1610612757,97.0,105.0,0.436,0.424,0,2014-11-26,16,4,12,0.25,15,12,3,0.8
21400211,1610612739,1610612764,113.0,87.0,0.514,0.465,1,2014-11-26,14,7,7,0.5,14,9,5,0.643
21400212,1610612753,1610612744,96.0,111.0,0.414,0.518,0,2014-11-26,17,6,11,0.353,14,12,2,0.857
21400213,1610612755,1610612751,91.0,99.0,0.4,0.493,0,2014-11-26,15,0,15,0.0,14,6,8,0.429
21400214,1610612742,1610612752,109.0,102.0,0.4,0.424,1,2014-11-26,16,11,5,0.688,16,4,12,0.25
21400215,1610612737,1610612761,115.0,126.0,0.512,0.512,0,2014-11-26,13,7,6,0.5379999999999999,15,13,2,0.867
21400216,1610612765,1610612746,98.0,104.0,0.449,0.474,0,2014-11-26,15,3,12,0.2,14,9,5,0.643
21400217,1610612745,1610612758,102.0,89.0,0.447,0.4370000000000001,1,2014-11-26,15,12,3,0.8,15,9,6,0.6
21400218,1610612750,1610612749,86.0,103.0,0.3829999999999999,0.471,0,2014-11-26,13,3,10,0.231,16,9,7,0.563
21400219,1610612760,1610612762,97.0,82.0,0.482,0.4429999999999999,1,2014-11-26,16,4,12,0.25,16,5,11,0.313
21400220,1610612759,1610612754,106.0,100.0,0.5539999999999999,0.46,1,2014-11-26,14,10,4,0.7140000000000001,15,6,9,0.4
21400221,1610612756,1610612743,120.0,112.0,0.511,0.433,1,2014-11-26,16,10,6,0.625,15,7,8,0.467
21400222,1610612747,1610612763,93.0,99.0,0.407,0.45,0,2014-11-26,15,3,12,0.2,15,13,2,0.867
21400205,1610612764,1610612737,102.0,106.0,0.429,0.424,0,2014-11-25,13,9,4,0.6920000000000001,12,7,5,0.583
21400206,1610612748,1610612744,97.0,114.0,0.3879999999999999,0.573,0,2014-11-25,15,8,7,0.5329999999999999,13,11,2,0.846
21400207,1610612749,1610612765,98.0,86.0,0.433,0.462,1,2014-11-25,15,8,7,0.5329999999999999,14,3,11,0.214
21400208,1610612740,1610612758,89.0,99.0,0.418,0.481,0,2014-11-25,13,7,6,0.5379999999999999,14,9,5,0.643
21400209,1610612743,1610612741,114.0,109.0,0.506,0.4270000000000001,1,2014-11-25,14,7,7,0.5,15,9,6,0.6
21400198,1610612766,1610612746,92.0,113.0,0.413,0.511,0,2014-11-24,15,4,11,0.267,13,8,5,0.615
21400199,1610612739,1610612753,106.0,74.0,0.519,0.363,1,2014-11-24,13,6,7,0.462,16,6,10,0.375
21400200,1610612755,1610612757,104.0,114.0,0.5,0.494,0,2014-11-24,14,0,14,0.0,14,11,3,0.7859999999999999
21400201,1610612761,1610612756,104.0,100.0,0.451,0.4639999999999999,1,2014-11-24,14,12,2,0.857,15,9,6,0.6
21400202,1610612745,1610612752,91.0,86.0,0.421,0.461,1,2014-11-24,14,11,3,0.7859999999999999,15,4,11,0.267
21400203,1610612742,1610612754,100.0,111.0,0.5,0.481,0,2014-11-24,15,10,5,0.667,14,6,8,0.429
21400204,1610612762,1610612741,95.0,97.0,0.488,0.5,0,2014-11-24,15,5,10,0.3329999999999999,14,9,5,0.643
21400193,1610612763,1610612746,107.0,91.0,0.494,0.416,1,2014-11-23,14,12,2,0.857,12,7,5,0.583
21400194,1610612738,1610612757,88.0,94.0,0.389,0.43,0,2014-11-23,12,4,8,0.3329999999999999,13,10,3,0.769
21400195,1610612748,1610612766,94.0,93.0,0.5,0.4679999999999999,1,2014-11-23,14,8,6,0.5710000000000001,14,4,10,0.286
21400196,1610612760,1610612744,86.0,91.0,0.356,0.355,0,2014-11-23,15,3,12,0.2,12,10,2,0.833
21400197,1610612747,1610612743,94.0,101.0,0.371,0.3779999999999999,0,2014-11-23,14,3,11,0.214,13,6,7,0.462
21400184,1610612754,1610612756,83.0,106.0,0.369,0.447,0,2014-11-22,13,5,8,0.385,14,9,5,0.643
21400185,1610612753,1610612748,92.0,99.0,0.449,0.521,0,2014-11-22,15,6,9,0.4,13,7,6,0.5379999999999999
21400186,1610612739,1610612761,93.0,110.0,0.4320000000000001,0.4,0,2014-11-22,12,5,7,0.417,13,11,2,0.846
21400187,1610612752,1610612755,91.0,83.0,0.5,0.4,1,2014-11-22,14,4,10,0.286,13,0,13,0.0
21400188,1610612745,1610612742,95.0,92.0,0.366,0.3979999999999999,1,2014-11-22,13,10,3,0.769,14,10,4,0.7140000000000001
21400189,1610612750,1610612758,101.0,113.0,0.411,0.494,0,2014-11-22,12,3,9,0.25,13,8,5,0.615
21400190,1610612749,1610612764,100.0,111.0,0.429,0.462,0,2014-11-22,14,7,7,0.5,12,9,3,0.75
21400191,1610612759,1610612751,99.0,87.0,0.519,0.374,1,2014-11-22,13,9,4,0.6920000000000001,13,5,8,0.385
21400192,1610612762,1610612740,94.0,106.0,0.465,0.452,0,2014-11-22,14,5,9,0.357,12,7,5,0.583
21400172,1610612766,1610612753,100.0,105.0,0.462,0.476,0,2014-11-21,13,4,9,0.308,14,6,8,0.429
21400173,1610612755,1610612756,96.0,122.0,0.462,0.512,0,2014-11-21,12,0,12,0.0,13,8,5,0.615
21400174,1610612737,1610612765,99.0,89.0,0.475,0.373,1,2014-11-21,11,6,5,0.545,13,3,10,0.231
21400175,1610612761,1610612749,124.0,82.0,0.523,0.365,1,2014-11-21,12,10,2,0.833,13,7,6,0.5379999999999999
21400176,1610612763,1610612738,117.0,100.0,0.527,0.4320000000000001,1,2014-11-21,13,11,2,0.846,11,4,7,0.364
21400177,1610612750,1610612759,92.0,121.0,0.411,0.5479999999999999,0,2014-11-21,11,3,8,0.273,12,8,4,0.667
21400178,1610612760,1610612751,92.0,94.0,0.447,0.4629999999999999,0,2014-11-21,14,3,11,0.214,12,5,7,0.417
21400179,1610612764,1610612739,91.0,78.0,0.488,0.36,1,2014-11-21,11,8,3,0.727,11,5,6,0.455
21400180,1610612742,1610612747,140.0,106.0,0.622,0.518,1,2014-11-21,13,10,3,0.769,13,3,10,0.231
21400181,1610612743,1610612740,117.0,97.0,0.524,0.397,1,2014-11-21,12,5,7,0.417,11,6,5,0.545
21400182,1610612744,1610612762,101.0,88.0,0.5,0.4270000000000001,1,2014-11-21,11,9,2,0.818,13,5,8,0.385
21400183,1610612757,1610612741,105.0,87.0,0.494,0.361,1,2014-11-21,12,9,3,0.75,13,8,5,0.615
21400170,1610612748,1610612746,93.0,110.0,0.4479999999999999,0.5579999999999999,0,2014-11-20,12,6,6,0.5,11,7,4,0.636
21400171,1610612758,1610612741,103.0,88.0,0.514,0.429,1,2014-11-20,12,7,5,0.583,12,8,4,0.667
21400159,1610612739,1610612759,90.0,92.0,0.446,0.473,0,2014-11-19,10,5,5,0.5,11,7,4,0.636
21400160,1610612754,1610612766,88.0,86.0,0.449,0.43,1,2014-11-19,12,5,7,0.417,12,4,8,0.3329999999999999
21400161,1610612753,1610612746,90.0,114.0,0.395,0.536,0,2014-11-19,13,5,8,0.385,10,6,4,0.6
21400162,1610612755,1610612738,90.0,101.0,0.395,0.494,0,2014-11-19,11,0,11,0.0,10,4,6,0.4
21400163,1610612764,1610612742,102.0,105.0,0.44,0.415,0,2014-11-19,10,7,3,0.7,12,9,3,0.75
21400164,1610612751,1610612749,118.0,122.0,0.478,0.444,0,2014-11-19,11,4,7,0.364,12,7,5,0.583
21400165,1610612765,1610612756,86.0,88.0,0.379,0.493,0,2014-11-19,12,3,9,0.25,12,7,5,0.583
21400166,1610612761,1610612763,96.0,92.0,0.4579999999999999,0.4379999999999999,1,2014-11-19,11,9,2,0.818,12,10,2,0.833
21400167,1610612750,1610612752,115.0,99.0,0.494,0.493,1,2014-11-19,10,3,7,0.3,13,3,10,0.231
21400168,1610612743,1610612760,107.0,100.0,0.488,0.456,1,2014-11-19,11,4,7,0.364,13,3,10,0.231
21400169,1610612745,1610612747,92.0,98.0,0.405,0.407,0,2014-11-19,12,9,3,0.75,12,3,9,0.25
21400155,1610612737,1610612747,109.0,114.0,0.482,0.54,0,2014-11-18,10,5,5,0.5,11,2,9,0.182
21400156,1610612749,1610612752,117.0,113.0,0.551,0.55,1,2014-11-18,11,6,5,0.545,12,3,9,0.25
21400157,1610612762,1610612760,98.0,81.0,0.4320000000000001,0.357,1,2014-11-18,12,5,7,0.417,12,3,9,0.25
21400158,1610612758,1610612740,100.0,106.0,0.442,0.494,0,2014-11-18,11,6,5,0.545,10,6,4,0.6
21400146,1610612766,1610612742,80.0,107.0,0.4,0.512,0,2014-11-17,11,4,7,0.364,11,8,3,0.727
21400147,1610612739,1610612743,97.0,106.0,0.43,0.482,0,2014-11-17,9,5,4,0.556,10,3,7,0.3
21400148,1610612738,1610612756,114.0,118.0,0.517,0.516,0,2014-11-17,9,3,6,0.3329999999999999,11,6,5,0.545
21400149,1610612751,1610612748,83.0,95.0,0.414,0.431,0,2014-11-17,10,4,6,0.4,11,6,5,0.545
21400150,1610612765,1610612753,93.0,107.0,0.4,0.519,0,2014-11-17,11,3,8,0.273,12,5,7,0.417
21400151,1610612763,1610612745,119.0,93.0,0.535,0.436,1,2014-11-17,11,10,1,0.909,11,9,2,0.818
21400152,1610612759,1610612755,100.0,75.0,0.444,0.325,1,2014-11-17,10,6,4,0.6,10,0,10,0.0
21400153,1610612757,1610612740,102.0,93.0,0.5,0.447,1,2014-11-17,11,8,3,0.727,9,5,4,0.556
21400154,1610612746,1610612741,89.0,105.0,0.444,0.488,0,2014-11-17,9,5,4,0.556,11,8,3,0.727
21400142,1610612752,1610612743,109.0,93.0,0.539,0.39,1,2014-11-16,11,3,8,0.273,9,2,7,0.222
21400143,1610612748,1610612749,84.0,91.0,0.411,0.473,0,2014-11-16,10,5,5,0.5,10,5,5,0.5
21400144,1610612760,1610612745,65.0,69.0,0.294,0.288,0,2014-11-16,11,3,8,0.273,10,9,1,0.9
21400145,1610612747,1610612744,115.0,136.0,0.3939999999999999,0.535,0,2014-11-16,10,1,9,0.1,10,8,2,0.8
21400132,1610612764,1610612753,98.0,93.0,0.5,0.474,1,2014-11-15,9,7,2,0.778,11,4,7,0.364
21400133,1610612739,1610612737,127.0,94.0,0.544,0.444,1,2014-11-15,8,5,3,0.625,9,5,4,0.556
21400134,1610612761,1610612762,111.0,93.0,0.512,0.44,1,2014-11-15,10,8,2,0.8,11,4,7,0.364
21400135,1610612741,1610612754,90.0,99.0,0.422,0.481,0,2014-11-15,10,7,3,0.7,11,4,7,0.364
21400136,1610612763,1610612765,95.0,88.0,0.3720000000000001,0.415,1,2014-11-15,10,9,1,0.9,10,3,7,0.3
21400137,1610612742,1610612750,131.0,117.0,0.5529999999999999,0.5,1,2014-11-15,10,7,3,0.7,9,2,7,0.222
21400138,1610612757,1610612751,97.0,87.0,0.423,0.3929999999999999,1,2014-11-15,10,7,3,0.7,9,4,5,0.444
21400139,1610612758,1610612759,94.0,91.0,0.43,0.425,1,2014-11-15,10,6,4,0.6,9,5,4,0.556
21400140,1610612744,1610612766,112.0,87.0,0.517,0.381,1,2014-11-15,9,7,2,0.778,10,4,6,0.4
21400141,1610612746,1610612756,120.0,107.0,0.529,0.384,1,2014-11-15,8,5,3,0.625,10,5,5,0.5
21400122,1610612754,1610612743,87.0,108.0,0.405,0.494,0,2014-11-14,10,3,7,0.3,8,2,6,0.25
21400123,1610612753,1610612749,101.0,85.0,0.4379999999999999,0.45,1,2014-11-14,10,4,6,0.4,9,4,5,0.444
21400124,1610612737,1610612748,114.0,103.0,0.56,0.473,1,2014-11-14,8,5,3,0.625,9,5,4,0.556
21400125,1610612738,1610612739,121.0,122.0,0.545,0.506,0,2014-11-14,8,3,5,0.375,7,4,3,0.5710000000000001
21400126,1610612752,1610612762,100.0,102.0,0.476,0.514,0,2014-11-14,10,2,8,0.2,10,4,6,0.4
21400127,1610612745,1610612755,88.0,87.0,0.3720000000000001,0.425,1,2014-11-14,9,8,1,0.889,9,0,9,0.0
21400128,1610612740,1610612750,139.0,91.0,0.667,0.4029999999999999,1,2014-11-14,8,5,3,0.625,8,2,6,0.25
21400129,1610612760,1610612765,89.0,96.0,0.396,0.4270000000000001,0,2014-11-14,10,3,7,0.3,9,3,6,0.3329999999999999
21400130,1610612756,1610612766,95.0,103.0,0.43,0.429,0,2014-11-14,9,5,4,0.556,9,4,5,0.444
21400131,1610612747,1610612759,80.0,93.0,0.373,0.413,0,2014-11-14,9,1,8,0.111,8,5,3,0.625
21400118,1610612763,1610612758,111.0,110.0,0.506,0.481,1,2014-11-13,9,8,1,0.889,9,5,4,0.556
21400119,1610612761,1610612741,93.0,100.0,0.3929999999999999,0.481,0,2014-11-13,9,7,2,0.778,9,7,2,0.778
21400120,1610612742,1610612755,123.0,70.0,0.513,0.299,1,2014-11-13,9,6,3,0.667,8,0,8,0.0
21400121,1610612744,1610612751,107.0,99.0,0.456,0.4379999999999999,1,2014-11-13,8,6,2,0.75,8,4,4,0.5
21400109,1610612764,1610612765,107.0,103.0,0.482,0.469,1,2014-11-12,8,6,2,0.75,8,2,6,0.25
21400110,1610612737,1610612762,100.0,97.0,0.513,0.5,1,2014-11-12,7,4,3,0.5710000000000001,9,3,6,0.3329999999999999
21400111,1610612738,1610612760,94.0,109.0,0.446,0.488,0,2014-11-12,7,3,4,0.429,9,3,6,0.3329999999999999
21400112,1610612748,1610612754,75.0,81.0,0.426,0.375,0,2014-11-12,8,5,3,0.625,9,3,6,0.3329999999999999
21400113,1610612752,1610612753,95.0,97.0,0.43,0.471,0,2014-11-12,9,2,7,0.222,9,3,6,0.3329999999999999
21400114,1610612740,1610612747,109.0,102.0,0.5489999999999999,0.417,1,2014-11-12,7,4,3,0.5710000000000001,8,1,7,0.125
21400115,1610612743,1610612757,113.0,130.0,0.433,0.511,0,2014-11-12,7,1,6,0.143,9,6,3,0.667
21400116,1610612756,1610612751,112.0,104.0,0.481,0.473,1,2014-11-12,8,5,3,0.625,7,4,3,0.5710000000000001
21400117,1610612750,1610612745,101.0,113.0,0.444,0.483,0,2014-11-12,7,2,5,0.286,8,7,1,0.875
21400103,1610612761,1610612753,104.0,100.0,0.455,0.481,1,2014-11-11,8,7,1,0.875,8,2,6,0.25
21400104,1610612763,1610612747,107.0,102.0,0.526,0.471,1,2014-11-11,8,7,1,0.875,7,1,6,0.143
21400105,1610612749,1610612760,85.0,78.0,0.407,0.3329999999999999,1,2014-11-11,8,4,4,0.5,8,2,6,0.25
21400106,1610612742,1610612758,106.0,98.0,0.475,0.444,1,2014-11-11,8,5,3,0.625,8,5,3,0.625
21400107,1610612757,1610612766,102.0,100.0,0.43,0.467,1,2014-11-11,8,5,3,0.625,8,3,5,0.375
21400108,1610612744,1610612759,100.0,113.0,0.5429999999999999,0.495,0,2014-11-11,7,5,2,0.7140000000000001,7,4,3,0.5710000000000001
21400098,1610612739,1610612740,118.0,111.0,0.494,0.441,1,2014-11-10,6,3,3,0.5,6,3,3,0.5
21400099,1610612754,1610612762,97.0,86.0,0.433,0.4320000000000001,1,2014-11-10,8,2,6,0.25,8,3,5,0.375
21400100,1610612752,1610612737,85.0,91.0,0.434,0.38,0,2014-11-10,8,2,6,0.25,6,3,3,0.5
21400101,1610612741,1610612765,102.0,91.0,0.4429999999999999,0.425,1,2014-11-10,8,6,2,0.75,7,2,5,0.286
21400102,1610612746,1610612759,85.0,89.0,0.446,0.3979999999999999,0,2014-11-10,7,4,3,0.5710000000000001,6,3,3,0.5
21400090,1610612751,1610612753,104.0,96.0,0.482,0.52,1,2014-11-09,6,4,2,0.667,7,2,5,0.286
21400091,1610612765,1610612762,96.0,97.0,0.387,0.4579999999999999,0,2014-11-09,6,2,4,0.3329999999999999,7,3,4,0.429
21400092,1610612760,1610612758,101.0,93.0,0.462,0.45,1,2014-11-09,7,2,5,0.286,7,5,2,0.7140000000000001
21400093,1610612761,1610612755,120.0,88.0,0.5660000000000001,0.379,1,2014-11-09,7,6,1,0.857,7,0,7,0.0
21400094,1610612742,1610612748,96.0,105.0,0.422,0.5529999999999999,0,2014-11-09,7,4,3,0.5710000000000001,7,5,2,0.7140000000000001
21400095,1610612756,1610612744,107.0,95.0,0.43,0.478,1,2014-11-09,7,4,3,0.5710000000000001,6,5,1,0.833
21400096,1610612757,1610612743,116.0,100.0,0.45,0.396,1,2014-11-09,7,4,3,0.5710000000000001,6,1,5,0.1669999999999999
21400097,1610612747,1610612766,107.0,92.0,0.512,0.4429999999999999,1,2014-11-09,6,1,5,0.1669999999999999,7,3,4,0.429
21400082,1610612746,1610612757,106.0,102.0,0.494,0.45,1,2014-11-08,6,4,2,0.667,6,3,3,0.5
21400083,1610612754,1610612764,90.0,97.0,0.429,0.481,0,2014-11-08,7,1,6,0.143,7,5,2,0.7140000000000001
21400084,1610612737,1610612752,103.0,96.0,0.407,0.476,1,2014-11-08,5,2,3,0.4,7,2,5,0.286
21400085,1610612748,1610612750,102.0,92.0,0.526,0.402,1,2014-11-08,6,4,2,0.667,6,2,4,0.3329999999999999
21400086,1610612741,1610612738,101.0,106.0,0.457,0.519,0,2014-11-08,7,5,2,0.7140000000000001,6,3,3,0.5
21400087,1610612745,1610612744,87.0,98.0,0.349,0.4479999999999999,0,2014-11-08,7,6,1,0.857,5,5,0,1.0
21400088,1610612749,1610612763,93.0,92.0,0.455,0.354,1,2014-11-08,7,3,4,0.429,7,6,1,0.857
21400089,1610612759,1610612740,99.0,100.0,0.45,0.471,0,2014-11-08,5,2,3,0.4,5,3,2,0.6
21400071,1610612766,1610612737,122.0,119.0,0.495,0.462,1,2014-11-07,6,3,3,0.5,4,1,3,0.25
21400072,1610612753,1610612750,112.0,103.0,0.505,0.43,1,2014-11-07,6,2,4,0.3329999999999999,5,2,3,0.4
21400073,1610612755,1610612741,115.0,118.0,0.473,0.513,0,2014-11-07,6,0,6,0.0,6,5,1,0.833
21400074,1610612738,1610612754,101.0,98.0,0.4589999999999999,0.455,1,2014-11-07,5,2,3,0.4,6,1,5,0.1669999999999999
21400075,1610612751,1610612752,110.0,99.0,0.514,0.411,1,2014-11-07,5,3,2,0.6,6,2,4,0.3329999999999999
21400076,1610612765,1610612749,98.0,95.0,0.493,0.4679999999999999,1,2014-11-07,5,2,3,0.4,6,2,4,0.3329999999999999
21400077,1610612761,1610612764,103.0,84.0,0.4379999999999999,0.361,1,2014-11-07,6,5,1,0.833,6,4,2,0.667
21400078,1610612760,1610612763,89.0,91.0,0.4679999999999999,0.42,0,2014-11-07,6,1,5,0.1669999999999999,6,6,0,1.0
21400079,1610612756,1610612758,112.0,114.0,0.429,0.429,0,2014-11-07,6,3,3,0.5,6,5,1,0.833
21400080,1610612762,1610612742,82.0,105.0,0.426,0.477,0,2014-11-07,6,2,4,0.3329999999999999,6,4,2,0.667
21400081,1610612743,1610612739,101.0,110.0,0.471,0.476,0,2014-11-07,5,1,4,0.2,5,2,3,0.4
21400069,1610612745,1610612759,98.0,81.0,0.472,0.344,1,2014-11-06,6,6,0,1.0,4,2,2,0.5
21400070,1610612757,1610612742,108.0,87.0,0.519,0.3670000000000001,1,2014-11-06,5,3,2,0.6,5,3,2,0.6
21400057,1610612766,1610612748,96.0,89.0,0.4270000000000001,0.39,1,2014-11-05,5,2,3,0.4,5,3,2,0.6
21400058,1610612755,1610612753,89.0,91.0,0.429,0.4429999999999999,0,2014-11-05,5,0,5,0.0,5,1,4,0.2
21400059,1610612738,1610612761,107.0,110.0,0.513,0.483,0,2014-11-05,4,1,3,0.25,5,4,1,0.8
21400060,1610612751,1610612750,91.0,98.0,0.439,0.411,0,2014-11-05,4,2,2,0.5,4,2,2,0.5
21400061,1610612765,1610612752,98.0,95.0,0.368,0.433,1,2014-11-05,4,1,3,0.25,5,2,3,0.4
21400062,1610612749,1610612741,86.0,95.0,0.371,0.466,0,2014-11-05,5,2,3,0.4,5,4,1,0.8
21400063,1610612764,1610612754,96.0,94.0,0.374,0.389,1,2014-11-05,5,4,1,0.8,5,1,4,0.2
21400064,1610612759,1610612737,94.0,92.0,0.449,0.413,1,2014-11-05,3,2,1,0.667,3,1,2,0.3329999999999999
21400065,1610612756,1610612763,91.0,102.0,0.4639999999999999,0.5,0,2014-11-05,5,3,2,0.6,5,5,0,1.0
21400066,1610612762,1610612739,102.0,100.0,0.506,0.417,1,2014-11-05,5,2,3,0.4,4,1,3,0.25
21400067,1610612758,1610612743,131.0,109.0,0.5529999999999999,0.451,1,2014-11-05,5,4,1,0.8,4,1,3,0.25
21400068,1610612744,1610612746,121.0,104.0,0.581,0.4629999999999999,1,2014-11-05,4,4,0,1.0,5,3,2,0.6
21400049,1610612754,1610612749,81.0,87.0,0.397,0.446,0,2014-11-04,4,1,3,0.25,4,2,2,0.5
21400050,1610612748,1610612745,91.0,108.0,0.419,0.515,0,2014-11-04,4,3,1,0.75,5,5,0,1.0
21400051,1610612752,1610612764,83.0,98.0,0.37,0.488,0,2014-11-04,4,2,2,0.5,4,3,1,0.75
21400052,1610612761,1610612760,100.0,88.0,0.395,0.523,1,2014-11-04,4,3,1,0.75,5,1,4,0.2
21400053,1610612741,1610612753,98.0,90.0,0.467,0.4320000000000001,1,2014-11-04,4,3,1,0.75,4,0,4,0.0
21400054,1610612740,1610612766,100.0,91.0,0.469,0.4629999999999999,1,2014-11-04,4,2,2,0.5,4,1,3,0.25
21400055,1610612757,1610612739,101.0,82.0,0.493,0.365,1,2014-11-04,4,2,2,0.5,3,1,2,0.3329999999999999
21400056,1610612747,1610612756,106.0,112.0,0.3979999999999999,0.451,0,2014-11-04,5,0,5,0.0,4,3,1,0.75
21400043,1610612755,1610612745,93.0,104.0,0.446,0.4270000000000001,0,2014-11-03,4,0,4,0.0,4,4,0,1.0
21400044,1610612751,1610612760,116.0,85.0,0.524,0.39,1,2014-11-03,3,2,1,0.667,4,1,3,0.25
21400045,1610612763,1610612740,93.0,81.0,0.408,0.337,1,2014-11-03,4,4,0,1.0,3,1,2,0.3329999999999999
21400046,1610612742,1610612738,118.0,113.0,0.537,0.441,1,2014-11-03,4,3,1,0.75,3,1,2,0.3329999999999999
21400047,1610612743,1610612758,105.0,110.0,0.387,0.42,0,2014-11-03,3,1,2,0.3329999999999999,4,3,1,0.75
21400048,1610612746,1610612762,107.0,101.0,0.506,0.4679999999999999,1,2014-11-03,4,3,1,0.75,4,1,3,0.25
21400039,1610612746,1610612758,92.0,98.0,0.375,0.5,0,2014-11-02,3,2,1,0.667,3,2,1,0.667
21400040,1610612748,1610612761,107.0,102.0,0.5,0.4679999999999999,1,2014-11-02,3,3,0,1.0,3,2,1,0.667
21400041,1610612752,1610612766,96.0,93.0,0.5,0.471,1,2014-11-02,3,2,1,0.667,3,1,2,0.3329999999999999
21400042,1610612757,1610612744,90.0,95.0,0.402,0.444,0,2014-11-02,3,1,2,0.3329999999999999,3,3,0,1.0
21400027,1610612740,1610612742,104.0,109.0,0.4270000000000001,0.517,0,2014-11-01,2,1,1,0.5,3,2,1,0.667
21400028,1610612766,1610612763,69.0,71.0,0.361,0.363,0,2014-11-01,2,1,1,0.5,3,3,0,1.0
21400029,1610612753,1610612761,95.0,108.0,0.469,0.3979999999999999,0,2014-11-01,3,0,3,0.0,2,2,0,1.0
21400030,1610612755,1610612748,96.0,114.0,0.522,0.494,0,2014-11-01,3,0,3,0.0,2,2,0,1.0
21400031,1610612764,1610612749,108.0,97.0,0.5479999999999999,0.425,1,2014-11-01,3,2,1,0.667,3,1,2,0.3329999999999999
21400032,1610612737,1610612754,102.0,92.0,0.507,0.3829999999999999,1,2014-11-01,2,1,1,0.5,3,1,2,0.3329999999999999
21400033,1610612765,1610612751,90.0,102.0,0.421,0.483,0,2014-11-01,3,0,3,0.0,2,1,1,0.5
21400034,1610612745,1610612738,104.0,90.0,0.421,0.3779999999999999,1,2014-11-01,3,3,0,1.0,2,1,1,0.5
21400035,1610612750,1610612741,105.0,106.0,0.447,0.478,0,2014-11-01,3,1,2,0.3329999999999999,3,2,1,0.667
21400036,1610612760,1610612743,102.0,91.0,0.4629999999999999,0.4379999999999999,1,2014-11-01,3,1,2,0.3329999999999999,2,1,1,0.5
21400037,1610612762,1610612756,118.0,91.0,0.477,0.414,1,2014-11-01,3,1,2,0.3329999999999999,3,2,1,0.667
21400038,1610612744,1610612747,127.0,104.0,0.5539999999999999,0.466,1,2014-11-01,2,2,0,1.0,4,0,4,0.0
21400021,1610612754,1610612763,89.0,97.0,0.4589999999999999,0.4429999999999999,0,2014-10-31,2,1,1,0.5,2,2,0,1.0
21400022,1610612741,1610612739,108.0,114.0,0.456,0.3939999999999999,0,2014-10-31,2,1,1,0.5,2,1,1,0.5
21400023,1610612749,1610612755,93.0,81.0,0.409,0.3720000000000001,1,2014-10-31,2,1,1,0.5,2,0,2,0.0
21400024,1610612756,1610612759,94.0,89.0,0.402,0.41,1,2014-10-31,2,2,0,1.0,2,1,1,0.5
21400025,1610612758,1610612757,103.0,94.0,0.42,0.41,1,2014-10-31,2,1,1,0.5,2,1,1,0.5
21400026,1610612747,1610612746,111.0,118.0,0.512,0.479,0,2014-10-31,3,0,3,0.0,2,2,0,1.0
21400016,1610612753,1610612764,98.0,105.0,0.514,0.488,0,2014-10-30,2,0,2,0.0,2,1,1,0.5
21400017,1610612750,1610612765,97.0,91.0,0.487,0.418,1,2014-10-30,2,1,1,0.5,2,0,2,0.0
21400018,1610612739,1610612752,90.0,95.0,0.457,0.536,0,2014-10-30,1,0,1,0.0,2,1,1,0.5
21400019,1610612742,1610612762,120.0,102.0,0.5529999999999999,0.434,1,2014-10-30,2,1,1,0.5,2,0,2,0.0
21400020,1610612746,1610612760,93.0,90.0,0.391,0.431,1,2014-10-30,1,1,0,1.0,2,0,2,0.0
21400004,1610612766,1610612749,108.0,106.0,0.406,0.488,1,2014-10-29,1,1,0,1.0,1,0,1,0.0
21400005,1610612754,1610612755,103.0,91.0,0.469,0.382,1,2014-10-29,1,1,0,1.0,1,0,1,0.0
21400006,1610612738,1610612751,121.0,105.0,0.557,0.488,1,2014-10-29,1,1,0,1.0,1,0,1,0.0
21400007,1610612748,1610612764,107.0,95.0,0.481,0.48,1,2014-10-29,1,1,0,1.0,1,0,1,0.0
21400008,1610612761,1610612737,109.0,102.0,0.411,0.5,1,2014-10-29,1,1,0,1.0,1,0,1,0.0
21400009,1610612763,1610612750,105.0,101.0,0.524,0.4529999999999999,1,2014-10-29,1,1,0,1.0,1,0,1,0.0
21400010,1610612752,1610612741,80.0,104.0,0.365,0.507,0,2014-10-29,1,0,1,0.0,1,1,0,1.0
21400011,1610612743,1610612765,89.0,79.0,0.353,0.369,1,2014-10-29,1,1,0,1.0,1,0,1,0.0
21400012,1610612762,1610612745,93.0,104.0,0.469,0.519,0,2014-10-29,1,0,1,0.0,2,2,0,1.0
21400013,1610612756,1610612747,119.0,99.0,0.5489999999999999,0.43,1,2014-10-29,1,1,0,1.0,2,0,2,0.0
21400014,1610612758,1610612744,77.0,95.0,0.308,0.44,0,2014-10-29,1,0,1,0.0,1,1,0,1.0
21400015,1610612757,1610612760,106.0,89.0,0.4479999999999999,0.407,1,2014-10-29,1,1,0,1.0,1,0,1,0.0
21400001,1610612740,1610612753,101.0,84.0,0.406,0.381,1,2014-10-28,1,1,0,1.0,1,0,1,0.0
21400002,1610612759,1610612742,101.0,100.0,0.529,0.487,1,2014-10-28,1,1,0,1.0,1,0,1,0.0
21400003,1610612747,1610612745,90.0,108.0,0.354,0.425,0,2014-10-28,1,0,1,0.0,1,1,0,1.0
11400110,1610612753,1610612742,92.0,117.0,0.4629999999999999,0.551,0,2014-10-24,8,4,4,0.5,8,4,4,0.5
11400116,1610612761,1610612752,83.0,80.0,0.418,0.326,1,2014-10-24,8,7,1,0.875,7,3,4,0.429
11400111,1610612741,1610612750,112.0,113.0,0.424,0.519,0,2014-10-24,8,4,4,0.5,7,5,2,0.7140000000000001
11400112,1610612763,1610612748,98.0,104.0,0.434,0.5429999999999999,0,2014-10-24,8,3,5,0.375,8,4,4,0.5
11400113,1610612745,1610612759,96.0,87.0,0.422,0.406,1,2014-10-24,8,6,2,0.75,7,2,5,0.286
11400114,1610612762,1610612756,100.0,105.0,0.418,0.456,0,2014-10-24,8,5,3,0.625,7,5,2,0.7140000000000001
11400115,1610612747,1610612758,92.0,93.0,0.4629999999999999,0.41,0,2014-10-24,8,3,5,0.375,7,3,4,0.429
11400117,1610612744,1610612743,119.0,112.0,0.512,0.5,1,2014-10-24,8,6,2,0.75,8,2,6,0.25
11400118,1610612746,1610612757,89.0,99.0,0.455,0.4320000000000001,0,2014-10-24,8,2,6,0.25,7,4,3,0.5710000000000001
11400107,1610612766,1610612754,79.0,88.0,0.37,0.451,0,2014-10-23,8,3,5,0.375,7,3,4,0.429
11400109,1610612765,1610612755,109.0,103.0,0.486,0.473,1,2014-10-23,7,5,2,0.7140000000000001,8,2,6,0.25
11400108,1610612740,1610612742,88.0,85.0,0.368,0.3929999999999999,1,2014-10-23,7,5,2,0.7140000000000001,7,3,4,0.429
11400098,1610612753,1610612745,89.0,90.0,0.4379999999999999,0.365,0,2014-10-22,7,4,3,0.5710000000000001,7,5,2,0.7140000000000001
11400102,1610612738,1610612751,100.0,86.0,0.4579999999999999,0.387,1,2014-10-22,8,5,3,0.625,6,4,2,0.667
11400103,1610612752,1610612764,103.0,100.0,0.532,0.514,1,2014-10-22,6,3,3,0.5,8,4,4,0.5
11400099,1610612763,1610612739,96.0,92.0,0.4579999999999999,0.415,1,2014-10-22,7,3,4,0.429,7,5,2,0.7140000000000001
11400100,1610612749,1610612750,91.0,110.0,0.402,0.425,0,2014-10-22,7,3,4,0.429,6,4,2,0.667
11400105,1610612759,1610612737,107.0,117.0,0.532,0.519,0,2014-10-22,6,2,4,0.3329999999999999,7,4,3,0.5710000000000001
11400101,1610612747,1610612757,94.0,86.0,0.5,0.465,1,2014-10-22,7,3,4,0.429,6,3,3,0.5
11400106,1610612746,1610612756,108.0,105.0,0.494,0.4429999999999999,1,2014-10-22,7,2,5,0.286,6,4,2,0.667
11400092,1610612750,1610612754,107.0,89.0,0.506,0.423,1,2014-10-21,5,3,2,0.6,6,2,4,0.3329999999999999
11400093,1610612760,1610612762,91.0,105.0,0.42,0.4,0,2014-10-21,7,2,5,0.286,7,5,2,0.7140000000000001
11400097,1610612748,1610612745,90.0,85.0,0.466,0.395,1,2014-10-21,7,3,4,0.429,6,4,2,0.667
11400094,1610612743,1610612757,75.0,93.0,0.326,0.408,0,2014-10-21,7,2,5,0.286,5,3,2,0.6
11400095,1610612747,1610612756,108.0,114.0,0.5,0.413,0,2014-10-21,6,2,4,0.3329999999999999,5,4,1,0.8
11400096,1610612744,1610612746,125.0,107.0,0.59,0.386,1,2014-10-21,7,5,2,0.7140000000000001,6,1,5,0.1669999999999999
11400085,1610612764,1610612740,84.0,88.0,0.434,0.457,0,2014-10-20,7,4,3,0.5710000000000001,6,4,2,0.667
11400086,1610612739,1610612741,107.0,98.0,0.488,0.416,1,2014-10-20,6,5,1,0.833,7,4,3,0.5710000000000001
11400087,1610612751,1610612755,99.0,88.0,0.417,0.392,1,2014-10-20,5,4,1,0.8,7,2,5,0.286
11400088,1610612752,1610612749,107.0,120.0,0.3720000000000001,0.597,0,2014-10-20,5,2,3,0.4,6,3,3,0.5
11400089,1610612737,1610612766,117.0,114.0,0.452,0.446,1,2014-10-20,6,3,3,0.5,7,3,4,0.429
11400090,1610612742,1610612763,108.0,103.0,0.483,0.4320000000000001,1,2014-10-20,6,3,3,0.5,6,2,4,0.3329999999999999
11400091,1610612759,1610612758,106.0,99.0,0.4679999999999999,0.507,1,2014-10-20,5,2,3,0.4,6,2,4,0.3329999999999999
11400080,1610612751,1610612738,90.0,95.0,0.451,0.3779999999999999,0,2014-10-19,4,3,1,0.75,7,4,3,0.5710000000000001
11400081,1610612760,1610612750,94.0,112.0,0.41,0.466,0,2014-10-19,6,2,4,0.3329999999999999,4,2,2,0.5
11400083,1610612741,1610612766,101.0,96.0,0.4679999999999999,0.4429999999999999,1,2014-10-19,6,4,2,0.667,6,3,3,0.5
11400084,1610612745,1610612744,90.0,83.0,0.392,0.418,1,2014-10-19,5,4,1,0.8,6,4,2,0.667
11400082,1610612747,1610612762,98.0,91.0,0.4,0.485,1,2014-10-19,5,2,3,0.4,6,4,2,0.667
11400074,1610612754,1610612742,98.0,93.0,0.425,0.435,1,2014-10-18,5,2,3,0.4,5,2,3,0.4
11400076,1610612755,1610612753,95.0,84.0,0.442,0.3829999999999999,1,2014-10-18,6,2,4,0.3329999999999999,6,4,2,0.667
11400077,1610612737,1610612765,100.0,104.0,0.429,0.469,0,2014-10-18,5,2,3,0.4,6,4,2,0.667
11400078,1610612759,1610612748,108.0,111.0,0.413,0.455,0,2014-10-18,4,1,3,0.25,6,2,4,0.3329999999999999
11400079,1610612746,1610612743,93.0,104.0,0.37,0.4579999999999999,0,2014-10-18,5,1,4,0.2,6,2,4,0.3329999999999999
11400065,1610612764,1610612766,86.0,96.0,0.4,0.439,0,2014-10-17,6,4,2,0.667,5,3,2,0.6
11400066,1610612753,1610612765,99.0,87.0,0.462,0.375,1,2014-10-17,5,4,1,0.8,5,3,2,0.6
11400072,1610612739,1610612742,102.0,108.0,0.4589999999999999,0.4589999999999999,0,2014-10-17,5,4,1,0.8,4,2,2,0.5
11400068,1610612750,1610612749,98.0,105.0,0.422,0.457,0,2014-10-17,3,1,2,0.3329999999999999,5,2,3,0.4
11400069,1610612760,1610612761,90.0,109.0,0.3929999999999999,0.494,0,2014-10-17,5,2,3,0.4,6,5,1,0.833
11400071,1610612748,1610612744,115.0,108.0,0.557,0.487,1,2014-10-17,5,1,4,0.2,5,4,1,0.8
11400073,1610612746,1610612762,101.0,97.0,0.446,0.4429999999999999,1,2014-10-17,4,1,3,0.25,5,4,1,0.8
11400059,1610612755,1610612738,91.0,111.0,0.4,0.472,0,2014-10-16,5,1,4,0.2,6,3,3,0.5
11400060,1610612741,1610612737,85.0,84.0,0.3720000000000001,0.3879999999999999,1,2014-10-16,5,3,2,0.6,4,2,2,0.5
11400061,1610612740,1610612760,120.0,86.0,0.5539999999999999,0.391,1,2014-10-16,5,3,2,0.6,4,2,2,0.5
11400063,1610612744,1610612743,104.0,101.0,0.494,0.456,1,2014-10-16,4,4,0,1.0,5,1,4,0.2
11400062,1610612756,1610612759,121.0,90.0,0.556,0.444,1,2014-10-16,4,3,1,0.75,3,1,2,0.3329999999999999
11400064,1610612747,1610612762,86.0,119.0,0.41,0.512,0,2014-10-16,4,1,3,0.25,4,4,0,1.0
11400058,1610612751,1610612758,129.0,117.0,0.512,0.4589999999999999,1,2014-10-15,3,3,0,1.0,4,1,3,0.25
11400053,1610612766,1610612765,84.0,104.0,0.341,0.476,0,2014-10-15,4,2,2,0.5,4,3,1,0.75
11400056,1610612739,1610612754,98.0,93.0,0.44,0.4,1,2014-10-15,4,4,0,1.0,4,1,3,0.25
11400057,1610612738,1610612761,89.0,92.0,0.41,0.425,0,2014-10-15,5,2,3,0.4,5,4,1,0.8
11400048,1610612755,1610612752,77.0,84.0,0.381,0.441,0,2014-10-14,4,1,3,0.25,4,2,2,0.5
11400049,1610612739,1610612749,106.0,100.0,0.4529999999999999,0.4679999999999999,1,2014-10-14,3,3,0,1.0,4,1,3,0.25
11400052,1610612748,1610612737,103.0,109.0,0.439,0.488,0,2014-10-14,4,0,4,0.0,3,2,1,0.667
11400050,1610612740,1610612745,117.0,98.0,0.5379999999999999,0.407,1,2014-10-14,4,2,2,0.5,4,3,1,0.75
11400051,1610612760,1610612763,117.0,107.0,0.5329999999999999,0.506,1,2014-10-14,3,2,1,0.667,4,1,3,0.25
11400043,1610612766,1610612753,99.0,97.0,0.426,0.442,1,2014-10-13,3,2,1,0.667,3,2,1,0.667
11400047,1610612752,1610612761,76.0,81.0,0.3779999999999999,0.4029999999999999,0,2014-10-13,3,1,2,0.3329999999999999,4,3,1,0.75
11400044,1610612741,1610612743,110.0,90.0,0.456,0.4429999999999999,1,2014-10-13,4,2,2,0.5,4,1,3,0.25
11400045,1610612745,1610612756,95.0,92.0,0.405,0.434,1,2014-10-13,3,3,0,1.0,3,2,1,0.667
11400046,1610612762,1610612746,102.0,89.0,0.506,0.42,1,2014-10-13,3,3,0,1.0,3,0,3,0.0
11400039,1610612758,1610612751,95.0,97.0,0.425,0.444,0,2014-10-12,3,1,2,0.3329999999999999,2,2,0,1.0
11400038,1610612764,1610612765,91.0,89.0,0.426,0.4629999999999999,1,2014-10-12,4,3,1,0.75,3,2,1,0.667
11400041,1610612742,1610612754,106.0,98.0,0.456,0.486,1,2014-10-12,3,1,2,0.3329999999999999,3,1,2,0.3329999999999999
11400040,1610612757,1610612746,119.0,114.0,0.539,0.436,1,2014-10-12,3,1,2,0.3329999999999999,2,0,2,0.0
11400042,1610612747,1610612744,75.0,116.0,0.366,0.562,0,2014-10-12,3,1,2,0.3329999999999999,3,3,0,1.0
11400033,1610612748,1610612739,119.0,122.0,0.465,0.506,0,2014-10-11,3,0,3,0.0,2,2,0,1.0
11400036,1610612738,1610612752,80.0,96.0,0.375,0.526,0,2014-10-11,4,2,2,0.5,2,1,1,0.5
11400035,1610612763,1610612737,93.0,88.0,0.434,0.4270000000000001,1,2014-10-11,3,1,2,0.3329999999999999,2,1,1,0.5
11400037,1610612749,1610612741,85.0,91.0,0.353,0.423,0,2014-10-11,3,1,2,0.3329999999999999,3,1,2,0.3329999999999999
11400027,1610612766,1610612764,99.0,86.0,0.4270000000000001,0.373,1,2014-10-10,2,1,1,0.5,3,2,1,0.667
11400028,1610612754,1610612753,93.0,96.0,0.3829999999999999,0.488,0,2014-10-10,2,1,1,0.5,2,2,0,1.0
11400031,1610612761,1610612738,116.0,109.0,0.5,0.493,1,2014-10-10,3,2,1,0.667,3,2,1,0.667
11400029,1610612750,1610612755,116.0,110.0,0.485,0.537,1,2014-10-10,2,1,1,0.5,3,1,2,0.3329999999999999
11400032,1610612742,1610612760,109.0,118.0,0.413,0.481,0,2014-10-10,2,0,2,0.0,2,1,1,0.5
11400030,1610612756,1610612743,97.0,89.0,0.3929999999999999,0.402,1,2014-10-10,2,2,0,1.0,3,1,2,0.3329999999999999
11400025,1610612765,1610612749,94.0,80.0,0.3829999999999999,0.365,1,2014-10-09,2,2,0,1.0,2,1,1,0.5
11400023,1610612745,1610612763,113.0,93.0,0.42,0.392,1,2014-10-09,2,2,0,1.0,2,0,2,0.0
11400024,1610612757,1610612762,105.0,109.0,0.4629999999999999,0.5429999999999999,0,2014-10-09,2,0,2,0.0,2,2,0,1.0
11400026,1610612747,1610612744,105.0,120.0,0.4379999999999999,0.56,0,2014-10-09,2,1,1,0.5,2,2,0,1.0
11400016,1610612755,1610612766,106.0,92.0,0.422,0.368,1,2014-10-08,2,1,1,0.5,1,0,1,0.0
11400018,1610612740,1610612764,89.0,94.0,0.364,0.486,0,2014-10-08,3,1,2,0.3329999999999999,2,2,0,1.0
11400021,1610612738,1610612752,106.0,86.0,0.488,0.406,1,2014-10-08,2,2,0,1.0,1,0,1,0.0
11400017,1610612749,1610612763,86.0,83.0,0.413,0.41,1,2014-10-08,1,1,0,1.0,1,0,1,0.0
11400019,1610612743,1610612760,114.0,101.0,0.569,0.37,1,2014-10-08,2,1,1,0.5,1,0,1,0.0
11400008,1610612754,1610612750,103.0,90.0,0.482,0.3720000000000001,1,2014-10-07,1,1,0,1.0,1,0,1,0.0
11400012,1610612748,1610612753,101.0,108.0,0.3939999999999999,0.455,0,2014-10-07,2,0,2,0.0,1,1,0,1.0
11400013,1610612765,1610612741,111.0,109.0,0.415,0.467,1,2014-10-07,1,1,0,1.0,2,0,2,0.0
11400014,1610612742,1610612745,108.0,111.0,0.406,0.462,0,2014-10-07,1,0,1,0.0,1,1,0,1.0
11400009,1610612762,1610612757,92.0,73.0,0.442,0.346,1,2014-10-07,1,1,0,1.0,1,0,1,0.0
11400010,1610612758,1610612761,113.0,106.0,0.552,0.488,1,2014-10-07,2,1,1,0.5,2,1,1,0.5
11400015,1610612746,1610612744,94.0,112.0,0.407,0.486,0,2014-10-07,1,0,1,0.0,1,1,0,1.0
11400006,1610612738,1610612755,98.0,78.0,0.341,0.4029999999999999,1,2014-10-06,1,1,0,1.0,1,0,1,0.0
11400007,1610612737,1610612740,93.0,87.0,0.419,0.366,1,2014-10-06,1,1,0,1.0,2,1,1,0.5
11400004,1610612741,1610612764,81.0,85.0,0.3379999999999999,0.411,0,2014-10-06,1,0,1,0.0,1,1,0,1.0
11400005,1610612747,1610612743,98.0,95.0,0.4479999999999999,0.387,1,2014-10-06,1,1,0,1.0,1,0,1,0.0
11400002,1610612761,1610612758,99.0,94.0,0.44,0.469,1,2014-10-05,1,1,0,1.0,1,0,1,0.0
11400001,1610612748,1610612740,86.0,98.0,0.431,0.462,0,2014-10-04,1,0,1,0.0,1,1,0,1.0
